Year,Code,Destination,Country or area of origin,TotalMigrantStocks,MaleMigrantStocks,FemaleMigrantStocks
1990,108,Burundi,Other South,50676,24837,25839
1990,174,Comoros,Other South,847,432,415
1990,262,Djibouti,Other South,5484,3056,2428
1990,232,Eritrea,Other South,737,390,347
1990,231,Ethiopia,Other South,22075,11603,10472
1990,404,Kenya,Other South,65948,37825,28123
1990,450,Madagascar,Other South,2851,1590,1261
1990,454,Malawi,Other South,19158,7903,11255
1990,480,Mauritius,Other South,292,132,160
1990,175,Mayotte,Other South,1354,697,657
1990,508,Mozambique,Other South,2148,1157,991
1990,638,Réunion,Other South,6776,3450,3326
1990,646,Rwanda,Other South,19265,9357,9908
1990,690,Seychelles,Other South,493,261,232
1990,706,Somalia,Other South,12196,6227,5969
1990,800,Uganda,Other South,19697,10183,9514
1990,834,United Republic of Tanzania,Other South,2845,1441,1404
1990,894,Zambia,Other South,6228,3257,2971
1990,716,Zimbabwe,Other South,20017,11350,8667
1990,24,Angola,Other South,2953,1548,1405
1990,120,Cameroon,Other South,40119,23804,16315
1990,140,Central African Republic,Other South,7445,3992,3453
1990,148,Chad,Other South,4986,2692,2294
1990,178,Congo,Other South,5934,3209,2725
1990,180,Democratic Republic of the Congo,Other South,60792,29264,31528
1990,226,Equatorial Guinea,Other South,365,228,137
1990,266,Gabon,Other South,2721,1834,887
1990,678,Sao Tome and Principe,Other South,74,32,42
1990,72,Botswana,Other South,1150,760,390
1990,748,Eswatini,Other South,5693,2850,2843
1990,426,Lesotho,Other South,1092,591,501
1990,516,Namibia,Other South,2568,1281,1287
1990,710,South Africa,Other South,86678,45550,41128
1990,204,Benin,Other South,7171,3806,3365
1990,854,Burkina Faso,Other South,16390,8152,8238
1990,132,Cabo Verde,Other South,787,401,386
1990,384,Côte d'Ivoire,Other South,12155,6782,5373
1990,270,Gambia,Other South,2293,1443,850
1990,288,Ghana,Other South,6779,2591,4188
1990,324,Guinea,Other South,909,631,278
1990,624,Guinea-Bissau,Other South,262,133,129
1990,430,Liberia,Other South,14804,7820,6984
1990,466,Mali,Other South,16035,8436,7599
1990,478,Mauritania,Other South,1371,644,727
1990,562,Niger,Other South,7620,3960,3660
1990,566,Nigeria,Other South,142800,80106,62694
1990,654,Saint Helena,Other South,10,5,5
1990,686,Senegal,Other South,23993,10958,13035
1990,694,Sierra Leone,Other South,386,211,175
1990,768,Togo,Other South,9000,2504,6496
1990,12,Algeria,Other South,11498,6762,4736
1990,818,Egypt,Other South,7163,3602,3561
1990,504,Morocco,Other South,7760,4103,3657
1990,729,Sudan,Other South,33284,17112,16172
1990,788,Tunisia,Other South,3707,1844,1863
1990,732,Western Sahara,Other South,65,36,29
1990,51,Armenia,Other South,52293,22629,29664
1990,31,Azerbaijan,Other South,2348,1120,1228
1990,48,Bahrain,Other South,1979,1203,776
1990,196,Cyprus,Other South,93,53,40
1990,268,Georgia,Other South,11464,6851,4613
1990,368,Iraq,Other South,19446,10882,8564
1990,376,Israel,Other South,16296,7840,8456
1990,400,Jordan,Other South,1512,731,781
1990,414,Kuwait,Other South,19716,9873,9843
1990,422,Lebanon,Other South,2707,1222,1485
1990,512,Oman,Other South,3379,2163,1216
1990,634,Qatar,Other South,3538,2222,1316
1990,682,Saudi Arabia,Other South,138673,92243,46430
1990,275,State of Palestine,Other South,20734,9957,10777
1990,760,Syrian Arab Republic,Other South,453300,231317,221983
1990,792,Turkey,Other South,183532,90319,93213
1990,784,United Arab Emirates,Other South,14989,9051,5938
1990,887,Yemen,Other South,26690,14807,11883
1990,398,Kazakhstan,Other South,202797,94904,107893
1990,417,Kyrgyzstan,Other South,6818,2794,4024
1990,762,Tajikistan,Other South,309,141,168
1990,795,Turkmenistan,Other South,1262,666,596
1990,860,Uzbekistan,Other South,43369,20225,23144
1990,4,Afghanistan,Other South,4677,2640,2037
1990,50,Bangladesh,Other South,42072,27467,14605
1990,64,Bhutan,Other South,456,353,103
1990,356,India,Other South,193458,97357,96101
1990,364,Iran (Islamic Republic of),Other South,828,474,354
1990,462,Maldives,Other South,82,45,37
1990,524,Nepal,Other South,17551,5406,12145
1990,586,Pakistan,Other South,3325,1902,1423
1990,144,Sri Lanka,Other South,1035,584,451
1990,156,China,Other South,62366,28985,33381
1990,344,"China, Hong Kong SAR",Other South,189176,72426,116750
1990,446,"China, Macao SAR",Other South,3415,1798,1617
1990,408,Dem. People's Republic of Korea,Other South,2473,1022,1451
1990,392,Japan,Other South,8616,4390,4226
1990,496,Mongolia,Other South,506,261,245
1990,410,Republic of Korea,Other South,1563,875,688
1990,96,Brunei Darussalam,Other South,600,330,270
1990,116,Cambodia,Other South,3962,2125,1837
1990,360,Indonesia,Other South,31731,15385,16346
1990,418,Lao People's Democratic Republic,Other South,484,278,206
1990,458,Malaysia,Other South,53583,30427,23156
1990,104,Myanmar,Other South,8835,4477,4358
1990,608,Philippines,Other South,13018,5846,7172
1990,702,Singapore,Other South,132943,63914,69029
1990,764,Thailand,Other South,17,13,4
1990,626,Timor-Leste,Other South,948,489,459
1990,704,Viet Nam,Other South,434,220,214
1990,660,Anguilla,Other South,581,196,385
1990,28,Antigua and Barbuda,Other South,743,357,386
1990,533,Aruba,Other South,1673,826,847
1990,44,Bahamas,Other South,962,478,484
1990,52,Barbados,Other South,2997,1419,1578
1990,92,British Virgin Islands,Other South,182,94,88
1990,535,"Bonaire, Sint Eustatius and Saba",Other South,404,210,194
1990,136,Cayman Islands,Other South,21,11,10
1990,192,Cuba,Other South,3726,1956,1770
1990,212,Dominica,Other South,389,198,191
1990,214,Dominican Republic,Other South,300,167,133
1990,308,Grenada,Other South,416,205,211
1990,312,Guadeloupe,Other South,3061,1473,1588
1990,332,Haiti,Other South,951,518,433
1990,388,Jamaica,Other South,2130,1069,1061
1990,474,Martinique,Other South,1029,740,289
1990,500,Montserrat,Other South,325,164,161
1990,630,Puerto Rico,Other South,2883,1365,1518
1990,659,Saint Kitts and Nevis,Other South,1138,603,535
1990,662,Saint Lucia,Other South,1100,589,511
1990,670,Saint Vincent and the Grenadines,Other South,211,109,102
1990,780,Trinidad and Tobago,Other South,3016,1423,1593
1990,796,Turks and Caicos Islands,Other South,233,121,112
1990,850,United States Virgin Islands,Other South,4427,2202,2225
1990,84,Belize,Other South,888,515,373
1990,188,Costa Rica,Other South,207798,105633,102165
1990,222,El Salvador,Other South,183,99,84
1990,320,Guatemala,Other South,60,13,47
1990,340,Honduras,Other South,87,59,28
1990,484,Mexico,Other South,1425,618,807
1990,558,Nicaragua,Other South,920,492,428
1990,591,Panama,Other South,201,130,71
1990,32,Argentina,Other South,59169,26252,32917
1990,68,Bolivia (Plurinational State of),Other South,261,129,132
1990,76,Brazil,Other South,21752,12283,9469
1990,170,Colombia,Other South,208,107,101
1990,218,Ecuador,Other South,170,94,76
1990,238,Falkland Islands (Malvinas),Other South,11,7,4
1990,254,French Guiana,Other South,2477,1321,1156
1990,328,Guyana,Other South,296,163,133
1990,600,Paraguay,Other South,5461,3160,2301
1990,604,Peru,Other South,329,117,212
1990,740,Suriname,Other South,5268,2854,2414
1990,858,Uruguay,Other South,4244,939,3305
1990,862,Venezuela (Bolivarian Republic of),Other South,256,206,50
1990,36,Australia,Other South,6240,3263,2977
1990,554,New Zealand,Other South,13630,7096,6534
1990,242,Fiji,Other South,1434,765,669
1990,540,New Caledonia,Other South,1064,594,470
1990,598,Papua New Guinea,Other South,1414,792,622
1990,90,Solomon Islands,Other South,219,105,114
1990,548,Vanuatu,Other South,619,345,274
1990,316,Guam,Other South,1446,769,677
1990,296,Kiribati,Other South,188,112,76
1990,584,Marshall Islands,Other South,104,72,32
1990,583,Micronesia (Fed. States of),Other South,1899,1080,819
1990,520,Nauru,Other South,166,82,84
1990,580,Northern Mariana Islands,Other South,934,297,637
1990,585,Palau,Other South,100,62,38
1990,16,American Samoa,Other South,598,309,289
1990,184,Cook Islands,Other South,49,34,15
1990,258,French Polynesia,Other South,2929,1471,1458
1990,570,Niue,Other South,16,7,9
1990,882,Samoa,Other South,177,90,87
1990,772,Tokelau,Other South,21,11,10
1990,776,Tonga,Other South,962,475,487
1990,798,Tuvalu,Other South,34,17,17
1990,876,Wallis and Futuna Islands,Other South,7,4,3
1990,112,Belarus,Other South,78,54,24
1990,100,Bulgaria,Other South,604,253,351
1990,348,Hungary,Other South,1692,684,1008
1990,616,Poland,Other South,40795,17550,23245
1990,498,Republic of Moldova,Other South,1810,882,928
1990,642,Romania,Other South,2304,891,1413
1990,643,Russian Federation,Other South,7222,3539,3683
1990,703,Slovakia,Other South,100,63,37
1990,804,Ukraine,Other South,181039,71589,109450
1990,830,Channel Islands,Other South,357,169,188
1990,233,Estonia,Other South,107,58,49
1990,234,Faroe Islands,Other South,104,61,43
1990,246,Finland,Other South,532,260,272
1990,833,Isle of Man,Other South,554,259,295
1990,440,Lithuania,Other South,3598,1706,1892
1990,578,Norway,Other South,5524,3166,2358
1990,752,Sweden,Other South,250,117,133
1990,826,United Kingdom,Other South,2277,1297,980
1990,8,Albania,Other South,1441,370,1071
1990,20,Andorra,Other South,189,148,41
1990,70,Bosnia and Herzegovina,Other South,727,313,414
1990,191,Croatia,Other South,25954,12531,13423
1990,292,Gibraltar,Other South,347,186,161
1990,336,Holy See,Other South,362,177,185
1990,470,Malta,Other South,98,37,61
1990,807,North Macedonia,Other South,912,380,532
1990,620,Portugal,Other South,3103,1431,1672
1990,674,San Marino,Other South,60,28,32
1990,688,Serbia,Other South,68,35,33
1990,705,Slovenia,Other South,916,470,446
1990,724,Spain,Other South,3416,1333,2083
1990,56,Belgium,Other South,10495,2810,7685
1990,276,Germany,Other South,74364,43027,31337
1990,438,Liechtenstein,Other South,11,2,9
1990,442,Luxembourg,Other South,336,136,200
1990,492,Monaco,Other South,2735,1252,1483
1990,528,Netherlands,Other South,1925,995,930
1990,756,Switzerland,Other South,56558,40199,16359
1990,60,Bermuda,Other South,624,307,317
1990,124,Canada,Other South,2205,1104,1101
1990,304,Greenland,Other South,24,7,17
1990,666,Saint Pierre and Miquelon,Other South,154,90,64
1990,840,United States of America,Other South,2920646,1585134,1335512
1995,108,Burundi,Other South,33396,16284,17112
1995,174,Comoros,Other South,839,426,413
1995,262,Djibouti,Other South,4478,2497,1981
1995,232,Eritrea,Other South,935,461,474
1995,231,Ethiopia,Other South,31136,18556,12580
1995,404,Kenya,Other South,69611,39001,30610
1995,450,Madagascar,Other South,2523,1418,1105
1995,454,Malawi,Other South,39468,20408,19060
1995,480,Mauritius,Other South,411,221,190
1995,175,Mayotte,Other South,703,385,318
1995,508,Mozambique,Other South,2952,1598,1354
1995,638,Réunion,Other South,6979,3429,3550
1995,646,Rwanda,Other South,13004,6257,6747
1995,690,Seychelles,Other South,396,226,170
1995,706,Somalia,Other South,988,528,460
1995,800,Uganda,Other South,18425,9229,9196
1995,834,United Republic of Tanzania,Other South,3574,1805,1769
1995,894,Zambia,Other South,9277,5207,4070
1995,716,Zimbabwe,Other South,29659,16922,12737
1995,24,Angola,Other South,3427,1730,1697
1995,120,Cameroon,Other South,35335,21015,14320
1995,140,Central African Republic,Other South,17851,9809,8042
1995,148,Chad,Other South,5416,2921,2495
1995,178,Congo,Other South,4541,2385,2156
1995,180,Democratic Republic of the Congo,Other South,67362,33304,34058
1995,226,Equatorial Guinea,Other South,482,302,180
1995,266,Gabon,Other South,3638,2451,1187
1995,678,Sao Tome and Principe,Other South,68,30,38
1995,72,Botswana,Other South,4356,2542,1814
1995,748,Eswatini,Other South,6443,3153,3290
1995,426,Lesotho,Other South,1047,578,469
1995,516,Namibia,Other South,2477,1228,1249
1995,710,South Africa,Other South,38038,20328,17710
1995,204,Benin,Other South,9870,5303,4567
1995,854,Burkina Faso,Other South,20390,10159,10231
1995,132,Cabo Verde,Other South,519,272,247
1995,384,Côte d'Ivoire,Other South,20279,11015,9264
1995,270,Gambia,Other South,2829,1738,1091
1995,288,Ghana,Other South,6755,2982,3773
1995,324,Guinea,Other South,1321,921,400
1995,624,Guinea-Bissau,Other South,590,300,290
1995,430,Liberia,Other South,13407,7308,6099
1995,466,Mali,Other South,16808,8828,7980
1995,478,Mauritania,Other South,1453,761,692
1995,562,Niger,Other South,7747,4072,3675
1995,566,Nigeria,Other South,86999,48491,38508
1995,654,Saint Helena,Other South,7,3,4
1995,686,Senegal,Other South,24540,11133,13407
1995,694,Sierra Leone,Other South,389,210,179
1995,768,Togo,Other South,9456,2379,7077
1995,12,Algeria,Other South,8871,5003,3868
1995,818,Egypt,Other South,6820,3428,3392
1995,504,Morocco,Other South,7119,3713,3406
1995,729,Sudan,Other South,33853,17441,16412
1995,788,Tunisia,Other South,3742,1884,1858
1995,732,Western Sahara,Other South,77,44,33
1995,51,Armenia,Other South,21785,9327,12458
1995,31,Azerbaijan,Other South,2070,1054,1016
1995,48,Bahrain,Other South,3621,2031,1590
1995,196,Cyprus,Other South,132,73,59
1995,268,Georgia,Other South,1983,1336,647
1995,368,Iraq,Other South,22927,9454,13473
1995,376,Israel,Other South,18701,8588,10113
1995,400,Jordan,Other South,1662,804,858
1995,414,Kuwait,Other South,21240,11243,9997
1995,422,Lebanon,Other South,2631,1169,1462
1995,512,Oman,Other South,14193,8817,5376
1995,634,Qatar,Other South,6192,3960,2232
1995,682,Saudi Arabia,Other South,142112,94779,47333
1995,275,State of Palestine,Other South,20262,9678,10584
1995,760,Syrian Arab Republic,Other South,523154,267660,255494
1995,792,Turkey,Other South,144020,69661,74359
1995,784,United Arab Emirates,Other South,33691,19733,13958
1995,887,Yemen,Other South,30180,16242,13938
1995,398,Kazakhstan,Other South,149889,70413,79476
1995,417,Kyrgyzstan,Other South,5221,1954,3267
1995,762,Tajikistan,Other South,259,115,144
1995,795,Turkmenistan,Other South,1207,762,445
1995,860,Uzbekistan,Other South,50740,23730,27010
1995,4,Afghanistan,Other South,12059,5543,6516
1995,50,Bangladesh,Other South,45496,29125,16371
1995,64,Bhutan,Other South,536,415,121
1995,356,India,Other South,29415,12452,16963
1995,364,Iran (Islamic Republic of),Other South,45540,26070,19470
1995,462,Maldives,Other South,554,277,277
1995,524,Nepal,Other South,36715,16029,20686
1995,586,Pakistan,Other South,2801,1599,1202
1995,144,Sri Lanka,Other South,1049,589,460
1995,156,China,Other South,80708,34924,45784
1995,344,"China, Hong Kong SAR",Other South,261185,81856,179329
1995,446,"China, Macao SAR",Other South,3746,1942,1804
1995,408,Dem. People's Republic of Korea,Other South,2897,1094,1803
1995,392,Japan,Other South,19149,9198,9951
1995,496,Mongolia,Other South,561,287,274
1995,410,Republic of Korea,Other South,4154,2311,1843
1995,96,Brunei Darussalam,Other South,658,368,290
1995,116,Cambodia,Other South,4002,2147,1855
1995,360,Indonesia,Other South,20994,10462,10532
1995,418,Lao People's Democratic Republic,Other South,1855,1052,803
1995,458,Malaysia,Other South,56734,32305,24429
1995,104,Myanmar,Other South,8893,4751,4142
1995,608,Philippines,Other South,17561,7673,9888
1995,702,Singapore,Other South,122922,60211,62711
1995,764,Thailand,Other South,29,21,8
1995,626,Timor-Leste,Other South,1049,530,519
1995,704,Viet Nam,Other South,939,507,432
1995,660,Anguilla,Other South,755,241,514
1995,28,Antigua and Barbuda,Other South,430,213,217
1995,533,Aruba,Other South,1636,797,839
1995,44,Bahamas,Other South,611,304,307
1995,52,Barbados,Other South,3272,1577,1695
1995,92,British Virgin Islands,Other South,419,213,206
1995,535,"Bonaire, Sint Eustatius and Saba",Other South,842,435,407
1995,136,Cayman Islands,Other South,20,11,9
1995,192,Cuba,Other South,2822,1432,1390
1995,212,Dominica,Other South,350,179,171
1995,214,Dominican Republic,Other South,334,182,152
1995,308,Grenada,Other South,545,267,278
1995,312,Guadeloupe,Other South,3440,1627,1813
1995,332,Haiti,Other South,915,492,423
1995,388,Jamaica,Other South,2274,1156,1118
1995,474,Martinique,Other South,1030,605,425
1995,500,Montserrat,Other South,260,132,128
1995,630,Puerto Rico,Other South,3071,1454,1617
1995,659,Saint Kitts and Nevis,Other South,1505,806,699
1995,662,Saint Lucia,Other South,1551,845,706
1995,670,Saint Vincent and the Grenadines,Other South,219,113,106
1995,780,Trinidad and Tobago,Other South,2738,1289,1449
1995,796,Turks and Caicos Islands,Other South,399,207,192
1995,850,United States Virgin Islands,Other South,3170,1578,1592
1995,84,Belize,Other South,920,532,388
1995,188,Costa Rica,Other South,160059,79586,80473
1995,222,El Salvador,Other South,140,75,65
1995,320,Guatemala,Other South,42,19,23
1995,340,Honduras,Other South,86,58,28
1995,484,Mexico,Other South,1478,679,799
1995,558,Nicaragua,Other South,743,393,350
1995,591,Panama,Other South,344,181,163
1995,32,Argentina,Other South,57776,26012,31764
1995,68,Bolivia (Plurinational State of),Other South,282,138,144
1995,76,Brazil,Other South,22228,12526,9702
1995,170,Colombia,Other South,194,102,92
1995,218,Ecuador,Other South,12650,6807,5843
1995,238,Falkland Islands (Malvinas),Other South,14,9,5
1995,254,French Guiana,Other South,2751,1411,1340
1995,328,Guyana,Other South,478,266,212
1995,600,Paraguay,Other South,4178,2252,1926
1995,604,Peru,Other South,305,117,188
1995,740,Suriname,Other South,6479,3506,2973
1995,858,Uruguay,Other South,4730,1633,3097
1995,862,Venezuela (Bolivarian Republic of),Other South,1297,741,556
1995,36,Australia,Other South,27180,12816,14364
1995,554,New Zealand,Other South,24828,12501,12327
1995,242,Fiji,Other South,1413,747,666
1995,540,New Caledonia,Other South,1233,680,553
1995,598,Papua New Guinea,Other South,1462,732,730
1995,90,Solomon Islands,Other South,215,106,109
1995,548,Vanuatu,Other South,882,460,422
1995,316,Guam,Other South,1518,758,760
1995,296,Kiribati,Other South,186,106,80
1995,584,Marshall Islands,Other South,133,91,42
1995,583,Micronesia (Fed. States of),Other South,1722,1091,631
1995,520,Nauru,Other South,157,77,80
1995,580,Northern Mariana Islands,Other South,1085,379,706
1995,585,Palau,Other South,170,96,74
1995,16,American Samoa,Other South,598,306,292
1995,184,Cook Islands,Other South,51,35,16
1995,258,French Polynesia,Other South,3217,1575,1642
1995,570,Niue,Other South,22,10,12
1995,882,Samoa,Other South,192,96,96
1995,772,Tokelau,Other South,18,10,8
1995,776,Tonga,Other South,1068,539,529
1995,798,Tuvalu,Other South,43,22,21
1995,876,Wallis and Futuna Islands,Other South,11,7,4
1995,112,Belarus,Other South,105,72,33
1995,100,Bulgaria,Other South,522,215,307
1995,348,Hungary,Other South,1336,530,806
1995,616,Poland,Other South,34969,14706,20263
1995,498,Republic of Moldova,Other South,1190,564,626
1995,642,Romania,Other South,2007,996,1011
1995,643,Russian Federation,Other South,7322,3717,3605
1995,703,Slovakia,Other South,40,19,21
1995,804,Ukraine,Other South,175142,72257,102885
1995,830,Channel Islands,Other South,350,165,185
1995,233,Estonia,Other South,96,52,44
1995,234,Faroe Islands,Other South,70,33,37
1995,246,Finland,Other South,482,246,236
1995,833,Isle of Man,Other South,560,261,299
1995,440,Lithuania,Other South,3659,1755,1904
1995,578,Norway,Other South,8990,5033,3957
1995,752,Sweden,Other South,330,203,127
1995,826,United Kingdom,Other South,8879,4084,4795
1995,8,Albania,Other South,1558,407,1151
1995,20,Andorra,Other South,1130,645,485
1995,70,Bosnia and Herzegovina,Other South,611,269,342
1995,191,Croatia,Other South,27593,13054,14539
1995,292,Gibraltar,Other South,384,206,178
1995,336,Holy See,Other South,345,168,177
1995,380,Italy,Other South,4,1,3
1995,470,Malta,Other South,142,52,90
1995,807,North Macedonia,Other South,853,355,498
1995,620,Portugal,Other South,3564,1597,1967
1995,674,San Marino,Other South,59,28,31
1995,688,Serbia,Other South,2436,1719,717
1995,705,Slovenia,Other South,918,480,438
1995,724,Spain,Other South,5128,2088,3040
1995,56,Belgium,Other South,21004,4440,16564
1995,276,Germany,Other South,74262,41324,32938
1995,438,Liechtenstein,Other South,26,8,18
1995,442,Luxembourg,Other South,271,123,148
1995,492,Monaco,Other South,3018,1424,1594
1995,528,Netherlands,Other South,2932,1419,1513
1995,756,Switzerland,Other South,40786,27330,13456
1995,60,Bermuda,Other South,633,270,363
1995,124,Canada,Other South,2515,1263,1252
1995,304,Greenland,Other South,33,23,10
1995,666,Saint Pierre and Miquelon,Other South,173,96,77
1995,840,United States of America,Other South,1842706,1021285,821421
2000,108,Burundi,Other South,9438,4588,4850
2000,174,Comoros,Other South,831,420,411
2000,262,Djibouti,Other South,4513,2520,1993
2000,232,Eritrea,Other South,1132,531,601
2000,231,Ethiopia,Other South,46100,29055,17045
2000,404,Kenya,Other South,46659,24274,22385
2000,450,Madagascar,Other South,2804,1582,1222
2000,454,Malawi,Other South,37999,19598,18401
2000,480,Mauritius,Other South,736,392,344
2000,175,Mayotte,Other South,262,147,115
2000,508,Mozambique,Other South,3430,1806,1624
2000,638,Réunion,Other South,7505,3536,3969
2000,646,Rwanda,Other South,7106,4065,3041
2000,690,Seychelles,Other South,291,190,101
2000,706,Somalia,Other South,13033,6895,6138
2000,800,Uganda,Other South,2474,1376,1098
2000,834,United Republic of Tanzania,Other South,5459,2762,2697
2000,894,Zambia,Other South,4209,2345,1864
2000,716,Zimbabwe,Other South,38322,21846,16476
2000,24,Angola,Other South,3909,1911,1998
2000,120,Cameroon,Other South,33273,19717,13556
2000,140,Central African Republic,Other South,26705,14769,11936
2000,148,Chad,Other South,5849,3150,2699
2000,178,Congo,Other South,4867,2449,2418
2000,180,Democratic Republic of the Congo,Other South,84662,41523,43139
2000,226,Equatorial Guinea,Other South,602,374,228
2000,266,Gabon,Other South,4551,3077,1474
2000,678,Sao Tome and Principe,Other South,67,28,39
2000,72,Botswana,Other South,19900,11944,7956
2000,748,Eswatini,Other South,6650,2953,3697
2000,426,Lesotho,Other South,963,545,418
2000,516,Namibia,Other South,2276,1148,1128
2000,710,South Africa,Other South,25812,15449,10363
2000,204,Benin,Other South,12564,6795,5769
2000,854,Burkina Faso,Other South,24840,12460,12380
2000,132,Cabo Verde,Other South,268,143,125
2000,384,Côte d'Ivoire,Other South,42276,22942,19334
2000,270,Gambia,Other South,3544,2143,1401
2000,288,Ghana,Other South,7556,2948,4608
2000,324,Guinea,Other South,2390,1559,831
2000,624,Guinea-Bissau,Other South,917,466,451
2000,430,Liberia,Other South,11474,6206,5268
2000,466,Mali,Other South,49739,24716,25023
2000,478,Mauritania,Other South,1829,1048,781
2000,562,Niger,Other South,7938,4217,3721
2000,566,Nigeria,Other South,34664,19193,15471
2000,654,Saint Helena,Other South,6,3,3
2000,686,Senegal,Other South,21783,9301,12482
2000,694,Sierra Leone,Other South,366,188,178
2000,768,Togo,Other South,12240,3761,8479
2000,12,Algeria,Other South,6243,3243,3000
2000,818,Egypt,Other South,8136,4359,3777
2000,504,Morocco,Other South,7498,3851,3647
2000,729,Sudan,Other South,34636,17878,16758
2000,788,Tunisia,Other South,4263,2169,2094
2000,732,Western Sahara,Other South,80,46,34
2000,51,Armenia,Other South,20693,8858,11835
2000,31,Azerbaijan,Other South,1660,838,822
2000,48,Bahrain,Other South,5275,2845,2430
2000,196,Cyprus,Other South,170,92,78
2000,268,Georgia,Other South,2192,860,1332
2000,368,Iraq,Other South,21728,5820,15908
2000,376,Israel,Other South,20058,8962,11096
2000,400,Jordan,Other South,1812,881,931
2000,414,Kuwait,Other South,31017,17096,13921
2000,422,Lebanon,Other South,2554,1116,1438
2000,512,Oman,Other South,21023,13581,7442
2000,634,Qatar,Other South,7923,5119,2804
2000,682,Saudi Arabia,Other South,146006,95583,50423
2000,275,State of Palestine,Other South,19790,9398,10392
2000,760,Syrian Arab Republic,Other South,432347,221095,211252
2000,792,Turkey,Other South,104668,48928,55740
2000,784,United Arab Emirates,Other South,54383,31435,22948
2000,887,Yemen,Other South,28741,15426,13315
2000,398,Kazakhstan,Other South,91973,43470,48503
2000,417,Kyrgyzstan,Other South,4222,1866,2356
2000,762,Tajikistan,Other South,233,103,130
2000,795,Turkmenistan,Other South,1551,822,729
2000,860,Uzbekistan,Other South,57866,27122,30744
2000,4,Afghanistan,Other South,9999,5643,4356
2000,50,Bangladesh,Other South,48917,30790,18127
2000,64,Bhutan,Other South,616,477,139
2000,356,India,Other South,32080,13429,18651
2000,364,Iran (Islamic Republic of),Other South,131944,78225,53719
2000,462,Maldives,Other South,990,545,445
2000,524,Nepal,Other South,35766,17591,18175
2000,586,Pakistan,Other South,2534,1446,1088
2000,144,Sri Lanka,Other South,1064,584,480
2000,156,China,Other South,99037,40864,58173
2000,344,"China, Hong Kong SAR",Other South,333211,91287,241924
2000,446,"China, Macao SAR",Other South,3615,1933,1682
2000,408,Dem. People's Republic of Korea,Other South,3333,1170,2163
2000,392,Japan,Other South,30121,13937,16184
2000,496,Mongolia,Other South,622,346,276
2000,410,Republic of Korea,Other South,8081,4631,3450
2000,96,Brunei Darussalam,Other South,723,404,319
2000,116,Cambodia,Other South,4041,2168,1873
2000,360,Indonesia,Other South,10258,5539,4719
2000,418,Lao People's Democratic Republic,Other South,3048,1734,1314
2000,458,Malaysia,Other South,75450,42866,32584
2000,104,Myanmar,Other South,8007,4269,3738
2000,608,Philippines,Other South,57966,29321,28645
2000,702,Singapore,Other South,124788,61224,63564
2000,764,Thailand,Other South,47,33,14
2000,626,Timor-Leste,Other South,1139,567,572
2000,704,Viet Nam,Other South,2255,1311,944
2000,660,Anguilla,Other South,928,286,642
2000,28,Antigua and Barbuda,Other South,147,72,75
2000,533,Aruba,Other South,1604,765,839
2000,44,Bahamas,Other South,260,131,129
2000,52,Barbados,Other South,3546,1734,1812
2000,92,British Virgin Islands,Other South,1682,830,852
2000,535,"Bonaire, Sint Eustatius and Saba",Other South,1281,661,620
2000,136,Cayman Islands,Other South,23,12,11
2000,192,Cuba,Other South,1917,907,1010
2000,212,Dominica,Other South,418,216,202
2000,214,Dominican Republic,Other South,367,197,170
2000,308,Grenada,Other South,666,330,336
2000,312,Guadeloupe,Other South,3833,1782,2051
2000,332,Haiti,Other South,882,468,414
2000,388,Jamaica,Other South,2418,1243,1175
2000,474,Martinique,Other South,1033,471,562
2000,500,Montserrat,Other South,196,100,96
2000,630,Puerto Rico,Other South,3254,1556,1698
2000,659,Saint Kitts and Nevis,Other South,2080,1126,954
2000,662,Saint Lucia,Other South,2105,1159,946
2000,670,Saint Vincent and the Grenadines,Other South,228,118,110
2000,780,Trinidad and Tobago,Other South,2964,1414,1550
2000,796,Turks and Caicos Islands,Other South,317,170,147
2000,850,United States Virgin Islands,Other South,1910,946,964
2000,84,Belize,Other South,951,548,403
2000,188,Costa Rica,Other South,10210,5152,5058
2000,222,El Salvador,Other South,96,51,45
2000,320,Guatemala,Other South,48,25,23
2000,340,Honduras,Other South,85,57,28
2000,484,Mexico,Other South,1595,773,822
2000,558,Nicaragua,Other South,1094,560,534
2000,591,Panama,Other South,405,231,174
2000,32,Argentina,Other South,56355,25693,30662
2000,68,Bolivia (Plurinational State of),Other South,301,147,154
2000,76,Brazil,Other South,22736,12769,9967
2000,170,Colombia,Other South,179,96,83
2000,218,Ecuador,Other South,25130,13521,11609
2000,238,Falkland Islands (Malvinas),Other South,15,9,6
2000,254,French Guiana,Other South,3031,1498,1533
2000,328,Guyana,Other South,669,368,301
2000,600,Paraguay,Other South,2862,1322,1540
2000,604,Peru,Other South,333,141,192
2000,740,Suriname,Other South,7979,4346,3633
2000,858,Uruguay,Other South,5274,2607,2667
2000,862,Venezuela (Bolivarian Republic of),Other South,199,108,91
2000,36,Australia,Other South,12640,5865,6775
2000,554,New Zealand,Other South,25047,12134,12913
2000,242,Fiji,Other South,1408,744,664
2000,540,New Caledonia,Other South,1402,766,636
2000,598,Papua New Guinea,Other South,1106,646,460
2000,90,Solomon Islands,Other South,201,103,98
2000,548,Vanuatu,Other South,1132,565,567
2000,316,Guam,Other South,1599,752,847
2000,296,Kiribati,Other South,184,100,84
2000,584,Marshall Islands,Other South,160,105,55
2000,583,Micronesia (Fed. States of),Other South,1605,881,724
2000,520,Nauru,Other South,142,69,73
2000,580,Northern Mariana Islands,Other South,1288,424,864
2000,585,Palau,Other South,581,478,103
2000,16,American Samoa,Other South,598,303,295
2000,184,Cook Islands,Other South,53,37,16
2000,258,French Polynesia,Other South,3439,1647,1792
2000,570,Niue,Other South,29,13,16
2000,882,Samoa,Other South,207,110,97
2000,772,Tokelau,Other South,22,17,5
2000,776,Tonga,Other South,1217,635,582
2000,798,Tuvalu,Other South,44,25,19
2000,876,Wallis and Futuna Islands,Other South,13,8,5
2000,112,Belarus,Other South,124,85,39
2000,100,Bulgaria,Other South,438,176,262
2000,348,Hungary,Other South,979,375,604
2000,616,Poland,Other South,29888,12326,17562
2000,498,Republic of Moldova,Other South,790,363,427
2000,642,Romania,Other South,1668,918,750
2000,643,Russian Federation,Other South,7214,3759,3455
2000,703,Slovakia,Other South,201,87,114
2000,804,Ukraine,Other South,171384,73808,97576
2000,830,Channel Islands,Other South,372,175,197
2000,233,Estonia,Other South,85,46,39
2000,234,Faroe Islands,Other South,119,55,64
2000,246,Finland,Other South,454,233,221
2000,833,Isle of Man,Other South,566,263,303
2000,440,Lithuania,Other South,2829,1359,1470
2000,578,Norway,Other South,14031,7524,6507
2000,752,Sweden,Other South,914,362,552
2000,826,United Kingdom,Other South,15535,6947,8588
2000,8,Albania,Other South,1674,444,1230
2000,20,Andorra,Other South,228,120,108
2000,70,Bosnia and Herzegovina,Other South,495,226,269
2000,191,Croatia,Other South,26284,12373,13911
2000,292,Gibraltar,Other South,421,227,194
2000,336,Holy See,Other South,327,157,170
2000,380,Italy,Other South,8,2,6
2000,470,Malta,Other South,156,58,98
2000,807,North Macedonia,Other South,795,331,464
2000,620,Portugal,Other South,4025,1840,2185
2000,674,San Marino,Other South,79,37,42
2000,688,Serbia,Other South,5103,3600,1503
2000,705,Slovenia,Other South,1620,1091,529
2000,724,Spain,Other South,7346,3890,3456
2000,56,Belgium,Other South,37066,14500,22566
2000,276,Germany,Other South,74160,39621,34539
2000,438,Liechtenstein,Other South,41,13,28
2000,442,Luxembourg,Other South,295,114,181
2000,492,Monaco,Other South,3302,1599,1703
2000,528,Netherlands,Other South,3932,1885,2047
2000,756,Switzerland,Other South,25204,14614,10590
2000,60,Bermuda,Other South,641,232,409
2000,124,Canada,Other South,2886,1454,1432
2000,304,Greenland,Other South,49,32,17
2000,666,Saint Pierre and Miquelon,Other South,182,95,87
2000,840,United States of America,Other South,1642662,939619,703043
2005,108,Burundi,Other South,12615,6193,6422
2005,174,Comoros,Other South,796,405,391
2005,262,Djibouti,Other South,4134,2426,1708
2005,232,Eritrea,Other South,1320,651,669
2005,231,Ethiopia,Other South,38775,22418,16357
2005,404,Kenya,Other South,39648,21261,18387
2005,450,Madagascar,Other South,3103,1757,1346
2005,454,Malawi,Other South,36203,18622,17581
2005,480,Mauritius,Other South,938,440,498
2005,175,Mayotte,Other South,546,273,273
2005,508,Mozambique,Other South,4636,2239,2397
2005,638,Réunion,Other South,7556,3162,4394
2005,646,Rwanda,Other South,14694,8263,6431
2005,690,Seychelles,Other South,264,174,90
2005,706,Somalia,Other South,13011,6929,6082
2005,800,Uganda,Other South,2397,1316,1081
2005,834,United Republic of Tanzania,Other South,6641,3727,2914
2005,894,Zambia,Other South,23170,11771,11399
2005,716,Zimbabwe,Other South,64116,36468,27648
2005,24,Angola,Other South,9195,5039,4156
2005,120,Cameroon,Other South,17883,9945,7938
2005,140,Central African Republic,Other South,20419,11304,9115
2005,148,Chad,Other South,8095,3672,4423
2005,178,Congo,Other South,5291,3017,2274
2005,180,Democratic Republic of the Congo,Other South,86693,41814,44879
2005,226,Equatorial Guinea,Other South,877,555,322
2005,266,Gabon,Other South,4963,3371,1592
2005,678,Sao Tome and Principe,Other South,56,22,34
2005,72,Botswana,Other South,5686,2578,3108
2005,748,Eswatini,Other South,7166,3811,3355
2005,426,Lesotho,Other South,985,557,428
2005,516,Namibia,Other South,1802,905,897
2005,710,South Africa,Other South,23900,14267,9633
2005,204,Benin,Other South,21429,10973,10456
2005,854,Burkina Faso,Other South,28939,14484,14455
2005,132,Cabo Verde,Other South,751,375,376
2005,384,Côte d'Ivoire,Other South,44280,24026,20254
2005,270,Gambia,Other South,3517,2118,1399
2005,288,Ghana,Other South,4366,1516,2850
2005,324,Guinea,Other South,10347,5478,4869
2005,624,Guinea-Bissau,Other South,505,255,250
2005,430,Liberia,Other South,6370,4426,1944
2005,466,Mali,Other South,62790,32310,30480
2005,478,Mauritania,Other South,1979,1159,820
2005,562,Niger,Other South,8080,4288,3792
2005,566,Nigeria,Other South,68892,40102,28790
2005,654,Saint Helena,Other South,10,5,5
2005,686,Senegal,Other South,23148,10360,12788
2005,694,Sierra Leone,Other South,235,140,95
2005,768,Togo,Other South,17934,7960,9974
2005,12,Algeria,Other South,4937,2558,2379
2005,818,Egypt,Other South,16759,9742,7017
2005,504,Morocco,Other South,7689,3895,3794
2005,729,Sudan,Other South,37268,19237,18031
2005,788,Tunisia,Other South,4083,2105,1978
2005,732,Western Sahara,Other South,95,54,41
2005,51,Armenia,Other South,16274,6973,9301
2005,31,Azerbaijan,Other South,1660,838,822
2005,48,Bahrain,Other South,9399,5348,4051
2005,196,Cyprus,Other South,247,132,115
2005,268,Georgia,Other South,2106,816,1290
2005,368,Iraq,Other South,24909,11795,13114
2005,376,Israel,Other South,21728,9325,12403
2005,400,Jordan,Other South,3315,1834,1481
2005,414,Kuwait,Other South,49176,27400,21776
2005,422,Lebanon,Other South,2000,917,1083
2005,512,Oman,Other South,21181,13115,8066
2005,634,Qatar,Other South,16605,10992,5613
2005,682,Saudi Arabia,Other South,180350,123986,56364
2005,275,State of Palestine,Other South,20393,9632,10761
2005,760,Syrian Arab Republic,Other South,87728,45289,42439
2005,792,Turkey,Other South,107859,49122,58737
2005,784,United Arab Emirates,Other South,77269,45336,31933
2005,887,Yemen,Other South,31027,16400,14627
2005,398,Kazakhstan,Other South,103316,49778,53538
2005,417,Kyrgyzstan,Other South,3357,1479,1878
2005,762,Tajikistan,Other South,210,90,120
2005,795,Turkmenistan,Other South,2210,1119,1091
2005,860,Uzbekistan,Other South,58527,28144,30383
2005,4,Afghanistan,Other South,14121,7970,6151
2005,50,Bangladesh,Other South,63341,36451,26890
2005,64,Bhutan,Other South,772,596,176
2005,356,India,Other South,38351,16861,21490
2005,364,Iran (Islamic Republic of),Other South,224304,132982,91322
2005,462,Maldives,Other South,2185,1330,855
2005,524,Nepal,Other South,33554,15874,17680
2005,586,Pakistan,Other South,2361,1349,1012
2005,144,Sri Lanka,Other South,1116,571,545
2005,156,China,Other South,109272,51839,57433
2005,344,"China, Hong Kong SAR",Other South,179780,50121,129659
2005,446,"China, Macao SAR",Other South,4193,2287,1906
2005,408,Dem. People's Republic of Korea,Other South,2315,890,1425
2005,392,Japan,Other South,55831,25452,30379
2005,496,Mongolia,Other South,502,276,226
2005,410,Republic of Korea,Other South,16368,9563,6805
2005,96,Brunei Darussalam,Other South,739,415,324
2005,116,Cambodia,Other South,3154,1732,1422
2005,360,Indonesia,Other South,7643,4436,3207
2005,418,Lao People's Democratic Republic,Other South,2856,1657,1199
2005,458,Malaysia,Other South,90192,53003,37189
2005,104,Myanmar,Other South,6782,3643,3139
2005,608,Philippines,Other South,46966,24096,22870
2005,702,Singapore,Other South,163712,77214,86498
2005,764,Thailand,Other South,243,159,84
2005,626,Timor-Leste,Other South,1212,620,592
2005,704,Viet Nam,Other South,2584,1548,1036
2005,660,Anguilla,Other South,1076,334,742
2005,28,Antigua and Barbuda,Other South,150,87,63
2005,533,Aruba,Other South,1198,651,547
2005,44,Bahamas,Other South,422,215,207
2005,52,Barbados,Other South,6782,3277,3505
2005,92,British Virgin Islands,Other South,2029,1001,1028
2005,535,"Bonaire, Sint Eustatius and Saba",Other South,1362,704,658
2005,136,Cayman Islands,Other South,21,11,10
2005,192,Cuba,Other South,1284,608,676
2005,212,Dominica,Other South,660,342,318
2005,214,Dominican Republic,Other South,1191,666,525
2005,308,Grenada,Other South,704,347,357
2005,312,Guadeloupe,Other South,4038,1859,2179
2005,332,Haiti,Other South,849,446,403
2005,388,Jamaica,Other South,2357,1220,1137
2005,474,Martinique,Other South,1081,478,603
2005,500,Montserrat,Other South,198,103,95
2005,630,Puerto Rico,Other South,9564,4504,5060
2005,659,Saint Kitts and Nevis,Other South,2370,1287,1083
2005,662,Saint Lucia,Other South,1386,757,629
2005,670,Saint Vincent and the Grenadines,Other South,238,127,111
2005,534,Sint Maarten (Dutch part),Other South,824,411,413
2005,780,Trinidad and Tobago,Other South,3181,1514,1667
2005,796,Turks and Caicos Islands,Other South,1204,636,568
2005,850,United States Virgin Islands,Other South,1427,747,680
2005,84,Belize,Other South,1048,602,446
2005,188,Costa Rica,Other South,160043,79577,80466
2005,222,El Salvador,Other South,94,51,43
2005,320,Guatemala,Other South,34,17,17
2005,340,Honduras,Other South,83,56,27
2005,484,Mexico,Other South,1838,913,925
2005,558,Nicaragua,Other South,1523,740,783
2005,591,Panama,Other South,478,237,241
2005,32,Argentina,Other South,41543,19310,22233
2005,68,Bolivia (Plurinational State of),Other South,525,270,255
2005,76,Brazil,Other South,13903,7823,6080
2005,170,Colombia,Other South,162,89,73
2005,218,Ecuador,Other South,29666,16252,13414
2005,238,Falkland Islands (Malvinas),Other South,21,13,8
2005,254,French Guiana,Other South,2986,1468,1518
2005,328,Guyana,Other South,589,281,308
2005,600,Paraguay,Other South,2734,1258,1476
2005,604,Peru,Other South,373,194,179
2005,740,Suriname,Other South,9767,5322,4445
2005,858,Uruguay,Other South,1592,835,757
2005,862,Venezuela (Bolivarian Republic of),Other South,130,75,55
2005,36,Australia,Other South,13993,6414,7579
2005,554,New Zealand,Other South,26876,13019,13857
2005,242,Fiji,Other South,1414,746,668
2005,540,New Caledonia,Other South,2647,1451,1196
2005,598,Papua New Guinea,Other South,1107,662,445
2005,90,Solomon Islands,Other South,372,199,173
2005,548,Vanuatu,Other South,815,407,408
2005,316,Guam,Other South,1624,803,821
2005,296,Kiribati,Other South,154,90,64
2005,584,Marshall Islands,Other South,205,134,71
2005,583,Micronesia (Fed. States of),Other South,1481,791,690
2005,520,Nauru,Other South,136,67,69
2005,580,Northern Mariana Islands,Other South,1239,350,889
2005,585,Palau,Other South,657,558,99
2005,16,American Samoa,Other South,511,258,253
2005,184,Cook Islands,Other South,244,141,103
2005,258,French Polynesia,Other South,3604,1736,1868
2005,570,Niue,Other South,29,13,16
2005,882,Samoa,Other South,290,154,136
2005,772,Tokelau,Other South,21,16,5
2005,776,Tonga,Other South,1422,742,680
2005,798,Tuvalu,Other South,47,27,20
2005,876,Wallis and Futuna Islands,Other South,17,10,7
2005,112,Belarus,Other South,124,85,39
2005,100,Bulgaria,Other South,403,162,241
2005,348,Hungary,Other South,1209,475,734
2005,616,Poland,Other South,17577,7266,10311
2005,498,Republic of Moldova,Other South,546,245,301
2005,642,Romania,Other South,1411,764,647
2005,643,Russian Federation,Other South,3878,2073,1805
2005,703,Slovakia,Other South,61,39,22
2005,804,Ukraine,Other South,156599,67564,89035
2005,830,Channel Islands,Other South,604,287,317
2005,233,Estonia,Other South,85,46,39
2005,234,Faroe Islands,Other South,173,89,84
2005,246,Finland,Other South,464,242,222
2005,833,Isle of Man,Other South,639,284,355
2005,440,Lithuania,Other South,1653,852,801
2005,578,Norway,Other South,9685,5100,4585
2005,752,Sweden,Other South,1269,578,691
2005,826,United Kingdom,Other South,13327,6107,7220
2005,8,Albania,Other South,1413,453,960
2005,20,Andorra,Other South,443,211,232
2005,70,Bosnia and Herzegovina,Other South,377,172,205
2005,191,Croatia,Other South,15619,7466,8153
2005,292,Gibraltar,Other South,637,346,291
2005,336,Holy See,Other South,324,155,169
2005,380,Italy,Other South,8,2,6
2005,470,Malta,Other South,250,81,169
2005,807,North Macedonia,Other South,823,342,481
2005,620,Portugal,Other South,3502,1605,1897
2005,674,San Marino,Other South,79,37,42
2005,688,Serbia,Other South,2085,1284,801
2005,705,Slovenia,Other South,1699,904,795
2005,724,Spain,Other South,3533,1846,1687
2005,56,Belgium,Other South,21679,7798,13881
2005,276,Germany,Other South,34831,18848,15983
2005,438,Liechtenstein,Other South,284,137,147
2005,442,Luxembourg,Other South,213,100,113
2005,492,Monaco,Other South,3346,1644,1702
2005,528,Netherlands,Other South,4302,2007,2295
2005,756,Switzerland,Other South,43448,23322,20126
2005,60,Bermuda,Other South,657,284,373
2005,124,Canada,Other South,2964,1495,1469
2005,304,Greenland,Other South,60,37,23
2005,666,Saint Pierre and Miquelon,Other South,20,10,10
2005,840,United States of America,Other South,2248918,1292505,956413
2010,108,Burundi,Other South,16897,8332,8565
2010,174,Comoros,Other South,761,391,370
2010,262,Djibouti,Other South,4558,2536,2022
2010,232,Eritrea,Other South,1507,771,736
2010,231,Ethiopia,Other South,19053,9075,9978
2010,404,Kenya,Other South,38516,19763,18753
2010,450,Madagascar,Other South,3445,1959,1486
2010,454,Malawi,Other South,35553,18263,17290
2010,480,Mauritius,Other South,1180,537,643
2010,175,Mayotte,Other South,756,359,397
2010,508,Mozambique,Other South,5366,2593,2773
2010,638,Réunion,Other South,7184,2602,4582
2010,646,Rwanda,Other South,13500,6286,7214
2010,690,Seychelles,Other South,231,160,71
2010,706,Somalia,Other South,14524,7796,6728
2010,728,South Sudan,Other South,2564,1475,1089
2010,800,Uganda,Other South,2438,1326,1112
2010,834,United Republic of Tanzania,Other South,4278,2154,2124
2010,894,Zambia,Other South,17114,9139,7975
2010,716,Zimbabwe,Other South,106108,60513,45595
2010,24,Angola,Other South,204346,99112,105234
2010,120,Cameroon,Other South,7612,4776,2836
2010,140,Central African Republic,Other South,20206,11192,9014
2010,148,Chad,Other South,9586,4294,5292
2010,178,Congo,Other South,10516,5803,4713
2010,180,Democratic Republic of the Congo,Other South,107006,52849,54157
2010,226,Equatorial Guinea,Other South,1155,734,421
2010,266,Gabon,Other South,5748,3940,1808
2010,678,Sao Tome and Principe,Other South,46,18,28
2010,72,Botswana,Other South,4540,1756,2784
2010,748,Eswatini,Other South,6931,4360,2571
2010,426,Lesotho,Other South,1006,568,438
2010,516,Namibia,Other South,1774,879,895
2010,710,South Africa,Other South,137161,69484,67677
2010,204,Benin,Other South,30324,15188,15136
2010,854,Burkina Faso,Other South,32427,16159,16268
2010,132,Cabo Verde,Other South,1257,615,642
2010,384,Côte d'Ivoire,Other South,46284,25098,21186
2010,270,Gambia,Other South,3594,2162,1432
2010,288,Ghana,Other South,12492,5578,6914
2010,324,Guinea,Other South,12187,7786,4401
2010,624,Guinea-Bissau,Other South,93,45,48
2010,430,Liberia,Other South,4669,3310,1359
2010,466,Mali,Other South,20272,9749,10523
2010,478,Mauritania,Other South,27669,16183,11486
2010,562,Niger,Other South,8211,4352,3859
2010,566,Nigeria,Other South,70265,40905,29360
2010,654,Saint Helena,Other South,18,9,9
2010,686,Senegal,Other South,26146,12279,13867
2010,694,Sierra Leone,Other South,228,138,90
2010,768,Togo,Other South,19438,9263,10175
2010,12,Algeria,Other South,5437,2698,2739
2010,818,Egypt,Other South,4907,2242,2665
2010,504,Morocco,Other South,8607,4338,4269
2010,729,Sudan,Other South,28222,14594,13628
2010,788,Tunisia,Other South,5459,2814,2645
2010,732,Western Sahara,Other South,109,66,43
2010,51,Armenia,Other South,14900,5802,9098
2010,31,Azerbaijan,Other South,1660,838,822
2010,48,Bahrain,Other South,15597,9041,6556
2010,196,Cyprus,Other South,481,222,259
2010,268,Georgia,Other South,2145,829,1316
2010,368,Iraq,Other South,25156,12705,12451
2010,376,Israel,Other South,23662,9777,13885
2010,400,Jordan,Other South,4747,2713,2034
2010,414,Kuwait,Other South,79598,44805,34793
2010,422,Lebanon,Other South,1445,718,727
2010,512,Oman,Other South,24760,15129,9631
2010,634,Qatar,Other South,38758,28812,9946
2010,682,Saudi Arabia,Other South,233823,164449,69374
2010,275,State of Palestine,Other South,20997,9866,11131
2010,760,Syrian Arab Republic,Other South,154931,79529,75402
2010,792,Turkey,Other South,111142,49247,61895
2010,784,United Arab Emirates,Other South,175593,107595,67998
2010,887,Yemen,Other South,33082,17158,15924
2010,398,Kazakhstan,Other South,116120,57555,58565
2010,417,Kyrgyzstan,Other South,2439,1063,1376
2010,762,Tajikistan,Other South,209,90,119
2010,795,Turkmenistan,Other South,2452,1162,1290
2010,860,Uzbekistan,Other South,56856,28039,28817
2010,4,Afghanistan,Other South,21804,12307,9497
2010,50,Bangladesh,Other South,87758,47508,40250
2010,64,Bhutan,Other South,928,715,213
2010,356,India,Other South,13466,4265,9201
2010,364,Iran (Islamic Republic of),Other South,201873,119684,82189
2010,462,Maldives,Other South,3135,1843,1292
2010,524,Nepal,Other South,21956,11876,10080
2010,586,Pakistan,Other South,2321,1324,997
2010,144,Sri Lanka,Other South,1239,599,640
2010,156,China,Other South,119494,62812,56682
2010,344,"China, Hong Kong SAR",Other South,26801,9081,17720
2010,446,"China, Macao SAR",Other South,7787,3123,4664
2010,408,Dem. People's Republic of Korea,Other South,1310,615,695
2010,392,Japan,Other South,59194,26626,32568
2010,496,Mongolia,Other South,408,271,137
2010,410,Republic of Korea,Other South,31137,17883,13254
2010,96,Brunei Darussalam,Other South,755,426,329
2010,116,Cambodia,Other South,2267,1296,971
2010,360,Indonesia,Other South,5526,3282,2244
2010,418,Lao People's Democratic Republic,Other South,2688,1669,1019
2010,458,Malaysia,Other South,100166,60649,39517
2010,104,Myanmar,Other South,6242,3399,2843
2010,608,Philippines,Other South,41158,20381,20777
2010,702,Singapore,Other South,211744,97367,114377
2010,764,Thailand,Other South,457,297,160
2010,626,Timor-Leste,Other South,1221,649,572
2010,704,Viet Nam,Other South,3106,1787,1319
2010,660,Anguilla,Other South,1176,365,811
2010,28,Antigua and Barbuda,Other South,168,84,84
2010,533,Aruba,Other South,769,377,392
2010,44,Bahamas,Other South,583,298,285
2010,52,Barbados,Other South,10051,4838,5213
2010,92,British Virgin Islands,Other South,1001,509,492
2010,535,"Bonaire, Sint Eustatius and Saba",Other South,446,245,201
2010,136,Cayman Islands,Other South,21,11,10
2010,192,Cuba,Other South,732,338,394
2010,531,Curaçao,Other South,156,78,78
2010,212,Dominica,Other South,1179,603,576
2010,214,Dominican Republic,Other South,2006,1129,877
2010,308,Grenada,Other South,730,364,366
2010,312,Guadeloupe,Other South,4254,1938,2316
2010,332,Haiti,Other South,901,470,431
2010,388,Jamaica,Other South,2295,1196,1099
2010,474,Martinique,Other South,1130,486,644
2010,500,Montserrat,Other South,211,112,99
2010,630,Puerto Rico,Other South,12654,5859,6795
2010,659,Saint Kitts and Nevis,Other South,2570,1400,1170
2010,662,Saint Lucia,Other South,560,299,261
2010,670,Saint Vincent and the Grenadines,Other South,244,132,112
2010,534,Sint Maarten (Dutch part),Other South,1652,848,804
2010,780,Trinidad and Tobago,Other South,5465,2797,2668
2010,796,Turks and Caicos Islands,Other South,1120,619,501
2010,850,United States Virgin Islands,Other South,917,547,370
2010,84,Belize,Other South,291,143,148
2010,188,Costa Rica,Other South,13180,6583,6597
2010,222,El Salvador,Other South,92,51,41
2010,320,Guatemala,Other South,20,9,11
2010,340,Honduras,Other South,81,55,26
2010,484,Mexico,Other South,2296,1161,1135
2010,558,Nicaragua,Other South,1614,789,825
2010,591,Panama,Other South,461,248,213
2010,32,Argentina,Other South,26788,12922,13866
2010,68,Bolivia (Plurinational State of),Other South,747,392,355
2010,76,Brazil,Other South,4947,2827,2120
2010,170,Colombia,Other South,172,98,74
2010,218,Ecuador,Other South,41671,22349,19322
2010,238,Falkland Islands (Malvinas),Other South,21,12,9
2010,254,French Guiana,Other South,2950,1436,1514
2010,328,Guyana,Other South,520,195,325
2010,600,Paraguay,Other South,2613,1195,1418
2010,604,Peru,Other South,416,198,218
2010,740,Suriname,Other South,11521,6283,5238
2010,858,Uruguay,Other South,1475,768,707
2010,862,Venezuela (Bolivarian Republic of),Other South,148,90,58
2010,36,Australia,Other South,16680,7452,9228
2010,554,New Zealand,Other South,29338,14179,15159
2010,242,Fiji,Other South,1518,811,707
2010,540,New Caledonia,Other South,3892,2135,1757
2010,598,Papua New Guinea,Other South,935,576,359
2010,90,Solomon Islands,Other South,554,302,252
2010,548,Vanuatu,Other South,569,277,292
2010,316,Guam,Other South,1653,850,803
2010,296,Kiribati,Other South,185,101,84
2010,584,Marshall Islands,Other South,262,171,91
2010,583,Micronesia (Fed. States of),Other South,1424,753,671
2010,520,Nauru,Other South,417,184,233
2010,580,Northern Mariana Islands,Other South,823,186,637
2010,585,Palau,Other South,104,70,34
2010,16,American Samoa,Other South,423,213,210
2010,184,Cook Islands,Other South,437,241,196
2010,258,French Polynesia,Other South,3477,1728,1749
2010,570,Niue,Other South,56,27,29
2010,882,Samoa,Other South,333,175,158
2010,772,Tokelau,Other South,33,25,8
2010,776,Tonga,Other South,1525,799,726
2010,798,Tuvalu,Other South,55,32,23
2010,876,Wallis and Futuna Islands,Other South,7,5,2
2010,112,Belarus,Other South,116,77,39
2010,100,Bulgaria,Other South,351,141,210
2010,348,Hungary,Other South,1439,576,863
2010,616,Poland,Other South,5380,2259,3121
2010,498,Republic of Moldova,Other South,539,246,293
2010,642,Romania,Other South,6255,3206,3049
2010,643,Russian Federation,Other South,532,358,174
2010,703,Slovakia,Other South,572,319,253
2010,804,Ukraine,Other South,148919,64197,84722
2010,830,Channel Islands,Other South,836,399,437
2010,233,Estonia,Other South,12,7,5
2010,234,Faroe Islands,Other South,219,116,103
2010,246,Finland,Other South,689,387,302
2010,833,Isle of Man,Other South,704,300,404
2010,440,Lithuania,Other South,254,190,64
2010,578,Norway,Other South,9222,4900,4322
2010,752,Sweden,Other South,1927,857,1070
2010,826,United Kingdom,Other South,14039,6590,7449
2010,8,Albania,Other South,1152,370,782
2010,20,Andorra,Other South,628,282,346
2010,70,Bosnia and Herzegovina,Other South,477,221,256
2010,191,Croatia,Other South,4954,2559,2395
2010,292,Gibraltar,Other South,852,465,387
2010,336,Holy See,Other South,315,150,165
2010,380,Italy,Other South,17140,9173,7967
2010,470,Malta,Other South,665,451,214
2010,499,Montenegro,Other South,254,92,162
2010,807,North Macedonia,Other South,852,353,499
2010,620,Portugal,Other South,2274,1095,1179
2010,674,San Marino,Other South,119,54,65
2010,688,Serbia,Other South,581,285,296
2010,705,Slovenia,Other South,4984,2241,2743
2010,724,Spain,Other South,510,277,233
2010,56,Belgium,Other South,34954,15449,19505
2010,276,Germany,Other South,1721,789,932
2010,438,Liechtenstein,Other South,528,261,267
2010,442,Luxembourg,Other South,234,115,119
2010,492,Monaco,Other South,3431,1711,1720
2010,528,Netherlands,Other South,4656,2179,2477
2010,756,Switzerland,Other South,67100,34742,32358
2010,60,Bermuda,Other South,672,336,336
2010,124,Canada,Other South,3966,856,3110
2010,304,Greenland,Other South,83,47,36
2010,666,Saint Pierre and Miquelon,Other South,20,12,8
2010,840,United States of America,Other South,2099990,1194704,905286
2015,108,Burundi,Other South,23599,11644,11955
2015,174,Comoros,Other South,754,388,366
2015,262,Djibouti,Other South,5042,2811,2231
2015,232,Eritrea,Other South,1533,793,740
2015,231,Ethiopia,Other South,53985,21887,32098
2015,404,Kenya,Other South,51715,27196,24519
2015,450,Madagascar,Other South,3827,2186,1641
2015,454,Malawi,Other South,37781,18182,19599
2015,480,Mauritius,Other South,1361,651,710
2015,175,Mayotte,Other South,768,356,412
2015,508,Mozambique,Other South,4636,2242,2394
2015,638,Réunion,Other South,7428,2668,4760
2015,646,Rwanda,Other South,6267,3740,2527
2015,690,Seychelles,Other South,272,182,90
2015,706,Somalia,Other South,13713,7556,6157
2015,728,South Sudan,Other South,2497,1503,994
2015,800,Uganda,Other South,2475,1334,1141
2015,834,United Republic of Tanzania,Other South,30803,15427,15376
2015,894,Zambia,Other South,14076,7524,6552
2015,716,Zimbabwe,Other South,106687,60100,46587
2015,24,Angola,Other South,392283,189283,203000
2015,120,Cameroon,Other South,13306,5869,7437
2015,140,Central African Republic,Other South,17641,9717,7924
2015,148,Chad,Other South,10758,6110,4648
2015,178,Congo,Other South,6330,3508,2822
2015,180,Democratic Republic of the Congo,Other South,22977,5991,16986
2015,226,Equatorial Guinea,Other South,200231,156472,43759
2015,266,Gabon,Other South,8038,5862,2176
2015,678,Sao Tome and Principe,Other South,40,17,23
2015,72,Botswana,Other South,4972,1913,3059
2015,748,Eswatini,Other South,6933,4317,2616
2015,426,Lesotho,Other South,1032,583,449
2015,516,Namibia,Other South,1736,863,873
2015,710,South Africa,Other South,819674,446902,372772
2015,204,Benin,Other South,36244,18522,17722
2015,854,Burkina Faso,Other South,33351,16632,16719
2015,132,Cabo Verde,Other South,1306,635,671
2015,384,Côte d'Ivoire,Other South,48289,26179,22110
2015,270,Gambia,Other South,3723,2237,1486
2015,288,Ghana,Other South,15379,6863,8516
2015,324,Guinea,Other South,6967,4237,2730
2015,624,Guinea-Bissau,Other South,99,48,51
2015,430,Liberia,Other South,5579,3920,1659
2015,466,Mali,Other South,25149,12080,13069
2015,478,Mauritania,Other South,5358,3057,2301
2015,562,Niger,Other South,8758,3699,5059
2015,566,Nigeria,Other South,85216,46749,38467
2015,654,Saint Helena,Other South,29,18,11
2015,686,Senegal,Other South,28388,13345,15043
2015,694,Sierra Leone,Other South,222,136,86
2015,768,Togo,Other South,21045,9438,11607
2015,12,Algeria,Other South,6011,2975,3036
2015,818,Egypt,Other South,13110,7305,5805
2015,504,Morocco,Other South,11229,5631,5598
2015,729,Sudan,Other South,21805,11256,10549
2015,788,Tunisia,Other South,7594,3961,3633
2015,732,Western Sahara,Other South,124,76,48
2015,51,Armenia,Other South,11022,4293,6729
2015,31,Azerbaijan,Other South,1660,838,822
2015,48,Bahrain,Other South,5435,3117,2318
2015,196,Cyprus,Other South,1936,835,1101
2015,268,Georgia,Other South,2278,873,1405
2015,368,Iraq,Other South,25223,14663,10560
2015,376,Israel,Other South,24403,10013,14390
2015,400,Jordan,Other South,15793,8074,7719
2015,414,Kuwait,Other South,85873,53329,32544
2015,422,Lebanon,Other South,1227,577,650
2015,512,Oman,Other South,56318,37702,18616
2015,634,Qatar,Other South,22850,17372,5478
2015,682,Saudi Arabia,Other South,300339,208649,91690
2015,275,State of Palestine,Other South,20792,9744,11048
2015,760,Syrian Arab Republic,Other South,60692,31934,28758
2015,792,Turkey,Other South,127895,69521,58374
2015,784,United Arab Emirates,Other South,191891,114640,77251
2015,887,Yemen,Other South,30075,14458,15617
2015,398,Kazakhstan,Other South,123008,62002,61006
2015,417,Kyrgyzstan,Other South,2148,930,1218
2015,762,Tajikistan,Other South,205,88,117
2015,795,Turkmenistan,Other South,2858,1528,1330
2015,860,Uzbekistan,Other South,54578,27347,27231
2015,4,Afghanistan,Other South,94199,46858,47341
2015,50,Bangladesh,Other South,100567,54405,46162
2015,64,Bhutan,Other South,979,824,155
2015,356,India,Other South,12973,6196,6777
2015,364,Iran (Islamic Republic of),Other South,192329,110140,82189
2015,462,Maldives,Other South,4078,2357,1721
2015,524,Nepal,Other South,12113,6830,5283
2015,586,Pakistan,Other South,60445,31855,28590
2015,144,Sri Lanka,Other South,1389,703,686
2015,156,China,Other South,137515,75267,62248
2015,344,"China, Hong Kong SAR",Other South,27367,8565,18802
2015,446,"China, Macao SAR",Other South,10837,4643,6194
2015,408,Dem. People's Republic of Korea,Other South,1442,681,761
2015,392,Japan,Other South,136333,60839,75494
2015,496,Mongolia,Other South,505,289,216
2015,410,Republic of Korea,Other South,38687,21836,16851
2015,96,Brunei Darussalam,Other South,771,437,334
2015,116,Cambodia,Other South,2045,1187,858
2015,360,Indonesia,Other South,6126,3681,2445
2015,418,Lao People's Democratic Republic,Other South,2514,1677,837
2015,458,Malaysia,Other South,128544,86847,41697
2015,104,Myanmar,Other South,5989,3286,2703
2015,608,Philippines,Other South,41895,20787,21108
2015,702,Singapore,Other South,241811,111192,130619
2015,764,Thailand,Other South,514,322,192
2015,626,Timor-Leste,Other South,1030,642,388
2015,704,Viet Nam,Other South,3755,2144,1611
2015,660,Anguilla,Other South,1265,393,872
2015,28,Antigua and Barbuda,Other South,179,89,90
2015,533,Aruba,Other South,809,405,404
2015,44,Bahamas,Other South,632,321,311
2015,52,Barbados,Other South,10559,5081,5478
2015,92,British Virgin Islands,Other South,1132,572,560
2015,535,"Bonaire, Sint Eustatius and Saba",Other South,507,279,228
2015,136,Cayman Islands,Other South,23,14,9
2015,192,Cuba,Other South,602,266,336
2015,531,Curaçao,Other South,170,86,84
2015,212,Dominica,Other South,1199,616,583
2015,214,Dominican Republic,Other South,2117,1191,926
2015,308,Grenada,Other South,738,368,370
2015,312,Guadeloupe,Other South,4415,1992,2423
2015,332,Haiti,Other South,957,495,462
2015,388,Jamaica,Other South,2246,1171,1075
2015,474,Martinique,Other South,1170,498,672
2015,500,Montserrat,Other South,220,117,103
2015,630,Puerto Rico,Other South,16068,7543,8525
2015,659,Saint Kitts and Nevis,Other South,2643,1442,1201
2015,662,Saint Lucia,Other South,554,285,269
2015,670,Saint Vincent and the Grenadines,Other South,248,135,113
2015,534,Sint Maarten (Dutch part),Other South,1720,896,824
2015,780,Trinidad and Tobago,Other South,5527,2850,2677
2015,796,Turks and Caicos Islands,Other South,1305,722,583
2015,850,United States Virgin Islands,Other South,926,546,380
2015,84,Belize,Other South,351,167,184
2015,188,Costa Rica,Other South,13384,6644,6740
2015,222,El Salvador,Other South,96,53,43
2015,320,Guatemala,Other South,2023,1011,1012
2015,340,Honduras,Other South,134,74,60
2015,484,Mexico,Other South,16080,8110,7970
2015,558,Nicaragua,Other South,1726,848,878
2015,591,Panama,Other South,502,300,202
2015,32,Argentina,Other South,30910,14910,16000
2015,68,Bolivia (Plurinational State of),Other South,870,457,413
2015,76,Brazil,Other South,15957,12505,3452
2015,170,Colombia,Other South,239,113,126
2015,218,Ecuador,Other South,60613,32307,28306
2015,238,Falkland Islands (Malvinas),Other South,23,13,10
2015,254,French Guiana,Other South,1783,857,926
2015,328,Guyana,Other South,610,229,381
2015,600,Paraguay,Other South,2559,1164,1395
2015,604,Peru,Other South,1095,228,867
2015,740,Suriname,Other South,12513,6829,5684
2015,858,Uruguay,Other South,1523,793,730
2015,862,Venezuela (Bolivarian Republic of),Other South,158,93,65
2015,36,Australia,Other South,22508,10804,11704
2015,554,New Zealand,Other South,31268,15092,16176
2015,242,Fiji,Other South,1564,842,722
2015,540,New Caledonia,Other South,2991,1485,1506
2015,598,Papua New Guinea,Other South,921,570,351
2015,90,Solomon Islands,Other South,526,282,244
2015,548,Vanuatu,Other South,667,326,341
2015,316,Guam,Other South,1667,855,812
2015,296,Kiribati,Other South,190,105,85
2015,584,Marshall Islands,Other South,278,181,97
2015,583,Micronesia (Fed. States of),Other South,1394,734,660
2015,520,Nauru,Other South,660,303,357
2015,580,Northern Mariana Islands,Other South,740,167,573
2015,585,Palau,Other South,93,65,28
2015,16,American Samoa,Other South,429,212,217
2015,184,Cook Islands,Other South,409,222,187
2015,258,French Polynesia,Other South,3304,1642,1662
2015,570,Niue,Other South,55,27,28
2015,882,Samoa,Other South,279,149,130
2015,772,Tokelau,Other South,36,27,9
2015,776,Tonga,Other South,1313,691,622
2015,798,Tuvalu,Other South,58,34,24
2015,876,Wallis and Futuna Islands,Other South,2,1,1
2015,112,Belarus,Other South,124,85,39
2015,100,Bulgaria,Other South,116,72,44
2015,348,Hungary,Other South,5953,2131,3822
2015,616,Poland,Other South,5481,2311,3170
2015,498,Republic of Moldova,Other South,611,281,330
2015,642,Romania,Other South,4424,2451,1973
2015,643,Russian Federation,Other South,578,345,233
2015,703,Slovakia,Other South,499,286,213
2015,804,Ukraine,Other South,105251,44105,61146
2015,830,Channel Islands,Other South,887,424,463
2015,233,Estonia,Other South,6,3,3
2015,234,Faroe Islands,Other South,183,88,95
2015,246,Finland,Other South,561,269,292
2015,352,Iceland,Other South,177,90,87
2015,833,Isle of Man,Other South,1875,847,1028
2015,440,Lithuania,Other South,242,184,58
2015,578,Norway,Other South,10248,5382,4866
2015,752,Sweden,Other South,2557,1182,1375
2015,826,United Kingdom,Other South,17953,8145,9808
2015,8,Albania,Other South,1139,366,773
2015,20,Andorra,Other South,621,224,397
2015,70,Bosnia and Herzegovina,Other South,482,222,260
2015,191,Croatia,Other South,1287,740,547
2015,292,Gibraltar,Other South,909,501,408
2015,336,Holy See,Other South,318,151,167
2015,380,Italy,Other South,18956,10018,8938
2015,470,Malta,Other South,2349,1663,686
2015,499,Montenegro,Other South,685,304,381
2015,807,North Macedonia,Other South,919,380,539
2015,620,Portugal,Other South,2577,1195,1382
2015,674,San Marino,Other South,152,62,90
2015,688,Serbia,Other South,559,269,290
2015,705,Slovenia,Other South,3029,1907,1122
2015,724,Spain,Other South,3795,2017,1778
2015,56,Belgium,Other South,43636,19194,24442
2015,276,Germany,Other South,1725,820,905
2015,438,Liechtenstein,Other South,380,170,210
2015,442,Luxembourg,Other South,356,178,178
2015,492,Monaco,Other South,3263,1432,1831
2015,528,Netherlands,Other South,5021,2405,2616
2015,756,Switzerland,Other South,40858,21393,19465
2015,60,Bermuda,Other South,681,341,340
2015,124,Canada,Other South,964,466,498
2015,304,Greenland,Other South,109,65,44
2015,666,Saint Pierre and Miquelon,Other South,19,12,7
2015,840,United States of America,Other South,2391790,1256307,1135483
2019,108,Burundi,Other South,26143,12897,13246
2019,174,Comoros,Other South,754,386,368
2019,262,Djibouti,Other South,5178,2886,2292
2019,232,Eritrea,Other South,1693,866,827
2019,231,Ethiopia,Other South,20738,9359,11379
2019,404,Kenya,Other South,47950,25233,22717
2019,450,Madagascar,Other South,4168,2381,1787
2019,454,Malawi,Other South,38330,18446,19884
2019,480,Mauritius,Other South,1373,657,716
2019,175,Mayotte,Other South,774,359,415
2019,508,Mozambique,Other South,4214,2037,2177
2019,638,Réunion,Other South,7544,2707,4837
2019,646,Rwanda,Other South,6576,3931,2645
2019,690,Seychelles,Other South,287,185,102
2019,706,Somalia,Other South,16440,8967,7473
2019,728,South Sudan,Other South,2568,1541,1027
2019,800,Uganda,Other South,2494,1338,1156
2019,834,United Republic of Tanzania,Other South,27623,13737,13886
2019,894,Zambia,Other South,17655,9432,8223
2019,716,Zimbabwe,Other South,109561,62229,47332
2019,24,Angola,Other South,383658,187821,195837
2019,120,Cameroon,Other South,10296,5243,5053
2019,140,Central African Republic,Other South,19597,10806,8791
2019,148,Chad,Other South,11806,6699,5107
2019,178,Congo,Other South,6532,3614,2918
2019,180,Democratic Republic of the Congo,Other South,22221,5506,16715
2019,226,Equatorial Guinea,Other South,174400,136208,38192
2019,266,Gabon,Other South,8762,6375,2387
2019,678,Sao Tome and Principe,Other South,36,15,21
2019,72,Botswana,Other South,5340,2050,3290
2019,748,Eswatini,Other South,6607,4160,2447
2019,426,Lesotho,Other South,1097,617,480
2019,516,Namibia,Other South,1837,913,924
2019,710,South Africa,Other South,878465,478780,399685
2019,204,Benin,Other South,38607,19757,18850
2019,854,Burkina Faso,Other South,34404,17153,17251
2019,132,Cabo Verde,Other South,1384,665,719
2019,384,Côte d'Ivoire,Other South,49895,27039,22856
2019,270,Gambia,Other South,4170,2505,1665
2019,288,Ghana,Other South,17314,7744,9570
2019,324,Guinea,Other South,6713,4052,2661
2019,624,Guinea-Bissau,Other South,1102,511,591
2019,430,Liberia,Other South,6009,4384,1625
2019,466,Mali,Other South,12739,5082,7657
2019,478,Mauritania,Other South,5318,3028,2290
2019,562,Niger,Other South,9924,3926,5998
2019,566,Nigeria,Other South,89294,48984,40310
2019,654,Saint Helena,Other South,32,21,11
2019,686,Senegal,Other South,29327,13781,15546
2019,694,Sierra Leone,Other South,219,135,84
2019,768,Togo,Other South,21178,9570,11608
2019,12,Algeria,Other South,6265,3096,3169
2019,818,Egypt,Other South,18732,9435,9297
2019,504,Morocco,Other South,11976,6007,5969
2019,729,Sudan,Other South,26895,13676,13219
2019,788,Tunisia,Other South,7727,4027,3700
2019,732,Western Sahara,Other South,133,80,53
2019,51,Armenia,Other South,10962,4320,6642
2019,31,Azerbaijan,Other South,1637,823,814
2019,48,Bahrain,Other South,5736,3280,2456
2019,196,Cyprus,Other South,2024,866,1158
2019,268,Georgia,Other South,2347,899,1448
2019,368,Iraq,Other South,25844,15019,10825
2019,376,Israel,Other South,23762,9740,14022
2019,400,Jordan,Other South,17017,8686,8331
2019,414,Kuwait,Other South,90941,56468,34473
2019,422,Lebanon,Other South,1172,543,629
2019,512,Oman,Other South,69373,46435,22938
2019,634,Qatar,Other South,23327,17336,5991
2019,682,Saudi Arabia,Other South,365891,251727,114164
2019,275,State of Palestine,Other South,20656,9677,10979
2019,760,Syrian Arab Republic,Other South,60460,31904,28556
2019,792,Turkey,Other South,105253,62052,43201
2019,784,United Arab Emirates,Other South,206102,123100,83002
2019,887,Yemen,Other South,30529,14677,15852
2019,398,Kazakhstan,Other South,128539,64790,63749
2019,417,Kyrgyzstan,Other South,2104,911,1193
2019,762,Tajikistan,Other South,204,88,116
2019,795,Turkmenistan,Other South,2853,1540,1313
2019,860,Uzbekistan,Other South,54468,27315,27153
2019,4,Afghanistan,Other South,28808,14148,14660
2019,50,Bangladesh,Other South,146658,40333,106325
2019,64,Bhutan,Other South,1016,850,166
2019,356,India,Other South,12116,3666,8450
2019,364,Iran (Islamic Republic of),Other South,189215,108354,80861
2019,462,Maldives,Other South,4393,2540,1853
2019,524,Nepal,Other South,11669,6548,5121
2019,586,Pakistan,Other South,56163,29598,26565
2019,144,Sri Lanka,Other South,1422,708,714
2019,156,China,Other South,144940,79327,65613
2019,344,"China, Hong Kong SAR",Other South,17612,9140,8472
2019,446,"China, Macao SAR",Other South,11514,4934,6580
2019,408,Dem. People's Republic of Korea,Other South,1481,694,787
2019,392,Japan,Other South,162440,101836,60604
2019,496,Mongolia,Other South,536,307,229
2019,410,Republic of Korea,Other South,39383,22223,17160
2019,96,Brunei Darussalam,Other South,842,473,369
2019,116,Cambodia,Other South,2190,1266,924
2019,360,Indonesia,Other South,6410,3846,2564
2019,418,Lao People's Democratic Republic,Other South,2668,1776,892
2019,458,Malaysia,Other South,134409,91130,43279
2019,104,Myanmar,Other South,6208,3406,2802
2019,608,Philippines,Other South,43213,21441,21772
2019,702,Singapore,Other South,204927,94094,110833
2019,764,Thailand,Other South,555,334,221
2019,626,Timor-Leste,Other South,1017,634,383
2019,704,Viet Nam,Other South,3925,2241,1684
2019,660,Anguilla,Other South,1320,410,910
2019,28,Antigua and Barbuda,Other South,327,150,177
2019,533,Aruba,Other South,823,408,415
2019,44,Bahamas,Other South,834,414,420
2019,52,Barbados,Other South,4311,2075,2236
2019,92,British Virgin Islands,Other South,1241,621,620
2019,535,"Bonaire, Sint Eustatius and Saba",Other South,621,329,292
2019,136,Cayman Islands,Other South,57,22,35
2019,192,Cuba,Other South,573,247,326
2019,531,Curaçao,Other South,206,95,111
2019,212,Dominica,Other South,1236,629,607
2019,214,Dominican Republic,Other South,2184,1227,957
2019,308,Grenada,Other South,751,371,380
2019,312,Guadeloupe,Other South,4483,2025,2458
2019,332,Haiti,Other South,1004,512,492
2019,388,Jamaica,Other South,2275,1187,1088
2019,474,Martinique,Other South,1168,497,671
2019,500,Montserrat,Other South,223,119,104
2019,630,Puerto Rico,Other South,15291,7137,8154
2019,659,Saint Kitts and Nevis,Other South,2694,1470,1224
2019,662,Saint Lucia,Other South,535,268,267
2019,670,Saint Vincent and the Grenadines,Other South,249,136,113
2019,534,Sint Maarten (Dutch part),Other South,1780,927,853
2019,780,Trinidad and Tobago,Other South,5113,2764,2349
2019,796,Turks and Caicos Islands,Other South,1414,783,631
2019,850,United States Virgin Islands,Other South,933,548,385
2019,84,Belize,Other South,393,183,210
2019,188,Costa Rica,Other South,13586,6790,6796
2019,222,El Salvador,Other South,120,60,60
2019,320,Guatemala,Other South,2104,1041,1063
2019,340,Honduras,Other South,157,78,79
2019,484,Mexico,Other South,16623,8361,8262
2019,558,Nicaragua,Other South,1807,888,919
2019,591,Panama,Other South,792,409,383
2019,32,Argentina,Other South,31446,14449,16997
2019,68,Bolivia (Plurinational State of),Other South,1012,512,500
2019,76,Brazil,Other South,17970,14083,3887
2019,170,Colombia,Other South,1494,615,879
2019,218,Ecuador,Other South,59673,31793,27880
2019,238,Falkland Islands (Malvinas),Other South,32,15,17
2019,254,French Guiana,Other South,1972,948,1024
2019,328,Guyana,Other South,631,232,399
2019,600,Paraguay,Other South,2634,1193,1441
2019,604,Peru,Other South,1591,397,1194
2019,740,Suriname,Other South,13395,7318,6077
2019,858,Uruguay,Other South,1574,822,752
2019,862,Venezuela (Bolivarian Republic of),Other South,209,96,113
2019,36,Australia,Other South,24352,13410,10942
2019,554,New Zealand,Other South,32140,15513,16627
2019,242,Fiji,Other South,1604,859,745
2019,540,New Caledonia,Other South,3149,1558,1591
2019,598,Papua New Guinea,Other South,938,574,364
2019,90,Solomon Islands,Other South,515,277,238
2019,548,Vanuatu,Other South,679,332,347
2019,316,Guam,Other South,1749,897,852
2019,296,Kiribati,Other South,196,109,87
2019,584,Marshall Islands,Other South,279,182,97
2019,583,Micronesia (Fed. States of),Other South,1432,752,680
2019,520,Nauru,Other South,735,338,397
2019,580,Northern Mariana Islands,Other South,752,171,581
2019,585,Palau,Other South,95,64,31
2019,16,American Samoa,Other South,434,214,220
2019,184,Cook Islands,Other South,414,224,190
2019,258,French Polynesia,Other South,3430,1705,1725
2019,570,Niue,Other South,55,27,28
2019,882,Samoa,Other South,280,141,139
2019,772,Tokelau,Other South,37,28,9
2019,776,Tonga,Other South,1249,656,593
2019,798,Tuvalu,Other South,60,35,25
2019,876,Wallis and Futuna Islands,Other South,6,5,1
2019,112,Belarus,Other South,122,84,38
2019,100,Bulgaria,Other South,645,329,316
2019,348,Hungary,Other South,5918,2147,3771
2019,616,Poland,Other South,5730,2538,3192
2019,498,Republic of Moldova,Other South,611,282,329
2019,642,Romania,Other South,7047,3910,3137
2019,643,Russian Federation,Other South,619,356,263
2019,703,Slovakia,Other South,635,379,256
2019,804,Ukraine,Other South,106307,44545,61762
2019,830,Channel Islands,Other South,905,432,473
2019,233,Estonia,Other South,5,3,2
2019,234,Faroe Islands,Other South,246,116,130
2019,246,Finland,Other South,525,261,264
2019,352,Iceland,Other South,375,228,147
2019,833,Isle of Man,Other South,1908,859,1049
2019,440,Lithuania,Other South,208,158,50
2019,578,Norway,Other South,11229,5789,5440
2019,752,Sweden,Other South,3597,1768,1829
2019,826,United Kingdom,Other South,20387,9278,11109
2019,8,Albania,Other South,1079,345,734
2019,20,Andorra,Other South,666,243,423
2019,70,Bosnia and Herzegovina,Other South,446,205,241
2019,191,Croatia,Other South,1197,682,515
2019,292,Gibraltar,Other South,917,506,411
2019,336,Holy See,Other South,316,149,167
2019,380,Italy,Other South,18078,8928,9150
2019,470,Malta,Other South,3790,2691,1099
2019,499,Montenegro,Other South,687,307,380
2019,807,North Macedonia,Other South,929,382,547
2019,620,Portugal,Other South,2620,1218,1402
2019,674,San Marino,Other South,166,48,118
2019,688,Serbia,Other South,609,260,349
2019,705,Slovenia,Other South,6167,3598,2569
2019,724,Spain,Other South,3932,2046,1886
2019,56,Belgium,Other South,46050,20329,25721
2019,276,Germany,Other South,1892,938,954
2019,438,Liechtenstein,Other South,430,182,248
2019,442,Luxembourg,Other South,70,18,52
2019,492,Monaco,Other South,3331,1461,1870
2019,528,Netherlands,Other South,5776,2706,3070
2019,756,Switzerland,Other South,45041,23345,21696
2019,60,Bermuda,Other South,694,352,342
2019,124,Canada,Other South,1055,502,553
2019,304,Greenland,Other South,108,64,44
2019,666,Saint Pierre and Miquelon,Other South,21,13,8
2019,840,United States of America,Other South,2582909,1343498,1239411
1990,108,Burundi,Other North,8943,4383,4560
1990,174,Comoros,Other North,672,342,330
1990,262,Djibouti,Other North,1827,1018,809
1990,232,Eritrea,Other North,345,179,166
1990,231,Ethiopia,Other North,7358,3868,3490
1990,404,Kenya,Other North,35411,18905,16506
1990,450,Madagascar,Other North,3563,1993,1570
1990,454,Malawi,Other North,11744,4732,7012
1990,480,Mauritius,Other North,75,9,66
1990,175,Mayotte,Other North,1142,593,549
1990,508,Mozambique,Other North,6443,3472,2971
1990,638,Réunion,Other North,6330,3173,3157
1990,646,Rwanda,Other North,954,487,467
1990,690,Seychelles,Other North,281,134,147
1990,706,Somalia,Other North,6098,3113,2985
1990,800,Uganda,Other North,359,149,210
1990,834,United Republic of Tanzania,Other North,1577,798,779
1990,894,Zambia,Other North,2905,1622,1283
1990,716,Zimbabwe,Other North,9658,5774,3884
1990,24,Angola,Other North,2805,1423,1382
1990,120,Cameroon,Other North,13373,7935,5438
1990,140,Central African Republic,Other North,2482,1331,1151
1990,148,Chad,Other North,245,132,113
1990,178,Congo,Other North,1978,1070,908
1990,180,Democratic Republic of the Congo,Other North,30396,14632,15764
1990,226,Equatorial Guinea,Other North,161,94,67
1990,266,Gabon,Other North,643,338,305
1990,678,Sao Tome and Principe,Other North,25,5,20
1990,72,Botswana,Other North,531,330,201
1990,748,Eswatini,Other North,1478,836,642
1990,426,Lesotho,Other North,2679,1516,1163
1990,516,Namibia,Other North,669,222,447
1990,710,South Africa,Other North,19342,6551,12791
1990,204,Benin,Other North,542,321,221
1990,854,Burkina Faso,Other North,6383,3119,3264
1990,132,Cabo Verde,Other North,1000,501,499
1990,384,Côte d'Ivoire,Other North,9313,5135,4178
1990,270,Gambia,Other North,1147,723,424
1990,288,Ghana,Other North,4357,2486,1871
1990,324,Guinea,Other North,2726,1892,834
1990,624,Guinea-Bissau,Other North,380,170,210
1990,430,Liberia,Other North,5561,2942,2619
1990,466,Mali,Other North,1782,938,844
1990,478,Mauritania,Other North,52,24,28
1990,562,Niger,Other North,2539,1320,1219
1990,566,Nigeria,Other North,14265,8003,6262
1990,654,Saint Helena,Other North,9,6,3
1990,686,Senegal,Other North,11997,5480,6517
1990,694,Sierra Leone,Other North,664,365,299
1990,768,Togo,Other North,1793,865,928
1990,12,Algeria,Other North,3833,2254,1579
1990,818,Egypt,Other North,2346,1178,1168
1990,504,Morocco,Other North,3162,1662,1500
1990,788,Tunisia,Other North,2252,1120,1132
1990,732,Western Sahara,Other North,43,24,19
1990,51,Armenia,Other North,41834,18104,23730
1990,31,Azerbaijan,Other North,1174,560,614
1990,48,Bahrain,Other North,532,277,255
1990,196,Cyprus,Other North,280,159,121
1990,268,Georgia,Other North,3822,2284,1538
1990,368,Iraq,Other North,494,269,225
1990,376,Israel,Other North,126758,59833,66925
1990,400,Jordan,Other North,503,243,260
1990,414,Kuwait,Other North,6571,3290,3281
1990,422,Lebanon,Other North,870,399,471
1990,512,Oman,Other North,1269,754,515
1990,634,Qatar,Other North,950,517,433
1990,682,Saudi Arabia,Other North,29093,19353,9740
1990,275,State of Palestine,Other North,1813,792,1021
1990,760,Syrian Arab Republic,Other North,12108,5514,6594
1990,792,Turkey,Other North,450,256,194
1990,784,United Arab Emirates,Other North,4029,2073,1956
1990,887,Yemen,Other North,1922,1067,855
1990,398,Kazakhstan,Other North,224143,104893,119250
1990,417,Kyrgyzstan,Other North,7545,3087,4458
1990,762,Tajikistan,Other North,355,151,204
1990,795,Turkmenistan,Other North,542,286,256
1990,860,Uzbekistan,Other North,32198,14934,17264
1990,4,Afghanistan,Other North,2338,1319,1019
1990,50,Bangladesh,Other North,97997,63996,34001
1990,64,Bhutan,Other North,1369,1062,307
1990,356,India,Other North,38691,19471,19220
1990,364,Iran (Islamic Republic of),Other North,276,158,118
1990,462,Maldives,Other North,172,95,77
1990,524,Nepal,Other North,1393,244,1149
1990,586,Pakistan,Other North,1080,620,460
1990,144,Sri Lanka,Other North,591,334,257
1990,156,China,Other North,15595,9371,6224
1990,344,"China, Hong Kong SAR",Other North,29032,17049,11983
1990,446,"China, Macao SAR",Other North,10247,5395,4852
1990,408,Dem. People's Republic of Korea,Other North,618,347,271
1990,392,Japan,Other North,1316,670,646
1990,496,Mongolia,Other North,169,87,82
1990,410,Republic of Korea,Other North,533,302,231
1990,96,Brunei Darussalam,Other North,200,110,90
1990,116,Cambodia,Other North,1731,925,806
1990,360,Indonesia,Other North,58930,28574,30356
1990,418,Lao People's Democratic Republic,Other North,308,186,122
1990,458,Malaysia,Other North,33033,18596,14437
1990,104,Myanmar,Other North,4663,2518,2145
1990,608,Philippines,Other North,12587,6041,6546
1990,702,Singapore,Other North,148625,70649,77976
1990,764,Thailand,Other North,5,4,1
1990,626,Timor-Leste,Other North,114,55,59
1990,704,Viet Nam,Other North,286,144,142
1990,660,Anguilla,Other North,87,33,54
1990,28,Antigua and Barbuda,Other North,82,39,43
1990,533,Aruba,Other North,1672,826,846
1990,44,Bahamas,Other North,574,286,288
1990,52,Barbados,Other North,2575,1235,1340
1990,92,British Virgin Islands,Other North,337,173,164
1990,535,"Bonaire, Sint Eustatius and Saba",Other North,73,38,35
1990,136,Cayman Islands,Other North,50,25,25
1990,192,Cuba,Other North,1242,653,589
1990,212,Dominica,Other North,75,41,34
1990,214,Dominican Republic,Other North,902,501,401
1990,308,Grenada,Other North,1054,521,533
1990,312,Guadeloupe,Other North,935,450,485
1990,332,Haiti,Other North,408,222,186
1990,388,Jamaica,Other North,219,110,109
1990,474,Martinique,Other North,643,297,346
1990,500,Montserrat,Other North,36,14,22
1990,630,Puerto Rico,Other North,6111,2894,3217
1990,659,Saint Kitts and Nevis,Other North,551,287,264
1990,662,Saint Lucia,Other North,588,320,268
1990,670,Saint Vincent and the Grenadines,Other North,41,21,20
1990,780,Trinidad and Tobago,Other North,1005,474,531
1990,796,Turks and Caicos Islands,Other North,348,180,168
1990,850,United States Virgin Islands,Other North,3531,1675,1856
1990,84,Belize,Other North,202,120,82
1990,188,Costa Rica,Other North,530,269,261
1990,222,El Salvador,Other North,61,33,28
1990,320,Guatemala,Other North,28,14,14
1990,340,Honduras,Other North,57,39,18
1990,484,Mexico,Other North,495,253,242
1990,558,Nicaragua,Other North,389,227,162
1990,591,Panama,Other North,58,41,17
1990,32,Argentina,Other North,25358,11250,14108
1990,68,Bolivia (Plurinational State of),Other North,791,388,403
1990,76,Brazil,Other North,6442,3076,3366
1990,170,Colombia,Other North,621,318,303
1990,218,Ecuador,Other North,57,31,26
1990,238,Falkland Islands (Malvinas),Other North,20,12,8
1990,254,French Guiana,Other North,777,414,363
1990,328,Guyana,Other North,125,66,59
1990,600,Paraguay,Other North,989,452,537
1990,604,Peru,Other North,583,325,258
1990,740,Suriname,Other North,2234,1203,1031
1990,858,Uruguay,Other North,2006,968,1038
1990,862,Venezuela (Bolivarian Republic of),Other North,27,18,9
1990,36,Australia,Other North,655,359,296
1990,554,New Zealand,Other North,4768,2491,2277
1990,242,Fiji,Other North,194,102,92
1990,540,New Caledonia,Other North,1242,595,647
1990,598,Papua New Guinea,Other North,249,143,106
1990,90,Solomon Islands,Other North,82,46,36
1990,548,Vanuatu,Other North,124,70,54
1990,316,Guam,Other North,1189,678,511
1990,296,Kiribati,Other North,283,169,114
1990,584,Marshall Islands,Other North,32,22,10
1990,583,Micronesia (Fed. States of),Other North,544,310,234
1990,520,Nauru,Other North,51,25,26
1990,580,Northern Mariana Islands,Other North,161,72,89
1990,585,Palau,Other North,6,3,3
1990,16,American Samoa,Other North,199,103,96
1990,184,Cook Islands,Other North,27,19,8
1990,258,French Polynesia,Other North,485,343,142
1990,570,Niue,Other North,41,24,17
1990,882,Samoa,Other North,56,27,29
1990,772,Tokelau,Other North,4,3,1
1990,776,Tonga,Other North,1129,609,520
1990,798,Tuvalu,Other North,38,29,9
1990,876,Wallis and Futuna Islands,Other North,20,11,9
1990,112,Belarus,Other North,117,80,37
1990,100,Bulgaria,Other North,1829,766,1063
1990,348,Hungary,Other North,9119,4020,5099
1990,616,Poland,Other North,13426,5740,7686
1990,498,Republic of Moldova,Other North,15324,8299,7025
1990,642,Romania,Other North,2909,1648,1261
1990,643,Russian Federation,Other North,1428,699,729
1990,703,Slovakia,Other North,12,5,7
1990,804,Ukraine,Other North,230443,88771,141672
1990,830,Channel Islands,Other North,904,426,478
1990,233,Estonia,Other North,535,286,249
1990,234,Faroe Islands,Other North,41,21,20
1990,246,Finland,Other North,1595,780,815
1990,833,Isle of Man,Other North,1075,503,572
1990,440,Lithuania,Other North,9714,4376,5338
1990,578,Norway,Other North,333,161,172
1990,752,Sweden,Other North,68302,34314,33988
1990,826,United Kingdom,Other North,6364,4616,1748
1990,8,Albania,Other North,5869,2746,3123
1990,20,Andorra,Other North,565,443,122
1990,70,Bosnia and Herzegovina,Other North,731,311,420
1990,191,Croatia,Other North,77858,37591,40267
1990,292,Gibraltar,Other North,924,552,372
1990,336,Holy See,Other North,406,199,207
1990,380,Italy,Other North,2,1,1
1990,807,North Macedonia,Other North,613,255,358
1990,620,Portugal,Other North,1142,535,607
1990,674,San Marino,Other North,47,26,21
1990,688,Serbia,Other North,12,6,6
1990,705,Slovenia,Other North,2747,1409,1338
1990,724,Spain,Other North,616,336,280
1990,56,Belgium,Other North,15425,2338,13087
1990,276,Germany,Other North,260273,150595,109678
1990,438,Liechtenstein,Other North,18,7,11
1990,442,Luxembourg,Other North,20,5,15
1990,492,Monaco,Other North,6059,2797,3262
1990,528,Netherlands,Other North,102,47,55
1990,756,Switzerland,Other North,134578,69290,65288
1990,60,Bermuda,Other North,29,20,9
1990,124,Canada,Other North,3308,1655,1653
1990,304,Greenland,Other North,36,10,26
1990,840,United States of America,Other North,195590,77107,118483
1995,108,Burundi,Other North,7340,3574,3766
1995,174,Comoros,Other North,665,336,329
1995,262,Djibouti,Other North,1492,832,660
1995,232,Eritrea,Other North,435,213,222
1995,231,Ethiopia,Other North,10378,6185,4193
1995,404,Kenya,Other North,37372,19398,17974
1995,450,Madagascar,Other North,3155,1774,1381
1995,454,Malawi,Other North,13149,6805,6344
1995,480,Mauritius,Other North,146,76,70
1995,175,Mayotte,Other North,607,336,271
1995,508,Mozambique,Other North,8853,4793,4060
1995,638,Réunion,Other North,5198,2569,2629
1995,646,Rwanda,Other North,1454,742,712
1995,690,Seychelles,Other North,238,96,142
1995,706,Somalia,Other North,495,264,231
1995,800,Uganda,Other North,340,135,205
1995,834,United Republic of Tanzania,Other North,2178,1101,1077
1995,894,Zambia,Other North,2599,1452,1147
1995,716,Zimbabwe,Other North,8116,4630,3486
1995,24,Angola,Other North,3260,1587,1673
1995,120,Cameroon,Other North,11778,7005,4773
1995,140,Central African Republic,Other North,5951,3270,2681
1995,148,Chad,Other North,266,143,123
1995,178,Congo,Other North,1513,795,718
1995,180,Democratic Republic of the Congo,Other North,33681,16652,17029
1995,226,Equatorial Guinea,Other North,213,123,90
1995,266,Gabon,Other North,859,451,408
1995,678,Sao Tome and Principe,Other North,22,4,18
1995,72,Botswana,Other North,551,342,209
1995,748,Eswatini,Other North,573,345,228
1995,426,Lesotho,Other North,2133,1202,931
1995,516,Namibia,Other North,659,220,439
1995,710,South Africa,Other North,12068,4735,7333
1995,204,Benin,Other North,747,446,301
1995,854,Burkina Faso,Other North,7938,3886,4052
1995,132,Cabo Verde,Other North,538,271,267
1995,384,Côte d'Ivoire,Other North,17320,9299,8021
1995,270,Gambia,Other North,1415,871,544
1995,288,Ghana,Other North,4344,2658,1686
1995,324,Guinea,Other North,3962,2762,1200
1995,624,Guinea-Bissau,Other North,488,224,264
1995,430,Liberia,Other North,5428,2811,2617
1995,466,Mali,Other North,1864,981,883
1995,478,Mauritania,Other North,55,28,27
1995,562,Niger,Other North,2217,1088,1129
1995,566,Nigeria,Other North,14463,8063,6400
1995,654,Saint Helena,Other North,6,4,2
1995,686,Senegal,Other North,12546,5689,6857
1995,694,Sierra Leone,Other North,636,339,297
1995,768,Togo,Other North,1405,781,624
1995,12,Algeria,Other North,2957,1667,1290
1995,818,Egypt,Other North,2273,1142,1131
1995,504,Morocco,Other North,2893,1500,1393
1995,788,Tunisia,Other North,2274,1145,1129
1995,732,Western Sahara,Other North,47,27,20
1995,51,Armenia,Other North,17428,7461,9967
1995,31,Azerbaijan,Other North,1035,527,508
1995,48,Bahrain,Other North,966,510,456
1995,196,Cyprus,Other North,358,218,140
1995,268,Georgia,Other North,662,446,216
1995,368,Iraq,Other North,582,227,355
1995,376,Israel,Other North,219076,100516,118560
1995,400,Jordan,Other North,553,267,286
1995,414,Kuwait,Other North,7080,3748,3332
1995,422,Lebanon,Other North,853,384,469
1995,512,Oman,Other North,4366,2679,1687
1995,634,Qatar,Other North,1651,1001,650
1995,682,Saudi Arabia,Other North,29817,19886,9931
1995,275,State of Palestine,Other North,1772,769,1003
1995,760,Syrian Arab Republic,Other North,14471,7852,6619
1995,792,Turkey,Other North,606,296,310
1995,784,United Arab Emirates,Other North,8983,4996,3987
1995,887,Yemen,Other North,1990,1305,685
1995,398,Kazakhstan,Other North,165666,77826,87840
1995,417,Kyrgyzstan,Other North,6086,2561,3525
1995,762,Tajikistan,Other North,217,90,127
1995,795,Turkmenistan,Other North,518,326,192
1995,860,Uzbekistan,Other North,27931,12892,15039
1995,4,Afghanistan,Other North,3669,2071,1598
1995,50,Bangladesh,Other North,88760,58564,30196
1995,64,Bhutan,Other North,1608,1247,361
1995,356,India,Other North,5884,2490,3394
1995,364,Iran (Islamic Republic of),Other North,15180,8690,6490
1995,462,Maldives,Other North,130,65,65
1995,524,Nepal,Other North,1599,477,1122
1995,586,Pakistan,Other North,905,515,390
1995,144,Sri Lanka,Other North,577,319,258
1995,156,China,Other North,17428,10485,6943
1995,344,"China, Hong Kong SAR",Other North,29740,17928,11812
1995,446,"China, Macao SAR",Other North,11240,5826,5414
1995,408,Dem. People's Republic of Korea,Other North,633,355,278
1995,392,Japan,Other North,2983,1433,1550
1995,496,Mongolia,Other North,210,113,97
1995,410,Republic of Korea,Other North,1425,799,626
1995,96,Brunei Darussalam,Other North,220,122,98
1995,116,Cambodia,Other North,1748,934,814
1995,360,Indonesia,Other North,38996,19431,19565
1995,418,Lao People's Democratic Republic,Other North,760,437,323
1995,458,Malaysia,Other North,36812,20730,16082
1995,104,Myanmar,Other North,4922,2789,2133
1995,608,Philippines,Other North,16939,7954,8985
1995,702,Singapore,Other North,74715,36353,38362
1995,764,Thailand,Other North,9,7,2
1995,626,Timor-Leste,Other North,124,58,66
1995,704,Viet Nam,Other North,520,280,240
1995,660,Anguilla,Other North,112,41,71
1995,28,Antigua and Barbuda,Other North,130,62,68
1995,533,Aruba,Other North,1636,797,839
1995,44,Bahamas,Other North,363,181,182
1995,52,Barbados,Other North,2812,1373,1439
1995,92,British Virgin Islands,Other North,787,391,396
1995,535,"Bonaire, Sint Eustatius and Saba",Other North,152,79,73
1995,136,Cayman Islands,Other North,47,24,23
1995,192,Cuba,Other North,933,480,453
1995,212,Dominica,Other North,67,37,30
1995,214,Dominican Republic,Other North,971,535,436
1995,308,Grenada,Other North,1429,738,691
1995,312,Guadeloupe,Other North,1053,497,556
1995,332,Haiti,Other North,387,211,176
1995,388,Jamaica,Other North,231,118,113
1995,474,Martinique,Other North,570,262,308
1995,500,Montserrat,Other North,27,11,16
1995,630,Puerto Rico,Other North,6499,3064,3435
1995,659,Saint Kitts and Nevis,Other North,729,381,348
1995,662,Saint Lucia,Other North,806,444,362
1995,670,Saint Vincent and the Grenadines,Other North,42,22,20
1995,780,Trinidad and Tobago,Other North,912,429,483
1995,796,Turks and Caicos Islands,Other North,739,383,356
1995,850,United States Virgin Islands,Other North,2364,1117,1247
1995,84,Belize,Other North,209,123,86
1995,188,Costa Rica,Other North,372,192,180
1995,222,El Salvador,Other North,46,25,21
1995,320,Guatemala,Other North,22,11,11
1995,340,Honduras,Other North,57,39,18
1995,484,Mexico,Other North,410,204,206
1995,558,Nicaragua,Other North,315,181,134
1995,591,Panama,Other North,64,48,16
1995,32,Argentina,Other North,24755,11130,13625
1995,68,Bolivia (Plurinational State of),Other North,852,417,435
1995,76,Brazil,Other North,5345,2601,2744
1995,170,Colombia,Other North,560,306,254
1995,218,Ecuador,Other North,2230,1213,1017
1995,238,Falkland Islands (Malvinas),Other North,26,16,10
1995,254,French Guiana,Other North,864,442,422
1995,328,Guyana,Other North,243,126,117
1995,600,Paraguay,Other North,1196,568,628
1995,604,Peru,Other North,566,317,249
1995,740,Suriname,Other North,2771,1509,1262
1995,858,Uruguay,Other North,2063,874,1189
1995,862,Venezuela (Bolivarian Republic of),Other North,27,18,9
1995,36,Australia,Other North,600,275,325
1995,554,New Zealand,Other North,8673,4369,4304
1995,242,Fiji,Other North,192,101,91
1995,540,New Caledonia,Other North,1439,678,761
1995,598,Papua New Guinea,Other North,255,154,101
1995,90,Solomon Islands,Other North,75,43,32
1995,548,Vanuatu,Other North,128,67,61
1995,316,Guam,Other North,1139,517,622
1995,296,Kiribati,Other North,291,163,128
1995,584,Marshall Islands,Other North,42,29,13
1995,583,Micronesia (Fed. States of),Other North,493,313,180
1995,520,Nauru,Other North,48,24,24
1995,580,Northern Mariana Islands,Other North,185,87,98
1995,585,Palau,Other North,11,5,6
1995,16,American Samoa,Other North,199,102,97
1995,184,Cook Islands,Other North,28,19,9
1995,258,French Polynesia,Other North,532,373,159
1995,570,Niue,Other North,44,24,20
1995,882,Samoa,Other North,92,46,46
1995,772,Tokelau,Other North,5,3,2
1995,776,Tonga,Other North,1278,707,571
1995,798,Tuvalu,Other North,40,31,9
1995,876,Wallis and Futuna Islands,Other North,25,13,12
1995,112,Belarus,Other North,157,107,50
1995,100,Bulgaria,Other North,1533,637,896
1995,348,Hungary,Other North,7160,3115,4045
1995,616,Poland,Other North,11484,4809,6675
1995,498,Republic of Moldova,Other North,10342,5478,4864
1995,642,Romania,Other North,6854,4135,2719
1995,643,Russian Federation,Other North,1466,734,732
1995,703,Slovakia,Other North,19,9,10
1995,804,Ukraine,Other North,222951,89765,133186
1995,830,Channel Islands,Other North,887,418,469
1995,233,Estonia,Other North,482,258,224
1995,234,Faroe Islands,Other North,31,18,13
1995,246,Finland,Other North,1446,738,708
1995,833,Isle of Man,Other North,1087,507,580
1995,440,Lithuania,Other North,10048,4633,5415
1995,578,Norway,Other North,361,176,185
1995,752,Sweden,Other North,81003,40350,40653
1995,826,United Kingdom,Other North,14412,8548,5864
1995,8,Albania,Other North,6344,2989,3355
1995,20,Andorra,Other North,3388,1935,1453
1995,70,Bosnia and Herzegovina,Other North,615,268,347
1995,191,Croatia,Other North,82778,39162,43616
1995,292,Gibraltar,Other North,882,481,401
1995,336,Holy See,Other North,435,211,224
1995,380,Italy,Other North,8,3,5
1995,470,Malta,Other North,4,3,1
1995,807,North Macedonia,Other North,573,238,335
1995,620,Portugal,Other North,1131,529,602
1995,674,San Marino,Other North,46,26,20
1995,688,Serbia,Other North,208839,81037,127802
1995,705,Slovenia,Other North,2753,1440,1313
1995,724,Spain,Other North,2450,1247,1203
1995,56,Belgium,Other North,31502,6659,24843
1995,276,Germany,Other North,259885,144637,115248
1995,438,Liechtenstein,Other North,35,13,22
1995,442,Luxembourg,Other North,17,4,13
1995,492,Monaco,Other North,6461,3056,3405
1995,528,Netherlands,Other North,138,63,75
1995,756,Switzerland,Other North,125225,66311,58914
1995,60,Bermuda,Other North,63,35,28
1995,124,Canada,Other North,3774,1895,1879
1995,304,Greenland,Other North,49,34,15
1995,840,United States of America,Other North,14422,7026,7396
2000,108,Burundi,Other North,4269,2076,2193
2000,174,Comoros,Other North,658,331,327
2000,262,Djibouti,Other North,1503,839,664
2000,232,Eritrea,Other North,525,247,278
2000,231,Ethiopia,Other North,15366,9685,5681
2000,404,Kenya,Other North,25053,11905,13148
2000,450,Madagascar,Other North,3510,1982,1528
2000,454,Malawi,Other North,12659,6534,6125
2000,480,Mauritius,Other North,295,187,108
2000,175,Mayotte,Other North,260,148,112
2000,508,Mozambique,Other North,10290,5421,4869
2000,638,Réunion,Other North,4307,2060,2247
2000,646,Rwanda,Other North,2218,1132,1086
2000,690,Seychelles,Other North,188,57,131
2000,706,Somalia,Other North,6509,3440,3069
2000,800,Uganda,Other North,43,21,22
2000,834,United Republic of Tanzania,Other North,2328,1179,1149
2000,894,Zambia,Other North,1517,848,669
2000,716,Zimbabwe,Other North,9840,5625,4215
2000,24,Angola,Other North,3714,1750,1964
2000,120,Cameroon,Other North,11090,6572,4518
2000,140,Central African Republic,Other North,8902,4923,3979
2000,148,Chad,Other North,287,155,132
2000,178,Congo,Other North,1622,817,805
2000,180,Democratic Republic of the Congo,Other North,42332,20762,21570
2000,226,Equatorial Guinea,Other North,265,153,112
2000,266,Gabon,Other North,1074,568,506
2000,678,Sao Tome and Principe,Other North,21,4,17
2000,72,Botswana,Other North,6634,3981,2653
2000,748,Eswatini,Other North,701,414,287
2000,426,Lesotho,Other North,1505,846,659
2000,516,Namibia,Other North,511,206,305
2000,710,South Africa,Other North,8423,4098,4325
2000,204,Benin,Other North,952,571,381
2000,854,Burkina Faso,Other North,9544,4707,4837
2000,132,Cabo Verde,Other North,76,41,35
2000,384,Côte d'Ivoire,Other North,18047,9685,8362
2000,270,Gambia,Other North,1772,1073,699
2000,288,Ghana,Other North,4861,2802,2059
2000,324,Guinea,Other North,7170,4679,2491
2000,624,Guinea-Bissau,Other North,596,278,318
2000,430,Liberia,Other North,5322,2684,2638
2000,466,Mali,Other North,1708,903,805
2000,478,Mauritania,Other North,56,31,25
2000,562,Niger,Other North,1903,854,1049
2000,566,Nigeria,Other North,15241,8442,6799
2000,654,Saint Helena,Other North,5,2,3
2000,686,Senegal,Other North,11339,4849,6490
2000,694,Sierra Leone,Other North,631,332,299
2000,768,Togo,Other North,1244,625,619
2000,12,Algeria,Other North,2081,1080,1001
2000,818,Egypt,Other North,2711,1453,1258
2000,504,Morocco,Other North,3036,1549,1487
2000,788,Tunisia,Other North,2599,1322,1277
2000,732,Western Sahara,Other North,52,30,22
2000,51,Armenia,Other North,16556,7088,9468
2000,31,Azerbaijan,Other North,830,419,411
2000,48,Bahrain,Other North,1403,738,665
2000,196,Cyprus,Other North,512,277,235
2000,268,Georgia,Other North,731,287,444
2000,368,Iraq,Other North,552,133,419
2000,376,Israel,Other North,299127,136844,162283
2000,400,Jordan,Other North,602,292,310
2000,414,Kuwait,Other North,10339,5699,4640
2000,422,Lebanon,Other North,835,369,466
2000,512,Oman,Other North,6219,4034,2185
2000,634,Qatar,Other North,2107,1339,768
2000,682,Saudi Arabia,Other North,30636,20476,10160
2000,275,State of Palestine,Other North,1731,746,985
2000,760,Syrian Arab Republic,Other North,14835,9153,5682
2000,792,Turkey,Other North,559,300,259
2000,784,United Arab Emirates,Other North,14454,8159,6295
2000,887,Yemen,Other North,2062,1107,955
2000,398,Kazakhstan,Other North,101653,48046,53607
2000,417,Kyrgyzstan,Other North,4461,1958,2503
2000,762,Tajikistan,Other North,100,42,58
2000,795,Turkmenistan,Other North,665,352,313
2000,860,Uzbekistan,Other North,23531,10728,12803
2000,4,Afghanistan,Other North,5000,2822,2178
2000,50,Bangladesh,Other North,79512,53146,26366
2000,64,Bhutan,Other North,1848,1433,415
2000,356,India,Other North,6415,2686,3729
2000,364,Iran (Islamic Republic of),Other North,32986,19556,13430
2000,462,Maldives,Other North,81,45,36
2000,524,Nepal,Other North,1445,615,830
2000,586,Pakistan,Other North,799,458,341
2000,144,Sri Lanka,Other North,564,304,260
2000,156,China,Other North,19262,11599,7663
2000,344,"China, Hong Kong SAR",Other North,30447,18806,11641
2000,446,"China, Macao SAR",Other North,10847,5801,5046
2000,408,Dem. People's Republic of Korea,Other North,648,363,285
2000,392,Japan,Other North,7555,3496,4059
2000,496,Mongolia,Other North,216,123,93
2000,410,Republic of Korea,Other North,2772,1590,1182
2000,96,Brunei Darussalam,Other North,240,135,105
2000,116,Cambodia,Other North,1765,943,822
2000,360,Indonesia,Other North,19050,10287,8763
2000,418,Lao People's Democratic Republic,Other North,1140,649,491
2000,458,Malaysia,Other North,50915,28530,22385
2000,104,Myanmar,Other North,4628,2616,2012
2000,608,Philippines,Other North,26609,13511,13098
2000,702,Singapore,Other North,8038,4896,3142
2000,764,Thailand,Other North,15,10,5
2000,626,Timor-Leste,Other North,136,62,74
2000,704,Viet Nam,Other North,1123,652,471
2000,660,Anguilla,Other North,137,49,88
2000,28,Antigua and Barbuda,Other North,178,86,92
2000,533,Aruba,Other North,1603,765,838
2000,44,Bahamas,Other North,153,77,76
2000,52,Barbados,Other North,3047,1510,1537
2000,92,British Virgin Islands,Other North,1121,553,568
2000,535,"Bonaire, Sint Eustatius and Saba",Other North,232,121,111
2000,136,Cayman Islands,Other North,56,29,27
2000,192,Cuba,Other North,638,302,336
2000,212,Dominica,Other North,80,45,35
2000,214,Dominican Republic,Other North,1103,592,511
2000,308,Grenada,Other North,1804,954,850
2000,312,Guadeloupe,Other North,1171,544,627
2000,332,Haiti,Other North,367,200,167
2000,388,Jamaica,Other North,242,125,117
2000,474,Martinique,Other North,498,228,270
2000,500,Montserrat,Other North,18,7,11
2000,630,Puerto Rico,Other North,6863,3234,3629
2000,659,Saint Kitts and Nevis,Other North,1007,525,482
2000,662,Saint Lucia,Other North,1079,603,476
2000,670,Saint Vincent and the Grenadines,Other North,43,23,20
2000,780,Trinidad and Tobago,Other North,988,472,516
2000,796,Turks and Caicos Islands,Other North,952,509,443
2000,850,United States Virgin Islands,Other North,1192,565,627
2000,84,Belize,Other North,216,127,89
2000,188,Costa Rica,Other North,400,203,197
2000,222,El Salvador,Other North,31,17,14
2000,320,Guatemala,Other North,15,8,7
2000,340,Honduras,Other North,56,38,18
2000,484,Mexico,Other North,344,166,178
2000,558,Nicaragua,Other North,232,137,95
2000,591,Panama,Other North,93,61,32
2000,32,Argentina,Other North,24151,11010,13141
2000,68,Bolivia (Plurinational State of),Other North,904,442,462
2000,76,Brazil,Other North,4247,2126,2121
2000,170,Colombia,Other North,536,290,246
2000,218,Ecuador,Other North,4435,2386,2049
2000,238,Falkland Islands (Malvinas),Other North,28,17,11
2000,254,French Guiana,Other North,950,470,480
2000,328,Guyana,Other North,361,186,175
2000,600,Paraguay,Other North,1400,679,721
2000,604,Peru,Other North,636,363,273
2000,740,Suriname,Other North,3384,1852,1532
2000,858,Uruguay,Other North,2123,938,1185
2000,862,Venezuela (Bolivarian Republic of),Other North,27,18,9
2000,36,Australia,Other North,37920,17598,20322
2000,554,New Zealand,Other North,8751,4249,4502
2000,242,Fiji,Other North,191,100,91
2000,540,New Caledonia,Other North,1637,761,876
2000,598,Papua New Guinea,Other North,190,123,67
2000,90,Solomon Islands,Other North,69,41,28
2000,548,Vanuatu,Other North,133,67,66
2000,316,Guam,Other North,1089,356,733
2000,296,Kiribati,Other North,295,172,123
2000,584,Marshall Islands,Other North,47,30,17
2000,583,Micronesia (Fed. States of),Other North,459,252,207
2000,520,Nauru,Other North,46,24,22
2000,580,Northern Mariana Islands,Other North,221,100,121
2000,585,Palau,Other North,15,8,7
2000,16,American Samoa,Other North,199,101,98
2000,184,Cook Islands,Other North,29,20,9
2000,258,French Polynesia,Other North,569,395,174
2000,570,Niue,Other North,47,23,24
2000,882,Samoa,Other North,109,57,52
2000,772,Tokelau,Other North,2,2,0
2000,776,Tonga,Other North,1428,806,622
2000,798,Tuvalu,Other North,38,31,7
2000,876,Wallis and Futuna Islands,Other North,30,15,15
2000,112,Belarus,Other North,187,128,59
2000,100,Bulgaria,Other North,1324,531,793
2000,348,Hungary,Other North,5277,2217,3060
2000,616,Poland,Other North,9824,4027,5797
2000,498,Republic of Moldova,Other North,6976,3610,3366
2000,642,Romania,Other North,10942,6609,4333
2000,643,Russian Federation,Other North,1460,743,717
2000,703,Slovakia,Other North,32,15,17
2000,804,Ukraine,Other North,218144,91850,126294
2000,830,Channel Islands,Other North,942,443,499
2000,233,Estonia,Other North,428,229,199
2000,234,Faroe Islands,Other North,48,26,22
2000,246,Finland,Other North,1359,697,662
2000,833,Isle of Man,Other North,1099,511,588
2000,440,Lithuania,Other North,7935,3634,4301
2000,578,Norway,Other North,401,193,208
2000,752,Sweden,Other North,86860,43074,43786
2000,826,United Kingdom,Other North,22580,12581,9999
2000,8,Albania,Other North,6819,3231,3588
2000,20,Andorra,Other North,681,357,324
2000,70,Bosnia and Herzegovina,Other North,498,225,273
2000,191,Croatia,Other North,78851,37121,41730
2000,292,Gibraltar,Other North,842,410,432
2000,336,Holy See,Other North,458,222,236
2000,380,Italy,Other North,13,4,9
2000,470,Malta,Other North,7,3,4
2000,807,North Macedonia,Other North,534,221,313
2000,620,Portugal,Other North,1167,547,620
2000,674,San Marino,Other North,70,32,38
2000,688,Serbia,Other North,68010,24425,43585
2000,705,Slovenia,Other North,4857,3270,1587
2000,724,Spain,Other North,3149,1612,1537
2000,56,Belgium,Other North,55599,21751,33848
2000,276,Germany,Other North,259561,138674,120887
2000,438,Liechtenstein,Other North,53,20,33
2000,442,Luxembourg,Other North,17,3,14
2000,492,Monaco,Other North,6871,3320,3551
2000,528,Netherlands,Other North,185,82,103
2000,756,Switzerland,Other North,77135,42477,34658
2000,60,Bermuda,Other North,97,50,47
2000,124,Canada,Other North,4329,2179,2150
2000,304,Greenland,Other North,73,47,26
2000,840,United States of America,Other North,13450,6661,6789
2005,108,Burundi,Other North,3319,1789,1530
2005,174,Comoros,Other North,630,319,311
2005,262,Djibouti,Other North,1377,808,569
2005,232,Eritrea,Other North,603,295,308
2005,231,Ethiopia,Other North,12925,7473,5452
2005,404,Kenya,Other North,21288,10492,10796
2005,450,Madagascar,Other North,3885,2201,1684
2005,454,Malawi,Other North,12063,6209,5854
2005,480,Mauritius,Other North,226,114,112
2005,175,Mayotte,Other North,541,273,268
2005,508,Mozambique,Other North,13908,6718,7190
2005,638,Réunion,Other North,4793,1702,3091
2005,646,Rwanda,Other North,2621,1337,1284
2005,690,Seychelles,Other North,165,63,102
2005,706,Somalia,Other North,6500,3503,2997
2005,800,Uganda,Other North,41,20,21
2005,834,United Republic of Tanzania,Other North,2548,1081,1467
2005,894,Zambia,Other North,1586,887,699
2005,716,Zimbabwe,Other North,18200,10277,7923
2005,24,Angola,Other North,3064,1679,1385
2005,120,Cameroon,Other North,5960,3315,2645
2005,140,Central African Republic,Other North,6807,3768,3039
2005,148,Chad,Other North,993,451,542
2005,178,Congo,Other North,1763,1006,757
2005,180,Democratic Republic of the Congo,Other North,42332,20762,21570
2005,226,Equatorial Guinea,Other North,386,226,160
2005,266,Gabon,Other North,1171,624,547
2005,678,Sao Tome and Principe,Other North,17,4,13
2005,72,Botswana,Other North,1896,860,1036
2005,748,Eswatini,Other North,692,385,307
2005,426,Lesotho,Other North,1536,863,673
2005,516,Namibia,Other North,443,159,284
2005,710,South Africa,Other North,10995,5507,5488
2005,204,Benin,Other North,1622,933,689
2005,854,Burkina Faso,Other North,10999,5415,5584
2005,132,Cabo Verde,Other North,136,69,67
2005,384,Côte d'Ivoire,Other North,18893,10139,8754
2005,270,Gambia,Other North,1758,1059,699
2005,288,Ghana,Other North,13095,4547,8548
2005,324,Guinea,Other North,31040,16436,14604
2005,624,Guinea-Bissau,Other North,577,271,306
2005,430,Liberia,Other North,2599,1729,870
2005,466,Mali,Other North,6969,3578,3391
2005,478,Mauritania,Other North,56,32,24
2005,562,Niger,Other North,1937,868,1069
2005,566,Nigeria,Other North,30277,17630,12647
2005,654,Saint Helena,Other North,13,7,6
2005,686,Senegal,Other North,12201,5461,6740
2005,694,Sierra Leone,Other North,421,272,149
2005,768,Togo,Other North,1336,720,616
2005,12,Algeria,Other North,1642,852,790
2005,818,Egypt,Other North,5586,3247,2339
2005,504,Morocco,Other North,3103,1572,1531
2005,788,Tunisia,Other North,2483,1275,1208
2005,732,Western Sahara,Other North,62,37,25
2005,51,Armenia,Other North,13244,5670,7574
2005,31,Azerbaijan,Other North,830,419,411
2005,48,Bahrain,Other North,2507,1416,1091
2005,196,Cyprus,Other North,711,403,308
2005,268,Georgia,Other North,694,273,421
2005,368,Iraq,Other North,633,288,345
2005,376,Israel,Other North,428782,195267,233515
2005,400,Jordan,Other North,1101,608,493
2005,414,Kuwait,Other North,16392,9134,7258
2005,422,Lebanon,Other North,654,304,350
2005,512,Oman,Other North,6757,4208,2549
2005,634,Qatar,Other North,4675,3087,1588
2005,682,Saudi Arabia,Other North,37845,26018,11827
2005,275,State of Palestine,Other North,1879,799,1080
2005,760,Syrian Arab Republic,Other North,11172,6933,4239
2005,792,Turkey,Other North,639,307,332
2005,784,United Arab Emirates,Other North,20597,12003,8594
2005,887,Yemen,Other North,2214,1169,1045
2005,398,Kazakhstan,Other North,114190,55017,59173
2005,417,Kyrgyzstan,Other North,3537,1550,1987
2005,762,Tajikistan,Other North,98,39,59
2005,795,Turkmenistan,Other North,948,480,468
2005,860,Uzbekistan,Other North,23834,11149,12685
2005,4,Afghanistan,Other North,6134,3462,2672
2005,50,Bangladesh,Other North,106577,62795,43782
2005,64,Bhutan,Other North,2316,1790,526
2005,356,India,Other North,7673,3373,4300
2005,364,Iran (Islamic Republic of),Other North,56076,33245,22831
2005,462,Maldives,Other North,97,58,39
2005,524,Nepal,Other North,1252,461,791
2005,586,Pakistan,Other North,772,443,329
2005,144,Sri Lanka,Other North,550,285,265
2005,156,China,Other North,21250,13686,7564
2005,344,"China, Hong Kong SAR",Other North,17421,10718,6703
2005,446,"China, Macao SAR",Other North,12582,6864,5718
2005,408,Dem. People's Republic of Korea,Other North,638,352,286
2005,392,Japan,Other North,9864,4497,5367
2005,496,Mongolia,Other North,169,99,70
2005,410,Republic of Korea,Other North,5652,3303,2349
2005,96,Brunei Darussalam,Other North,245,138,107
2005,116,Cambodia,Other North,1378,754,624
2005,360,Indonesia,Other North,23539,14308,9231
2005,418,Lao People's Democratic Republic,Other North,1060,615,445
2005,458,Malaysia,Other North,64577,37502,27075
2005,104,Myanmar,Other North,3920,2227,1693
2005,608,Philippines,Other North,21537,11102,10435
2005,702,Singapore,Other North,20262,12706,7556
2005,764,Thailand,Other North,149,97,52
2005,626,Timor-Leste,Other North,144,68,76
2005,704,Viet Nam,Other North,1201,719,482
2005,660,Anguilla,Other North,157,56,101
2005,28,Antigua and Barbuda,Other North,183,82,101
2005,533,Aruba,Other North,1198,651,547
2005,44,Bahamas,Other North,250,127,123
2005,52,Barbados,Other North,3190,1557,1633
2005,92,British Virgin Islands,Other North,1352,668,684
2005,535,"Bonaire, Sint Eustatius and Saba",Other North,247,129,118
2005,136,Cayman Islands,Other North,51,27,24
2005,192,Cuba,Other North,446,203,243
2005,212,Dominica,Other North,126,70,56
2005,214,Dominican Republic,Other North,3573,1996,1577
2005,308,Grenada,Other North,1641,868,773
2005,312,Guadeloupe,Other North,1101,507,594
2005,332,Haiti,Other North,348,190,158
2005,388,Jamaica,Other North,236,122,114
2005,474,Martinique,Other North,521,231,290
2005,500,Montserrat,Other North,18,7,11
2005,630,Puerto Rico,Other North,4948,2335,2613
2005,659,Saint Kitts and Nevis,Other North,1147,600,547
2005,662,Saint Lucia,Other North,582,325,257
2005,670,Saint Vincent and the Grenadines,Other North,43,24,19
2005,534,Sint Maarten (Dutch part),Other North,291,145,146
2005,780,Trinidad and Tobago,Other North,1060,505,555
2005,796,Turks and Caicos Islands,Other North,3671,1953,1718
2005,850,United States Virgin Islands,Other North,716,340,376
2005,84,Belize,Other North,238,139,99
2005,188,Costa Rica,Other North,262,131,131
2005,222,El Salvador,Other North,31,17,14
2005,320,Guatemala,Other North,39,27,12
2005,340,Honduras,Other North,55,37,18
2005,484,Mexico,Other North,336,174,162
2005,558,Nicaragua,Other North,176,99,77
2005,591,Panama,Other North,99,64,35
2005,32,Argentina,Other North,17816,8275,9541
2005,68,Bolivia (Plurinational State of),Other North,1527,808,719
2005,76,Brazil,Other North,2597,1303,1294
2005,170,Colombia,Other North,484,269,215
2005,218,Ecuador,Other North,5235,2867,2368
2005,238,Falkland Islands (Malvinas),Other North,39,23,16
2005,254,French Guiana,Other North,938,460,478
2005,328,Guyana,Other North,295,154,141
2005,600,Paraguay,Other North,1333,647,686
2005,604,Peru,Other North,734,415,319
2005,740,Suriname,Other North,4142,2256,1886
2005,858,Uruguay,Other North,4773,2505,2268
2005,862,Venezuela (Bolivarian Republic of),Other North,27,18,9
2005,36,Australia,Other North,41977,19243,22734
2005,554,New Zealand,Other North,9504,4613,4891
2005,242,Fiji,Other North,192,101,91
2005,540,New Caledonia,Other North,1744,815,929
2005,598,Papua New Guinea,Other North,220,155,65
2005,90,Solomon Islands,Other North,63,34,29
2005,548,Vanuatu,Other North,175,88,87
2005,316,Guam,Other North,951,387,564
2005,296,Kiribati,Other North,229,133,96
2005,584,Marshall Islands,Other North,64,41,23
2005,583,Micronesia (Fed. States of),Other North,427,229,198
2005,520,Nauru,Other North,42,22,20
2005,580,Northern Mariana Islands,Other North,254,103,151
2005,585,Palau,Other North,18,6,12
2005,16,American Samoa,Other North,170,86,84
2005,184,Cook Islands,Other North,131,74,57
2005,258,French Polynesia,Other North,596,416,180
2005,570,Niue,Other North,48,24,24
2005,882,Samoa,Other North,117,55,62
2005,772,Tokelau,Other North,1,1,0
2005,776,Tonga,Other North,1667,945,722
2005,798,Tuvalu,Other North,39,32,7
2005,876,Wallis and Futuna Islands,Other North,34,16,18
2005,112,Belarus,Other North,185,126,59
2005,100,Bulgaria,Other North,1173,476,697
2005,348,Hungary,Other North,6498,2803,3695
2005,616,Poland,Other North,5712,2345,3367
2005,498,Republic of Moldova,Other North,4810,2446,2364
2005,642,Romania,Other North,10129,5947,4182
2005,643,Russian Federation,Other North,756,388,368
2005,703,Slovakia,Other North,36,17,19
2005,804,Ukraine,Other North,199343,84087,115256
2005,830,Channel Islands,Other North,1530,727,803
2005,233,Estonia,Other North,430,231,199
2005,234,Faroe Islands,Other North,38,21,17
2005,246,Finland,Other North,1392,729,663
2005,833,Isle of Man,Other North,1240,551,689
2005,440,Lithuania,Other North,4333,2052,2281
2005,578,Norway,Other North,435,207,228
2005,752,Sweden,Other North,91064,45059,46005
2005,826,United Kingdom,Other North,26231,14367,11864
2005,8,Albania,Other North,5756,2958,2798
2005,20,Andorra,Other North,1329,633,696
2005,70,Bosnia and Herzegovina,Other North,377,169,208
2005,191,Croatia,Other North,46835,22397,24438
2005,292,Gibraltar,Other North,1082,521,561
2005,336,Holy See,Other North,474,226,248
2005,380,Italy,Other North,12,3,9
2005,470,Malta,Other North,19,6,13
2005,807,North Macedonia,Other North,548,227,321
2005,620,Portugal,Other North,1077,507,570
2005,674,San Marino,Other North,70,32,38
2005,688,Serbia,Other North,8329,4220,4109
2005,705,Slovenia,Other North,5095,2713,2382
2005,724,Spain,Other North,771,403,368
2005,56,Belgium,Other North,32515,11695,20820
2005,276,Germany,Other North,118448,64451,53997
2005,438,Liechtenstein,Other North,81,35,46
2005,442,Luxembourg,Other North,14,4,10
2005,492,Monaco,Other North,6817,3349,3468
2005,528,Netherlands,Other North,376,175,201
2005,756,Switzerland,Other North,65171,34982,30189
2005,60,Bermuda,Other North,226,115,111
2005,124,Canada,Other North,4447,2243,2204
2005,304,Greenland,Other North,89,54,35
2005,840,United States of America,Other North,12540,5334,7206
2010,108,Burundi,Other North,2660,1656,1004
2010,174,Comoros,Other North,602,308,294
2010,262,Djibouti,Other North,1518,845,673
2010,232,Eritrea,Other North,682,343,339
2010,231,Ethiopia,Other North,6351,3024,3327
2010,404,Kenya,Other North,20681,9667,11014
2010,450,Madagascar,Other North,4309,2450,1859
2010,454,Malawi,Other North,11849,6089,5760
2010,480,Mauritius,Other North,159,56,103
2010,175,Mayotte,Other North,753,357,396
2010,508,Mozambique,Other North,16096,7777,8319
2010,638,Réunion,Other North,5011,1242,3769
2010,646,Rwanda,Other North,2607,1329,1278
2010,690,Seychelles,Other North,136,73,63
2010,706,Somalia,Other North,7362,4042,3320
2010,800,Uganda,Other North,41,20,21
2010,834,United Republic of Tanzania,Other North,2748,1391,1357
2010,894,Zambia,Other North,1665,890,775
2010,716,Zimbabwe,Other North,5557,3170,2387
2010,24,Angola,Other North,68115,33037,35078
2010,120,Cameroon,Other North,2537,1592,945
2010,140,Central African Republic,Other North,6736,3731,3005
2010,148,Chad,Other North,1176,527,649
2010,178,Congo,Other North,3505,1935,1570
2010,180,Democratic Republic of the Congo,Other North,53504,26425,27079
2010,226,Equatorial Guinea,Other North,507,300,207
2010,266,Gabon,Other North,1357,735,622
2010,678,Sao Tome and Principe,Other North,14,2,12
2010,72,Botswana,Other North,1514,586,928
2010,748,Eswatini,Other North,662,341,321
2010,426,Lesotho,Other North,1568,881,687
2010,516,Namibia,Other North,433,150,283
2010,710,South Africa,Other North,45721,23163,22558
2010,204,Benin,Other North,2294,1297,997
2010,854,Burkina Faso,Other North,12416,6083,6333
2010,132,Cabo Verde,Other North,195,96,99
2010,384,Côte d'Ivoire,Other North,19739,10590,9149
2010,270,Gambia,Other North,1797,1081,716
2010,288,Ghana,Other North,37473,16733,20740
2010,324,Guinea,Other North,36561,23358,13203
2010,624,Guinea-Bissau,Other North,558,264,294
2010,430,Liberia,Other North,1590,923,667
2010,466,Mali,Other North,6747,3320,3427
2010,478,Mauritania,Other North,56,33,23
2010,562,Niger,Other North,1968,880,1088
2010,566,Nigeria,Other North,30883,17983,12900
2010,654,Saint Helena,Other North,23,13,10
2010,686,Senegal,Other North,13646,6435,7211
2010,694,Sierra Leone,Other North,539,340,199
2010,768,Togo,Other North,733,361,372
2010,12,Algeria,Other North,1804,899,905
2010,818,Egypt,Other North,1635,747,888
2010,504,Morocco,Other North,3483,1756,1727
2010,788,Tunisia,Other North,2590,1333,1257
2010,732,Western Sahara,Other North,72,43,29
2010,51,Armenia,Other North,11919,5103,6816
2010,31,Azerbaijan,Other North,830,419,411
2010,48,Bahrain,Other North,4165,2410,1755
2010,196,Cyprus,Other North,1164,666,498
2010,268,Georgia,Other North,700,275,425
2010,368,Iraq,Other North,639,311,328
2010,376,Israel,Other North,563637,255584,308053
2010,400,Jordan,Other North,1577,900,677
2010,414,Kuwait,Other North,26532,14935,11597
2010,422,Lebanon,Other North,472,238,234
2010,512,Oman,Other North,8361,5175,3186
2010,634,Qatar,Other North,11035,8196,2839
2010,682,Saudi Arabia,Other North,49069,34537,14532
2010,275,State of Palestine,Other North,2027,851,1176
2010,760,Syrian Arab Republic,Other North,16409,10012,6397
2010,792,Turkey,Other North,732,322,410
2010,784,United Arab Emirates,Other North,46838,28657,18181
2010,887,Yemen,Other North,2379,1235,1144
2010,398,Kazakhstan,Other North,128342,63614,64728
2010,417,Kyrgyzstan,Other North,2559,1113,1446
2010,762,Tajikistan,Other North,97,39,58
2010,795,Turkmenistan,Other North,1051,497,554
2010,860,Uzbekistan,Other North,23192,11118,12074
2010,4,Afghanistan,Other North,7268,4102,3166
2010,50,Bangladesh,Other North,157051,85084,71967
2010,64,Bhutan,Other North,2784,2147,637
2010,356,India,Other North,2692,852,1840
2010,364,Iran (Islamic Republic of),Other North,50468,29921,20547
2010,462,Maldives,Other North,117,89,28
2010,524,Nepal,Other North,672,385,287
2010,586,Pakistan,Other North,754,433,321
2010,144,Sri Lanka,Other North,530,256,274
2010,156,China,Other North,23239,15773,7466
2010,344,"China, Hong Kong SAR",Other North,4438,2658,1780
2010,446,"China, Macao SAR",Other North,23361,9366,13995
2010,408,Dem. People's Republic of Korea,Other North,628,341,287
2010,392,Japan,Other North,10458,4704,5754
2010,496,Mongolia,Other North,143,94,49
2010,410,Republic of Korea,Other North,10751,6172,4579
2010,96,Brunei Darussalam,Other North,250,141,109
2010,116,Cambodia,Other North,991,565,426
2010,360,Indonesia,Other North,29537,18246,11291
2010,418,Lao People's Democratic Republic,Other North,992,612,380
2010,458,Malaysia,Other North,74606,44539,30067
2010,104,Myanmar,Other North,3607,2077,1530
2010,608,Philippines,Other North,13808,6844,6964
2010,702,Singapore,Other North,33615,21213,12402
2010,764,Thailand,Other North,294,191,103
2010,626,Timor-Leste,Other North,157,75,82
2010,704,Viet Nam,Other North,1282,737,545
2010,660,Anguilla,Other North,171,62,109
2010,28,Antigua and Barbuda,Other North,204,98,106
2010,533,Aruba,Other North,768,377,391
2010,44,Bahamas,Other North,347,177,170
2010,52,Barbados,Other North,3350,1613,1737
2010,92,British Virgin Islands,Other North,1595,795,800
2010,535,"Bonaire, Sint Eustatius and Saba",Other North,76,41,35
2010,136,Cayman Islands,Other North,51,26,25
2010,192,Cuba,Other North,248,113,135
2010,531,Curaçao,Other North,363,183,180
2010,212,Dominica,Other North,392,201,191
2010,214,Dominican Republic,Other North,6018,3387,2631
2010,308,Grenada,Other North,1479,783,696
2010,312,Guadeloupe,Other North,1031,470,561
2010,332,Haiti,Other North,365,200,165
2010,388,Jamaica,Other North,229,119,110
2010,474,Martinique,Other North,544,234,310
2010,500,Montserrat,Other North,19,8,11
2010,630,Puerto Rico,Other North,4384,2118,2266
2010,659,Saint Kitts and Nevis,Other North,1244,653,591
2010,662,Saint Lucia,Other North,40,22,18
2010,670,Saint Vincent and the Grenadines,Other North,43,24,19
2010,534,Sint Maarten (Dutch part),Other North,585,291,294
2010,780,Trinidad and Tobago,Other North,1821,932,889
2010,796,Turks and Caicos Islands,Other North,3162,1753,1409
2010,850,United States Virgin Islands,Other North,241,114,127
2010,84,Belize,Other North,872,430,442
2010,188,Costa Rica,Other North,516,259,257
2010,222,El Salvador,Other North,30,17,13
2010,320,Guatemala,Other North,62,45,17
2010,340,Honduras,Other North,54,37,17
2010,484,Mexico,Other North,369,203,166
2010,558,Nicaragua,Other North,183,103,80
2010,591,Panama,Other North,126,73,53
2010,32,Argentina,Other North,11480,5542,5938
2010,68,Bolivia (Plurinational State of),Other North,2240,1174,1066
2010,76,Brazil,Other North,909,459,450
2010,170,Colombia,Other North,515,296,219
2010,218,Ecuador,Other North,7354,3944,3410
2010,238,Falkland Islands (Malvinas),Other North,38,22,16
2010,254,French Guiana,Other North,925,450,475
2010,328,Guyana,Other North,228,121,107
2010,600,Paraguay,Other North,1270,616,654
2010,604,Peru,Other North,846,467,379
2010,740,Suriname,Other North,4886,2665,2221
2010,858,Uruguay,Other North,4433,2304,2129
2010,862,Venezuela (Bolivarian Republic of),Other North,29,20,9
2010,36,Australia,Other North,50040,22357,27683
2010,554,New Zealand,Other North,9706,4704,5002
2010,242,Fiji,Other North,206,110,96
2010,540,New Caledonia,Other North,1851,868,983
2010,598,Papua New Guinea,Other North,186,133,53
2010,90,Solomon Islands,Other North,58,33,25
2010,548,Vanuatu,Other North,231,115,116
2010,316,Guam,Other North,813,418,395
2010,296,Kiribati,Other North,276,150,126
2010,584,Marshall Islands,Other North,78,48,30
2010,583,Micronesia (Fed. States of),Other North,410,218,192
2010,520,Nauru,Other North,80,32,48
2010,580,Northern Mariana Islands,Other North,215,79,136
2010,585,Palau,Other North,45,30,15
2010,16,American Samoa,Other North,141,71,70
2010,184,Cook Islands,Other North,232,127,105
2010,258,French Polynesia,Other North,575,406,169
2010,570,Niue,Other North,5,3,2
2010,882,Samoa,Other North,118,59,59
2010,772,Tokelau,Other North,1,1,0
2010,776,Tonga,Other North,1784,1016,768
2010,798,Tuvalu,Other North,45,37,8
2010,876,Wallis and Futuna Islands,Other North,18,9,9
2010,112,Belarus,Other North,174,116,58
2010,100,Bulgaria,Other North,1059,425,634
2010,348,Hungary,Other North,7757,3395,4362
2010,616,Poland,Other North,1781,715,1066
2010,498,Republic of Moldova,Other North,4356,2236,2120
2010,642,Romania,Other North,10065,5814,4251
2010,643,Russian Federation,Other North,41,24,17
2010,703,Slovakia,Other North,40,19,21
2010,804,Ukraine,Other North,190207,80386,109821
2010,830,Channel Islands,Other North,2117,1011,1106
2010,233,Estonia,Other North,64,35,29
2010,234,Faroe Islands,Other North,40,21,19
2010,246,Finland,Other North,2066,1162,904
2010,833,Isle of Man,Other North,1366,582,784
2010,440,Lithuania,Other North,144,77,67
2010,578,Norway,Other North,601,290,311
2010,752,Sweden,Other North,91815,45438,46377
2010,826,United Kingdom,Other North,27633,15392,12241
2010,8,Albania,Other North,4693,2412,2281
2010,20,Andorra,Other North,1881,844,1037
2010,70,Bosnia and Herzegovina,Other North,474,214,260
2010,191,Croatia,Other North,14860,7677,7183
2010,292,Gibraltar,Other North,1325,632,693
2010,336,Holy See,Other North,479,225,254
2010,380,Italy,Other North,25711,13759,11952
2010,470,Malta,Other North,20,12,8
2010,499,Montenegro,Other North,128,76,52
2010,807,North Macedonia,Other North,563,233,330
2010,620,Portugal,Other North,809,384,425
2010,674,San Marino,Other North,110,47,63
2010,688,Serbia,Other North,287,154,133
2010,705,Slovenia,Other North,14952,6726,8226
2010,724,Spain,Other North,1530,833,697
2010,56,Belgium,Other North,52431,23173,29258
2010,276,Germany,Other North,99150,55489,43661
2010,438,Liechtenstein,Other North,110,49,61
2010,442,Luxembourg,Other North,13,4,9
2010,492,Monaco,Other North,6859,3423,3436
2010,528,Netherlands,Other North,296,97,199
2010,756,Switzerland,Other North,67977,34047,33930
2010,60,Bermuda,Other North,355,180,175
2010,124,Canada,Other North,5950,1283,4667
2010,304,Greenland,Other North,124,72,52
2010,840,United States of America,Other North,11824,4418,7406
2015,108,Burundi,Other North,3242,2019,1223
2015,174,Comoros,Other North,597,307,290
2015,262,Djibouti,Other North,1679,936,743
2015,232,Eritrea,Other North,693,352,341
2015,231,Ethiopia,Other North,17996,7296,10700
2015,404,Kenya,Other North,27769,13642,14127
2015,450,Madagascar,Other North,4785,2732,2053
2015,454,Malawi,Other North,11708,6010,5698
2015,480,Mauritius,Other North,191,72,119
2015,175,Mayotte,Other North,765,354,411
2015,508,Mozambique,Other North,13906,6725,7181
2015,638,Réunion,Other North,5181,1266,3915
2015,646,Rwanda,Other North,2583,1317,1266
2015,690,Seychelles,Other North,152,86,66
2015,706,Somalia,Other North,7719,4197,3522
2015,800,Uganda,Other North,41,20,21
2015,834,United Republic of Tanzania,Other North,10268,5179,5089
2015,894,Zambia,Other North,1466,781,685
2015,716,Zimbabwe,Other North,5587,3149,2438
2015,24,Angola,Other North,130760,63094,67666
2015,120,Cameroon,Other North,4435,1956,2479
2015,140,Central African Republic,Other North,5881,3239,2642
2015,148,Chad,Other North,3586,2037,1549
2015,178,Congo,Other North,2109,1169,940
2015,180,Democratic Republic of the Congo,Other North,12128,4159,7969
2015,226,Equatorial Guinea,Other North,634,378,256
2015,266,Gabon,Other North,1897,1149,748
2015,678,Sao Tome and Principe,Other North,16,5,11
2015,72,Botswana,Other North,1652,639,1013
2015,748,Eswatini,Other North,605,288,317
2015,426,Lesotho,Other North,1608,904,704
2015,516,Namibia,Other North,423,147,276
2015,710,South Africa,Other North,273235,148978,124257
2015,204,Benin,Other North,2744,1575,1169
2015,854,Burkina Faso,Other North,12983,6361,6622
2015,132,Cabo Verde,Other North,202,99,103
2015,384,Côte d'Ivoire,Other North,20585,11044,9541
2015,270,Gambia,Other North,1862,1119,743
2015,288,Ghana,Other North,46135,20587,25548
2015,324,Guinea,Other North,2987,1817,1170
2015,624,Guinea-Bissau,Other North,592,277,315
2015,430,Liberia,Other North,1824,1052,772
2015,466,Mali,Other North,8359,4114,4245
2015,478,Mauritania,Other North,56,34,22
2015,562,Niger,Other North,2920,1233,1687
2015,566,Nigeria,Other North,37457,20551,16906
2015,654,Saint Helena,Other North,35,23,12
2015,686,Senegal,Other North,14581,6873,7708
2015,694,Sierra Leone,Other North,691,423,268
2015,768,Togo,Other North,492,242,250
2015,12,Algeria,Other North,1991,992,999
2015,818,Egypt,Other North,4369,2434,1935
2015,504,Morocco,Other North,4539,2279,2260
2015,788,Tunisia,Other North,3358,1736,1622
2015,732,Western Sahara,Other North,88,52,36
2015,51,Armenia,Other North,8882,3843,5039
2015,31,Azerbaijan,Other North,830,419,411
2015,48,Bahrain,Other North,2329,1333,996
2015,196,Cyprus,Other North,645,278,367
2015,268,Georgia,Other North,734,288,446
2015,368,Iraq,Other North,641,363,278
2015,376,Israel,Other North,581297,262040,319257
2015,400,Jordan,Other North,5264,2692,2572
2015,414,Kuwait,Other North,28624,17776,10848
2015,422,Lebanon,Other North,397,190,207
2015,512,Oman,Other North,19014,12859,6155
2015,634,Qatar,Other North,9793,7440,2353
2015,682,Saudi Arabia,Other North,62698,43433,19265
2015,275,State of Palestine,Other North,2007,840,1167
2015,760,Syrian Arab Republic,Other North,6428,3989,2439
2015,792,Turkey,Other North,24001,12121,11880
2015,784,United Arab Emirates,Other North,51180,30530,20650
2015,887,Yemen,Other North,4281,2223,2058
2015,398,Kazakhstan,Other North,135955,68529,67426
2015,417,Kyrgyzstan,Other North,2253,972,1281
2015,762,Tajikistan,Other North,95,38,57
2015,795,Turkmenistan,Other North,1226,656,570
2015,860,Uzbekistan,Other North,22287,10858,11429
2015,4,Afghanistan,Other North,31399,15620,15779
2015,50,Bangladesh,Other North,184104,99647,84457
2015,64,Bhutan,Other North,2938,2463,475
2015,356,India,Other North,2593,1239,1354
2015,364,Iran (Islamic Republic of),Other North,49963,29416,20547
2015,462,Maldives,Other North,137,120,17
2015,524,Nepal,Other North,656,374,282
2015,586,Pakistan,Other North,20148,10618,9530
2015,144,Sri Lanka,Other North,539,256,283
2015,156,China,Other North,26744,18545,8199
2015,344,"China, Hong Kong SAR",Other North,4532,2643,1889
2015,446,"China, Macao SAR",Other North,32512,13927,18585
2015,408,Dem. People's Republic of Korea,Other North,691,377,314
2015,392,Japan,Other North,19325,8629,10696
2015,496,Mongolia,Other North,177,100,77
2015,410,Republic of Korea,Other North,13374,7538,5836
2015,96,Brunei Darussalam,Other North,255,144,111
2015,116,Cambodia,Other North,894,517,377
2015,360,Indonesia,Other North,32701,20471,12230
2015,418,Lao People's Democratic Republic,Other North,925,610,315
2015,458,Malaysia,Other North,90980,54864,36116
2015,104,Myanmar,Other North,3460,2005,1455
2015,608,Philippines,Other North,14024,6959,7065
2015,702,Singapore,Other North,40801,25792,15009
2015,764,Thailand,Other North,317,206,111
2015,626,Timor-Leste,Other North,128,67,61
2015,704,Viet Nam,Other North,1548,883,665
2015,660,Anguilla,Other North,183,67,116
2015,28,Antigua and Barbuda,Other North,216,103,113
2015,533,Aruba,Other North,809,405,404
2015,44,Bahamas,Other North,376,190,186
2015,52,Barbados,Other North,3519,1694,1825
2015,92,British Virgin Islands,Other North,1787,891,896
2015,535,"Bonaire, Sint Eustatius and Saba",Other North,86,47,39
2015,136,Cayman Islands,Other North,55,29,26
2015,192,Cuba,Other North,198,89,109
2015,531,Curaçao,Other North,394,203,191
2015,212,Dominica,Other North,399,205,194
2015,214,Dominican Republic,Other North,6351,3573,2778
2015,308,Grenada,Other North,1496,792,704
2015,312,Guadeloupe,Other North,1070,482,588
2015,332,Haiti,Other North,383,210,173
2015,388,Jamaica,Other North,224,116,108
2015,474,Martinique,Other North,563,240,323
2015,500,Montserrat,Other North,19,8,11
2015,630,Puerto Rico,Other North,5356,2515,2841
2015,659,Saint Kitts and Nevis,Other North,1279,667,612
2015,662,Saint Lucia,Other North,48,22,26
2015,670,Saint Vincent and the Grenadines,Other North,43,24,19
2015,534,Sint Maarten (Dutch part),Other North,609,303,306
2015,780,Trinidad and Tobago,Other North,1869,964,905
2015,796,Turks and Caicos Islands,Other North,3654,2071,1583
2015,850,United States Virgin Islands,Other North,241,114,127
2015,84,Belize,Other North,1028,504,524
2015,188,Costa Rica,Other North,564,266,298
2015,222,El Salvador,Other North,31,17,14
2015,320,Guatemala,Other North,71,52,19
2015,340,Honduras,Other North,76,53,23
2015,484,Mexico,Other North,5360,2703,2657
2015,558,Nicaragua,Other North,191,108,83
2015,591,Panama,Other North,147,82,65
2015,32,Argentina,Other North,13247,6391,6856
2015,68,Bolivia (Plurinational State of),Other North,2608,1367,1241
2015,76,Brazil,Other North,1095,553,542
2015,170,Colombia,Other North,576,334,242
2015,218,Ecuador,Other North,10696,5701,4995
2015,238,Falkland Islands (Malvinas),Other North,42,24,18
2015,254,French Guiana,Other North,557,268,289
2015,328,Guyana,Other North,267,142,125
2015,600,Paraguay,Other North,1239,600,639
2015,604,Peru,Other North,899,508,391
2015,740,Suriname,Other North,5306,2898,2408
2015,858,Uruguay,Other North,4585,2374,2211
2015,862,Venezuela (Bolivarian Republic of),Other North,34,24,10
2015,36,Australia,Other North,67522,32411,35111
2015,554,New Zealand,Other North,9753,4717,5036
2015,242,Fiji,Other North,212,114,98
2015,540,New Caledonia,Other North,1422,580,842
2015,598,Papua New Guinea,Other North,188,136,52
2015,90,Solomon Islands,Other North,54,31,23
2015,548,Vanuatu,Other North,242,121,121
2015,316,Guam,Other North,820,422,398
2015,296,Kiribati,Other North,285,151,134
2015,584,Marshall Islands,Other North,82,51,31
2015,583,Micronesia (Fed. States of),Other North,402,213,189
2015,520,Nauru,Other North,126,53,73
2015,580,Northern Mariana Islands,Other North,193,70,123
2015,585,Palau,Other North,44,27,17
2015,16,American Samoa,Other North,140,70,70
2015,184,Cook Islands,Other North,214,117,97
2015,258,French Polynesia,Other North,546,386,160
2015,570,Niue,Other North,4,3,1
2015,882,Samoa,Other North,95,47,48
2015,772,Tokelau,Other North,1,1,0
2015,776,Tonga,Other North,1532,877,655
2015,798,Tuvalu,Other North,47,38,9
2015,876,Wallis and Futuna Islands,Other North,5,3,2
2015,112,Belarus,Other North,187,128,59
2015,100,Bulgaria,Other North,348,219,129
2015,348,Hungary,Other North,13888,4971,8917
2015,616,Poland,Other North,1777,739,1038
2015,498,Republic of Moldova,Other North,4501,2332,2169
2015,642,Romania,Other North,7431,4106,3325
2015,643,Russian Federation,Other North,47,25,22
2015,703,Slovakia,Other North,20,12,8
2015,804,Ukraine,Other North,314055,131221,182834
2015,830,Channel Islands,Other North,2246,1075,1171
2015,233,Estonia,Other North,30,19,11
2015,234,Faroe Islands,Other North,116,57,59
2015,246,Finland,Other North,1681,806,875
2015,352,Iceland,Other North,355,181,174
2015,833,Isle of Man,Other North,3636,1643,1993
2015,440,Lithuania,Other North,136,76,60
2015,578,Norway,Other North,540,283,257
2015,752,Sweden,Other North,91291,44998,46293
2015,826,United Kingdom,Other North,35338,19220,16118
2015,8,Albania,Other North,4626,2378,2248
2015,20,Andorra,Other North,1864,673,1191
2015,70,Bosnia and Herzegovina,Other North,471,213,258
2015,191,Croatia,Other North,3862,2219,1643
2015,292,Gibraltar,Other North,1415,686,729
2015,336,Holy See,Other North,485,225,260
2015,380,Italy,Other North,28436,15027,13409
2015,470,Malta,Other North,33,21,12
2015,499,Montenegro,Other North,288,173,115
2015,807,North Macedonia,Other North,609,251,358
2015,620,Portugal,Other North,984,421,563
2015,674,San Marino,Other North,136,55,81
2015,688,Serbia,Other North,105,51,54
2015,705,Slovenia,Other North,9086,5722,3364
2015,724,Spain,Other North,11383,6049,5334
2015,56,Belgium,Other North,65454,28790,36664
2015,276,Germany,Other North,99868,55790,44078
2015,438,Liechtenstein,Other North,401,219,182
2015,442,Luxembourg,Other North,19,6,13
2015,492,Monaco,Other North,9268,4666,4602
2015,528,Netherlands,Other North,419,107,312
2015,756,Switzerland,Other North,104043,53227,50816
2015,60,Bermuda,Other North,359,181,178
2015,124,Canada,Other North,2834,1340,1494
2015,304,Greenland,Other North,163,97,66
2015,840,United States of America,Other North,11512,4289,7223
2019,108,Burundi,Other North,3591,2237,1354
2019,174,Comoros,Other North,594,306,288
2019,262,Djibouti,Other North,1723,961,762
2019,232,Eritrea,Other North,565,289,276
2019,231,Ethiopia,Other North,6913,3120,3793
2019,404,Kenya,Other North,25747,12659,13088
2019,450,Madagascar,Other North,5211,2975,2236
2019,454,Malawi,Other North,11878,6098,5780
2019,480,Mauritius,Other North,192,72,120
2019,175,Mayotte,Other North,771,357,414
2019,508,Mozambique,Other North,12642,6112,6530
2019,638,Réunion,Other North,5260,1286,3974
2019,646,Rwanda,Other North,2709,1386,1323
2019,690,Seychelles,Other North,153,87,66
2019,706,Somalia,Other North,9252,4978,4274
2019,800,Uganda,Other North,41,20,21
2019,834,United Republic of Tanzania,Other North,9208,4646,4562
2019,894,Zambia,Other North,1889,1009,880
2019,716,Zimbabwe,Other North,5737,3261,2476
2019,24,Angola,Other North,127885,62607,65278
2019,120,Cameroon,Other North,3432,1748,1684
2019,140,Central African Republic,Other North,6533,3602,2931
2019,148,Chad,Other North,3935,2233,1702
2019,178,Congo,Other North,2177,1205,972
2019,180,Democratic Republic of the Congo,Other North,11729,3887,7842
2019,226,Equatorial Guinea,Other North,43600,34052,9548
2019,266,Gabon,Other North,2061,1248,813
2019,678,Sao Tome and Principe,Other North,17,4,13
2019,72,Botswana,Other North,1769,685,1084
2019,748,Eswatini,Other North,614,288,326
2019,426,Lesotho,Other North,1695,953,742
2019,516,Namibia,Other North,447,155,292
2019,710,South Africa,Other North,292826,159577,133249
2019,204,Benin,Other North,2922,1680,1242
2019,854,Burkina Faso,Other North,13388,6561,6827
2019,132,Cabo Verde,Other North,212,104,108
2019,384,Côte d'Ivoire,Other North,21261,11407,9854
2019,270,Gambia,Other North,2083,1252,831
2019,288,Ghana,Other North,51941,23234,28707
2019,324,Guinea,Other North,2877,1736,1141
2019,624,Guinea-Bissau,Other North,649,304,345
2019,430,Liberia,Other North,2255,1330,925
2019,466,Mali,Other North,9307,4581,4726
2019,478,Mauritania,Other North,79,41,38
2019,562,Niger,Other North,3308,1308,2000
2019,566,Nigeria,Other North,39246,21533,17713
2019,654,Saint Helena,Other North,41,29,12
2019,686,Senegal,Other North,15061,7096,7965
2019,694,Sierra Leone,Other North,672,411,261
2019,768,Togo,Other North,495,245,250
2019,12,Algeria,Other North,2070,1031,1039
2019,818,Egypt,Other North,6243,3145,3098
2019,504,Morocco,Other North,4841,2431,2410
2019,788,Tunisia,Other North,3412,1765,1647
2019,732,Western Sahara,Other North,91,54,37
2019,51,Armenia,Other North,8833,3866,4967
2019,31,Azerbaijan,Other North,797,403,394
2019,48,Bahrain,Other North,2451,1403,1048
2019,196,Cyprus,Other North,674,289,385
2019,268,Georgia,Other North,756,297,459
2019,368,Iraq,Other North,656,372,284
2019,376,Israel,Other North,565294,254826,310468
2019,400,Jordan,Other North,5672,2896,2776
2019,414,Kuwait,Other North,30313,18823,11490
2019,422,Lebanon,Other North,375,180,195
2019,512,Oman,Other North,23418,15838,7580
2019,634,Qatar,Other North,9988,7417,2571
2019,682,Saudi Arabia,Other North,76391,52394,23997
2019,275,State of Palestine,Other North,1993,835,1158
2019,760,Syrian Arab Republic,Other North,6403,3982,2421
2019,792,Turkey,Other North,32453,16549,15904
2019,784,United Arab Emirates,Other North,54970,32787,22183
2019,887,Yemen,Other North,4350,2256,2094
2019,398,Kazakhstan,Other North,142068,71610,70458
2019,417,Kyrgyzstan,Other North,2207,952,1255
2019,762,Tajikistan,Other North,94,38,56
2019,795,Turkmenistan,Other North,1224,661,563
2019,860,Uzbekistan,Other North,22239,10841,11398
2019,4,Afghanistan,Other North,9601,4716,4885
2019,50,Bangladesh,Other North,188806,58140,130666
2019,64,Bhutan,Other North,3061,2567,494
2019,356,India,Other North,2421,734,1687
2019,364,Iran (Islamic Republic of),Other North,49152,28939,20213
2019,462,Maldives,Other North,147,129,18
2019,524,Nepal,Other North,631,358,273
2019,586,Pakistan,Other North,18721,9866,8855
2019,144,Sri Lanka,Other North,543,258,285
2019,156,China,Other North,28199,19548,8651
2019,344,"China, Hong Kong SAR",Other North,5871,3351,2520
2019,446,"China, Macao SAR",Other North,34544,14798,19746
2019,408,Dem. People's Republic of Korea,Other North,704,384,320
2019,392,Japan,Other North,23024,14438,8586
2019,496,Mongolia,Other North,188,107,81
2019,410,Republic of Korea,Other North,13630,7671,5959
2019,96,Brunei Darussalam,Other North,274,155,119
2019,116,Cambodia,Other North,950,550,400
2019,360,Indonesia,Other North,34152,21380,12772
2019,418,Lao People's Democratic Republic,Other North,980,647,333
2019,458,Malaysia,Other North,95131,57644,37487
2019,104,Myanmar,Other North,3586,2078,1508
2019,608,Philippines,Other North,14511,7182,7329
2019,702,Singapore,Other North,34577,21842,12735
2019,764,Thailand,Other North,330,215,115
2019,626,Timor-Leste,Other North,132,66,66
2019,704,Viet Nam,Other North,1630,924,706
2019,660,Anguilla,Other North,189,69,120
2019,28,Antigua and Barbuda,Other North,108,50,58
2019,533,Aruba,Other North,823,409,414
2019,44,Bahamas,Other North,278,138,140
2019,52,Barbados,Other North,9913,4769,5144
2019,92,British Virgin Islands,Other North,1940,967,973
2019,535,"Bonaire, Sint Eustatius and Saba",Other North,102,56,46
2019,136,Cayman Islands,Other North,60,32,28
2019,192,Cuba,Other North,182,82,100
2019,531,Curaçao,Other North,428,221,207
2019,212,Dominica,Other North,412,210,202
2019,214,Dominican Republic,Other North,6563,3693,2870
2019,308,Grenada,Other North,1510,800,710
2019,312,Guadeloupe,Other North,1099,488,611
2019,332,Haiti,Other North,398,219,179
2019,388,Jamaica,Other North,226,117,109
2019,474,Martinique,Other North,562,240,322
2019,500,Montserrat,Other North,19,8,11
2019,630,Puerto Rico,Other North,5120,2394,2726
2019,659,Saint Kitts and Nevis,Other North,1311,681,630
2019,662,Saint Lucia,Other North,56,16,40
2019,670,Saint Vincent and the Grenadines,Other North,51,25,26
2019,534,Sint Maarten (Dutch part),Other North,648,315,333
2019,780,Trinidad and Tobago,Other North,2012,1083,929
2019,796,Turks and Caicos Islands,Other North,3945,2232,1713
2019,850,United States Virgin Islands,Other North,241,114,127
2019,84,Belize,Other North,1128,553,575
2019,188,Costa Rica,Other North,607,278,329
2019,222,El Salvador,Other North,31,17,14
2019,320,Guatemala,Other North,72,53,19
2019,340,Honduras,Other North,77,54,23
2019,484,Mexico,Other North,5526,2787,2739
2019,558,Nicaragua,Other North,200,114,86
2019,591,Panama,Other North,196,108,88
2019,32,Argentina,Other North,13479,6492,6987
2019,68,Bolivia (Plurinational State of),Other North,2847,1493,1354
2019,76,Brazil,Other North,1314,637,677
2019,170,Colombia,Other North,497,204,293
2019,218,Ecuador,Other North,10530,5611,4919
2019,238,Falkland Islands (Malvinas),Other North,50,29,21
2019,254,French Guiana,Other North,616,297,319
2019,328,Guyana,Other North,272,145,127
2019,600,Paraguay,Other North,1271,616,655
2019,604,Peru,Other North,1255,733,522
2019,740,Suriname,Other North,5678,3105,2573
2019,858,Uruguay,Other North,4749,2466,2283
2019,862,Venezuela (Bolivarian Republic of),Other North,33,24,9
2019,36,Australia,Other North,73055,40231,32824
2019,554,New Zealand,Other North,10025,4849,5176
2019,242,Fiji,Other North,216,116,100
2019,540,New Caledonia,Other North,1497,608,889
2019,598,Papua New Guinea,Other North,189,137,52
2019,90,Solomon Islands,Other North,61,30,31
2019,548,Vanuatu,Other North,251,123,128
2019,316,Guam,Other North,860,443,417
2019,296,Kiribati,Other North,295,157,138
2019,584,Marshall Islands,Other North,82,51,31
2019,583,Micronesia (Fed. States of),Other North,411,218,193
2019,520,Nauru,Other North,140,59,81
2019,580,Northern Mariana Islands,Other North,194,71,123
2019,585,Palau,Other North,45,26,19
2019,16,American Samoa,Other North,140,70,70
2019,184,Cook Islands,Other North,214,117,97
2019,258,French Polynesia,Other North,566,400,166
2019,570,Niue,Other North,4,3,1
2019,882,Samoa,Other North,90,45,45
2019,772,Tokelau,Other North,3,1,2
2019,776,Tonga,Other North,1453,832,621
2019,798,Tuvalu,Other North,48,39,9
2019,876,Wallis and Futuna Islands,Other North,5,3,2
2019,112,Belarus,Other North,184,126,58
2019,100,Bulgaria,Other North,1934,986,948
2019,348,Hungary,Other North,13811,5017,8794
2019,616,Poland,Other North,1908,811,1097
2019,498,Republic of Moldova,Other North,4430,2287,2143
2019,642,Romania,Other North,9523,5181,4342
2019,643,Russian Federation,Other North,46,25,21
2019,703,Slovakia,Other North,28,20,8
2019,804,Ukraine,Other North,317205,132530,184675
2019,830,Channel Islands,Other North,2289,1096,1193
2019,233,Estonia,Other North,29,19,10
2019,234,Faroe Islands,Other North,164,82,82
2019,246,Finland,Other North,1575,784,791
2019,352,Iceland,Other North,750,455,295
2019,833,Isle of Man,Other North,3689,1667,2022
2019,440,Lithuania,Other North,117,66,51
2019,578,Norway,Other North,591,304,287
2019,752,Sweden,Other North,90877,44572,46305
2019,826,United Kingdom,Other North,40130,21873,18257
2019,8,Albania,Other North,4370,2247,2123
2019,20,Andorra,Other North,1996,727,1269
2019,70,Bosnia and Herzegovina,Other North,436,197,239
2019,191,Croatia,Other North,3594,2046,1548
2019,292,Gibraltar,Other North,1428,693,735
2019,336,Holy See,Other North,483,224,259
2019,380,Italy,Other North,27119,13392,13727
2019,470,Malta,Other North,53,34,19
2019,499,Montenegro,Other North,288,174,114
2019,807,North Macedonia,Other North,611,252,359
2019,620,Portugal,Other North,1000,429,571
2019,674,San Marino,Other North,144,55,89
2019,688,Serbia,Other North,106,52,54
2019,705,Slovenia,Other North,18500,10793,7707
2019,724,Spain,Other North,11794,6135,5659
2019,56,Belgium,Other North,69075,30493,38582
2019,276,Germany,Other North,109530,63400,46130
2019,438,Liechtenstein,Other North,429,235,194
2019,442,Luxembourg,Other North,17,6,11
2019,492,Monaco,Other North,9456,4760,4696
2019,528,Netherlands,Other North,464,142,322
2019,756,Switzerland,Other North,118766,60836,57930
2019,60,Bermuda,Other North,375,179,196
2019,124,Canada,Other North,3115,1436,1679
2019,304,Greenland,Other North,159,95,64
2019,840,United States of America,Other North,12499,4531,7968
1990,516,Namibia,Afghanistan,64,26,38
1990,710,South Africa,Afghanistan,59,37,22
1990,818,Egypt,Afghanistan,237,194,43
1990,434,Libya,Afghanistan,677,556,121
1990,31,Azerbaijan,Afghanistan,254,175,79
1990,48,Bahrain,Afghanistan,215,154,61
1990,196,Cyprus,Afghanistan,2,2,0
1990,368,Iraq,Afghanistan,241,160,81
1990,376,Israel,Afghanistan,2724,1282,1442
1990,400,Jordan,Afghanistan,74,43,31
1990,414,Kuwait,Afghanistan,1334,808,526
1990,634,Qatar,Afghanistan,384,281,103
1990,682,Saudi Arabia,Afghanistan,166255,110590,55665
1990,792,Turkey,Afghanistan,7652,3875,3777
1990,784,United Arab Emirates,Afghanistan,1630,1161,469
1990,762,Tajikistan,Afghanistan,8485,3726,4759
1990,795,Turkmenistan,Afghanistan,321,158,163
1990,356,India,Afghanistan,14159,7259,6900
1990,364,Iran (Islamic Republic of),Afghanistan,3123968,1788296,1335672
1990,586,Pakistan,Afghanistan,3374973,1723293,1651680
1990,458,Malaysia,Afghanistan,32,18,14
1990,608,Philippines,Afghanistan,25,19,6
1990,188,Costa Rica,Afghanistan,25,11,14
1990,558,Nicaragua,Afghanistan,27,16,11
1990,32,Argentina,Afghanistan,20,1,19
1990,68,Bolivia (Plurinational State of),Afghanistan,2,1,1
1990,170,Colombia,Afghanistan,107,62,45
1990,218,Ecuador,Afghanistan,18,11,7
1990,36,Australia,Afghanistan,2729,1455,1274
1990,554,New Zealand,Afghanistan,156,103,53
1990,112,Belarus,Afghanistan,140,106,34
1990,100,Bulgaria,Afghanistan,222,145,77
1990,203,Czechia,Afghanistan,51,37,14
1990,348,Hungary,Afghanistan,274,122,152
1990,616,Poland,Afghanistan,219,194,25
1990,643,Russian Federation,Afghanistan,19103,9374,9729
1990,703,Slovakia,Afghanistan,26,24,2
1990,804,Ukraine,Afghanistan,2552,1945,607
1990,208,Denmark,Afghanistan,354,212,142
1990,246,Finland,Afghanistan,4,4,0
1990,352,Iceland,Afghanistan,1,1,0
1990,372,Ireland,Afghanistan,29,24,5
1990,428,Latvia,Afghanistan,20,8,12
1990,440,Lithuania,Afghanistan,40,26,14
1990,578,Norway,Afghanistan,253,186,67
1990,752,Sweden,Afghanistan,3368,1889,1479
1990,826,United Kingdom,Afghanistan,2076,1533,543
1990,300,Greece,Afghanistan,621,502,119
1990,380,Italy,Afghanistan,271,211,60
1990,705,Slovenia,Afghanistan,1,1,0
1990,724,Spain,Afghanistan,24,17,7
1990,40,Austria,Afghanistan,4748,3194,1554
1990,56,Belgium,Afghanistan,93,46,47
1990,250,France,Afghanistan,3346,1909,1437
1990,276,Germany,Afghanistan,33279,21242,12037
1990,528,Netherlands,Afghanistan,9865,5786,4079
1990,756,Switzerland,Afghanistan,1756,1064,692
1990,124,Canada,Afghanistan,5321,2590,2731
1990,840,United States of America,Afghanistan,28444,15757,12687
1995,516,Namibia,Afghanistan,61,25,36
1995,710,South Africa,Afghanistan,36,24,12
1995,818,Egypt,Afghanistan,188,150,38
1995,434,Libya,Afghanistan,452,351,101
1995,31,Azerbaijan,Afghanistan,223,158,65
1995,48,Bahrain,Afghanistan,236,167,69
1995,196,Cyprus,Afghanistan,3,3,0
1995,368,Iraq,Afghanistan,284,114,170
1995,376,Israel,Afghanistan,2836,1322,1514
1995,400,Jordan,Afghanistan,75,44,31
1995,414,Kuwait,Afghanistan,1068,681,387
1995,634,Qatar,Afghanistan,417,312,105
1995,682,Saudi Arabia,Afghanistan,170388,113637,56751
1995,760,Syrian Arab Republic,Afghanistan,92,47,45
1995,792,Turkey,Afghanistan,9633,5233,4400
1995,784,United Arab Emirates,Afghanistan,2088,1496,592
1995,762,Tajikistan,Afghanistan,12248,5517,6731
1995,795,Turkmenistan,Afghanistan,3210,1384,1826
1995,356,India,Afghanistan,19916,10318,9598
1995,364,Iran (Islamic Republic of),Afghanistan,2029435,1186056,843379
1995,586,Pakistan,Afghanistan,1291867,660633,631234
1995,144,Sri Lanka,Afghanistan,15,13,2
1995,458,Malaysia,Afghanistan,36,20,16
1995,608,Philippines,Afghanistan,33,25,8
1995,764,Thailand,Afghanistan,9,5,4
1995,188,Costa Rica,Afghanistan,11,5,6
1995,558,Nicaragua,Afghanistan,22,13,9
1995,32,Argentina,Afghanistan,20,2,18
1995,68,Bolivia (Plurinational State of),Afghanistan,1,0,1
1995,152,Chile,Afghanistan,7,6,1
1995,170,Colombia,Afghanistan,104,60,44
1995,218,Ecuador,Afghanistan,21,13,8
1995,36,Australia,Afghanistan,7893,4518,3375
1995,554,New Zealand,Afghanistan,489,282,207
1995,112,Belarus,Afghanistan,216,152,64
1995,100,Bulgaria,Afghanistan,223,153,70
1995,203,Czechia,Afghanistan,77,57,20
1995,348,Hungary,Afghanistan,403,224,179
1995,616,Poland,Afghanistan,187,166,21
1995,643,Russian Federation,Afghanistan,15576,9811,5765
1995,703,Slovakia,Afghanistan,125,106,19
1995,804,Ukraine,Afghanistan,2468,1897,571
1995,208,Denmark,Afghanistan,1648,903,745
1995,246,Finland,Afghanistan,144,72,72
1995,352,Iceland,Afghanistan,1,1,0
1995,372,Ireland,Afghanistan,79,64,15
1995,428,Latvia,Afghanistan,22,15,7
1995,440,Lithuania,Afghanistan,45,29,16
1995,578,Norway,Afghanistan,351,206,145
1995,752,Sweden,Afghanistan,3997,2229,1768
1995,826,United Kingdom,Afghanistan,8160,5437,2723
1995,300,Greece,Afghanistan,472,388,84
1995,380,Italy,Afghanistan,236,187,49
1995,705,Slovenia,Afghanistan,2,2,0
1995,724,Spain,Afghanistan,37,26,11
1995,40,Austria,Afghanistan,5357,3632,1725
1995,56,Belgium,Afghanistan,79,40,39
1995,250,France,Afghanistan,3455,1946,1509
1995,276,Germany,Afghanistan,51537,29287,22250
1995,528,Netherlands,Afghanistan,14531,8388,6143
1995,756,Switzerland,Afghanistan,2243,1411,832
1995,124,Canada,Afghanistan,13677,6608,7069
1995,840,United States of America,Afghanistan,37312,20837,16475
2000,516,Namibia,Afghanistan,58,23,35
2000,710,South Africa,Afghanistan,30,20,10
2000,818,Egypt,Afghanistan,154,117,37
2000,434,Libya,Afghanistan,236,155,81
2000,31,Azerbaijan,Afghanistan,224,157,67
2000,48,Bahrain,Afghanistan,258,178,80
2000,196,Cyprus,Afghanistan,4,4,0
2000,268,Georgia,Afghanistan,42,22,20
2000,368,Iraq,Afghanistan,269,68,201
2000,376,Israel,Afghanistan,2790,1305,1485
2000,400,Jordan,Afghanistan,76,46,30
2000,414,Kuwait,Afghanistan,1219,823,396
2000,634,Qatar,Afghanistan,388,296,92
2000,682,Saudi Arabia,Afghanistan,175068,117007,58061
2000,760,Syrian Arab Republic,Afghanistan,172,87,85
2000,792,Turkey,Afghanistan,9020,5149,3871
2000,784,United Arab Emirates,Afghanistan,2668,1911,757
2000,762,Tajikistan,Afghanistan,17118,7845,9273
2000,795,Turkmenistan,Afghanistan,1784,769,1015
2000,356,India,Afghanistan,12794,6593,6201
2000,364,Iran (Islamic Republic of),Afghanistan,2087864,1248844,839020
2000,586,Pakistan,Afghanistan,2069977,1106710,963267
2000,144,Sri Lanka,Afghanistan,31,22,9
2000,458,Malaysia,Afghanistan,50,27,23
2000,608,Philippines,Afghanistan,781,380,401
2000,764,Thailand,Afghanistan,20,10,10
2000,188,Costa Rica,Afghanistan,3,1,2
2000,558,Nicaragua,Afghanistan,37,21,16
2000,32,Argentina,Afghanistan,20,3,17
2000,152,Chile,Afghanistan,15,12,3
2000,170,Colombia,Afghanistan,101,59,42
2000,218,Ecuador,Afghanistan,23,14,9
2000,36,Australia,Afghanistan,12580,7330,5250
2000,554,New Zealand,Afghanistan,714,347,367
2000,112,Belarus,Afghanistan,292,199,93
2000,100,Bulgaria,Afghanistan,223,161,62
2000,203,Czechia,Afghanistan,103,77,26
2000,348,Hungary,Afghanistan,532,326,206
2000,616,Poland,Afghanistan,160,142,18
2000,643,Russian Federation,Afghanistan,11486,9896,1590
2000,703,Slovakia,Afghanistan,315,276,39
2000,804,Ukraine,Afghanistan,2416,1874,542
2000,208,Denmark,Afghanistan,2941,1594,1347
2000,246,Finland,Afghanistan,284,141,143
2000,352,Iceland,Afghanistan,1,1,0
2000,372,Ireland,Afghanistan,173,140,33
2000,428,Latvia,Afghanistan,24,22,2
2000,440,Lithuania,Afghanistan,35,23,12
2000,578,Norway,Afghanistan,638,351,287
2000,752,Sweden,Afghanistan,4287,2378,1909
2000,826,United Kingdom,Afghanistan,14382,9425,4957
2000,300,Greece,Afghanistan,331,279,52
2000,380,Italy,Afghanistan,201,164,37
2000,724,Spain,Afghanistan,455,326,129
2000,40,Austria,Afghanistan,5966,4070,1896
2000,56,Belgium,Afghanistan,60,31,29
2000,250,France,Afghanistan,3563,1983,1580
2000,276,Germany,Afghanistan,69794,37331,32463
2000,528,Netherlands,Afghanistan,19683,11252,8431
2000,756,Switzerland,Afghanistan,2740,1766,974
2000,124,Canada,Afghanistan,22359,10786,11573
2000,840,United States of America,Afghanistan,46342,26035,20307
2005,516,Namibia,Afghanistan,45,18,27
2005,710,South Africa,Afghanistan,52,30,22
2005,818,Egypt,Afghanistan,183,142,41
2005,434,Libya,Afghanistan,259,187,72
2005,31,Azerbaijan,Afghanistan,213,148,65
2005,48,Bahrain,Afghanistan,392,267,125
2005,196,Cyprus,Afghanistan,6,4,2
2005,268,Georgia,Afghanistan,39,21,18
2005,368,Iraq,Afghanistan,308,142,166
2005,376,Israel,Afghanistan,2610,1235,1375
2005,400,Jordan,Afghanistan,72,44,28
2005,414,Kuwait,Afghanistan,1316,868,448
2005,634,Qatar,Afghanistan,620,462,158
2005,682,Saudi Arabia,Afghanistan,216261,148673,67588
2005,760,Syrian Arab Republic,Afghanistan,626,320,306
2005,792,Turkey,Afghanistan,9325,5233,4092
2005,784,United Arab Emirates,Afghanistan,3208,2219,989
2005,762,Tajikistan,Afghanistan,12636,5687,6949
2005,795,Turkmenistan,Afghanistan,808,349,459
2005,356,India,Afghanistan,9720,4997,4723
2005,364,Iran (Islamic Republic of),Afghanistan,2171005,1176408,994597
2005,586,Pakistan,Afghanistan,1162810,621787,541023
2005,144,Sri Lanka,Afghanistan,63,33,30
2005,458,Malaysia,Afghanistan,271,154,117
2005,608,Philippines,Afghanistan,632,313,319
2005,764,Thailand,Afghanistan,10,6,4
2005,188,Costa Rica,Afghanistan,2,1,1
2005,558,Nicaragua,Afghanistan,54,29,25
2005,32,Argentina,Afghanistan,15,3,12
2005,68,Bolivia (Plurinational State of),Afghanistan,1,1,0
2005,76,Brazil,Afghanistan,28,18,10
2005,152,Chile,Afghanistan,22,18,4
2005,170,Colombia,Afghanistan,96,56,40
2005,218,Ecuador,Afghanistan,27,17,10
2005,36,Australia,Afghanistan,18620,10598,8022
2005,554,New Zealand,Afghanistan,2051,996,1055
2005,112,Belarus,Afghanistan,281,192,89
2005,100,Bulgaria,Afghanistan,260,198,62
2005,203,Czechia,Afghanistan,221,142,79
2005,348,Hungary,Afghanistan,657,406,251
2005,616,Poland,Afghanistan,151,135,16
2005,643,Russian Federation,Afghanistan,8328,6935,1393
2005,703,Slovakia,Afghanistan,488,451,37
2005,804,Ukraine,Afghanistan,2207,1713,494
2005,208,Denmark,Afghanistan,6641,3580,3061
2005,246,Finland,Afghanistan,1510,838,672
2005,352,Iceland,Afghanistan,4,4,0
2005,372,Ireland,Afghanistan,173,142,31
2005,428,Latvia,Afghanistan,24,23,1
2005,440,Lithuania,Afghanistan,31,24,7
2005,578,Norway,Afghanistan,5071,3083,1988
2005,752,Sweden,Afghanistan,8345,4487,3858
2005,826,United Kingdom,Afghanistan,36100,22370,13730
2005,300,Greece,Afghanistan,3401,2741,660
2005,380,Italy,Afghanistan,3384,3164,220
2005,724,Spain,Afghanistan,219,156,63
2005,40,Austria,Afghanistan,6668,4498,2170
2005,56,Belgium,Afghanistan,2488,1527,961
2005,250,France,Afghanistan,3409,1946,1463
2005,276,Germany,Afghanistan,75824,41742,34082
2005,528,Netherlands,Afghanistan,32382,18155,14227
2005,756,Switzerland,Afghanistan,3300,2090,1210
2005,124,Canada,Afghanistan,30718,15252,15466
2005,840,United States of America,Afghanistan,51965,29321,22644
2010,516,Namibia,Afghanistan,43,18,25
2010,710,South Africa,Afghanistan,81,47,34
2010,466,Mali,Afghanistan,388,302,86
2010,818,Egypt,Afghanistan,198,152,46
2010,434,Libya,Afghanistan,284,206,78
2010,31,Azerbaijan,Afghanistan,195,138,57
2010,48,Bahrain,Afghanistan,613,414,199
2010,196,Cyprus,Afghanistan,9,6,3
2010,268,Georgia,Afghanistan,39,21,18
2010,368,Iraq,Afghanistan,311,153,158
2010,376,Israel,Afghanistan,2462,1178,1284
2010,400,Jordan,Afghanistan,142,95,47
2010,414,Kuwait,Afghanistan,1743,1136,607
2010,634,Qatar,Afghanistan,1356,1087,269
2010,682,Saudi Arabia,Afghanistan,280395,197352,83043
2010,760,Syrian Arab Republic,Afghanistan,2611,1331,1280
2010,792,Turkey,Afghanistan,11022,6122,4900
2010,784,United Arab Emirates,Afghanistan,6878,4818,2060
2010,762,Tajikistan,Afghanistan,12606,5703,6903
2010,795,Turkmenistan,Afghanistan,345,156,189
2010,356,India,Afghanistan,9317,4779,4538
2010,364,Iran (Islamic Republic of),Afghanistan,2372090,1335371,1036719
2010,586,Pakistan,Afghanistan,1988641,1015986,972655
2010,144,Sri Lanka,Afghanistan,129,68,61
2010,458,Malaysia,Afghanistan,506,284,222
2010,608,Philippines,Afghanistan,1201,569,632
2010,764,Thailand,Afghanistan,1,1,0
2010,188,Costa Rica,Afghanistan,4,1,3
2010,558,Nicaragua,Afghanistan,57,31,26
2010,32,Argentina,Afghanistan,9,2,7
2010,68,Bolivia (Plurinational State of),Afghanistan,1,1,0
2010,76,Brazil,Afghanistan,57,37,20
2010,152,Chile,Afghanistan,30,25,5
2010,170,Colombia,Afghanistan,108,64,44
2010,218,Ecuador,Afghanistan,38,24,14
2010,36,Australia,Afghanistan,30840,16873,13967
2010,554,New Zealand,Afghanistan,2314,1122,1192
2010,112,Belarus,Afghanistan,270,185,85
2010,100,Bulgaria,Afghanistan,286,227,59
2010,203,Czechia,Afghanistan,317,196,121
2010,348,Hungary,Afghanistan,782,487,295
2010,616,Poland,Afghanistan,147,132,15
2010,643,Russian Federation,Afghanistan,4999,3832,1167
2010,703,Slovakia,Afghanistan,139,119,20
2010,804,Ukraine,Afghanistan,2605,2022,583
2010,208,Denmark,Afghanistan,10158,5471,4687
2010,233,Estonia,Afghanistan,13,10,3
2010,246,Finland,Afghanistan,3044,1559,1485
2010,352,Iceland,Afghanistan,6,6,0
2010,372,Ireland,Afghanistan,145,117,28
2010,428,Latvia,Afghanistan,25,24,1
2010,440,Lithuania,Afghanistan,24,22,2
2010,578,Norway,Afghanistan,8864,5417,3447
2010,752,Sweden,Afghanistan,14420,8400,6020
2010,826,United Kingdom,Afghanistan,38029,23862,14167
2010,300,Greece,Afghanistan,6731,5413,1318
2010,380,Italy,Afghanistan,5549,5208,341
2010,705,Slovenia,Afghanistan,5,5,0
2010,724,Spain,Afghanistan,439,344,95
2010,40,Austria,Afghanistan,7370,4927,2443
2010,56,Belgium,Afghanistan,4244,2567,1677
2010,250,France,Afghanistan,4470,2445,2025
2010,276,Germany,Afghanistan,80611,45208,35403
2010,528,Netherlands,Afghanistan,31153,16795,14358
2010,756,Switzerland,Afghanistan,3621,2191,1430
2010,124,Canada,Afghanistan,40945,20687,20258
2010,840,United States of America,Afghanistan,59330,30501,28829
2015,516,Namibia,Afghanistan,42,18,24
2015,710,South Africa,Afghanistan,145,82,63
2015,324,Guinea,Afghanistan,3,3,0
2015,466,Mali,Afghanistan,480,374,106
2015,818,Egypt,Afghanistan,146,117,29
2015,434,Libya,Afghanistan,320,231,89
2015,31,Azerbaijan,Afghanistan,186,132,54
2015,48,Bahrain,Afghanistan,656,440,216
2015,196,Cyprus,Afghanistan,8,6,2
2015,268,Georgia,Afghanistan,40,22,18
2015,368,Iraq,Afghanistan,312,178,134
2015,376,Israel,Afghanistan,2539,1208,1331
2015,400,Jordan,Afghanistan,60,36,24
2015,414,Kuwait,Afghanistan,2669,1612,1057
2015,634,Qatar,Afghanistan,1571,1280,291
2015,682,Saudi Arabia,Afghanistan,385241,266864,118377
2015,760,Syrian Arab Republic,Afghanistan,1022,535,487
2015,792,Turkey,Afghanistan,13601,7467,6134
2015,784,United Arab Emirates,Afghanistan,7515,5176,2339
2015,762,Tajikistan,Afghanistan,12393,5550,6843
2015,795,Turkmenistan,Afghanistan,231,116,115
2015,356,India,Afghanistan,12924,6571,6353
2015,364,Iran (Islamic Republic of),Afghanistan,2348369,1220304,1128065
2015,586,Pakistan,Afghanistan,1710378,810665,899713
2015,144,Sri Lanka,Afghanistan,131,69,62
2015,458,Malaysia,Afghanistan,545,317,228
2015,608,Philippines,Afghanistan,1220,579,641
2015,764,Thailand,Afghanistan,1,1,0
2015,188,Costa Rica,Afghanistan,4,1,3
2015,558,Nicaragua,Afghanistan,61,34,27
2015,32,Argentina,Afghanistan,9,2,7
2015,68,Bolivia (Plurinational State of),Afghanistan,1,1,0
2015,76,Brazil,Afghanistan,69,45,24
2015,152,Chile,Afghanistan,45,38,7
2015,170,Colombia,Afghanistan,120,72,48
2015,218,Ecuador,Afghanistan,112,59,53
2015,36,Australia,Afghanistan,49550,28587,20963
2015,554,New Zealand,Afghanistan,2540,1229,1311
2015,112,Belarus,Afghanistan,282,192,90
2015,100,Bulgaria,Afghanistan,330,246,84
2015,203,Czechia,Afghanistan,418,268,150
2015,348,Hungary,Afghanistan,1350,947,403
2015,616,Poland,Afghanistan,141,127,14
2015,643,Russian Federation,Afghanistan,5095,3899,1196
2015,703,Slovakia,Afghanistan,299,258,41
2015,804,Ukraine,Afghanistan,4812,3736,1076
2015,208,Denmark,Afghanistan,12760,7175,5585
2015,233,Estonia,Afghanistan,26,20,6
2015,246,Finland,Afghanistan,5017,2602,2415
2015,352,Iceland,Afghanistan,13,7,6
2015,372,Ireland,Afghanistan,148,119,29
2015,428,Latvia,Afghanistan,27,21,6
2015,440,Lithuania,Afghanistan,20,16,4
2015,578,Norway,Afghanistan,13270,8093,5177
2015,752,Sweden,Afghanistan,31267,18709,12558
2015,826,United Kingdom,Afghanistan,48633,29979,18654
2015,300,Greece,Afghanistan,5810,2835,2975
2015,380,Italy,Afghanistan,7505,7047,458
2015,705,Slovenia,Afghanistan,25,25,0
2015,724,Spain,Afghanistan,458,348,110
2015,40,Austria,Afghanistan,8620,5779,2841
2015,56,Belgium,Afghanistan,12819,8950,3869
2015,250,France,Afghanistan,6507,3173,3334
2015,276,Germany,Afghanistan,83992,47017,36975
2015,528,Netherlands,Afghanistan,33852,18148,15704
2015,756,Switzerland,Afghanistan,12697,9050,3647
2015,124,Canada,Afghanistan,51641,25859,25782
2015,840,United States of America,Afghanistan,74106,37912,36194
2019,516,Namibia,Afghanistan,44,19,25
2019,710,South Africa,Afghanistan,162,93,69
2019,324,Guinea,Afghanistan,2,2,0
2019,466,Mali,Afghanistan,534,416,118
2019,818,Egypt,Afghanistan,208,162,46
2019,434,Libya,Afghanistan,339,245,94
2019,31,Azerbaijan,Afghanistan,178,127,51
2019,48,Bahrain,Afghanistan,690,463,227
2019,196,Cyprus,Afghanistan,7,6,1
2019,268,Georgia,Afghanistan,41,23,18
2019,368,Iraq,Afghanistan,319,182,137
2019,376,Israel,Afghanistan,2469,1175,1294
2019,400,Jordan,Afghanistan,64,39,25
2019,414,Kuwait,Afghanistan,2826,1707,1119
2019,634,Qatar,Afghanistan,1602,1285,317
2019,682,Saudi Arabia,Afghanistan,469324,321932,147392
2019,760,Syrian Arab Republic,Afghanistan,1018,535,483
2019,792,Turkey,Afghanistan,18390,10179,8211
2019,784,United Arab Emirates,Afghanistan,8071,5559,2512
2019,762,Tajikistan,Afghanistan,12346,5530,6816
2019,795,Turkmenistan,Afghanistan,216,108,108
2019,356,India,Afghanistan,13501,6865,6636
2019,364,Iran (Islamic Republic of),Afghanistan,2310292,1200519,1109773
2019,586,Pakistan,Afghanistan,1589146,753205,835941
2019,144,Sri Lanka,Afghanistan,132,70,62
2019,458,Malaysia,Afghanistan,569,333,236
2019,608,Philippines,Afghanistan,1258,597,661
2019,764,Thailand,Afghanistan,1,1,0
2019,188,Costa Rica,Afghanistan,4,1,3
2019,558,Nicaragua,Afghanistan,63,35,28
2019,32,Argentina,Afghanistan,9,2,7
2019,68,Bolivia (Plurinational State of),Afghanistan,1,1,0
2019,76,Brazil,Afghanistan,77,50,27
2019,152,Chile,Afghanistan,60,51,9
2019,170,Colombia,Afghanistan,122,73,49
2019,218,Ecuador,Afghanistan,157,82,75
2019,36,Australia,Afghanistan,59798,36629,23169
2019,554,New Zealand,Afghanistan,2610,1263,1347
2019,112,Belarus,Afghanistan,278,190,88
2019,100,Bulgaria,Afghanistan,396,294,102
2019,203,Czechia,Afghanistan,516,346,170
2019,348,Hungary,Afghanistan,1452,1035,417
2019,616,Poland,Afghanistan,149,135,14
2019,643,Russian Federation,Afghanistan,5093,3898,1195
2019,703,Slovakia,Afghanistan,252,217,35
2019,804,Ukraine,Afghanistan,4860,3774,1086
2019,208,Denmark,Afghanistan,14168,7861,6307
2019,233,Estonia,Afghanistan,42,31,11
2019,246,Finland,Afghanistan,7706,4502,3204
2019,352,Iceland,Afghanistan,34,22,12
2019,372,Ireland,Afghanistan,162,131,31
2019,428,Latvia,Afghanistan,25,16,9
2019,440,Lithuania,Afghanistan,7,3,4
2019,578,Norway,Afghanistan,17347,10997,6350
2019,752,Sweden,Afghanistan,45413,28619,16794
2019,826,United Kingdom,Afghanistan,55227,34097,21130
2019,300,Greece,Afghanistan,11673,5696,5977
2019,380,Italy,Afghanistan,11896,11212,684
2019,705,Slovenia,Afghanistan,40,40,0
2019,724,Spain,Afghanistan,474,358,116
2019,40,Austria,Afghanistan,20561,13924,6637
2019,56,Belgium,Afghanistan,23386,17393,5993
2019,250,France,Afghanistan,6887,3350,3537
2019,276,Germany,Afghanistan,208732,131973,76759
2019,528,Netherlands,Afghanistan,37216,20255,16961
2019,756,Switzerland,Afghanistan,14952,10620,4332
2019,124,Canada,Afghanistan,55339,27711,27628
2019,840,United States of America,Afghanistan,80026,40521,39505
1990,710,South Africa,Albania,78,34,44
1990,818,Egypt,Albania,111,74,37
1990,434,Libya,Albania,315,209,106
1990,196,Cyprus,Albania,69,41,28
1990,792,Turkey,Albania,801,426,375
1990,608,Philippines,Albania,421,209,212
1990,192,Cuba,Albania,242,133,109
1990,188,Costa Rica,Albania,2,1,1
1990,32,Argentina,Albania,148,86,62
1990,68,Bolivia (Plurinational State of),Albania,6,0,6
1990,152,Chile,Albania,23,10,13
1990,170,Colombia,Albania,57,38,19
1990,218,Ecuador,Albania,8,4,4
1990,862,Venezuela (Bolivarian Republic of),Albania,17,9,8
1990,36,Australia,Albania,984,681,303
1990,100,Bulgaria,Albania,103,54,49
1990,203,Czechia,Albania,44,28,16
1990,348,Hungary,Albania,96,34,62
1990,616,Poland,Albania,82,51,31
1990,642,Romania,Albania,591,264,327
1990,643,Russian Federation,Albania,1026,503,523
1990,703,Slovakia,Albania,6,4,2
1990,208,Denmark,Albania,5,3,2
1990,352,Iceland,Albania,10,3,7
1990,372,Ireland,Albania,57,34,23
1990,428,Latvia,Albania,4,2,2
1990,578,Norway,Albania,21,13,8
1990,752,Sweden,Albania,293,160,133
1990,826,United Kingdom,Albania,156,91,65
1990,300,Greece,Albania,63963,42970,20993
1990,380,Italy,Albania,44935,31662,13273
1990,470,Malta,Albania,16,6,10
1990,807,North Macedonia,Albania,45001,18759,26242
1990,620,Portugal,Albania,11,7,4
1990,674,San Marino,Albania,27,6,21
1990,688,Serbia,Albania,57,13,44
1990,705,Slovenia,Albania,15,10,5
1990,724,Spain,Albania,162,83,79
1990,40,Austria,Albania,1733,863,870
1990,56,Belgium,Albania,2157,1102,1055
1990,250,France,Albania,3391,1857,1534
1990,276,Germany,Albania,5211,4451,760
1990,442,Luxembourg,Albania,290,151,139
1990,528,Netherlands,Albania,181,107,74
1990,756,Switzerland,Albania,1333,803,530
1990,124,Canada,Albania,398,193,205
1990,840,United States of America,Albania,5627,3220,2407
1995,710,South Africa,Albania,63,28,35
1995,818,Egypt,Albania,96,61,35
1995,434,Libya,Albania,266,171,95
1995,196,Cyprus,Albania,98,57,41
1995,792,Turkey,Albania,1939,993,946
1995,608,Philippines,Albania,566,276,290
1995,192,Cuba,Albania,184,98,86
1995,188,Costa Rica,Albania,2,2,0
1995,32,Argentina,Albania,144,84,60
1995,68,Bolivia (Plurinational State of),Albania,3,0,3
1995,152,Chile,Albania,24,11,13
1995,170,Colombia,Albania,52,32,20
1995,218,Ecuador,Albania,19,10,9
1995,862,Venezuela (Bolivarian Republic of),Albania,16,8,8
1995,36,Australia,Albania,1315,803,512
1995,100,Bulgaria,Albania,316,165,151
1995,203,Czechia,Albania,66,42,24
1995,348,Hungary,Albania,113,49,64
1995,616,Poland,Albania,70,43,27
1995,642,Romania,Albania,632,290,342
1995,643,Russian Federation,Albania,988,527,461
1995,703,Slovakia,Albania,29,25,4
1995,208,Denmark,Albania,45,19,26
1995,246,Finland,Albania,17,11,6
1995,352,Iceland,Albania,15,5,10
1995,372,Ireland,Albania,158,91,67
1995,428,Latvia,Albania,6,3,3
1995,578,Norway,Albania,81,42,39
1995,752,Sweden,Albania,348,189,159
1995,826,United Kingdom,Albania,1181,748,433
1995,191,Croatia,Albania,83,41,42
1995,300,Greece,Albania,230218,138742,91476
1995,380,Italy,Albania,159672,88919,70753
1995,470,Malta,Albania,19,7,12
1995,807,North Macedonia,Albania,58009,24182,33827
1995,620,Portugal,Albania,24,15,9
1995,674,San Marino,Albania,28,5,23
1995,688,Serbia,Albania,364,77,287
1995,705,Slovenia,Albania,51,34,17
1995,724,Spain,Albania,359,190,169
1995,40,Austria,Albania,1955,989,966
1995,56,Belgium,Albania,2143,1092,1051
1995,250,France,Albania,3501,1890,1611
1995,276,Germany,Albania,8303,5370,2933
1995,442,Luxembourg,Albania,275,143,132
1995,528,Netherlands,Albania,267,155,112
1995,756,Switzerland,Albania,1316,723,593
1995,124,Canada,Albania,3263,1574,1689
1995,840,United States of America,Albania,22440,12978,9462
2000,710,South Africa,Albania,69,31,38
2000,818,Egypt,Albania,88,53,35
2000,434,Libya,Albania,223,139,84
2000,196,Cyprus,Albania,126,72,54
2000,268,Georgia,Albania,11,4,7
2000,792,Turkey,Albania,3086,1563,1523
2000,608,Philippines,Albania,582,286,296
2000,192,Cuba,Albania,125,62,63
2000,188,Costa Rica,Albania,3,3,0
2000,32,Argentina,Albania,140,83,57
2000,152,Chile,Albania,25,11,14
2000,170,Colombia,Albania,47,26,21
2000,218,Ecuador,Albania,30,16,14
2000,862,Venezuela (Bolivarian Republic of),Albania,16,8,8
2000,36,Australia,Albania,1530,873,657
2000,100,Bulgaria,Albania,528,276,252
2000,203,Czechia,Albania,88,56,32
2000,348,Hungary,Albania,129,63,66
2000,616,Poland,Albania,60,36,24
2000,642,Romania,Albania,675,315,360
2000,643,Russian Federation,Albania,915,532,383
2000,703,Slovakia,Albania,60,51,9
2000,208,Denmark,Albania,84,35,49
2000,246,Finland,Albania,34,22,12
2000,352,Iceland,Albania,20,7,13
2000,372,Ireland,Albania,346,204,142
2000,428,Latvia,Albania,8,4,4
2000,578,Norway,Albania,149,81,68
2000,752,Sweden,Albania,374,202,172
2000,826,United Kingdom,Albania,2227,1417,810
2000,191,Croatia,Albania,157,78,79
2000,300,Greece,Albania,400253,235135,165118
2000,380,Italy,Albania,274408,146176,128232
2000,470,Malta,Albania,48,19,29
2000,807,North Macedonia,Albania,69367,28917,40450
2000,620,Portugal,Albania,40,25,15
2000,674,San Marino,Albania,31,5,26
2000,688,Serbia,Albania,495,96,399
2000,705,Slovenia,Albania,76,45,31
2000,724,Spain,Albania,712,383,329
2000,40,Austria,Albania,2177,1116,1061
2000,56,Belgium,Albania,2067,1056,1011
2000,250,France,Albania,3611,1924,1687
2000,276,Germany,Albania,11394,6288,5106
2000,442,Luxembourg,Albania,264,136,128
2000,528,Netherlands,Albania,362,206,156
2000,756,Switzerland,Albania,1304,646,658
2000,124,Canada,Albania,6205,2993,3212
2000,840,United States of America,Albania,39644,22984,16660
2005,710,South Africa,Albania,90,38,52
2005,818,Egypt,Albania,105,66,39
2005,434,Libya,Albania,244,169,75
2005,196,Cyprus,Albania,185,105,80
2005,268,Georgia,Albania,10,4,6
2005,792,Turkey,Albania,3180,1576,1604
2005,608,Philippines,Albania,471,236,235
2005,192,Cuba,Albania,83,41,42
2005,188,Costa Rica,Albania,2,2,0
2005,32,Argentina,Albania,103,61,42
2005,68,Bolivia (Plurinational State of),Albania,1,0,1
2005,152,Chile,Albania,37,17,20
2005,170,Colombia,Albania,43,23,20
2005,218,Ecuador,Albania,35,19,16
2005,862,Venezuela (Bolivarian Republic of),Albania,16,8,8
2005,36,Australia,Albania,2270,1214,1056
2005,100,Bulgaria,Albania,824,440,384
2005,203,Czechia,Albania,184,123,61
2005,348,Hungary,Albania,159,79,80
2005,616,Poland,Albania,94,73,21
2005,642,Romania,Albania,690,329,361
2005,643,Russian Federation,Albania,578,337,241
2005,703,Slovakia,Albania,68,58,10
2005,208,Denmark,Albania,173,77,96
2005,246,Finland,Albania,114,94,20
2005,352,Iceland,Albania,30,13,17
2005,372,Ireland,Albania,347,213,134
2005,428,Latvia,Albania,7,4,3
2005,578,Norway,Albania,276,157,119
2005,752,Sweden,Albania,691,383,308
2005,826,United Kingdom,Albania,7351,4654,2697
2005,191,Croatia,Albania,165,77,88
2005,300,Greece,Albania,423598,236038,187560
2005,380,Italy,Albania,360959,190016,170943
2005,470,Malta,Albania,76,28,48
2005,807,North Macedonia,Albania,69782,29077,40705
2005,620,Portugal,Albania,45,26,19
2005,674,San Marino,Albania,30,7,23
2005,688,Serbia,Albania,489,91,398
2005,705,Slovenia,Albania,49,19,30
2005,724,Spain,Albania,1094,616,478
2005,40,Austria,Albania,2434,1219,1215
2005,56,Belgium,Albania,3289,1699,1590
2005,250,France,Albania,5747,3015,2732
2005,276,Germany,Albania,13162,7015,6147
2005,442,Luxembourg,Albania,229,125,104
2005,528,Netherlands,Albania,666,346,320
2005,756,Switzerland,Albania,1492,708,784
2005,124,Canada,Albania,9642,4835,4807
2005,840,United States of America,Albania,54825,31914,22911
2010,710,South Africa,Albania,140,59,81
2010,466,Mali,Albania,1037,465,572
2010,818,Egypt,Albania,113,69,44
2010,434,Libya,Albania,267,185,82
2010,196,Cyprus,Albania,302,173,129
2010,268,Georgia,Albania,10,4,6
2010,792,Turkey,Albania,3276,1586,1690
2010,608,Philippines,Albania,114,55,59
2010,192,Cuba,Albania,46,23,23
2010,188,Costa Rica,Albania,4,4,0
2010,32,Argentina,Albania,66,39,27
2010,68,Bolivia (Plurinational State of),Albania,1,0,1
2010,152,Chile,Albania,50,23,27
2010,170,Colombia,Albania,46,23,23
2010,218,Ecuador,Albania,49,26,23
2010,862,Venezuela (Bolivarian Republic of),Albania,18,9,9
2010,36,Australia,Albania,2880,1476,1404
2010,100,Bulgaria,Albania,1086,586,500
2010,203,Czechia,Albania,262,180,82
2010,348,Hungary,Albania,189,95,94
2010,616,Poland,Albania,131,111,20
2010,642,Romania,Albania,790,379,411
2010,643,Russian Federation,Albania,230,136,94
2010,703,Slovakia,Albania,76,65,11
2010,208,Denmark,Albania,256,117,139
2010,233,Estonia,Albania,7,7,0
2010,246,Finland,Albania,226,190,36
2010,352,Iceland,Albania,39,18,21
2010,372,Ireland,Albania,291,171,120
2010,428,Latvia,Albania,7,5,2
2010,578,Norway,Albania,438,228,210
2010,752,Sweden,Albania,1281,739,542
2010,826,United Kingdom,Albania,7743,4961,2782
2010,191,Croatia,Albania,172,76,96
2010,300,Greece,Albania,465034,246614,218420
2010,380,Italy,Albania,440648,231439,209209
2010,470,Malta,Albania,63,29,34
2010,499,Montenegro,Albania,2015,829,1186
2010,807,North Macedonia,Albania,70230,28250,41980
2010,620,Portugal,Albania,44,24,20
2010,674,San Marino,Albania,30,7,23
2010,688,Serbia,Albania,478,88,390
2010,705,Slovenia,Albania,96,48,48
2010,724,Spain,Albania,1807,1044,763
2010,40,Austria,Albania,2690,1322,1368
2010,56,Belgium,Albania,6132,3112,3020
2010,250,France,Albania,6286,3284,3002
2010,276,Germany,Albania,14597,7607,6990
2010,442,Luxembourg,Albania,197,115,82
2010,528,Netherlands,Albania,897,486,411
2010,756,Switzerland,Albania,1723,756,967
2010,124,Canada,Albania,13610,6956,6654
2010,840,United States of America,Albania,72085,38493,33592
2015,710,South Africa,Albania,251,99,152
2015,324,Guinea,Albania,11,7,4
2015,466,Mali,Albania,1284,576,708
2015,818,Egypt,Albania,83,55,28
2015,434,Libya,Albania,301,208,93
2015,196,Cyprus,Albania,290,167,123
2015,268,Georgia,Albania,10,4,6
2015,792,Turkey,Albania,3325,1571,1754
2015,608,Philippines,Albania,116,56,60
2015,192,Cuba,Albania,36,18,18
2015,188,Costa Rica,Albania,4,4,0
2015,32,Argentina,Albania,66,39,27
2015,68,Bolivia (Plurinational State of),Albania,1,0,1
2015,152,Chile,Albania,75,34,41
2015,170,Colombia,Albania,51,26,25
2015,218,Ecuador,Albania,71,38,33
2015,862,Venezuela (Bolivarian Republic of),Albania,19,9,10
2015,36,Australia,Albania,3460,1793,1667
2015,100,Bulgaria,Albania,1130,624,506
2015,203,Czechia,Albania,309,209,100
2015,348,Hungary,Albania,243,141,102
2015,616,Poland,Albania,126,108,18
2015,642,Romania,Albania,3,2,1
2015,643,Russian Federation,Albania,234,137,97
2015,703,Slovakia,Albania,99,84,15
2015,208,Denmark,Albania,334,152,182
2015,233,Estonia,Albania,20,15,5
2015,246,Finland,Albania,433,318,115
2015,352,Iceland,Albania,45,25,20
2015,372,Ireland,Albania,297,173,124
2015,428,Latvia,Albania,9,5,4
2015,578,Norway,Albania,979,571,408
2015,752,Sweden,Albania,2569,1461,1108
2015,826,United Kingdom,Albania,9902,6239,3663
2015,191,Croatia,Albania,173,76,97
2015,300,Greece,Albania,436566,222722,213844
2015,380,Italy,Albania,446571,229178,217393
2015,470,Malta,Albania,106,52,54
2015,499,Montenegro,Albania,2754,1143,1611
2015,807,North Macedonia,Albania,67799,27915,39884
2015,620,Portugal,Albania,50,25,25
2015,674,San Marino,Albania,37,8,29
2015,688,Serbia,Albania,467,85,382
2015,705,Slovenia,Albania,148,79,69
2015,724,Spain,Albania,1938,1050,888
2015,40,Austria,Albania,3147,1556,1591
2015,56,Belgium,Albania,9380,4711,4669
2015,250,France,Albania,6964,3548,3416
2015,276,Germany,Albania,15209,7909,7300
2015,442,Luxembourg,Albania,300,177,123
2015,528,Netherlands,Albania,1192,604,588
2015,756,Switzerland,Albania,2978,1335,1643
2015,124,Canada,Albania,15270,7540,7730
2015,840,United States of America,Albania,91865,45147,46718
2019,710,South Africa,Albania,280,110,170
2019,324,Guinea,Albania,10,7,3
2019,466,Mali,Albania,1429,641,788
2019,818,Egypt,Albania,118,74,44
2019,434,Libya,Albania,319,221,98
2019,196,Cyprus,Albania,289,168,121
2019,268,Georgia,Albania,10,4,6
2019,792,Turkey,Albania,4495,2147,2348
2019,608,Philippines,Albania,119,58,61
2019,192,Cuba,Albania,33,17,16
2019,188,Costa Rica,Albania,4,4,0
2019,32,Argentina,Albania,67,40,27
2019,68,Bolivia (Plurinational State of),Albania,1,0,1
2019,152,Chile,Albania,100,43,57
2019,170,Colombia,Albania,52,27,25
2019,218,Ecuador,Albania,69,37,32
2019,862,Venezuela (Bolivarian Republic of),Albania,18,9,9
2019,36,Australia,Albania,3872,2016,1856
2019,100,Bulgaria,Albania,1348,763,585
2019,203,Czechia,Albania,384,250,134
2019,348,Hungary,Albania,307,189,118
2019,616,Poland,Albania,133,115,18
2019,642,Romania,Albania,626,473,153
2019,643,Russian Federation,Albania,233,137,96
2019,703,Slovakia,Albania,116,98,18
2019,208,Denmark,Albania,520,253,267
2019,233,Estonia,Albania,36,23,13
2019,246,Finland,Albania,659,448,211
2019,352,Iceland,Albania,112,70,42
2019,372,Ireland,Albania,326,191,135
2019,428,Latvia,Albania,10,6,4
2019,578,Norway,Albania,1611,921,690
2019,752,Sweden,Albania,7136,4089,3047
2019,826,United Kingdom,Albania,11244,7095,4149
2019,191,Croatia,Albania,159,70,89
2019,300,Greece,Albania,426449,225433,201016
2019,380,Italy,Albania,475196,243152,232044
2019,470,Malta,Albania,171,85,86
2019,499,Montenegro,Albania,2763,1154,1609
2019,807,North Macedonia,Albania,68029,28010,40019
2019,620,Portugal,Albania,50,25,25
2019,674,San Marino,Albania,39,7,32
2019,688,Serbia,Albania,474,87,387
2019,705,Slovenia,Albania,127,44,83
2019,724,Spain,Albania,2008,1066,942
2019,40,Austria,Albania,3715,1870,1845
2019,56,Belgium,Albania,11042,5570,5472
2019,250,France,Albania,7371,3747,3624
2019,276,Germany,Albania,50894,28429,22465
2019,442,Luxembourg,Albania,1070,559,511
2019,528,Netherlands,Albania,1913,961,952
2019,756,Switzerland,Albania,3968,1878,2090
2019,124,Canada,Albania,16363,8080,8283
2019,840,United States of America,Albania,99205,48211,50994
1990,800,Uganda,Algeria,35,27,8
1990,266,Gabon,Algeria,34,20,14
1990,516,Namibia,Algeria,716,336,380
1990,710,South Africa,Algeria,348,218,130
1990,288,Ghana,Algeria,7,5,2
1990,466,Mali,Algeria,380,245,135
1990,478,Mauritania,Algeria,1450,808,642
1990,562,Niger,Algeria,293,183,110
1990,686,Senegal,Algeria,3464,1238,2226
1990,818,Egypt,Algeria,543,183,360
1990,434,Libya,Algeria,1551,530,1021
1990,504,Morocco,Algeria,9188,4858,4330
1990,788,Tunisia,Algeria,13757,6845,6912
1990,732,Western Sahara,Algeria,41,18,23
1990,196,Cyprus,Algeria,9,5,4
1990,376,Israel,Algeria,19544,9202,10342
1990,400,Jordan,Algeria,222,63,159
1990,792,Turkey,Algeria,156,116,40
1990,762,Tajikistan,Algeria,198,88,110
1990,608,Philippines,Algeria,795,444,351
1990,192,Cuba,Algeria,103,55,48
1990,312,Guadeloupe,Algeria,74,36,38
1990,474,Martinique,Algeria,45,22,23
1990,188,Costa Rica,Algeria,44,19,25
1990,484,Mexico,Algeria,47,24,23
1990,558,Nicaragua,Algeria,50,27,23
1990,32,Argentina,Algeria,229,136,93
1990,68,Bolivia (Plurinational State of),Algeria,4,3,1
1990,152,Chile,Algeria,45,22,23
1990,170,Colombia,Algeria,17,9,8
1990,218,Ecuador,Algeria,16,12,4
1990,254,French Guiana,Algeria,95,50,45
1990,604,Peru,Algeria,10,7,3
1990,862,Venezuela (Bolivarian Republic of),Algeria,84,40,44
1990,36,Australia,Algeria,665,397,268
1990,540,New Caledonia,Algeria,513,291,222
1990,258,French Polynesia,Algeria,605,386,219
1990,112,Belarus,Algeria,27,24,3
1990,100,Bulgaria,Algeria,32,23,9
1990,203,Czechia,Algeria,80,69,11
1990,348,Hungary,Algeria,263,252,11
1990,616,Poland,Algeria,643,485,158
1990,642,Romania,Algeria,3,2,1
1990,643,Russian Federation,Algeria,1303,639,664
1990,703,Slovakia,Algeria,8,6,2
1990,208,Denmark,Algeria,526,395,131
1990,246,Finland,Algeria,233,216,17
1990,352,Iceland,Algeria,10,8,2
1990,372,Ireland,Algeria,113,81,32
1990,428,Latvia,Algeria,6,5,1
1990,578,Norway,Algeria,448,357,91
1990,752,Sweden,Algeria,1320,878,442
1990,826,United Kingdom,Algeria,3594,2353,1241
1990,300,Greece,Algeria,203,164,39
1990,380,Italy,Algeria,6171,3826,2345
1990,470,Malta,Algeria,21,15,6
1990,620,Portugal,Algeria,55,35,20
1990,688,Serbia,Algeria,6,4,2
1990,705,Slovenia,Algeria,4,2,2
1990,724,Spain,Algeria,11518,6656,4862
1990,40,Austria,Algeria,711,541,170
1990,56,Belgium,Algeria,26077,15089,10988
1990,250,France,Algeria,788914,446449,342465
1990,276,Germany,Algeria,8493,6415,2078
1990,442,Luxembourg,Algeria,98,58,40
1990,528,Netherlands,Algeria,1764,1255,509
1990,756,Switzerland,Algeria,5334,3285,2049
1990,124,Canada,Algeria,3743,1823,1920
1990,840,United States of America,Algeria,4629,2955,1674
1995,800,Uganda,Algeria,33,26,7
1995,266,Gabon,Algeria,45,26,19
1995,516,Namibia,Algeria,684,323,361
1995,710,South Africa,Algeria,233,158,75
1995,288,Ghana,Algeria,7,5,2
1995,466,Mali,Algeria,507,272,235
1995,478,Mauritania,Algeria,1549,927,622
1995,562,Niger,Algeria,364,222,142
1995,686,Senegal,Algeria,3622,1280,2342
1995,818,Egypt,Algeria,573,189,384
1995,434,Libya,Algeria,2079,879,1200
1995,504,Morocco,Algeria,8429,4396,4033
1995,788,Tunisia,Algeria,13669,6873,6796
1995,732,Western Sahara,Algeria,45,20,25
1995,196,Cyprus,Algeria,13,7,6
1995,376,Israel,Algeria,25514,11797,13717
1995,400,Jordan,Algeria,320,116,204
1995,792,Turkey,Algeria,378,276,102
1995,762,Tajikistan,Algeria,160,71,89
1995,608,Philippines,Algeria,1069,588,481
1995,192,Cuba,Algeria,78,40,38
1995,312,Guadeloupe,Algeria,99,47,52
1995,474,Martinique,Algeria,68,32,36
1995,188,Costa Rica,Algeria,21,9,12
1995,484,Mexico,Algeria,87,53,34
1995,558,Nicaragua,Algeria,40,21,19
1995,32,Argentina,Algeria,224,134,90
1995,68,Bolivia (Plurinational State of),Algeria,7,5,2
1995,152,Chile,Algeria,44,27,17
1995,170,Colombia,Algeria,19,11,8
1995,218,Ecuador,Algeria,18,13,5
1995,254,French Guiana,Algeria,94,48,46
1995,604,Peru,Algeria,11,7,4
1995,862,Venezuela (Bolivarian Republic of),Algeria,82,39,43
1995,36,Australia,Algeria,950,595,355
1995,540,New Caledonia,Algeria,594,333,261
1995,258,French Polynesia,Algeria,664,418,246
1995,112,Belarus,Algeria,41,35,6
1995,100,Bulgaria,Algeria,105,60,45
1995,203,Czechia,Algeria,121,105,16
1995,348,Hungary,Algeria,365,301,64
1995,616,Poland,Algeria,549,412,137
1995,642,Romania,Algeria,5,4,1
1995,643,Russian Federation,Algeria,1189,669,520
1995,703,Slovakia,Algeria,32,27,5
1995,208,Denmark,Algeria,717,506,211
1995,246,Finland,Algeria,305,271,34
1995,352,Iceland,Algeria,17,13,4
1995,372,Ireland,Algeria,313,221,92
1995,428,Latvia,Algeria,9,8,1
1995,578,Norway,Algeria,558,428,130
1995,752,Sweden,Algeria,1567,1038,529
1995,826,United Kingdom,Algeria,6898,4777,2121
1995,300,Greece,Algeria,258,176,82
1995,380,Italy,Algeria,10991,7501,3490
1995,470,Malta,Algeria,25,17,8
1995,620,Portugal,Algeria,118,75,43
1995,688,Serbia,Algeria,41,26,15
1995,705,Slovenia,Algeria,8,5,3
1995,724,Spain,Algeria,12706,7895,4811
1995,40,Austria,Algeria,802,613,189
1995,56,Belgium,Algeria,24149,13661,10488
1995,250,France,Algeria,814417,454931,359486
1995,276,Germany,Algeria,12366,9659,2707
1995,442,Luxembourg,Algeria,92,49,43
1995,528,Netherlands,Algeria,2694,1898,796
1995,756,Switzerland,Algeria,5980,3730,2250
1995,124,Canada,Algeria,12014,5803,6211
1995,840,United States of America,Algeria,7859,5051,2808
2000,266,Gabon,Algeria,57,35,22
2000,516,Namibia,Algeria,637,302,335
2000,710,South Africa,Algeria,188,142,46
2000,288,Ghana,Algeria,8,6,2
2000,466,Mali,Algeria,554,263,291
2000,478,Mauritania,Algeria,1601,1024,577
2000,562,Niger,Algeria,438,261,177
2000,686,Senegal,Algeria,3275,1058,2217
2000,818,Egypt,Algeria,648,209,439
2000,434,Libya,Algeria,2642,1271,1371
2000,504,Morocco,Algeria,8877,4559,4318
2000,788,Tunisia,Algeria,10041,5109,4932
2000,732,Western Sahara,Algeria,50,23,27
2000,196,Cyprus,Algeria,16,8,8
2000,268,Georgia,Algeria,18,7,11
2000,376,Israel,Algeria,30056,13880,16176
2000,400,Jordan,Algeria,417,169,248
2000,792,Turkey,Algeria,603,438,165
2000,762,Tajikistan,Algeria,138,63,75
2000,608,Philippines,Algeria,541,279,262
2000,192,Cuba,Algeria,53,25,28
2000,312,Guadeloupe,Algeria,124,58,66
2000,474,Martinique,Algeria,91,41,50
2000,188,Costa Rica,Algeria,9,4,5
2000,484,Mexico,Algeria,131,84,47
2000,558,Nicaragua,Algeria,68,33,35
2000,32,Argentina,Algeria,219,133,86
2000,68,Bolivia (Plurinational State of),Algeria,10,7,3
2000,152,Chile,Algeria,44,26,18
2000,170,Colombia,Algeria,20,12,8
2000,218,Ecuador,Algeria,20,15,5
2000,254,French Guiana,Algeria,93,46,47
2000,604,Peru,Algeria,14,9,5
2000,862,Venezuela (Bolivarian Republic of),Algeria,81,38,43
2000,36,Australia,Algeria,1170,750,420
2000,540,New Caledonia,Algeria,676,376,300
2000,258,French Polynesia,Algeria,710,441,269
2000,112,Belarus,Algeria,55,46,9
2000,100,Bulgaria,Algeria,178,98,80
2000,203,Czechia,Algeria,161,140,21
2000,348,Hungary,Algeria,467,351,116
2000,616,Poland,Algeria,470,351,119
2000,642,Romania,Algeria,7,6,1
2000,643,Russian Federation,Algeria,1033,676,357
2000,703,Slovakia,Algeria,66,55,11
2000,208,Denmark,Algeria,907,617,290
2000,246,Finland,Algeria,377,327,50
2000,352,Iceland,Algeria,23,18,5
2000,372,Ireland,Algeria,686,490,196
2000,428,Latvia,Algeria,12,10,2
2000,578,Norway,Algeria,731,516,215
2000,752,Sweden,Algeria,1681,1110,571
2000,826,United Kingdom,Algeria,10318,7274,3044
2000,300,Greece,Algeria,317,189,128
2000,380,Italy,Algeria,15810,11175,4635
2000,470,Malta,Algeria,31,22,9
2000,620,Portugal,Algeria,187,118,69
2000,688,Serbia,Algeria,56,35,21
2000,705,Slovenia,Algeria,25,18,7
2000,724,Spain,Algeria,19360,12658,6702
2000,40,Austria,Algeria,893,686,207
2000,56,Belgium,Algeria,21519,11875,9644
2000,250,France,Algeria,839920,463414,376506
2000,276,Germany,Algeria,16238,12903,3335
2000,442,Luxembourg,Algeria,88,41,47
2000,528,Netherlands,Algeria,3717,2604,1113
2000,756,Switzerland,Algeria,6648,4195,2453
2000,124,Canada,Algeria,20571,9923,10648
2000,840,United States of America,Algeria,11158,7195,3963
2005,266,Gabon,Algeria,62,38,24
2005,516,Namibia,Algeria,503,237,266
2005,710,South Africa,Algeria,247,184,63
2005,288,Ghana,Algeria,11,8,3
2005,466,Mali,Algeria,2260,1037,1223
2005,478,Mauritania,Algeria,1614,1055,559
2005,562,Niger,Algeria,446,264,182
2005,686,Senegal,Algeria,3523,1221,2302
2005,818,Egypt,Algeria,771,281,490
2005,434,Libya,Algeria,2910,1669,1241
2005,504,Morocco,Algeria,9103,4611,4492
2005,788,Tunisia,Algeria,9577,4921,4656
2005,732,Western Sahara,Algeria,59,28,31
2005,196,Cyprus,Algeria,24,12,12
2005,268,Georgia,Algeria,17,7,10
2005,376,Israel,Algeria,36950,17046,19904
2005,400,Jordan,Algeria,602,287,315
2005,792,Turkey,Algeria,621,448,173
2005,762,Tajikistan,Algeria,133,60,73
2005,608,Philippines,Algeria,437,229,208
2005,192,Cuba,Algeria,35,17,18
2005,312,Guadeloupe,Algeria,137,63,74
2005,474,Martinique,Algeria,95,42,53
2005,188,Costa Rica,Algeria,6,3,3
2005,484,Mexico,Algeria,108,73,35
2005,558,Nicaragua,Algeria,99,45,54
2005,32,Argentina,Algeria,162,99,63
2005,68,Bolivia (Plurinational State of),Algeria,7,5,2
2005,76,Brazil,Algeria,91,46,45
2005,152,Chile,Algeria,66,40,26
2005,170,Colombia,Algeria,20,13,7
2005,218,Ecuador,Algeria,24,18,6
2005,254,French Guiana,Algeria,88,42,46
2005,604,Peru,Algeria,17,11,6
2005,862,Venezuela (Bolivarian Republic of),Algeria,84,39,45
2005,36,Australia,Algeria,1330,811,519
2005,540,New Caledonia,Algeria,719,401,318
2005,258,French Polynesia,Algeria,743,463,280
2005,112,Belarus,Algeria,53,44,9
2005,100,Bulgaria,Algeria,279,153,126
2005,203,Czechia,Algeria,408,366,42
2005,348,Hungary,Algeria,578,437,141
2005,616,Poland,Algeria,528,417,111
2005,642,Romania,Algeria,8,8,0
2005,643,Russian Federation,Algeria,907,613,294
2005,703,Slovakia,Algeria,75,62,13
2005,208,Denmark,Algeria,924,604,320
2005,246,Finland,Algeria,542,444,98
2005,352,Iceland,Algeria,24,18,6
2005,372,Ireland,Algeria,688,504,184
2005,428,Latvia,Algeria,14,12,2
2005,578,Norway,Algeria,920,626,294
2005,752,Sweden,Algeria,1992,1304,688
2005,826,United Kingdom,Algeria,16429,11105,5324
2005,191,Croatia,Algeria,28,13,15
2005,300,Greece,Algeria,722,575,147
2005,380,Italy,Algeria,19139,12733,6406
2005,470,Malta,Algeria,38,26,12
2005,620,Portugal,Algeria,212,149,63
2005,688,Serbia,Algeria,56,35,21
2005,705,Slovenia,Algeria,27,21,6
2005,724,Spain,Algeria,48283,35324,12959
2005,40,Austria,Algeria,998,761,237
2005,56,Belgium,Algeria,18521,10643,7878
2005,250,France,Algeria,1337210,676380,660830
2005,276,Germany,Algeria,17681,13162,4519
2005,442,Luxembourg,Algeria,76,38,38
2005,528,Netherlands,Algeria,4050,2679,1371
2005,756,Switzerland,Algeria,7337,4489,2848
2005,124,Canada,Algeria,34754,18102,16652
2005,840,United States of America,Algeria,12680,8202,4478
2010,266,Gabon,Algeria,72,44,28
2010,516,Namibia,Algeria,484,229,255
2010,710,South Africa,Algeria,386,288,98
2010,288,Ghana,Algeria,11,8,3
2010,466,Mali,Algeria,388,248,140
2010,478,Mauritania,Algeria,1627,1075,552
2010,562,Niger,Algeria,454,266,188
2010,686,Senegal,Algeria,3940,1477,2463
2010,818,Egypt,Algeria,832,283,549
2010,434,Libya,Algeria,3184,1842,1342
2010,504,Morocco,Algeria,10190,5136,5054
2010,788,Tunisia,Algeria,8068,4156,3912
2010,732,Western Sahara,Algeria,68,33,35
2010,196,Cyprus,Algeria,39,20,19
2010,268,Georgia,Algeria,17,7,10
2010,376,Israel,Algeria,44292,20378,23914
2010,400,Jordan,Algeria,774,392,382
2010,792,Turkey,Algeria,640,458,182
2010,762,Tajikistan,Algeria,132,60,72
2010,608,Philippines,Algeria,454,229,225
2010,192,Cuba,Algeria,19,9,10
2010,312,Guadeloupe,Algeria,150,69,81
2010,474,Martinique,Algeria,99,42,57
2010,188,Costa Rica,Algeria,12,5,7
2010,484,Mexico,Algeria,98,71,27
2010,558,Nicaragua,Algeria,105,48,57
2010,32,Argentina,Algeria,104,64,40
2010,68,Bolivia (Plurinational State of),Algeria,3,2,1
2010,76,Brazil,Algeria,182,92,90
2010,152,Chile,Algeria,88,53,35
2010,170,Colombia,Algeria,24,16,8
2010,218,Ecuador,Algeria,33,25,8
2010,254,French Guiana,Algeria,83,39,44
2010,604,Peru,Algeria,18,12,6
2010,862,Venezuela (Bolivarian Republic of),Algeria,90,43,47
2010,36,Australia,Algeria,1380,847,533
2010,540,New Caledonia,Algeria,763,427,336
2010,258,French Polynesia,Algeria,717,455,262
2010,112,Belarus,Algeria,50,41,9
2010,100,Bulgaria,Algeria,369,203,166
2010,203,Czechia,Algeria,616,559,57
2010,348,Hungary,Algeria,688,522,166
2010,616,Poland,Algeria,604,495,109
2010,642,Romania,Algeria,12,9,3
2010,643,Russian Federation,Algeria,763,537,226
2010,703,Slovakia,Algeria,84,70,14
2010,208,Denmark,Algeria,923,581,342
2010,233,Estonia,Algeria,14,11,3
2010,246,Finland,Algeria,825,650,175
2010,352,Iceland,Algeria,24,17,7
2010,372,Ireland,Algeria,576,410,166
2010,428,Latvia,Algeria,17,15,2
2010,578,Norway,Algeria,1117,724,393
2010,752,Sweden,Algeria,2575,1686,889
2010,826,United Kingdom,Algeria,17307,11814,5493
2010,191,Croatia,Algeria,56,27,29
2010,300,Greece,Algeria,1171,1000,171
2010,380,Italy,Algeria,23713,15472,8241
2010,470,Malta,Algeria,43,31,12
2010,620,Portugal,Algeria,203,155,48
2010,688,Serbia,Algeria,55,34,21
2010,705,Slovenia,Algeria,35,26,9
2010,724,Spain,Algeria,60246,41619,18627
2010,40,Austria,Algeria,1103,836,267
2010,56,Belgium,Algeria,22386,12547,9839
2010,250,France,Algeria,1343555,727715,615840
2010,276,Germany,Algeria,18828,13351,5477
2010,442,Luxembourg,Algeria,66,36,30
2010,528,Netherlands,Algeria,3912,2509,1403
2010,756,Switzerland,Algeria,8784,5183,3601
2010,124,Canada,Algeria,51080,27443,23637
2010,840,United States of America,Algeria,14633,9342,5291
2015,266,Gabon,Algeria,100,65,35
2015,516,Namibia,Algeria,473,225,248
2015,710,South Africa,Algeria,695,511,184
2015,288,Ghana,Algeria,13,10,3
2015,324,Guinea,Algeria,7044,4305,2739
2015,466,Mali,Algeria,480,307,173
2015,478,Mauritania,Algeria,1634,1085,549
2015,562,Niger,Algeria,460,278,182
2015,686,Senegal,Algeria,4204,1574,2630
2015,818,Egypt,Algeria,616,262,354
2015,434,Libya,Algeria,3589,2056,1533
2015,504,Morocco,Algeria,13281,6666,6615
2015,788,Tunisia,Algeria,10411,5378,5033
2015,732,Western Sahara,Algeria,78,39,39
2015,196,Cyprus,Algeria,37,19,18
2015,268,Georgia,Algeria,17,7,10
2015,376,Israel,Algeria,45680,20896,24784
2015,400,Jordan,Algeria,333,132,201
2015,792,Turkey,Algeria,648,460,188
2015,762,Tajikistan,Algeria,129,58,71
2015,608,Philippines,Algeria,462,234,228
2015,192,Cuba,Algeria,15,7,8
2015,312,Guadeloupe,Algeria,156,71,85
2015,474,Martinique,Algeria,102,43,59
2015,188,Costa Rica,Algeria,12,5,7
2015,484,Mexico,Algeria,103,75,28
2015,558,Nicaragua,Algeria,113,52,61
2015,32,Argentina,Algeria,104,64,40
2015,68,Bolivia (Plurinational State of),Algeria,3,2,1
2015,76,Brazil,Algeria,219,111,108
2015,152,Chile,Algeria,133,79,54
2015,170,Colombia,Algeria,26,18,8
2015,218,Ecuador,Algeria,48,37,11
2015,254,French Guiana,Algeria,83,38,45
2015,604,Peru,Algeria,19,13,6
2015,862,Venezuela (Bolivarian Republic of),Algeria,95,45,50
2015,36,Australia,Algeria,1600,982,618
2015,540,New Caledonia,Algeria,586,299,287
2015,258,French Polynesia,Algeria,681,432,249
2015,112,Belarus,Algeria,53,44,9
2015,100,Bulgaria,Algeria,396,232,164
2015,203,Czechia,Algeria,686,583,103
2015,348,Hungary,Algeria,731,527,204
2015,616,Poland,Algeria,582,479,103
2015,642,Romania,Algeria,130,60,70
2015,643,Russian Federation,Algeria,778,546,232
2015,703,Slovakia,Algeria,105,88,17
2015,208,Denmark,Algeria,993,612,381
2015,233,Estonia,Algeria,24,20,4
2015,246,Finland,Algeria,1009,786,223
2015,352,Iceland,Algeria,40,31,9
2015,372,Ireland,Algeria,588,416,172
2015,428,Latvia,Algeria,15,12,3
2015,578,Norway,Algeria,1223,781,442
2015,752,Sweden,Algeria,3022,1926,1096
2015,826,United Kingdom,Algeria,22133,14900,7233
2015,191,Croatia,Algeria,56,27,29
2015,300,Greece,Algeria,1099,932,167
2015,380,Italy,Algeria,21990,13909,8081
2015,470,Malta,Algeria,72,53,19
2015,620,Portugal,Algeria,230,172,58
2015,688,Serbia,Algeria,53,33,20
2015,705,Slovenia,Algeria,28,22,6
2015,724,Spain,Algeria,56038,35129,20909
2015,40,Austria,Algeria,1290,979,311
2015,56,Belgium,Algeria,25666,14539,11127
2015,250,France,Algeria,1488349,787360,700989
2015,276,Germany,Algeria,19617,13896,5721
2015,442,Luxembourg,Algeria,100,55,45
2015,528,Netherlands,Algeria,3975,2486,1489
2015,756,Switzerland,Algeria,9499,5477,4022
2015,124,Canada,Algeria,64223,33698,30525
2015,840,United States of America,Algeria,19633,9549,10084
2019,266,Gabon,Algeria,108,71,37
2019,516,Namibia,Algeria,500,238,262
2019,710,South Africa,Algeria,778,573,205
2019,288,Ghana,Algeria,14,11,3
2019,324,Guinea,Algeria,6723,4109,2614
2019,466,Mali,Algeria,534,342,192
2019,478,Mauritania,Algeria,1697,1128,569
2019,562,Niger,Algeria,497,301,196
2019,686,Senegal,Algeria,4342,1624,2718
2019,818,Egypt,Algeria,877,313,564
2019,434,Libya,Algeria,3808,2182,1626
2019,504,Morocco,Algeria,14164,7110,7054
2019,788,Tunisia,Algeria,10580,5468,5112
2019,732,Western Sahara,Algeria,81,41,40
2019,196,Cyprus,Algeria,36,19,17
2019,268,Georgia,Algeria,17,7,10
2019,376,Israel,Algeria,44422,20321,24101
2019,400,Jordan,Algeria,358,142,216
2019,792,Turkey,Algeria,876,625,251
2019,762,Tajikistan,Algeria,128,58,70
2019,608,Philippines,Algeria,476,241,235
2019,192,Cuba,Algeria,13,6,7
2019,312,Guadeloupe,Algeria,158,72,86
2019,474,Martinique,Algeria,101,43,58
2019,188,Costa Rica,Algeria,12,5,7
2019,484,Mexico,Algeria,106,78,28
2019,558,Nicaragua,Algeria,118,55,63
2019,32,Argentina,Algeria,105,65,40
2019,68,Bolivia (Plurinational State of),Algeria,3,2,1
2019,76,Brazil,Algeria,246,125,121
2019,152,Chile,Algeria,177,101,76
2019,170,Colombia,Algeria,26,18,8
2019,218,Ecuador,Algeria,47,37,10
2019,254,French Guiana,Algeria,91,42,49
2019,604,Peru,Algeria,22,16,6
2019,862,Venezuela (Bolivarian Republic of),Algeria,93,44,49
2019,36,Australia,Algeria,1745,1032,713
2019,540,New Caledonia,Algeria,617,314,303
2019,258,French Polynesia,Algeria,706,448,258
2019,112,Belarus,Algeria,52,44,8
2019,100,Bulgaria,Algeria,482,286,196
2019,203,Czechia,Algeria,741,625,116
2019,348,Hungary,Algeria,842,594,248
2019,616,Poland,Algeria,616,512,104
2019,642,Romania,Algeria,373,224,149
2019,643,Russian Federation,Algeria,777,546,231
2019,703,Slovakia,Algeria,114,96,18
2019,208,Denmark,Algeria,1046,624,422
2019,233,Estonia,Algeria,29,25,4
2019,246,Finland,Algeria,1212,924,288
2019,352,Iceland,Algeria,60,44,16
2019,372,Ireland,Algeria,645,457,188
2019,428,Latvia,Algeria,12,10,2
2019,578,Norway,Algeria,1362,878,484
2019,752,Sweden,Algeria,3475,2173,1302
2019,826,United Kingdom,Algeria,25134,16941,8193
2019,191,Croatia,Algeria,51,25,26
2019,300,Greece,Algeria,390,191,199
2019,380,Italy,Algeria,22877,14515,8362
2019,470,Malta,Algeria,116,86,30
2019,620,Portugal,Algeria,233,175,58
2019,688,Serbia,Algeria,53,33,20
2019,705,Slovenia,Algeria,33,25,8
2019,724,Spain,Algeria,57140,34566,22574
2019,40,Austria,Algeria,1522,1162,360
2019,56,Belgium,Algeria,27633,15505,12128
2019,250,France,Algeria,1575528,831731,743797
2019,276,Germany,Algeria,21519,15851,5668
2019,442,Luxembourg,Algeria,1154,629,525
2019,528,Netherlands,Algeria,4267,2631,1636
2019,756,Switzerland,Algeria,10122,5833,4289
2019,124,Canada,Algeria,68822,36111,32711
2019,840,United States of America,Algeria,21201,10196,11005
1990,36,Australia,American Samoa,64,33,31
1990,583,Micronesia (Fed. States of),American Samoa,19,11,8
1990,882,Samoa,American Samoa,995,533,462
1990,643,Russian Federation,American Samoa,959,471,488
1990,300,Greece,American Samoa,3,1,2
1990,250,France,American Samoa,1,0,1
1995,36,Australia,American Samoa,94,58,36
1995,583,Micronesia (Fed. States of),American Samoa,17,11,6
1995,882,Samoa,American Samoa,1506,801,705
1995,643,Russian Federation,American Samoa,1012,493,519
1995,300,Greece,American Samoa,8,2,6
1995,250,France,American Samoa,1,0,1
2000,36,Australia,American Samoa,120,60,60
2000,583,Micronesia (Fed. States of),American Samoa,15,9,6
2000,882,Samoa,American Samoa,2007,1059,948
2000,643,Russian Federation,American Samoa,1029,498,531
2000,300,Greece,American Samoa,14,3,11
2000,250,France,American Samoa,1,0,1
2005,36,Australia,American Samoa,120,60,60
2005,583,Micronesia (Fed. States of),American Samoa,19,11,8
2005,882,Samoa,American Samoa,1889,986,903
2005,643,Russian Federation,American Samoa,541,263,278
2005,300,Greece,American Samoa,7,1,6
2005,250,France,American Samoa,12,6,6
2010,466,Mali,American Samoa,324,152,172
2010,36,Australia,American Samoa,120,60,60
2010,583,Micronesia (Fed. States of),American Samoa,21,12,9
2010,882,Samoa,American Samoa,1650,852,798
2010,643,Russian Federation,American Samoa,43,22,21
2010,250,France,American Samoa,1,0,1
2015,466,Mali,American Samoa,401,188,213
2015,36,Australia,American Samoa,120,67,53
2015,583,Micronesia (Fed. States of),American Samoa,23,12,11
2015,882,Samoa,American Samoa,1379,706,673
2015,643,Russian Federation,American Samoa,43,22,21
2015,250,France,American Samoa,1,0,1
2019,466,Mali,American Samoa,446,209,237
2019,583,Micronesia (Fed. States of),American Samoa,23,12,11
2019,882,Samoa,American Samoa,1305,669,636
2019,643,Russian Federation,American Samoa,42,22,20
2019,250,France,American Samoa,1,0,1
1990,32,Argentina,Andorra,1,1,0
1990,68,Bolivia (Plurinational State of),Andorra,2,1,1
1990,152,Chile,Andorra,10,7,3
1990,170,Colombia,Andorra,42,25,17
1990,36,Australia,Andorra,333,163,170
1990,203,Czechia,Andorra,4,2,2
1990,208,Denmark,Andorra,1,1,0
1990,246,Finland,Andorra,1,1,0
1990,826,United Kingdom,Andorra,6,5,1
1990,300,Greece,Andorra,6,3,3
1990,380,Italy,Andorra,2,1,1
1990,620,Portugal,Andorra,122,58,64
1990,724,Spain,Andorra,2008,925,1083
1990,40,Austria,Andorra,1,1,0
1990,250,France,Andorra,1233,563,670
1990,756,Switzerland,Andorra,20,12,8
1995,32,Argentina,Andorra,1,1,0
1995,68,Bolivia (Plurinational State of),Andorra,1,0,1
1995,152,Chile,Andorra,9,6,3
1995,170,Colombia,Andorra,41,24,17
1995,36,Australia,Andorra,181,94,87
1995,203,Czechia,Andorra,6,3,3
1995,208,Denmark,Andorra,1,1,0
1995,246,Finland,Andorra,1,1,0
1995,372,Ireland,Andorra,1,0,1
1995,826,United Kingdom,Andorra,15,10,5
1995,300,Greece,Andorra,5,4,1
1995,380,Italy,Andorra,11,4,7
1995,620,Portugal,Andorra,264,126,138
1995,724,Spain,Andorra,2355,1107,1248
1995,40,Austria,Andorra,2,2,0
1995,250,France,Andorra,1273,570,703
1995,756,Switzerland,Andorra,25,16,9
2000,32,Argentina,Andorra,1,1,0
2000,152,Chile,Andorra,9,5,4
2000,170,Colombia,Andorra,40,24,16
2000,36,Australia,Andorra,30,15,15
2000,203,Czechia,Andorra,8,4,4
2000,208,Denmark,Andorra,1,1,0
2000,246,Finland,Andorra,1,1,0
2000,372,Ireland,Andorra,3,0,3
2000,752,Sweden,Andorra,1,0,1
2000,826,United Kingdom,Andorra,26,15,11
2000,300,Greece,Andorra,4,4,0
2000,380,Italy,Andorra,19,7,12
2000,620,Portugal,Andorra,417,199,218
2000,724,Spain,Andorra,3717,1800,1917
2000,40,Austria,Andorra,2,2,0
2000,250,France,Andorra,1313,577,736
2000,756,Switzerland,Andorra,32,21,11
2005,32,Argentina,Andorra,1,1,0
2005,76,Brazil,Andorra,5,5,0
2005,152,Chile,Andorra,13,8,5
2005,170,Colombia,Andorra,38,23,15
2005,36,Australia,Andorra,30,15,15
2005,100,Bulgaria,Andorra,1,1,0
2005,203,Czechia,Andorra,4,2,2
2005,208,Denmark,Andorra,1,1,0
2005,246,Finland,Andorra,2,2,0
2005,372,Ireland,Andorra,3,0,3
2005,752,Sweden,Andorra,1,0,1
2005,826,United Kingdom,Andorra,39,21,18
2005,300,Greece,Andorra,4,3,1
2005,380,Italy,Andorra,75,23,52
2005,620,Portugal,Andorra,406,195,211
2005,724,Spain,Andorra,4135,2002,2133
2005,40,Austria,Andorra,2,2,0
2005,250,France,Andorra,980,443,537
2005,756,Switzerland,Andorra,38,25,13
2010,466,Mali,Andorra,842,443,399
2010,32,Argentina,Andorra,1,1,0
2010,76,Brazil,Andorra,10,10,0
2010,152,Chile,Andorra,18,11,7
2010,170,Colombia,Andorra,43,26,17
2010,36,Australia,Andorra,20,10,10
2010,100,Bulgaria,Andorra,1,1,0
2010,203,Czechia,Andorra,4,2,2
2010,246,Finland,Andorra,2,2,0
2010,372,Ireland,Andorra,2,0,2
2010,428,Latvia,Andorra,1,1,0
2010,752,Sweden,Andorra,2,0,2
2010,826,United Kingdom,Andorra,41,23,18
2010,300,Greece,Andorra,4,2,2
2010,380,Italy,Andorra,61,18,43
2010,620,Portugal,Andorra,329,159,170
2010,724,Spain,Andorra,5578,2733,2845
2010,40,Austria,Andorra,2,2,0
2010,250,France,Andorra,922,394,528
2010,756,Switzerland,Andorra,43,26,17
2015,324,Guinea,Andorra,6,4,2
2015,466,Mali,Andorra,1043,549,494
2015,32,Argentina,Andorra,1,1,0
2015,76,Brazil,Andorra,12,12,0
2015,152,Chile,Andorra,27,17,10
2015,170,Colombia,Andorra,48,30,18
2015,36,Australia,Andorra,20,12,8
2015,208,Denmark,Andorra,1,1,0
2015,246,Finland,Andorra,1,1,0
2015,352,Iceland,Andorra,2,2,0
2015,372,Ireland,Andorra,2,0,2
2015,752,Sweden,Andorra,5,1,4
2015,826,United Kingdom,Andorra,52,29,23
2015,300,Greece,Andorra,3,2,1
2015,380,Italy,Andorra,106,29,77
2015,620,Portugal,Andorra,372,169,203
2015,724,Spain,Andorra,5900,2861,3039
2015,40,Austria,Andorra,2,2,0
2015,250,France,Andorra,1020,420,600
2015,756,Switzerland,Andorra,100,58,42
2019,324,Guinea,Andorra,5,4,1
2019,466,Mali,Andorra,1161,611,550
2019,32,Argentina,Andorra,1,1,0
2019,76,Brazil,Andorra,13,13,0
2019,152,Chile,Andorra,36,22,14
2019,170,Colombia,Andorra,49,31,18
2019,36,Australia,Andorra,31,17,14
2019,203,Czechia,Andorra,1,1,0
2019,208,Denmark,Andorra,6,3,3
2019,246,Finland,Andorra,2,2,0
2019,352,Iceland,Andorra,2,0,2
2019,372,Ireland,Andorra,2,0,2
2019,752,Sweden,Andorra,2,0,2
2019,826,United Kingdom,Andorra,59,33,26
2019,300,Greece,Andorra,2,2,0
2019,380,Italy,Andorra,55,16,39
2019,620,Portugal,Andorra,378,172,206
2019,724,Spain,Andorra,6113,2889,3224
2019,40,Austria,Andorra,2,2,0
2019,250,France,Andorra,1079,443,636
2019,756,Switzerland,Andorra,115,64,51
1990,232,Eritrea,Angola,247,138,109
1990,508,Mozambique,Angola,14337,7741,6596
1990,834,United Republic of Tanzania,Angola,717,427,290
1990,894,Zambia,Angola,123807,62079,61728
1990,178,Congo,Angola,10334,4907,5427
1990,180,Democratic Republic of the Congo,Angola,468462,225505,242957
1990,266,Gabon,Angola,342,202,140
1990,678,Sao Tome and Principe,Angola,468,203,265
1990,72,Botswana,Angola,551,289,262
1990,748,Eswatini,Angola,4,3,1
1990,516,Namibia,Angola,24028,15093,8935
1990,710,South Africa,Angola,6602,4613,1989
1990,132,Cabo Verde,Angola,1588,790,798
1990,466,Mali,Angola,70,39,31
1990,818,Egypt,Angola,23,12,11
1990,608,Philippines,Angola,581,322,259
1990,192,Cuba,Angola,218,132,86
1990,188,Costa Rica,Angola,4,1,3
1990,484,Mexico,Angola,39,21,18
1990,32,Argentina,Angola,20,7,13
1990,68,Bolivia (Plurinational State of),Angola,6,4,2
1990,76,Brazil,Angola,4868,2437,2431
1990,152,Chile,Angola,7,5,2
1990,170,Colombia,Angola,49,25,24
1990,218,Ecuador,Angola,14,5,9
1990,604,Peru,Angola,8,3,5
1990,862,Venezuela (Bolivarian Republic of),Angola,167,89,78
1990,36,Australia,Angola,310,177,133
1990,100,Bulgaria,Angola,4,4,0
1990,203,Czechia,Angola,33,29,4
1990,348,Hungary,Angola,32,28,4
1990,616,Poland,Angola,38,38,0
1990,643,Russian Federation,Angola,519,255,264
1990,703,Slovakia,Angola,11,9,2
1990,208,Denmark,Angola,48,30,18
1990,246,Finland,Angola,4,2,2
1990,352,Iceland,Angola,10,6,4
1990,372,Ireland,Angola,92,47,45
1990,428,Latvia,Angola,1,0,1
1990,578,Norway,Angola,30,15,15
1990,752,Sweden,Angola,340,155,185
1990,826,United Kingdom,Angola,825,507,318
1990,300,Greece,Angola,20,11,9
1990,380,Italy,Angola,304,105,199
1990,620,Portugal,Angola,141573,66405,75168
1990,724,Spain,Angola,1201,634,567
1990,40,Austria,Angola,188,103,85
1990,56,Belgium,Angola,1282,664,618
1990,250,France,Angola,11499,6547,4952
1990,528,Netherlands,Angola,1727,1118,609
1990,756,Switzerland,Angola,3772,2052,1720
1990,124,Canada,Angola,1266,617,649
1990,840,United States of America,Angola,2252,845,1407
1995,232,Eritrea,Angola,433,238,195
1995,508,Mozambique,Angola,19720,10688,9032
1995,834,United Republic of Tanzania,Angola,958,571,387
1995,894,Zambia,Angola,141001,70558,70443
1995,178,Congo,Angola,18270,8654,9616
1995,180,Democratic Republic of the Congo,Angola,276402,137155,139247
1995,266,Gabon,Angola,457,269,188
1995,678,Sao Tome and Principe,Angola,556,285,271
1995,72,Botswana,Angola,889,456,433
1995,748,Eswatini,Angola,143,80,63
1995,516,Namibia,Angola,22978,14488,8490
1995,710,South Africa,Angola,11043,6771,4272
1995,132,Cabo Verde,Angola,1899,969,930
1995,466,Mali,Angola,72,41,31
1995,818,Egypt,Angola,21,10,11
1995,608,Philippines,Angola,781,426,355
1995,192,Cuba,Angola,165,97,68
1995,188,Costa Rica,Angola,2,0,2
1995,484,Mexico,Angola,43,22,21
1995,32,Argentina,Angola,20,7,13
1995,68,Bolivia (Plurinational State of),Angola,5,2,3
1995,76,Brazil,Angola,5612,2994,2618
1995,152,Chile,Angola,31,19,12
1995,170,Colombia,Angola,48,24,24
1995,218,Ecuador,Angola,16,6,10
1995,604,Peru,Angola,9,3,6
1995,862,Venezuela (Bolivarian Republic of),Angola,164,88,76
1995,36,Australia,Angola,370,204,166
1995,100,Bulgaria,Angola,4,3,1
1995,203,Czechia,Angola,50,44,6
1995,348,Hungary,Angola,43,31,12
1995,616,Poland,Angola,32,32,0
1995,643,Russian Federation,Angola,470,267,203
1995,703,Slovakia,Angola,11,10,1
1995,208,Denmark,Angola,77,41,36
1995,246,Finland,Angola,49,31,18
1995,352,Iceland,Angola,15,9,6
1995,372,Ireland,Angola,255,125,130
1995,428,Latvia,Angola,1,0,1
1995,578,Norway,Angola,41,20,21
1995,752,Sweden,Angola,403,182,221
1995,826,United Kingdom,Angola,3243,1650,1593
1995,300,Greece,Angola,19,9,10
1995,380,Italy,Angola,1024,481,543
1995,620,Portugal,Angola,154254,72483,81771
1995,724,Spain,Angola,1532,833,699
1995,40,Austria,Angola,212,117,95
1995,56,Belgium,Angola,985,526,459
1995,250,France,Angola,11871,6673,5198
1995,528,Netherlands,Angola,2543,1626,917
1995,756,Switzerland,Angola,4232,2319,1913
1995,124,Canada,Angola,1834,888,946
1995,840,United States of America,Angola,3352,1281,2071
2000,232,Eritrea,Angola,620,338,282
2000,508,Mozambique,Angola,22937,12090,10847
2000,834,United Republic of Tanzania,Angola,1018,607,411
2000,894,Zambia,Angola,238248,120723,117525
2000,178,Congo,Angola,31100,14697,16403
2000,180,Democratic Republic of the Congo,Angola,325733,159759,165974
2000,266,Gabon,Angola,572,338,234
2000,678,Sao Tome and Principe,Angola,654,267,387
2000,72,Botswana,Angola,1320,671,649
2000,748,Eswatini,Angola,166,85,81
2000,516,Namibia,Angola,49790,29488,20302
2000,710,South Africa,Angola,15785,9515,6270
2000,132,Cabo Verde,Angola,2209,1148,1061
2000,466,Mali,Angola,67,38,29
2000,818,Egypt,Angola,21,10,11
2000,608,Philippines,Angola,2523,1170,1353
2000,192,Cuba,Angola,112,62,50
2000,188,Costa Rica,Angola,2,1,1
2000,484,Mexico,Angola,49,24,25
2000,32,Argentina,Angola,20,8,12
2000,68,Bolivia (Plurinational State of),Angola,4,1,3
2000,76,Brazil,Angola,6355,3550,2805
2000,152,Chile,Angola,55,33,22
2000,170,Colombia,Angola,47,24,23
2000,218,Ecuador,Angola,18,7,11
2000,604,Peru,Angola,11,3,8
2000,862,Venezuela (Bolivarian Republic of),Angola,161,86,75
2000,36,Australia,Angola,420,229,191
2000,100,Bulgaria,Angola,4,2,2
2000,203,Czechia,Angola,67,59,8
2000,348,Hungary,Angola,53,34,19
2000,616,Poland,Angola,28,28,0
2000,643,Russian Federation,Angola,404,269,135
2000,703,Slovakia,Angola,16,15,1
2000,208,Denmark,Angola,106,52,54
2000,246,Finland,Angola,94,60,34
2000,352,Iceland,Angola,19,12,7
2000,372,Ireland,Angola,559,282,277
2000,428,Latvia,Angola,2,1,1
2000,578,Norway,Angola,103,50,53
2000,752,Sweden,Angola,433,194,239
2000,826,United Kingdom,Angola,5717,2818,2899
2000,300,Greece,Angola,19,8,11
2000,380,Italy,Angola,1744,858,886
2000,620,Portugal,Angola,173193,81815,91378
2000,724,Spain,Angola,2524,1409,1115
2000,40,Austria,Angola,236,132,104
2000,56,Belgium,Angola,658,373,285
2000,250,France,Angola,12243,6799,5444
2000,528,Netherlands,Angola,3445,2184,1261
2000,756,Switzerland,Angola,4709,2601,2108
2000,124,Canada,Angola,2446,1180,1266
2000,840,United States of America,Angola,4475,1729,2746
2005,232,Eritrea,Angola,480,267,213
2005,508,Mozambique,Angola,31022,14987,16035
2005,834,United Republic of Tanzania,Angola,1153,688,465
2005,894,Zambia,Angola,98687,49394,49293
2005,120,Cameroon,Angola,2571,1244,1327
2005,178,Congo,Angola,15550,7349,8201
2005,180,Democratic Republic of the Congo,Angola,262085,126043,136042
2005,266,Gabon,Angola,624,372,252
2005,678,Sao Tome and Principe,Angola,514,208,306
2005,72,Botswana,Angola,1992,1000,992
2005,748,Eswatini,Angola,219,106,113
2005,516,Namibia,Angola,39319,23181,16138
2005,710,South Africa,Angola,21994,11405,10589
2005,132,Cabo Verde,Angola,1283,659,624
2005,466,Mali,Angola,271,152,119
2005,818,Egypt,Angola,25,13,12
2005,608,Philippines,Angola,2042,964,1078
2005,192,Cuba,Angola,75,42,33
2005,188,Costa Rica,Angola,1,0,1
2005,484,Mexico,Angola,47,23,24
2005,32,Argentina,Angola,15,6,9
2005,68,Bolivia (Plurinational State of),Angola,5,3,2
2005,76,Brazil,Angola,6418,3441,2977
2005,152,Chile,Angola,82,50,32
2005,170,Colombia,Angola,45,24,21
2005,218,Ecuador,Angola,21,8,13
2005,604,Peru,Angola,13,3,10
2005,862,Venezuela (Bolivarian Republic of),Angola,169,91,78
2005,36,Australia,Angola,450,229,221
2005,100,Bulgaria,Angola,5,2,3
2005,203,Czechia,Angola,129,110,19
2005,348,Hungary,Angola,67,44,23
2005,616,Poland,Angola,42,39,3
2005,643,Russian Federation,Angola,457,340,117
2005,703,Slovakia,Angola,18,16,2
2005,208,Denmark,Angola,129,61,68
2005,246,Finland,Angola,228,143,85
2005,352,Iceland,Angola,30,21,9
2005,372,Ireland,Angola,561,301,260
2005,428,Latvia,Angola,2,1,1
2005,578,Norway,Angola,241,111,130
2005,752,Sweden,Angola,552,252,300
2005,826,United Kingdom,Angola,9467,4452,5015
2005,300,Greece,Angola,14,6,8
2005,380,Italy,Angola,1807,872,935
2005,620,Portugal,Angola,169591,79766,89825
2005,705,Slovenia,Angola,2,0,2
2005,724,Spain,Angola,3438,1926,1512
2005,40,Austria,Angola,264,145,119
2005,56,Belgium,Angola,3213,1646,1567
2005,250,France,Angola,14835,7750,7085
2005,528,Netherlands,Angola,9301,5708,3593
2005,756,Switzerland,Angola,5161,2739,2422
2005,124,Canada,Angola,2486,1257,1229
2005,840,United States of America,Angola,7294,3654,3640
2010,232,Eritrea,Angola,341,197,144
2010,508,Mozambique,Angola,35921,17354,18567
2010,834,United Republic of Tanzania,Angola,1186,708,478
2010,894,Zambia,Angola,37306,18838,18468
2010,120,Cameroon,Angola,2046,1038,1008
2010,178,Congo,Angola,31028,16751,14277
2010,180,Democratic Republic of the Congo,Angola,260002,125641,134361
2010,266,Gabon,Angola,723,437,286
2010,678,Sao Tome and Principe,Angola,404,163,241
2010,72,Botswana,Angola,670,320,350
2010,748,Eswatini,Angola,201,93,108
2010,516,Namibia,Angola,38119,22470,15648
2010,710,South Africa,Angola,34453,17803,16650
2010,132,Cabo Verde,Angola,356,169,187
2010,466,Mali,Angola,1264,595,669
2010,818,Egypt,Angola,27,14,13
2010,608,Philippines,Angola,74,34,40
2010,192,Cuba,Angola,41,23,18
2010,188,Costa Rica,Angola,3,2,1
2010,484,Mexico,Angola,51,24,27
2010,32,Argentina,Angola,9,3,6
2010,68,Bolivia (Plurinational State of),Angola,5,4,1
2010,76,Brazil,Angola,6389,3279,3110
2010,152,Chile,Angola,110,68,42
2010,170,Colombia,Angola,50,27,23
2010,218,Ecuador,Angola,29,11,18
2010,604,Peru,Angola,14,4,10
2010,862,Venezuela (Bolivarian Republic of),Angola,180,97,83
2010,36,Australia,Angola,530,280,250
2010,100,Bulgaria,Angola,6,2,4
2010,203,Czechia,Angola,178,150,28
2010,348,Hungary,Angola,80,53,27
2010,616,Poland,Angola,59,52,7
2010,643,Russian Federation,Angola,501,403,98
2010,703,Slovakia,Angola,20,18,2
2010,208,Denmark,Angola,149,70,79
2010,233,Estonia,Angola,3,2,1
2010,246,Finland,Angola,426,254,172
2010,352,Iceland,Angola,39,28,11
2010,372,Ireland,Angola,470,236,234
2010,428,Latvia,Angola,2,1,1
2010,578,Norway,Angola,379,179,200
2010,752,Sweden,Angola,716,336,380
2010,826,United Kingdom,Angola,9973,4799,5174
2010,300,Greece,Angola,9,4,5
2010,380,Italy,Angola,1934,934,1000
2010,620,Portugal,Angola,137826,64670,73156
2010,705,Slovenia,Angola,3,2,1
2010,724,Spain,Angola,4005,2282,1723
2010,40,Austria,Angola,292,158,134
2010,56,Belgium,Angola,4807,2478,2329
2010,250,France,Angola,19989,10192,9797
2010,528,Netherlands,Angola,7460,4469,2991
2010,756,Switzerland,Angola,6222,3128,3094
2010,124,Canada,Angola,2565,1355,1210
2010,840,United States of America,Angola,10411,5144,5267
2015,232,Eritrea,Angola,346,202,144
2015,508,Mozambique,Angola,37716,18221,19495
2015,834,United Republic of Tanzania,Angola,1249,751,498
2015,894,Zambia,Angola,27864,14033,13831
2015,120,Cameroon,Angola,2613,1152,1461
2015,178,Congo,Angola,41238,21453,19785
2015,180,Democratic Republic of the Congo,Angola,185205,94583,90622
2015,266,Gabon,Angola,1011,667,344
2015,678,Sao Tome and Principe,Angola,358,144,214
2015,72,Botswana,Angola,731,349,382
2015,748,Eswatini,Angola,131,65,66
2015,516,Namibia,Angola,37350,22031,15319
2015,710,South Africa,Angola,62147,30584,31563
2015,132,Cabo Verde,Angola,370,175,195
2015,324,Guinea,Angola,115,74,41
2015,466,Mali,Angola,1566,738,828
2015,818,Egypt,Angola,20,12,8
2015,608,Philippines,Angola,76,35,41
2015,192,Cuba,Angola,32,18,14
2015,188,Costa Rica,Angola,3,2,1
2015,484,Mexico,Angola,54,26,28
2015,32,Argentina,Angola,9,3,6
2015,68,Bolivia (Plurinational State of),Angola,6,5,1
2015,76,Brazil,Angola,7694,3949,3745
2015,152,Chile,Angola,166,102,64
2015,170,Colombia,Angola,55,30,25
2015,218,Ecuador,Angola,42,16,26
2015,604,Peru,Angola,15,5,10
2015,862,Venezuela (Bolivarian Republic of),Angola,188,99,89
2015,36,Australia,Angola,560,293,267
2015,100,Bulgaria,Angola,9,3,6
2015,203,Czechia,Angola,168,140,28
2015,348,Hungary,Angola,83,53,30
2015,616,Poland,Angola,56,50,6
2015,643,Russian Federation,Angola,511,410,101
2015,703,Slovakia,Angola,25,21,4
2015,208,Denmark,Angola,165,82,83
2015,233,Estonia,Angola,5,4,1
2015,246,Finland,Angola,532,308,224
2015,352,Iceland,Angola,34,21,13
2015,372,Ireland,Angola,480,238,242
2015,428,Latvia,Angola,2,1,1
2015,578,Norway,Angola,495,247,248
2015,752,Sweden,Angola,742,350,392
2015,826,United Kingdom,Angola,12753,5940,6813
2015,300,Greece,Angola,8,4,4
2015,380,Italy,Angola,1819,848,971
2015,620,Portugal,Angola,156251,69050,87201
2015,705,Slovenia,Angola,2,1,1
2015,724,Spain,Angola,3553,1966,1587
2015,40,Austria,Angola,341,185,156
2015,56,Belgium,Angola,6327,3223,3104
2015,250,France,Angola,22143,10992,11151
2015,528,Netherlands,Angola,5321,3070,2251
2015,756,Switzerland,Angola,6743,3321,3422
2015,124,Canada,Angola,3100,1564,1536
2015,840,United States of America,Angola,14068,6916,7152
2019,232,Eritrea,Angola,349,204,145
2019,508,Mozambique,Angola,39224,18950,20274
2019,834,United Republic of Tanzania,Angola,1123,674,449
2019,894,Zambia,Angola,28908,14400,14508
2019,120,Cameroon,Angola,2599,1147,1452
2019,178,Congo,Angola,42506,22102,20404
2019,180,Democratic Republic of the Congo,Angola,179065,89911,89154
2019,266,Gabon,Angola,1098,725,373
2019,678,Sao Tome and Principe,Angola,325,131,194
2019,72,Botswana,Angola,782,373,409
2019,748,Eswatini,Angola,132,65,67
2019,516,Namibia,Angola,39580,23322,16258
2019,710,South Africa,Angola,69659,34315,35344
2019,132,Cabo Verde,Angola,388,184,204
2019,324,Guinea,Angola,109,70,39
2019,466,Mali,Angola,1743,822,921
2019,818,Egypt,Angola,28,16,12
2019,608,Philippines,Angola,78,36,42
2019,192,Cuba,Angola,29,17,12
2019,188,Costa Rica,Angola,3,2,1
2019,484,Mexico,Angola,55,27,28
2019,32,Argentina,Angola,9,3,6
2019,68,Bolivia (Plurinational State of),Angola,6,5,1
2019,76,Brazil,Angola,8665,4448,4217
2019,152,Chile,Angola,221,131,90
2019,170,Colombia,Angola,56,31,25
2019,218,Ecuador,Angola,41,16,25
2019,604,Peru,Angola,17,7,10
2019,862,Venezuela (Bolivarian Republic of),Angola,184,97,87
2019,36,Australia,Angola,592,318,274
2019,100,Bulgaria,Angola,14,4,10
2019,203,Czechia,Angola,176,146,30
2019,348,Hungary,Angola,86,54,32
2019,616,Poland,Angola,59,53,6
2019,643,Russian Federation,Angola,510,410,100
2019,703,Slovakia,Angola,27,22,5
2019,208,Denmark,Angola,173,83,90
2019,233,Estonia,Angola,4,3,1
2019,246,Finland,Angola,577,329,248
2019,352,Iceland,Angola,41,28,13
2019,372,Ireland,Angola,526,262,264
2019,578,Norway,Angola,551,273,278
2019,752,Sweden,Angola,801,385,416
2019,826,United Kingdom,Angola,14482,6765,7717
2019,300,Greece,Angola,11,6,5
2019,380,Italy,Angola,1911,893,1018
2019,620,Portugal,Angola,158958,70485,88473
2019,705,Slovenia,Angola,3,1,2
2019,724,Spain,Angola,3681,1998,1683
2019,40,Austria,Angola,402,222,180
2019,56,Belgium,Angola,6897,3509,3388
2019,250,France,Angola,23438,11608,11830
2019,528,Netherlands,Angola,5202,2982,2220
2019,756,Switzerland,Angola,6984,3432,3552
2019,124,Canada,Angola,3322,1677,1645
2019,840,United States of America,Angola,15192,7386,7806
1990,28,Antigua and Barbuda,Anguilla,17,8,9
1990,535,"Bonaire, Sint Eustatius and Saba",Anguilla,168,88,80
1990,212,Dominica,Anguilla,7,5,2
1990,214,Dominican Republic,Anguilla,139,82,57
1990,662,Saint Lucia,Anguilla,16,7,9
1990,850,United States Virgin Islands,Anguilla,1113,571,542
1990,152,Chile,Anguilla,8,3,5
1990,170,Colombia,Anguilla,39,25,14
1990,100,Bulgaria,Anguilla,10,7,3
1990,643,Russian Federation,Anguilla,304,149,155
1990,428,Latvia,Anguilla,4,2,2
1990,826,United Kingdom,Anguilla,95,58,37
1990,300,Greece,Anguilla,6,3,3
1990,250,France,Anguilla,8,5,3
1990,528,Netherlands,Anguilla,7,4,3
1990,124,Canada,Anguilla,106,52,54
1995,28,Antigua and Barbuda,Anguilla,25,12,13
1995,535,"Bonaire, Sint Eustatius and Saba",Anguilla,351,184,167
1995,212,Dominica,Anguilla,9,6,3
1995,214,Dominican Republic,Anguilla,155,90,65
1995,662,Saint Lucia,Anguilla,21,10,11
1995,850,United States Virgin Islands,Anguilla,1106,567,539
1995,152,Chile,Anguilla,11,5,6
1995,170,Colombia,Anguilla,38,24,14
1995,100,Bulgaria,Anguilla,16,10,6
1995,643,Russian Federation,Anguilla,300,156,144
1995,372,Ireland,Anguilla,1,1,0
1995,428,Latvia,Anguilla,6,4,2
1995,826,United Kingdom,Anguilla,377,184,193
1995,300,Greece,Anguilla,11,6,5
1995,250,France,Anguilla,9,6,3
1995,528,Netherlands,Anguilla,9,5,4
1995,124,Canada,Anguilla,121,59,62
2000,28,Antigua and Barbuda,Anguilla,32,15,17
2000,535,"Bonaire, Sint Eustatius and Saba",Anguilla,534,280,254
2000,212,Dominica,Anguilla,11,7,4
2000,214,Dominican Republic,Anguilla,170,97,73
2000,662,Saint Lucia,Anguilla,29,13,16
2000,850,United States Virgin Islands,Anguilla,1103,565,538
2000,152,Chile,Anguilla,15,6,9
2000,170,Colombia,Anguilla,37,24,13
2000,100,Bulgaria,Anguilla,21,13,8
2000,643,Russian Federation,Anguilla,286,157,129
2000,372,Ireland,Anguilla,2,1,1
2000,428,Latvia,Anguilla,9,6,3
2000,826,United Kingdom,Anguilla,666,313,353
2000,300,Greece,Anguilla,17,9,8
2000,250,France,Anguilla,9,6,3
2000,528,Netherlands,Anguilla,14,6,8
2000,124,Canada,Anguilla,139,68,71
2005,28,Antigua and Barbuda,Anguilla,35,17,18
2005,535,"Bonaire, Sint Eustatius and Saba",Anguilla,569,299,270
2005,212,Dominica,Anguilla,13,9,4
2005,214,Dominican Republic,Anguilla,101,58,43
2005,662,Saint Lucia,Anguilla,18,9,9
2005,534,Sint Maarten (Dutch part),Anguilla,183,100,83
2005,850,United States Virgin Islands,Anguilla,1037,534,503
2005,152,Chile,Anguilla,22,9,13
2005,170,Colombia,Anguilla,35,23,12
2005,100,Bulgaria,Anguilla,30,19,11
2005,643,Russian Federation,Anguilla,168,98,70
2005,372,Ireland,Anguilla,2,1,1
2005,428,Latvia,Anguilla,4,3,1
2005,826,United Kingdom,Anguilla,569,273,296
2005,300,Greece,Anguilla,14,7,7
2005,250,France,Anguilla,123,40,83
2005,528,Netherlands,Anguilla,27,11,16
2005,124,Canada,Anguilla,103,43,60
2010,28,Antigua and Barbuda,Anguilla,37,18,19
2010,535,"Bonaire, Sint Eustatius and Saba",Anguilla,25,20,5
2010,531,Curaçao,Anguilla,39,10,29
2010,212,Dominica,Anguilla,16,12,4
2010,214,Dominican Republic,Anguilla,32,20,12
2010,662,Saint Lucia,Anguilla,6,3,3
2010,534,Sint Maarten (Dutch part),Anguilla,367,200,167
2010,850,United States Virgin Islands,Anguilla,972,503,469
2010,152,Chile,Anguilla,30,13,17
2010,170,Colombia,Anguilla,39,26,13
2010,100,Bulgaria,Anguilla,37,24,13
2010,643,Russian Federation,Anguilla,48,37,11
2010,372,Ireland,Anguilla,1,0,1
2010,826,United Kingdom,Anguilla,599,294,305
2010,300,Greece,Anguilla,11,5,6
2010,250,France,Anguilla,9,6,3
2010,528,Netherlands,Anguilla,23,8,15
2010,124,Canada,Anguilla,75,21,54
2015,28,Antigua and Barbuda,Anguilla,39,19,20
2015,535,"Bonaire, Sint Eustatius and Saba",Anguilla,28,23,5
2015,531,Curaçao,Anguilla,42,11,31
2015,212,Dominica,Anguilla,19,14,5
2015,214,Dominican Republic,Anguilla,33,21,12
2015,662,Saint Lucia,Anguilla,5,3,2
2015,534,Sint Maarten (Dutch part),Anguilla,383,209,174
2015,850,United States Virgin Islands,Anguilla,972,503,469
2015,152,Chile,Anguilla,45,19,26
2015,170,Colombia,Anguilla,43,29,14
2015,100,Bulgaria,Anguilla,33,23,10
2015,643,Russian Federation,Anguilla,49,37,12
2015,372,Ireland,Anguilla,1,0,1
2015,826,United Kingdom,Anguilla,766,365,401
2015,300,Greece,Anguilla,10,5,5
2015,250,France,Anguilla,10,7,3
2015,528,Netherlands,Anguilla,23,7,16
2015,124,Canada,Anguilla,64,40,24
2019,28,Antigua and Barbuda,Anguilla,40,20,20
2019,535,"Bonaire, Sint Eustatius and Saba",Anguilla,33,28,5
2019,531,Curaçao,Anguilla,45,12,33
2019,212,Dominica,Anguilla,19,14,5
2019,214,Dominican Republic,Anguilla,34,22,12
2019,662,Saint Lucia,Anguilla,4,3,1
2019,534,Sint Maarten (Dutch part),Anguilla,396,216,180
2019,850,United States Virgin Islands,Anguilla,972,503,469
2019,152,Chile,Anguilla,60,24,36
2019,170,Colombia,Anguilla,43,29,14
2019,100,Bulgaria,Anguilla,35,25,10
2019,643,Russian Federation,Anguilla,48,37,11
2019,372,Ireland,Anguilla,1,0,1
2019,826,United Kingdom,Anguilla,869,415,454
2019,300,Greece,Anguilla,9,5,4
2019,250,France,Anguilla,10,7,3
2019,528,Netherlands,Anguilla,21,6,15
2019,124,Canada,Anguilla,68,43,25
1990,516,Namibia,Antigua and Barbuda,693,275,418
1990,818,Egypt,Antigua and Barbuda,14,7,7
1990,44,Bahamas,Antigua and Barbuda,13,7,6
1990,52,Barbados,Antigua and Barbuda,226,73,153
1990,92,British Virgin Islands,Antigua and Barbuda,388,178,210
1990,535,"Bonaire, Sint Eustatius and Saba",Antigua and Barbuda,321,145,176
1990,212,Dominica,Antigua and Barbuda,184,97,87
1990,214,Dominican Republic,Antigua and Barbuda,266,134,132
1990,308,Grenada,Antigua and Barbuda,22,11,11
1990,388,Jamaica,Antigua and Barbuda,120,59,61
1990,500,Montserrat,Antigua and Barbuda,172,82,90
1990,659,Saint Kitts and Nevis,Antigua and Barbuda,175,81,94
1990,662,Saint Lucia,Antigua and Barbuda,49,25,24
1990,670,Saint Vincent and the Grenadines,Antigua and Barbuda,51,28,23
1990,850,United States Virgin Islands,Antigua and Barbuda,4398,1976,2422
1990,558,Nicaragua,Antigua and Barbuda,35,18,17
1990,68,Bolivia (Plurinational State of),Antigua and Barbuda,10,8,2
1990,152,Chile,Antigua and Barbuda,13,6,7
1990,170,Colombia,Antigua and Barbuda,37,10,27
1990,328,Guyana,Antigua and Barbuda,5,2,3
1990,36,Australia,Antigua and Barbuda,21,6,15
1990,100,Bulgaria,Antigua and Barbuda,1,1,0
1990,203,Czechia,Antigua and Barbuda,1,1,0
1990,372,Ireland,Antigua and Barbuda,1,1,0
1990,752,Sweden,Antigua and Barbuda,6,5,1
1990,826,United Kingdom,Antigua and Barbuda,542,316,226
1990,300,Greece,Antigua and Barbuda,12,6,6
1990,380,Italy,Antigua and Barbuda,1,1,0
1990,40,Austria,Antigua and Barbuda,4,0,4
1990,250,France,Antigua and Barbuda,19,5,14
1990,528,Netherlands,Antigua and Barbuda,11,6,5
1990,756,Switzerland,Antigua and Barbuda,20,17,3
1990,124,Canada,Antigua and Barbuda,1900,925,975
1990,840,United States of America,Antigua and Barbuda,12022,5305,6717
1995,516,Namibia,Antigua and Barbuda,662,265,397
1995,818,Egypt,Antigua and Barbuda,13,6,7
1995,44,Bahamas,Antigua and Barbuda,10,4,6
1995,52,Barbados,Antigua and Barbuda,246,82,164
1995,92,British Virgin Islands,Antigua and Barbuda,456,202,254
1995,535,"Bonaire, Sint Eustatius and Saba",Antigua and Barbuda,669,300,369
1995,212,Dominica,Antigua and Barbuda,243,128,115
1995,214,Dominican Republic,Antigua and Barbuda,296,146,150
1995,308,Grenada,Antigua and Barbuda,28,14,14
1995,388,Jamaica,Antigua and Barbuda,143,70,73
1995,500,Montserrat,Antigua and Barbuda,138,66,72
1995,659,Saint Kitts and Nevis,Antigua and Barbuda,231,109,122
1995,662,Saint Lucia,Antigua and Barbuda,65,33,32
1995,670,Saint Vincent and the Grenadines,Antigua and Barbuda,53,28,25
1995,850,United States Virgin Islands,Antigua and Barbuda,4610,2071,2539
1995,558,Nicaragua,Antigua and Barbuda,28,14,14
1995,68,Bolivia (Plurinational State of),Antigua and Barbuda,5,4,1
1995,152,Chile,Antigua and Barbuda,12,7,5
1995,170,Colombia,Antigua and Barbuda,36,10,26
1995,328,Guyana,Antigua and Barbuda,8,3,5
1995,36,Australia,Antigua and Barbuda,15,3,12
1995,100,Bulgaria,Antigua and Barbuda,2,2,0
1995,203,Czechia,Antigua and Barbuda,2,2,0
1995,372,Ireland,Antigua and Barbuda,2,2,0
1995,752,Sweden,Antigua and Barbuda,7,6,1
1995,826,United Kingdom,Antigua and Barbuda,2135,1000,1135
1995,300,Greece,Antigua and Barbuda,13,8,5
1995,380,Italy,Antigua and Barbuda,6,1,5
1995,40,Austria,Antigua and Barbuda,5,0,5
1995,250,France,Antigua and Barbuda,20,5,15
1995,528,Netherlands,Antigua and Barbuda,16,8,8
1995,756,Switzerland,Antigua and Barbuda,49,31,18
1995,124,Canada,Antigua and Barbuda,2082,1009,1073
1995,840,United States of America,Antigua and Barbuda,15376,6872,8504
2000,516,Namibia,Antigua and Barbuda,616,248,368
2000,818,Egypt,Antigua and Barbuda,13,6,7
2000,44,Bahamas,Antigua and Barbuda,8,3,5
2000,52,Barbados,Antigua and Barbuda,267,91,176
2000,92,British Virgin Islands,Antigua and Barbuda,524,227,297
2000,535,"Bonaire, Sint Eustatius and Saba",Antigua and Barbuda,1018,456,562
2000,212,Dominica,Antigua and Barbuda,290,155,135
2000,214,Dominican Republic,Antigua and Barbuda,325,157,168
2000,308,Grenada,Antigua and Barbuda,35,17,18
2000,388,Jamaica,Antigua and Barbuda,165,80,85
2000,500,Montserrat,Antigua and Barbuda,104,49,55
2000,659,Saint Kitts and Nevis,Antigua and Barbuda,319,153,166
2000,662,Saint Lucia,Antigua and Barbuda,90,46,44
2000,670,Saint Vincent and the Grenadines,Antigua and Barbuda,55,30,25
2000,850,United States Virgin Islands,Antigua and Barbuda,4832,2170,2662
2000,558,Nicaragua,Antigua and Barbuda,65,32,33
2000,152,Chile,Antigua and Barbuda,12,6,6
2000,170,Colombia,Antigua and Barbuda,35,10,25
2000,328,Guyana,Antigua and Barbuda,10,4,6
2000,36,Australia,Antigua and Barbuda,30,15,15
2000,100,Bulgaria,Antigua and Barbuda,3,3,0
2000,203,Czechia,Antigua and Barbuda,3,3,0
2000,372,Ireland,Antigua and Barbuda,3,2,1
2000,752,Sweden,Antigua and Barbuda,6,4,2
2000,826,United Kingdom,Antigua and Barbuda,3764,1697,2067
2000,300,Greece,Antigua and Barbuda,14,9,5
2000,380,Italy,Antigua and Barbuda,11,1,10
2000,40,Austria,Antigua and Barbuda,5,0,5
2000,250,France,Antigua and Barbuda,20,5,15
2000,528,Netherlands,Antigua and Barbuda,23,10,13
2000,756,Switzerland,Antigua and Barbuda,80,46,34
2000,124,Canada,Antigua and Barbuda,2313,1116,1197
2000,840,United States of America,Antigua and Barbuda,18789,8477,10312
2005,516,Namibia,Antigua and Barbuda,487,195,292
2005,818,Egypt,Antigua and Barbuda,15,7,8
2005,44,Bahamas,Antigua and Barbuda,11,5,6
2005,52,Barbados,Antigua and Barbuda,225,84,141
2005,92,British Virgin Islands,Antigua and Barbuda,600,260,340
2005,535,"Bonaire, Sint Eustatius and Saba",Antigua and Barbuda,1084,485,599
2005,212,Dominica,Antigua and Barbuda,357,189,168
2005,214,Dominican Republic,Antigua and Barbuda,248,124,124
2005,308,Grenada,Antigua and Barbuda,36,18,18
2005,388,Jamaica,Antigua and Barbuda,161,79,82
2005,500,Montserrat,Antigua and Barbuda,107,51,56
2005,659,Saint Kitts and Nevis,Antigua and Barbuda,363,175,188
2005,662,Saint Lucia,Antigua and Barbuda,95,48,47
2005,670,Saint Vincent and the Grenadines,Antigua and Barbuda,56,32,24
2005,534,Sint Maarten (Dutch part),Antigua and Barbuda,256,116,140
2005,850,United States Virgin Islands,Antigua and Barbuda,4708,2128,2580
2005,558,Nicaragua,Antigua and Barbuda,104,50,54
2005,152,Chile,Antigua and Barbuda,18,10,8
2005,170,Colombia,Antigua and Barbuda,33,9,24
2005,328,Guyana,Antigua and Barbuda,13,5,8
2005,36,Australia,Antigua and Barbuda,30,15,15
2005,100,Bulgaria,Antigua and Barbuda,4,3,1
2005,203,Czechia,Antigua and Barbuda,2,2,0
2005,208,Denmark,Antigua and Barbuda,2,0,2
2005,372,Ireland,Antigua and Barbuda,3,2,1
2005,752,Sweden,Antigua and Barbuda,8,5,3
2005,826,United Kingdom,Antigua and Barbuda,3517,1579,1938
2005,300,Greece,Antigua and Barbuda,22,12,10
2005,380,Italy,Antigua and Barbuda,17,5,12
2005,40,Austria,Antigua and Barbuda,6,0,6
2005,250,France,Antigua and Barbuda,103,40,63
2005,528,Netherlands,Antigua and Barbuda,28,9,19
2005,756,Switzerland,Antigua and Barbuda,87,49,38
2005,124,Canada,Antigua and Barbuda,2285,1099,1186
2005,840,United States of America,Antigua and Barbuda,22450,10197,12253
2010,516,Namibia,Antigua and Barbuda,469,189,280
2010,818,Egypt,Antigua and Barbuda,16,7,9
2010,44,Bahamas,Antigua and Barbuda,13,6,7
2010,52,Barbados,Antigua and Barbuda,185,78,107
2010,92,British Virgin Islands,Antigua and Barbuda,676,293,383
2010,535,"Bonaire, Sint Eustatius and Saba",Antigua and Barbuda,22,12,10
2010,531,Curaçao,Antigua and Barbuda,50,12,38
2010,212,Dominica,Antigua and Barbuda,379,182,197
2010,214,Dominican Republic,Antigua and Barbuda,170,90,80
2010,308,Grenada,Antigua and Barbuda,38,19,19
2010,388,Jamaica,Antigua and Barbuda,156,77,79
2010,500,Montserrat,Antigua and Barbuda,110,52,58
2010,659,Saint Kitts and Nevis,Antigua and Barbuda,393,191,202
2010,662,Saint Lucia,Antigua and Barbuda,94,47,47
2010,670,Saint Vincent and the Grenadines,Antigua and Barbuda,58,34,24
2010,534,Sint Maarten (Dutch part),Antigua and Barbuda,513,232,281
2010,850,United States Virgin Islands,Antigua and Barbuda,4585,2085,2500
2010,558,Nicaragua,Antigua and Barbuda,111,54,57
2010,152,Chile,Antigua and Barbuda,24,13,11
2010,170,Colombia,Antigua and Barbuda,37,10,27
2010,328,Guyana,Antigua and Barbuda,16,7,9
2010,36,Australia,Antigua and Barbuda,40,20,20
2010,100,Bulgaria,Antigua and Barbuda,5,4,1
2010,203,Czechia,Antigua and Barbuda,3,3,0
2010,208,Denmark,Antigua and Barbuda,2,0,2
2010,233,Estonia,Antigua and Barbuda,1,1,0
2010,372,Ireland,Antigua and Barbuda,2,1,1
2010,752,Sweden,Antigua and Barbuda,9,6,3
2010,826,United Kingdom,Antigua and Barbuda,3705,1706,1999
2010,300,Greece,Antigua and Barbuda,31,17,14
2010,380,Italy,Antigua and Barbuda,24,10,14
2010,40,Austria,Antigua and Barbuda,6,0,6
2010,250,France,Antigua and Barbuda,56,14,42
2010,528,Netherlands,Antigua and Barbuda,27,6,21
2010,756,Switzerland,Antigua and Barbuda,106,56,50
2010,124,Canada,Antigua and Barbuda,2400,1155,1245
2010,840,United States of America,Antigua and Barbuda,26899,12016,14883
2015,516,Namibia,Antigua and Barbuda,459,186,273
2015,324,Guinea,Antigua and Barbuda,4452,2545,1907
2015,818,Egypt,Antigua and Barbuda,11,6,5
2015,44,Bahamas,Antigua and Barbuda,14,6,8
2015,52,Barbados,Antigua and Barbuda,194,82,112
2015,92,British Virgin Islands,Antigua and Barbuda,757,328,429
2015,535,"Bonaire, Sint Eustatius and Saba",Antigua and Barbuda,25,14,11
2015,531,Curaçao,Antigua and Barbuda,54,13,41
2015,212,Dominica,Antigua and Barbuda,442,212,230
2015,214,Dominican Republic,Antigua and Barbuda,179,95,84
2015,308,Grenada,Antigua and Barbuda,38,19,19
2015,388,Jamaica,Antigua and Barbuda,153,76,77
2015,500,Montserrat,Antigua and Barbuda,115,55,60
2015,659,Saint Kitts and Nevis,Antigua and Barbuda,404,197,207
2015,662,Saint Lucia,Antigua and Barbuda,90,45,45
2015,670,Saint Vincent and the Grenadines,Antigua and Barbuda,58,33,25
2015,534,Sint Maarten (Dutch part),Antigua and Barbuda,534,241,293
2015,850,United States Virgin Islands,Antigua and Barbuda,4587,2085,2502
2015,558,Nicaragua,Antigua and Barbuda,119,58,61
2015,152,Chile,Antigua and Barbuda,36,20,16
2015,170,Colombia,Antigua and Barbuda,41,12,29
2015,328,Guyana,Antigua and Barbuda,19,8,11
2015,36,Australia,Antigua and Barbuda,60,34,26
2015,100,Bulgaria,Antigua and Barbuda,5,4,1
2015,203,Czechia,Antigua and Barbuda,4,4,0
2015,208,Denmark,Antigua and Barbuda,3,1,2
2015,233,Estonia,Antigua and Barbuda,2,2,0
2015,372,Ireland,Antigua and Barbuda,2,1,1
2015,428,Latvia,Antigua and Barbuda,1,0,1
2015,752,Sweden,Antigua and Barbuda,8,6,2
2015,826,United Kingdom,Antigua and Barbuda,4738,2106,2632
2015,300,Greece,Antigua and Barbuda,29,16,13
2015,380,Italy,Antigua and Barbuda,796,271,525
2015,40,Austria,Antigua and Barbuda,7,0,7
2015,250,France,Antigua and Barbuda,63,14,49
2015,528,Netherlands,Antigua and Barbuda,32,10,22
2015,756,Switzerland,Antigua and Barbuda,81,48,33
2015,124,Canada,Antigua and Barbuda,2295,1063,1232
2015,840,United States of America,Antigua and Barbuda,31677,14061,17616
2019,516,Namibia,Antigua and Barbuda,485,197,288
2019,324,Guinea,Antigua and Barbuda,4249,2429,1820
2019,818,Egypt,Antigua and Barbuda,15,8,7
2019,44,Bahamas,Antigua and Barbuda,14,6,8
2019,52,Barbados,Antigua and Barbuda,195,82,113
2019,92,British Virgin Islands,Antigua and Barbuda,822,357,465
2019,535,"Bonaire, Sint Eustatius and Saba",Antigua and Barbuda,29,16,13
2019,531,Curaçao,Antigua and Barbuda,58,14,44
2019,212,Dominica,Antigua and Barbuda,451,217,234
2019,214,Dominican Republic,Antigua and Barbuda,184,98,86
2019,308,Grenada,Antigua and Barbuda,38,19,19
2019,388,Jamaica,Antigua and Barbuda,154,77,77
2019,500,Montserrat,Antigua and Barbuda,117,56,61
2019,659,Saint Kitts and Nevis,Antigua and Barbuda,411,201,210
2019,662,Saint Lucia,Antigua and Barbuda,86,43,43
2019,670,Saint Vincent and the Grenadines,Antigua and Barbuda,57,32,25
2019,534,Sint Maarten (Dutch part),Antigua and Barbuda,552,249,303
2019,850,United States Virgin Islands,Antigua and Barbuda,4588,2085,2503
2019,558,Nicaragua,Antigua and Barbuda,124,61,63
2019,152,Chile,Antigua and Barbuda,48,26,22
2019,170,Colombia,Antigua and Barbuda,41,12,29
2019,328,Guyana,Antigua and Barbuda,19,8,11
2019,36,Australia,Antigua and Barbuda,63,33,30
2019,100,Bulgaria,Antigua and Barbuda,5,4,1
2019,203,Czechia,Antigua and Barbuda,6,6,0
2019,208,Denmark,Antigua and Barbuda,4,1,3
2019,233,Estonia,Antigua and Barbuda,5,5,0
2019,372,Ireland,Antigua and Barbuda,2,1,1
2019,752,Sweden,Antigua and Barbuda,3,3,0
2019,826,United Kingdom,Antigua and Barbuda,5380,2399,2981
2019,300,Greece,Antigua and Barbuda,28,16,12
2019,380,Italy,Antigua and Barbuda,23,9,14
2019,40,Austria,Antigua and Barbuda,8,0,8
2019,250,France,Antigua and Barbuda,66,15,51
2019,528,Netherlands,Antigua and Barbuda,35,14,21
2019,756,Switzerland,Antigua and Barbuda,66,39,27
2019,124,Canada,Antigua and Barbuda,2459,1139,1320
2019,840,United States of America,Antigua and Barbuda,34208,14980,19228
1990,516,Namibia,Argentina,74,27,47
1990,710,South Africa,Argentina,623,226,397
1990,132,Cabo Verde,Argentina,5,1,4
1990,478,Mauritania,Argentina,60,29,31
1990,818,Egypt,Argentina,322,194,128
1990,196,Cyprus,Argentina,21,12,9
1990,376,Israel,Argentina,25526,12315,13211
1990,792,Turkey,Argentina,34,18,16
1990,392,Japan,Argentina,2657,1354,1303
1990,608,Philippines,Argentina,32,21,11
1990,44,Bahamas,Argentina,8,4,4
1990,535,"Bonaire, Sint Eustatius and Saba",Argentina,14,5,9
1990,136,Cayman Islands,Argentina,3,2,1
1990,192,Cuba,Argentina,373,192,181
1990,214,Dominican Republic,Argentina,2642,1546,1096
1990,332,Haiti,Argentina,466,267,199
1990,630,Puerto Rico,Argentina,1234,584,650
1990,188,Costa Rica,Argentina,1041,513,528
1990,222,El Salvador,Argentina,255,143,112
1990,320,Guatemala,Argentina,285,122,163
1990,340,Honduras,Argentina,145,84,61
1990,484,Mexico,Argentina,4340,2142,2198
1990,558,Nicaragua,Argentina,185,105,80
1990,591,Panama,Argentina,580,304,276
1990,68,Bolivia (Plurinational State of),Argentina,21923,10684,11239
1990,76,Brazil,Argentina,28350,15178,13172
1990,152,Chile,Argentina,32696,16212,16484
1990,170,Colombia,Argentina,2359,1284,1075
1990,218,Ecuador,Argentina,1669,964,705
1990,238,Falkland Islands (Malvinas),Argentina,27,11,16
1990,600,Paraguay,Argentina,50447,25066,25381
1990,604,Peru,Argentina,7080,3502,3578
1990,858,Uruguay,Argentina,14559,5658,8901
1990,862,Venezuela (Bolivarian Republic of),Argentina,9483,4969,4514
1990,36,Australia,Argentina,13155,6602,6553
1990,554,New Zealand,Argentina,419,204,215
1990,112,Belarus,Argentina,76,40,36
1990,100,Bulgaria,Argentina,7,3,4
1990,203,Czechia,Argentina,76,37,39
1990,348,Hungary,Argentina,22,10,12
1990,616,Poland,Argentina,251,136,115
1990,642,Romania,Argentina,10,3,7
1990,643,Russian Federation,Argentina,582,286,296
1990,703,Slovakia,Argentina,20,9,11
1990,208,Denmark,Argentina,833,411,422
1990,246,Finland,Argentina,107,58,49
1990,352,Iceland,Argentina,5,4,1
1990,372,Ireland,Argentina,63,30,33
1990,428,Latvia,Argentina,9,3,6
1990,440,Lithuania,Argentina,83,45,38
1990,578,Norway,Argentina,445,203,242
1990,752,Sweden,Argentina,1913,962,951
1990,826,United Kingdom,Argentina,947,534,413
1990,20,Andorra,Argentina,86,46,40
1990,191,Croatia,Argentina,143,46,97
1990,300,Greece,Argentina,641,310,331
1990,380,Italy,Argentina,31345,10390,20955
1990,470,Malta,Argentina,7,5,2
1990,620,Portugal,Argentina,303,139,164
1990,674,San Marino,Argentina,68,37,31
1990,688,Serbia,Argentina,5,2,3
1990,705,Slovenia,Argentina,92,52,40
1990,724,Spain,Argentina,42923,20170,22753
1990,40,Austria,Argentina,839,423,416
1990,56,Belgium,Argentina,1156,536,620
1990,250,France,Argentina,10137,4592,5545
1990,276,Germany,Argentina,4499,2209,2290
1990,442,Luxembourg,Argentina,38,19,19
1990,528,Netherlands,Argentina,1614,752,862
1990,756,Switzerland,Argentina,4509,2208,2301
1990,124,Canada,Argentina,10660,5190,5470
1990,840,United States of America,Argentina,92563,43141,49422
1995,516,Namibia,Argentina,70,26,44
1995,710,South Africa,Argentina,702,318,384
1995,132,Cabo Verde,Argentina,8,2,6
1995,478,Mauritania,Argentina,64,34,30
1995,818,Egypt,Argentina,243,146,97
1995,196,Cyprus,Argentina,30,17,13
1995,376,Israel,Argentina,29503,14003,15500
1995,792,Turkey,Argentina,82,42,40
1995,392,Japan,Argentina,2950,1416,1534
1995,608,Philippines,Argentina,43,28,15
1995,44,Bahamas,Argentina,8,3,5
1995,535,"Bonaire, Sint Eustatius and Saba",Argentina,28,10,18
1995,136,Cayman Islands,Argentina,7,3,4
1995,192,Cuba,Argentina,283,140,143
1995,214,Dominican Republic,Argentina,2935,1687,1248
1995,332,Haiti,Argentina,442,253,189
1995,630,Puerto Rico,Argentina,1245,591,654
1995,188,Costa Rica,Argentina,864,431,433
1995,222,El Salvador,Argentina,211,120,91
1995,320,Guatemala,Argentina,318,159,159
1995,340,Honduras,Argentina,144,81,63
1995,484,Mexico,Argentina,5366,2662,2704
1995,558,Nicaragua,Argentina,147,83,64
1995,591,Panama,Argentina,667,352,315
1995,68,Bolivia (Plurinational State of),Argentina,25141,12434,12707
1995,76,Brazil,Argentina,27974,15391,12583
1995,152,Chile,Argentina,39251,19651,19600
1995,170,Colombia,Argentina,2471,1359,1112
1995,218,Ecuador,Argentina,1954,1140,814
1995,238,Falkland Islands (Malvinas),Argentina,36,21,15
1995,600,Paraguay,Argentina,57525,28910,28615
1995,604,Peru,Argentina,7087,3463,3624
1995,858,Uruguay,Argentina,17970,7292,10678
1995,862,Venezuela (Bolivarian Republic of),Argentina,9138,4809,4329
1995,36,Australia,Argentina,12541,6260,6281
1995,554,New Zealand,Argentina,516,243,273
1995,112,Belarus,Argentina,92,39,53
1995,100,Bulgaria,Argentina,30,13,17
1995,203,Czechia,Argentina,114,57,57
1995,348,Hungary,Argentina,123,64,59
1995,616,Poland,Argentina,214,115,99
1995,642,Romania,Argentina,8,4,4
1995,643,Russian Federation,Argentina,572,299,273
1995,703,Slovakia,Argentina,32,14,18
1995,208,Denmark,Argentina,899,435,464
1995,246,Finland,Argentina,120,68,52
1995,352,Iceland,Argentina,9,6,3
1995,372,Ireland,Argentina,175,81,94
1995,428,Latvia,Argentina,14,5,9
1995,440,Lithuania,Argentina,93,50,43
1995,578,Norway,Argentina,491,225,266
1995,752,Sweden,Argentina,2270,1133,1137
1995,826,United Kingdom,Argentina,3722,1654,2068
1995,20,Andorra,Argentina,118,62,56
1995,191,Croatia,Argentina,166,59,107
1995,300,Greece,Argentina,628,272,356
1995,380,Italy,Argentina,25795,9096,16699
1995,470,Malta,Argentina,9,6,3
1995,620,Portugal,Argentina,654,300,354
1995,674,San Marino,Argentina,74,40,34
1995,688,Serbia,Argentina,38,13,25
1995,705,Slovenia,Argentina,129,66,63
1995,724,Spain,Argentina,50810,24493,26317
1995,40,Austria,Argentina,947,485,462
1995,56,Belgium,Argentina,1152,532,620
1995,250,France,Argentina,10465,4644,5821
1995,276,Germany,Argentina,4616,2035,2581
1995,442,Luxembourg,Argentina,36,19,17
1995,528,Netherlands,Argentina,1785,815,970
1995,756,Switzerland,Argentina,5249,2682,2567
1995,124,Canada,Argentina,12036,5829,6207
1995,840,United States of America,Argentina,110347,50987,59360
2000,516,Namibia,Argentina,67,25,42
2000,710,South Africa,Argentina,996,490,506
2000,132,Cabo Verde,Argentina,10,3,7
2000,478,Mauritania,Argentina,66,39,27
2000,818,Egypt,Argentina,183,109,74
2000,196,Cyprus,Argentina,38,21,17
2000,268,Georgia,Argentina,16,8,8
2000,376,Israel,Argentina,31828,15074,16754
2000,792,Turkey,Argentina,131,66,65
2000,392,Japan,Argentina,3072,1419,1653
2000,608,Philippines,Argentina,657,396,261
2000,44,Bahamas,Argentina,9,3,6
2000,535,"Bonaire, Sint Eustatius and Saba",Argentina,43,16,27
2000,136,Cayman Islands,Argentina,13,5,8
2000,192,Cuba,Argentina,192,87,105
2000,214,Dominican Republic,Argentina,3227,1828,1399
2000,332,Haiti,Argentina,419,240,179
2000,630,Puerto Rico,Argentina,1259,598,661
2000,188,Costa Rica,Argentina,1120,547,573
2000,222,El Salvador,Argentina,166,97,69
2000,320,Guatemala,Argentina,350,195,155
2000,340,Honduras,Argentina,142,78,64
2000,484,Mexico,Argentina,6625,3312,3313
2000,558,Nicaragua,Argentina,188,101,87
2000,591,Panama,Argentina,796,420,376
2000,68,Bolivia (Plurinational State of),Argentina,28095,14043,14052
2000,76,Brazil,Argentina,27597,15603,11994
2000,152,Chile,Argentina,45770,22791,22979
2000,170,Colombia,Argentina,2582,1434,1148
2000,218,Ecuador,Argentina,2239,1316,923
2000,238,Falkland Islands (Malvinas),Argentina,39,24,15
2000,600,Paraguay,Argentina,64404,32483,31921
2000,604,Peru,Argentina,8282,4050,4232
2000,858,Uruguay,Argentina,21691,9589,12102
2000,862,Venezuela (Bolivarian Republic of),Argentina,8724,4605,4119
2000,36,Australia,Argentina,12020,5919,6101
2000,554,New Zealand,Argentina,373,182,191
2000,112,Belarus,Argentina,107,38,69
2000,100,Bulgaria,Argentina,53,24,29
2000,203,Czechia,Argentina,152,77,75
2000,348,Hungary,Argentina,223,118,105
2000,616,Poland,Argentina,183,97,86
2000,642,Romania,Argentina,8,4,4
2000,643,Russian Federation,Argentina,543,303,240
2000,703,Slovakia,Argentina,54,23,31
2000,208,Denmark,Argentina,965,460,505
2000,246,Finland,Argentina,132,77,55
2000,352,Iceland,Argentina,13,9,4
2000,372,Ireland,Argentina,382,183,199
2000,428,Latvia,Argentina,20,7,13
2000,440,Lithuania,Argentina,72,39,33
2000,578,Norway,Argentina,533,244,289
2000,752,Sweden,Argentina,2435,1207,1228
2000,826,United Kingdom,Argentina,6561,2796,3765
2000,20,Andorra,Argentina,151,80,71
2000,191,Croatia,Argentina,171,66,105
2000,300,Greece,Argentina,626,233,393
2000,380,Italy,Argentina,20245,7802,12443
2000,470,Malta,Argentina,10,7,3
2000,620,Portugal,Argentina,1032,473,559
2000,674,San Marino,Argentina,81,43,38
2000,688,Serbia,Argentina,52,17,35
2000,705,Slovenia,Argentina,163,83,80
2000,724,Spain,Argentina,79339,39327,40012
2000,40,Austria,Argentina,1054,547,507
2000,56,Belgium,Argentina,1114,515,599
2000,250,France,Argentina,10793,4696,6097
2000,276,Germany,Argentina,4732,1861,2871
2000,442,Luxembourg,Argentina,35,18,17
2000,528,Netherlands,Argentina,2020,904,1116
2000,756,Switzerland,Argentina,6009,3174,2835
2000,124,Canada,Argentina,13698,6608,7090
2000,840,United States of America,Argentina,128397,59027,69370
2005,516,Namibia,Argentina,52,19,33
2005,710,South Africa,Argentina,1310,616,694
2005,132,Cabo Verde,Argentina,7,2,5
2005,478,Mauritania,Argentina,66,40,26
2005,818,Egypt,Argentina,218,135,83
2005,196,Cyprus,Argentina,56,31,25
2005,268,Georgia,Argentina,15,8,7
2005,376,Israel,Argentina,34777,16457,18320
2005,792,Turkey,Argentina,134,66,68
2005,392,Japan,Argentina,3000,1366,1634
2005,608,Philippines,Argentina,531,324,207
2005,44,Bahamas,Argentina,56,35,21
2005,535,"Bonaire, Sint Eustatius and Saba",Argentina,45,17,28
2005,136,Cayman Islands,Argentina,12,5,7
2005,192,Cuba,Argentina,128,58,70
2005,214,Dominican Republic,Argentina,2129,1203,926
2005,332,Haiti,Argentina,398,228,170
2005,630,Puerto Rico,Argentina,1402,664,738
2005,188,Costa Rica,Argentina,734,354,380
2005,222,El Salvador,Argentina,187,112,75
2005,320,Guatemala,Argentina,416,246,170
2005,340,Honduras,Argentina,139,77,62
2005,484,Mexico,Argentina,9828,5087,4741
2005,558,Nicaragua,Argentina,235,121,114
2005,591,Panama,Argentina,1449,782,667
2005,68,Bolivia (Plurinational State of),Argentina,32418,16402,16016
2005,76,Brazil,Argentina,28410,16308,12102
2005,152,Chile,Argentina,50740,25600,25140
2005,170,Colombia,Argentina,2562,1438,1124
2005,218,Ecuador,Argentina,2643,1577,1066
2005,238,Falkland Islands (Malvinas),Argentina,55,32,23
2005,600,Paraguay,Argentina,61353,30947,30406
2005,604,Peru,Argentina,9729,4808,4921
2005,858,Uruguay,Argentina,28893,12773,16120
2005,862,Venezuela (Bolivarian Republic of),Argentina,9078,4778,4300
2005,36,Australia,Argentina,13090,6415,6675
2005,554,New Zealand,Argentina,869,422,447
2005,112,Belarus,Argentina,103,37,66
2005,100,Bulgaria,Argentina,85,40,45
2005,203,Czechia,Argentina,133,71,62
2005,348,Hungary,Argentina,275,148,127
2005,616,Poland,Argentina,229,133,96
2005,642,Romania,Argentina,6,3,3
2005,643,Russian Federation,Argentina,399,231,168
2005,703,Slovakia,Argentina,61,26,35
2005,208,Denmark,Argentina,1043,505,538
2005,246,Finland,Argentina,218,129,89
2005,352,Iceland,Argentina,20,13,7
2005,372,Ireland,Argentina,382,194,188
2005,428,Latvia,Argentina,21,9,12
2005,440,Lithuania,Argentina,74,39,35
2005,578,Norway,Argentina,627,281,346
2005,752,Sweden,Argentina,2712,1369,1343
2005,826,United Kingdom,Argentina,8001,3467,4534
2005,20,Andorra,Argentina,494,261,233
2005,191,Croatia,Argentina,185,71,114
2005,300,Greece,Argentina,641,235,406
2005,380,Italy,Argentina,46708,21085,25623
2005,470,Malta,Argentina,14,9,5
2005,620,Portugal,Argentina,1197,561,636
2005,674,San Marino,Argentina,74,40,34
2005,688,Serbia,Argentina,52,17,35
2005,705,Slovenia,Argentina,328,171,157
2005,724,Spain,Argentina,244014,125841,118173
2005,40,Austria,Argentina,1178,597,581
2005,56,Belgium,Argentina,1680,809,871
2005,250,France,Argentina,11825,5303,6522
2005,276,Germany,Argentina,10339,4736,5603
2005,438,Liechtenstein,Argentina,9,4,5
2005,442,Luxembourg,Argentina,30,17,13
2005,528,Netherlands,Argentina,2716,1175,1541
2005,756,Switzerland,Argentina,6710,3385,3325
2005,124,Canada,Argentina,15923,7697,8226
2005,840,United States of America,Argentina,152739,70675,82064
2010,516,Namibia,Argentina,50,19,31
2010,710,South Africa,Argentina,2051,961,1090
2010,132,Cabo Verde,Argentina,4,1,3
2010,478,Mauritania,Argentina,66,41,25
2010,818,Egypt,Argentina,235,142,93
2010,196,Cyprus,Argentina,91,51,40
2010,268,Georgia,Argentina,15,8,7
2010,376,Israel,Argentina,38148,18003,20145
2010,792,Turkey,Argentina,138,67,71
2010,392,Japan,Argentina,3181,1430,1751
2010,608,Philippines,Argentina,146,88,58
2010,44,Bahamas,Argentina,102,67,35
2010,535,"Bonaire, Sint Eustatius and Saba",Argentina,3,3,0
2010,136,Cayman Islands,Argentina,12,4,8
2010,192,Cuba,Argentina,71,32,39
2010,531,Curaçao,Argentina,20,7,13
2010,214,Dominican Republic,Argentina,1015,569,446
2010,332,Haiti,Argentina,417,239,178
2010,630,Puerto Rico,Argentina,1369,642,727
2010,188,Costa Rica,Argentina,1446,699,747
2010,222,El Salvador,Argentina,207,126,81
2010,320,Guatemala,Argentina,482,297,185
2010,340,Honduras,Argentina,136,77,59
2010,484,Mexico,Argentina,14171,7460,6711
2010,558,Nicaragua,Argentina,251,130,121
2010,591,Panama,Argentina,2172,1192,980
2010,68,Bolivia (Plurinational State of),Argentina,36671,18729,17942
2010,76,Brazil,Argentina,28815,16765,12050
2010,152,Chile,Argentina,55685,28401,27284
2010,170,Colombia,Argentina,2986,1709,1277
2010,218,Ecuador,Argentina,3712,2176,1536
2010,238,Falkland Islands (Malvinas),Argentina,24,12,12
2010,600,Paraguay,Argentina,58456,29425,29031
2010,604,Peru,Argentina,11961,6111,5850
2010,858,Uruguay,Argentina,26782,11706,15076
2010,862,Venezuela (Bolivarian Republic of),Argentina,9542,5012,4530
2010,36,Australia,Argentina,13730,6757,6973
2010,554,New Zealand,Argentina,1330,645,685
2010,112,Belarus,Argentina,99,36,63
2010,100,Bulgaria,Argentina,113,53,60
2010,203,Czechia,Argentina,102,61,41
2010,348,Hungary,Argentina,327,178,149
2010,616,Poland,Argentina,283,172,111
2010,642,Romania,Argentina,26,13,13
2010,643,Russian Federation,Argentina,247,153,94
2010,703,Slovakia,Argentina,68,30,38
2010,208,Denmark,Argentina,1100,541,559
2010,233,Estonia,Argentina,14,11,3
2010,246,Finland,Argentina,347,198,149
2010,352,Iceland,Argentina,26,16,10
2010,372,Ireland,Argentina,320,151,169
2010,428,Latvia,Argentina,22,11,11
2010,440,Lithuania,Argentina,67,32,35
2010,578,Norway,Argentina,811,386,425
2010,752,Sweden,Argentina,2868,1474,1394
2010,826,United Kingdom,Argentina,8428,3750,4678
2010,20,Andorra,Argentina,819,432,387
2010,191,Croatia,Argentina,199,76,123
2010,300,Greece,Argentina,681,247,434
2010,380,Italy,Argentina,78640,37217,41423
2010,470,Malta,Argentina,8,8,0
2010,620,Portugal,Argentina,1165,558,607
2010,674,San Marino,Argentina,69,36,33
2010,688,Serbia,Argentina,51,16,35
2010,705,Slovenia,Argentina,414,216,198
2010,724,Spain,Argentina,282553,145829,136724
2010,40,Austria,Argentina,1302,648,654
2010,56,Belgium,Argentina,1970,927,1043
2010,250,France,Argentina,12156,5135,7021
2010,276,Germany,Argentina,14996,7182,7814
2010,438,Liechtenstein,Argentina,19,8,11
2010,442,Luxembourg,Argentina,26,15,11
2010,528,Netherlands,Argentina,2844,1244,1600
2010,756,Switzerland,Argentina,7940,3779,4161
2010,124,Canada,Argentina,18870,9157,9713
2010,840,United States of America,Argentina,182404,83053,99351
2015,516,Namibia,Argentina,48,18,30
2015,710,South Africa,Argentina,3699,1633,2066
2015,132,Cabo Verde,Argentina,4,1,3
2015,324,Guinea,Argentina,112,65,47
2015,478,Mauritania,Argentina,66,42,24
2015,818,Egypt,Argentina,174,114,60
2015,196,Cyprus,Argentina,87,49,38
2015,268,Georgia,Argentina,15,8,7
2015,376,Israel,Argentina,39343,18465,20878
2015,792,Turkey,Argentina,140,67,73
2015,392,Japan,Argentina,2924,1304,1620
2015,608,Philippines,Argentina,148,89,59
2015,44,Bahamas,Argentina,111,73,38
2015,535,"Bonaire, Sint Eustatius and Saba",Argentina,3,3,0
2015,136,Cayman Islands,Argentina,12,5,7
2015,192,Cuba,Argentina,56,25,31
2015,531,Curaçao,Argentina,21,7,14
2015,214,Dominican Republic,Argentina,1071,600,471
2015,332,Haiti,Argentina,437,251,186
2015,630,Puerto Rico,Argentina,1180,551,629
2015,188,Costa Rica,Argentina,1468,705,763
2015,222,El Salvador,Argentina,216,132,84
2015,320,Guatemala,Argentina,554,344,210
2015,340,Honduras,Argentina,191,109,82
2015,484,Mexico,Argentina,15440,7904,7536
2015,558,Nicaragua,Argentina,270,141,129
2015,591,Panama,Argentina,2550,1397,1153
2015,68,Bolivia (Plurinational State of),Argentina,42691,21801,20890
2015,76,Brazil,Argentina,34699,20188,14511
2015,152,Chile,Argentina,56363,28148,28215
2015,170,Colombia,Argentina,3343,1928,1415
2015,218,Ecuador,Argentina,5399,3149,2250
2015,238,Falkland Islands (Malvinas),Argentina,26,13,13
2015,600,Paraguay,Argentina,57056,28685,28371
2015,604,Peru,Argentina,14386,7795,6591
2015,858,Uruguay,Argentina,27662,12086,15576
2015,862,Venezuela (Bolivarian Republic of),Argentina,9944,5158,4786
2015,36,Australia,Argentina,15510,7616,7894
2015,554,New Zealand,Argentina,1770,856,914
2015,112,Belarus,Argentina,102,35,67
2015,100,Bulgaria,Argentina,112,53,59
2015,203,Czechia,Argentina,199,116,83
2015,348,Hungary,Argentina,393,228,165
2015,616,Poland,Argentina,272,167,105
2015,642,Romania,Argentina,24,12,12
2015,643,Russian Federation,Argentina,252,155,97
2015,703,Slovakia,Argentina,83,37,46
2015,208,Denmark,Argentina,1273,643,630
2015,233,Estonia,Argentina,27,18,9
2015,246,Finland,Argentina,476,275,201
2015,352,Iceland,Argentina,46,30,16
2015,372,Ireland,Argentina,327,152,175
2015,428,Latvia,Argentina,12,4,8
2015,440,Lithuania,Argentina,53,24,29
2015,578,Norway,Argentina,1098,562,536
2015,752,Sweden,Argentina,3152,1629,1523
2015,826,United Kingdom,Argentina,10778,4619,6159
2015,20,Andorra,Argentina,682,349,333
2015,191,Croatia,Argentina,200,76,124
2015,300,Greece,Argentina,639,215,424
2015,380,Italy,Argentina,70140,32251,37889
2015,470,Malta,Argentina,14,13,1
2015,620,Portugal,Argentina,1320,598,722
2015,674,San Marino,Argentina,85,43,42
2015,688,Serbia,Argentina,49,15,34
2015,705,Slovenia,Argentina,417,212,205
2015,724,Spain,Argentina,251841,128585,123256
2015,40,Austria,Argentina,1523,762,761
2015,56,Belgium,Argentina,2261,1071,1190
2015,250,France,Argentina,13466,5473,7993
2015,276,Germany,Argentina,15626,7466,8160
2015,438,Liechtenstein,Argentina,26,10,16
2015,442,Luxembourg,Argentina,39,23,16
2015,528,Netherlands,Argentina,3170,1408,1762
2015,756,Switzerland,Argentina,8895,4189,4706
2015,124,Canada,Argentina,19310,9482,9828
2015,840,United States of America,Argentina,199314,90196,109118
2019,516,Namibia,Argentina,50,19,31
2019,710,South Africa,Argentina,4145,1833,2312
2019,132,Cabo Verde,Argentina,4,1,3
2019,324,Guinea,Argentina,106,62,44
2019,478,Mauritania,Argentina,68,44,24
2019,818,Egypt,Argentina,248,153,95
2019,196,Cyprus,Argentina,86,49,37
2019,268,Georgia,Argentina,15,8,7
2019,376,Israel,Argentina,38259,17956,20303
2019,792,Turkey,Argentina,189,92,97
2019,392,Japan,Argentina,3273,1460,1813
2019,608,Philippines,Argentina,152,92,60
2019,44,Bahamas,Argentina,117,77,40
2019,535,"Bonaire, Sint Eustatius and Saba",Argentina,3,3,0
2019,136,Cayman Islands,Argentina,13,5,8
2019,192,Cuba,Argentina,51,23,28
2019,531,Curaçao,Argentina,22,7,15
2019,214,Dominican Republic,Argentina,1106,620,486
2019,332,Haiti,Argentina,454,261,193
2019,630,Puerto Rico,Argentina,894,416,478
2019,188,Costa Rica,Argentina,1489,720,769
2019,222,El Salvador,Argentina,218,133,85
2019,320,Guatemala,Argentina,568,353,215
2019,340,Honduras,Argentina,194,111,83
2019,484,Mexico,Argentina,15918,8149,7769
2019,558,Nicaragua,Argentina,282,147,135
2019,591,Panama,Argentina,2714,1489,1225
2019,68,Bolivia (Plurinational State of),Argentina,46609,23802,22807
2019,76,Brazil,Argentina,39078,22736,16342
2019,152,Chile,Argentina,72813,33016,39797
2019,170,Colombia,Argentina,3419,1972,1447
2019,218,Ecuador,Argentina,5315,3099,2216
2019,238,Falkland Islands (Malvinas),Argentina,31,16,15
2019,600,Paraguay,Argentina,58535,29429,29106
2019,604,Peru,Argentina,17148,9711,7437
2019,858,Uruguay,Argentina,28604,12541,16063
2019,862,Venezuela (Bolivarian Republic of),Argentina,9740,5031,4709
2019,36,Australia,Argentina,17583,8541,9042
2019,554,New Zealand,Argentina,1819,880,939
2019,112,Belarus,Argentina,100,34,66
2019,100,Bulgaria,Argentina,128,65,63
2019,203,Czechia,Argentina,242,147,95
2019,348,Hungary,Argentina,402,225,177
2019,616,Poland,Argentina,288,182,106
2019,642,Romania,Argentina,120,66,54
2019,643,Russian Federation,Argentina,251,155,96
2019,703,Slovakia,Argentina,86,44,42
2019,208,Denmark,Argentina,2009,1026,983
2019,233,Estonia,Argentina,37,27,10
2019,246,Finland,Argentina,569,337,232
2019,352,Iceland,Argentina,63,43,20
2019,372,Ireland,Argentina,359,168,191
2019,428,Latvia,Argentina,15,9,6
2019,440,Lithuania,Argentina,47,24,23
2019,578,Norway,Argentina,1234,626,608
2019,752,Sweden,Argentina,3386,1781,1605
2019,826,United Kingdom,Argentina,12239,5263,6976
2019,20,Andorra,Argentina,727,375,352
2019,191,Croatia,Argentina,184,70,114
2019,300,Greece,Argentina,624,226,398
2019,380,Italy,Argentina,71880,33528,38352
2019,470,Malta,Argentina,22,21,1
2019,620,Portugal,Argentina,1342,610,732
2019,674,San Marino,Argentina,90,44,46
2019,688,Serbia,Argentina,49,15,34
2019,705,Slovenia,Argentina,405,204,201
2019,724,Spain,Argentina,259946,130599,129347
2019,40,Austria,Argentina,1797,915,882
2019,56,Belgium,Argentina,2525,1210,1315
2019,250,France,Argentina,14253,5774,8479
2019,276,Germany,Argentina,17141,8545,8596
2019,438,Liechtenstein,Argentina,25,11,14
2019,442,Luxembourg,Argentina,395,176,219
2019,528,Netherlands,Argentina,3855,1736,2119
2019,756,Switzerland,Argentina,9391,4494,4897
2019,124,Canada,Argentina,20692,10161,10531
2019,840,United States of America,Argentina,215239,96134,119105
1990,516,Namibia,Armenia,94,93,1
1990,818,Egypt,Armenia,179,64,115
1990,434,Libya,Armenia,511,184,327
1990,31,Azerbaijan,Armenia,202586,94942,107644
1990,196,Cyprus,Armenia,292,159,133
1990,268,Georgia,Armenia,4039,1827,2212
1990,400,Jordan,Armenia,26,11,15
1990,792,Turkey,Armenia,192,78,114
1990,398,Kazakhstan,Armenia,7596,4462,3134
1990,417,Kyrgyzstan,Armenia,7381,3192,4189
1990,762,Tajikistan,Armenia,257,114,143
1990,795,Turkmenistan,Armenia,11254,5126,6128
1990,860,Uzbekistan,Armenia,9213,4532,4681
1990,364,Iran (Islamic Republic of),Armenia,521,298,223
1990,608,Philippines,Armenia,31,17,14
1990,188,Costa Rica,Armenia,6,4,2
1990,484,Mexico,Armenia,60,33,27
1990,32,Argentina,Armenia,1236,597,639
1990,152,Chile,Armenia,21,11,10
1990,218,Ecuador,Armenia,13,7,6
1990,862,Venezuela (Bolivarian Republic of),Armenia,30,16,14
1990,36,Australia,Armenia,388,180,208
1990,112,Belarus,Armenia,6645,3957,2688
1990,100,Bulgaria,Armenia,1207,605,602
1990,203,Czechia,Armenia,227,136,91
1990,348,Hungary,Armenia,186,86,100
1990,616,Poland,Armenia,1181,696,485
1990,642,Romania,Armenia,1,1,0
1990,643,Russian Federation,Armenia,535266,262661,272605
1990,703,Slovakia,Armenia,37,19,18
1990,804,Ukraine,Armenia,35141,15058,20083
1990,208,Denmark,Armenia,400,212,188
1990,233,Estonia,Armenia,715,475,240
1990,352,Iceland,Armenia,2,1,1
1990,372,Ireland,Armenia,10,5,5
1990,428,Latvia,Armenia,1552,921,631
1990,440,Lithuania,Armenia,815,562,253
1990,578,Norway,Armenia,4,4,0
1990,752,Sweden,Armenia,267,128,139
1990,826,United Kingdom,Armenia,81,48,33
1990,300,Greece,Armenia,12148,6728,5420
1990,380,Italy,Armenia,25,8,17
1990,470,Malta,Armenia,11,6,5
1990,620,Portugal,Armenia,16,9,7
1990,688,Serbia,Armenia,19,5,14
1990,724,Spain,Armenia,282,148,134
1990,40,Austria,Armenia,1681,853,828
1990,56,Belgium,Armenia,7,4,3
1990,250,France,Armenia,6547,2990,3557
1990,276,Germany,Armenia,5581,3229,2352
1990,528,Netherlands,Armenia,43,23,20
1990,756,Switzerland,Armenia,374,192,182
1990,124,Canada,Armenia,1771,863,908
1990,840,United States of America,Armenia,41481,20290,21191
1995,516,Namibia,Armenia,89,89,0
1995,818,Egypt,Armenia,143,52,91
1995,434,Libya,Armenia,346,140,206
1995,31,Azerbaijan,Armenia,205368,89233,116135
1995,196,Cyprus,Armenia,413,217,196
1995,268,Georgia,Armenia,3297,1596,1701
1995,400,Jordan,Armenia,29,10,19
1995,792,Turkey,Armenia,465,178,287
1995,398,Kazakhstan,Armenia,7156,4123,3033
1995,417,Kyrgyzstan,Armenia,5997,2798,3199
1995,762,Tajikistan,Armenia,221,87,134
1995,795,Turkmenistan,Armenia,9193,4638,4555
1995,860,Uzbekistan,Armenia,8402,4078,4324
1995,364,Iran (Islamic Republic of),Armenia,573,328,245
1995,608,Philippines,Armenia,41,22,19
1995,188,Costa Rica,Armenia,4,2,2
1995,484,Mexico,Armenia,66,35,31
1995,32,Argentina,Armenia,1207,590,617
1995,68,Bolivia (Plurinational State of),Armenia,1,0,1
1995,152,Chile,Armenia,15,7,8
1995,218,Ecuador,Armenia,15,8,7
1995,862,Venezuela (Bolivarian Republic of),Armenia,29,16,13
1995,36,Australia,Armenia,710,340,370
1995,112,Belarus,Armenia,6295,3761,2534
1995,100,Bulgaria,Armenia,1179,579,600
1995,203,Czechia,Armenia,340,208,132
1995,348,Hungary,Armenia,165,75,90
1995,616,Poland,Armenia,1010,590,420
1995,642,Romania,Armenia,1,1,0
1995,643,Russian Federation,Armenia,516425,275248,241177
1995,703,Slovakia,Armenia,57,29,28
1995,804,Ukraine,Armenia,44340,23012,21328
1995,208,Denmark,Armenia,430,229,201
1995,233,Estonia,Armenia,655,419,236
1995,246,Finland,Armenia,10,5,5
1995,352,Iceland,Armenia,2,0,2
1995,372,Ireland,Armenia,28,14,14
1995,428,Latvia,Armenia,1312,795,517
1995,440,Lithuania,Armenia,870,601,269
1995,578,Norway,Armenia,15,8,7
1995,752,Sweden,Armenia,317,151,166
1995,826,United Kingdom,Armenia,323,155,168
1995,300,Greece,Armenia,10438,5495,4943
1995,380,Italy,Armenia,152,56,96
1995,470,Malta,Armenia,13,7,6
1995,620,Portugal,Armenia,34,19,15
1995,688,Serbia,Armenia,122,28,94
1995,724,Spain,Armenia,657,351,306
1995,40,Austria,Armenia,1896,977,919
1995,56,Belgium,Armenia,6,3,3
1995,250,France,Armenia,6759,3025,3734
1995,276,Germany,Armenia,7892,4170,3722
1995,528,Netherlands,Armenia,62,32,30
1995,756,Switzerland,Armenia,415,206,209
1995,124,Canada,Armenia,1778,862,916
1995,840,United States of America,Armenia,54094,26738,27356
2000,516,Namibia,Armenia,84,82,2
2000,818,Egypt,Armenia,118,44,74
2000,434,Libya,Armenia,188,104,84
2000,31,Azerbaijan,Armenia,188400,81860,106540
2000,196,Cyprus,Armenia,534,276,258
2000,268,Georgia,Armenia,12268,6721,5547
2000,400,Jordan,Armenia,32,10,22
2000,792,Turkey,Armenia,740,277,463
2000,398,Kazakhstan,Armenia,6716,3784,2932
2000,417,Kyrgyzstan,Armenia,4449,2319,2130
2000,762,Tajikistan,Armenia,207,82,125
2000,795,Turkmenistan,Armenia,7452,3648,3804
2000,860,Uzbekistan,Armenia,7498,3594,3904
2000,364,Iran (Islamic Republic of),Armenia,599,355,244
2000,608,Philippines,Armenia,141,72,69
2000,188,Costa Rica,Armenia,5,3,2
2000,484,Mexico,Armenia,75,38,37
2000,32,Argentina,Armenia,1178,583,595
2000,68,Bolivia (Plurinational State of),Armenia,1,0,1
2000,152,Chile,Armenia,10,4,6
2000,218,Ecuador,Armenia,16,8,8
2000,862,Venezuela (Bolivarian Republic of),Armenia,29,16,13
2000,36,Australia,Armenia,980,465,515
2000,112,Belarus,Armenia,5944,3564,2380
2000,100,Bulgaria,Armenia,1150,553,597
2000,203,Czechia,Armenia,453,280,173
2000,348,Hungary,Armenia,144,64,80
2000,616,Poland,Armenia,864,499,365
2000,642,Romania,Armenia,1,1,0
2000,643,Russian Federation,Armenia,478856,277944,200912
2000,703,Slovakia,Armenia,94,47,47
2000,804,Ukraine,Armenia,54082,31247,22835
2000,208,Denmark,Armenia,459,245,214
2000,233,Estonia,Armenia,595,364,231
2000,246,Finland,Armenia,19,9,10
2000,352,Iceland,Armenia,2,0,2
2000,372,Ireland,Armenia,62,32,30
2000,428,Latvia,Armenia,1073,669,404
2000,440,Lithuania,Armenia,681,470,211
2000,578,Norway,Armenia,33,16,17
2000,752,Sweden,Armenia,341,161,180
2000,826,United Kingdom,Armenia,572,265,307
2000,300,Greece,Armenia,8899,4263,4636
2000,380,Italy,Armenia,279,104,175
2000,470,Malta,Armenia,15,8,7
2000,620,Portugal,Armenia,54,30,24
2000,688,Serbia,Armenia,167,36,131
2000,724,Spain,Armenia,1315,712,603
2000,40,Austria,Armenia,2111,1101,1010
2000,56,Belgium,Armenia,4,2,2
2000,250,France,Armenia,6970,3060,3910
2000,276,Germany,Armenia,10202,5111,5091
2000,528,Netherlands,Armenia,85,41,44
2000,756,Switzerland,Armenia,459,221,238
2000,124,Canada,Armenia,1828,882,946
2000,840,United States of America,Armenia,66937,33343,33594
2005,516,Namibia,Armenia,66,65,1
2005,818,Egypt,Armenia,140,57,83
2005,434,Libya,Armenia,207,132,75
2005,31,Azerbaijan,Armenia,170050,81293,88757
2005,196,Cyprus,Armenia,782,402,380
2005,268,Georgia,Armenia,11654,6385,5269
2005,400,Jordan,Armenia,46,18,28
2005,792,Turkey,Armenia,762,275,487
2005,398,Kazakhstan,Armenia,7657,4403,3254
2005,417,Kyrgyzstan,Armenia,3603,1870,1733
2005,762,Tajikistan,Armenia,199,77,122
2005,795,Turkmenistan,Armenia,7391,3657,3734
2005,860,Uzbekistan,Armenia,7039,3479,3560
2005,364,Iran (Islamic Republic of),Armenia,718,426,292
2005,608,Philippines,Armenia,114,60,54
2005,188,Costa Rica,Armenia,3,2,1
2005,484,Mexico,Armenia,80,41,39
2005,32,Argentina,Armenia,869,437,432
2005,68,Bolivia (Plurinational State of),Armenia,3,1,2
2005,76,Brazil,Armenia,26,22,4
2005,152,Chile,Armenia,15,7,8
2005,218,Ecuador,Armenia,19,10,9
2005,862,Venezuela (Bolivarian Republic of),Armenia,30,17,13
2005,36,Australia,Armenia,1110,528,582
2005,112,Belarus,Armenia,5862,3514,2348
2005,100,Bulgaria,Armenia,1308,639,669
2005,203,Czechia,Armenia,1305,723,582
2005,348,Hungary,Armenia,178,81,97
2005,616,Poland,Armenia,1499,909,590
2005,642,Romania,Armenia,1,1,0
2005,643,Russian Federation,Armenia,503316,287600,215716
2005,703,Slovakia,Armenia,306,154,152
2005,804,Ukraine,Armenia,49416,28580,20836
2005,208,Denmark,Armenia,544,268,276
2005,233,Estonia,Armenia,645,389,256
2005,246,Finland,Armenia,47,18,29
2005,352,Iceland,Armenia,4,1,3
2005,372,Ireland,Armenia,62,34,28
2005,428,Latvia,Armenia,1010,632,378
2005,440,Lithuania,Armenia,729,501,228
2005,578,Norway,Armenia,157,75,82
2005,752,Sweden,Armenia,796,365,431
2005,826,United Kingdom,Armenia,1040,473,567
2005,300,Greece,Armenia,11750,5349,6401
2005,380,Italy,Armenia,768,287,481
2005,470,Malta,Armenia,20,10,10
2005,620,Portugal,Armenia,77,47,30
2005,688,Serbia,Armenia,165,34,131
2005,724,Spain,Armenia,7216,4075,3141
2005,40,Austria,Armenia,2360,1204,1156
2005,56,Belgium,Armenia,333,160,173
2005,250,France,Armenia,12278,5667,6611
2005,276,Germany,Armenia,10221,5016,5205
2005,528,Netherlands,Armenia,373,186,187
2005,756,Switzerland,Armenia,539,245,294
2005,124,Canada,Armenia,2590,1191,1399
2005,840,United States of America,Armenia,68588,34357,34231
2010,516,Namibia,Armenia,63,63,0
2010,818,Egypt,Armenia,151,58,93
2010,434,Libya,Armenia,227,145,82
2010,31,Azerbaijan,Armenia,155685,77374,78311
2010,196,Cyprus,Armenia,1280,666,614
2010,268,Georgia,Armenia,11770,6449,5321
2010,400,Jordan,Armenia,59,25,34
2010,792,Turkey,Armenia,785,272,513
2010,398,Kazakhstan,Armenia,8597,5021,3576
2010,417,Kyrgyzstan,Armenia,2702,1387,1315
2010,762,Tajikistan,Armenia,198,77,121
2010,795,Turkmenistan,Armenia,7172,3410,3762
2010,860,Uzbekistan,Armenia,6291,3225,3066
2010,364,Iran (Islamic Republic of),Armenia,2504,1533,971
2010,608,Philippines,Armenia,133,66,67
2010,188,Costa Rica,Armenia,7,4,3
2010,484,Mexico,Armenia,96,49,47
2010,32,Argentina,Armenia,559,291,268
2010,68,Bolivia (Plurinational State of),Armenia,4,2,2
2010,76,Brazil,Armenia,52,43,9
2010,152,Chile,Armenia,20,9,11
2010,218,Ecuador,Armenia,26,13,13
2010,862,Venezuela (Bolivarian Republic of),Armenia,32,17,15
2010,36,Australia,Armenia,1200,552,648
2010,112,Belarus,Armenia,5779,3464,2315
2010,100,Bulgaria,Armenia,1410,696,714
2010,203,Czechia,Armenia,2031,1120,911
2010,348,Hungary,Armenia,212,98,114
2010,616,Poland,Armenia,2183,1344,839
2010,642,Romania,Armenia,11,5,6
2010,643,Russian Federation,Armenia,517417,291468,225949
2010,703,Slovakia,Armenia,118,60,58
2010,804,Ukraine,Armenia,47150,27297,19853
2010,208,Denmark,Armenia,616,286,330
2010,233,Estonia,Armenia,690,410,280
2010,246,Finland,Armenia,89,31,58
2010,352,Iceland,Armenia,5,1,4
2010,372,Ireland,Armenia,52,27,25
2010,428,Latvia,Armenia,922,574,348
2010,440,Lithuania,Armenia,678,451,227
2010,578,Norway,Armenia,196,95,101
2010,752,Sweden,Armenia,1672,822,850
2010,826,United Kingdom,Armenia,1095,510,585
2010,300,Greece,Armenia,15191,6698,8493
2010,380,Italy,Armenia,1107,411,696
2010,470,Malta,Armenia,22,9,13
2010,620,Portugal,Armenia,89,58,31
2010,688,Serbia,Armenia,162,33,129
2010,705,Slovenia,Armenia,7,3,4
2010,724,Spain,Armenia,10246,5460,4786
2010,40,Austria,Armenia,2609,1307,1302
2010,56,Belgium,Armenia,846,460,386
2010,250,France,Armenia,17920,7642,10278
2010,276,Germany,Armenia,10201,4901,5300
2010,528,Netherlands,Armenia,521,268,253
2010,756,Switzerland,Armenia,607,257,350
2010,124,Canada,Armenia,3495,1569,1926
2010,840,United States of America,Armenia,72388,35763,36625
2015,516,Namibia,Armenia,61,61,0
2015,324,Guinea,Armenia,9,9,0
2015,818,Egypt,Armenia,111,51,60
2015,434,Libya,Armenia,255,162,93
2015,31,Azerbaijan,Armenia,148503,75416,73087
2015,196,Cyprus,Armenia,1229,643,586
2015,268,Georgia,Armenia,12358,6771,5587
2015,400,Jordan,Armenia,25,7,18
2015,792,Turkey,Armenia,796,264,532
2015,398,Kazakhstan,Armenia,9144,5403,3741
2015,417,Kyrgyzstan,Armenia,2380,1215,1165
2015,762,Tajikistan,Armenia,194,75,119
2015,795,Turkmenistan,Armenia,7113,3439,3674
2015,860,Uzbekistan,Armenia,5870,3064,2806
2015,364,Iran (Islamic Republic of),Armenia,2479,1508,971
2015,608,Philippines,Armenia,135,67,68
2015,188,Costa Rica,Armenia,7,4,3
2015,484,Mexico,Armenia,101,51,50
2015,32,Argentina,Armenia,561,292,269
2015,68,Bolivia (Plurinational State of),Armenia,5,3,2
2015,76,Brazil,Armenia,63,52,11
2015,152,Chile,Armenia,30,14,16
2015,218,Ecuador,Armenia,37,18,19
2015,862,Venezuela (Bolivarian Republic of),Armenia,34,18,16
2015,36,Australia,Armenia,1460,638,822
2015,112,Belarus,Armenia,5728,3434,2294
2015,100,Bulgaria,Armenia,1565,709,856
2015,203,Czechia,Armenia,1865,1018,847
2015,348,Hungary,Armenia,184,87,97
2015,616,Poland,Armenia,2104,1311,793
2015,642,Romania,Armenia,32,17,15
2015,643,Russian Federation,Armenia,527287,295875,231412
2015,703,Slovakia,Armenia,148,80,68
2015,804,Ukraine,Armenia,47307,27416,19891
2015,208,Denmark,Armenia,712,332,380
2015,233,Estonia,Armenia,687,399,288
2015,246,Finland,Armenia,114,46,68
2015,352,Iceland,Armenia,8,3,5
2015,372,Ireland,Armenia,53,27,26
2015,428,Latvia,Armenia,693,425,268
2015,440,Lithuania,Armenia,579,383,196
2015,578,Norway,Armenia,304,129,175
2015,752,Sweden,Armenia,2674,1276,1398
2015,826,United Kingdom,Armenia,1400,630,770
2015,300,Greece,Armenia,14257,5946,8311
2015,380,Italy,Armenia,1359,500,859
2015,470,Malta,Armenia,38,17,21
2015,620,Portugal,Armenia,100,63,37
2015,688,Serbia,Armenia,158,32,126
2015,705,Slovenia,Armenia,13,4,9
2015,724,Spain,Armenia,9516,4678,4838
2015,40,Austria,Armenia,3051,1537,1514
2015,56,Belgium,Armenia,1413,769,644
2015,250,France,Armenia,19851,8152,11699
2015,276,Germany,Armenia,10629,5093,5536
2015,528,Netherlands,Armenia,850,449,401
2015,756,Switzerland,Armenia,986,408,578
2015,124,Canada,Armenia,4139,1977,2162
2015,840,United States of America,Armenia,94229,46311,47918
2019,516,Namibia,Armenia,64,64,0
2019,324,Guinea,Armenia,8,8,0
2019,818,Egypt,Armenia,158,63,95
2019,434,Libya,Armenia,270,172,98
2019,31,Azerbaijan,Armenia,142650,72444,70206
2019,196,Cyprus,Armenia,1228,649,579
2019,268,Georgia,Armenia,12736,6976,5760
2019,400,Jordan,Armenia,26,7,19
2019,792,Turkey,Armenia,1076,364,712
2019,398,Kazakhstan,Armenia,9555,5646,3909
2019,417,Kyrgyzstan,Armenia,2331,1190,1141
2019,762,Tajikistan,Armenia,193,75,118
2019,795,Turkmenistan,Armenia,7067,3462,3605
2019,860,Uzbekistan,Armenia,5857,3060,2797
2019,364,Iran (Islamic Republic of),Armenia,2438,1483,955
2019,608,Philippines,Armenia,139,69,70
2019,188,Costa Rica,Armenia,7,4,3
2019,484,Mexico,Armenia,104,53,51
2019,32,Argentina,Armenia,570,296,274
2019,68,Bolivia (Plurinational State of),Armenia,5,3,2
2019,76,Brazil,Armenia,70,58,12
2019,152,Chile,Armenia,40,18,22
2019,218,Ecuador,Armenia,36,18,18
2019,862,Venezuela (Bolivarian Republic of),Armenia,33,18,15
2019,36,Australia,Armenia,1629,736,893
2019,112,Belarus,Armenia,5656,3391,2265
2019,100,Bulgaria,Armenia,1840,835,1005
2019,203,Czechia,Armenia,1954,1048,906
2019,348,Hungary,Armenia,194,91,103
2019,616,Poland,Armenia,2228,1421,807
2019,642,Romania,Armenia,95,44,51
2019,643,Russian Federation,Armenia,527163,295806,231357
2019,703,Slovakia,Armenia,161,86,75
2019,804,Ukraine,Armenia,47780,27691,20089
2019,208,Denmark,Armenia,782,345,437
2019,233,Estonia,Armenia,693,395,298
2019,246,Finland,Armenia,145,63,82
2019,352,Iceland,Armenia,10,5,5
2019,372,Ireland,Armenia,58,30,28
2019,428,Latvia,Armenia,667,400,267
2019,440,Lithuania,Armenia,404,255,149
2019,578,Norway,Armenia,347,153,194
2019,752,Sweden,Armenia,3348,1575,1773
2019,826,United Kingdom,Armenia,1589,717,872
2019,300,Greece,Armenia,13923,6114,7809
2019,380,Italy,Armenia,1630,604,1026
2019,470,Malta,Armenia,61,28,33
2019,620,Portugal,Armenia,101,64,37
2019,688,Serbia,Armenia,160,33,127
2019,705,Slovenia,Armenia,18,7,11
2019,724,Spain,Armenia,9860,4728,5132
2019,40,Austria,Armenia,3601,1845,1756
2019,56,Belgium,Armenia,1607,854,753
2019,250,France,Armenia,21012,8601,12411
2019,276,Germany,Armenia,21263,10617,10646
2019,528,Netherlands,Armenia,925,479,446
2019,756,Switzerland,Armenia,1107,468,639
2019,124,Canada,Armenia,4435,2119,2316
2019,840,United States of America,Armenia,101757,49454,52303
1990,608,Philippines,Aruba,9,6,3
1990,28,Antigua and Barbuda,Aruba,7,3,4
1990,535,"Bonaire, Sint Eustatius and Saba",Aruba,4376,1961,2415
1990,212,Dominica,Aruba,17,6,11
1990,214,Dominican Republic,Aruba,330,172,158
1990,662,Saint Lucia,Aruba,8,3,5
1990,850,United States Virgin Islands,Aruba,417,197,220
1990,188,Costa Rica,Aruba,29,20,9
1990,32,Argentina,Aruba,1,0,1
1990,152,Chile,Aruba,50,24,26
1990,170,Colombia,Aruba,283,151,132
1990,862,Venezuela (Bolivarian Republic of),Aruba,430,179,251
1990,36,Australia,Aruba,26,16,10
1990,100,Bulgaria,Aruba,1,1,0
1990,208,Denmark,Aruba,5,4,1
1990,372,Ireland,Aruba,1,0,1
1990,428,Latvia,Aruba,1,1,0
1990,826,United Kingdom,Aruba,111,63,48
1990,300,Greece,Aruba,41,23,18
1990,250,France,Aruba,10,5,5
1990,528,Netherlands,Aruba,557,302,255
1990,124,Canada,Aruba,523,254,269
1990,840,United States of America,Aruba,3363,1351,2012
1995,608,Philippines,Aruba,12,8,4
1995,28,Antigua and Barbuda,Aruba,6,3,3
1995,535,"Bonaire, Sint Eustatius and Saba",Aruba,3739,1637,2102
1995,212,Dominica,Aruba,22,7,15
1995,214,Dominican Republic,Aruba,367,187,180
1995,662,Saint Lucia,Aruba,10,4,6
1995,850,United States Virgin Islands,Aruba,468,221,247
1995,188,Costa Rica,Aruba,22,15,7
1995,32,Argentina,Aruba,1,0,1
1995,68,Bolivia (Plurinational State of),Aruba,2,0,2
1995,152,Chile,Aruba,27,14,13
1995,170,Colombia,Aruba,276,148,128
1995,862,Venezuela (Bolivarian Republic of),Aruba,424,177,247
1995,36,Australia,Aruba,28,18,10
1995,100,Bulgaria,Aruba,2,2,0
1995,208,Denmark,Aruba,3,2,1
1995,372,Ireland,Aruba,4,2,2
1995,428,Latvia,Aruba,1,1,0
1995,826,United Kingdom,Aruba,437,194,243
1995,300,Greece,Aruba,66,37,29
1995,250,France,Aruba,10,4,6
1995,528,Netherlands,Aruba,630,336,294
1995,124,Canada,Aruba,555,269,286
1995,840,United States of America,Aruba,3635,1479,2156
2000,608,Philippines,Aruba,67,38,29
2000,28,Antigua and Barbuda,Aruba,4,2,2
2000,535,"Bonaire, Sint Eustatius and Saba",Aruba,3103,1314,1789
2000,212,Dominica,Aruba,26,8,18
2000,214,Dominican Republic,Aruba,403,202,201
2000,662,Saint Lucia,Aruba,14,5,9
2000,850,United States Virgin Islands,Aruba,520,245,275
2000,188,Costa Rica,Aruba,25,17,8
2000,32,Argentina,Aruba,1,0,1
2000,68,Bolivia (Plurinational State of),Aruba,4,0,4
2000,152,Chile,Aruba,4,2,2
2000,170,Colombia,Aruba,268,144,124
2000,862,Venezuela (Bolivarian Republic of),Aruba,415,173,242
2000,36,Australia,Aruba,60,30,30
2000,100,Bulgaria,Aruba,3,3,0
2000,372,Ireland,Aruba,8,4,4
2000,428,Latvia,Aruba,1,1,0
2000,826,United Kingdom,Aruba,772,328,444
2000,300,Greece,Aruba,92,50,42
2000,250,France,Aruba,10,4,6
2000,528,Netherlands,Aruba,727,382,345
2000,124,Canada,Aruba,600,290,310
2000,840,United States of America,Aruba,3910,1613,2297
2005,608,Philippines,Aruba,54,31,23
2005,28,Antigua and Barbuda,Aruba,5,3,2
2005,535,"Bonaire, Sint Eustatius and Saba",Aruba,3306,1399,1907
2005,212,Dominica,Aruba,32,11,21
2005,214,Dominican Republic,Aruba,278,148,130
2005,662,Saint Lucia,Aruba,23,8,15
2005,534,Sint Maarten (Dutch part),Aruba,617,271,346
2005,850,United States Virgin Islands,Aruba,510,242,268
2005,188,Costa Rica,Aruba,16,11,5
2005,32,Argentina,Aruba,1,0,1
2005,68,Bolivia (Plurinational State of),Aruba,3,0,3
2005,152,Chile,Aruba,6,4,2
2005,170,Colombia,Aruba,255,138,117
2005,862,Venezuela (Bolivarian Republic of),Aruba,436,182,254
2005,36,Australia,Aruba,50,25,25
2005,100,Bulgaria,Aruba,4,3,1
2005,208,Denmark,Aruba,3,2,1
2005,352,Iceland,Aruba,1,1,0
2005,372,Ireland,Aruba,8,4,4
2005,826,United Kingdom,Aruba,660,287,373
2005,300,Greece,Aruba,47,26,21
2005,250,France,Aruba,67,26,41
2005,528,Netherlands,Aruba,1424,739,685
2005,124,Canada,Aruba,577,273,304
2005,840,United States of America,Aruba,4673,1943,2730
2010,608,Philippines,Aruba,62,34,28
2010,28,Antigua and Barbuda,Aruba,5,3,2
2010,535,"Bonaire, Sint Eustatius and Saba",Aruba,664,307,357
2010,531,Curaçao,Aruba,1572,581,991
2010,212,Dominica,Aruba,40,14,26
2010,214,Dominican Republic,Aruba,152,93,59
2010,662,Saint Lucia,Aruba,31,11,20
2010,534,Sint Maarten (Dutch part),Aruba,1234,541,693
2010,850,United States Virgin Islands,Aruba,501,239,262
2010,188,Costa Rica,Aruba,32,21,11
2010,32,Argentina,Aruba,1,0,1
2010,68,Bolivia (Plurinational State of),Aruba,2,1,1
2010,152,Chile,Aruba,8,5,3
2010,170,Colombia,Aruba,287,158,129
2010,862,Venezuela (Bolivarian Republic of),Aruba,463,193,270
2010,36,Australia,Aruba,60,30,30
2010,100,Bulgaria,Aruba,5,4,1
2010,208,Denmark,Aruba,4,4,0
2010,352,Iceland,Aruba,1,1,0
2010,372,Ireland,Aruba,7,3,4
2010,826,United Kingdom,Aruba,695,311,384
2010,300,Greece,Aruba,1,1,0
2010,250,France,Aruba,10,4,6
2010,528,Netherlands,Aruba,2509,1255,1254
2010,124,Canada,Aruba,535,248,287
2010,840,United States of America,Aruba,5598,2283,3315
2015,608,Philippines,Aruba,63,35,28
2015,28,Antigua and Barbuda,Aruba,5,3,2
2015,535,"Bonaire, Sint Eustatius and Saba",Aruba,755,349,406
2015,531,Curaçao,Aruba,1708,633,1075
2015,212,Dominica,Aruba,47,17,30
2015,214,Dominican Republic,Aruba,160,98,62
2015,662,Saint Lucia,Aruba,29,11,18
2015,534,Sint Maarten (Dutch part),Aruba,1286,563,723
2015,850,United States Virgin Islands,Aruba,501,239,262
2015,188,Costa Rica,Aruba,32,21,11
2015,32,Argentina,Aruba,1,0,1
2015,68,Bolivia (Plurinational State of),Aruba,2,1,1
2015,152,Chile,Aruba,12,8,4
2015,170,Colombia,Aruba,321,178,143
2015,862,Venezuela (Bolivarian Republic of),Aruba,486,200,286
2015,36,Australia,Aruba,70,40,30
2015,100,Bulgaria,Aruba,5,4,1
2015,208,Denmark,Aruba,6,5,1
2015,352,Iceland,Aruba,1,1,0
2015,372,Ireland,Aruba,7,3,4
2015,428,Latvia,Aruba,1,1,0
2015,826,United Kingdom,Aruba,888,383,505
2015,250,France,Aruba,11,4,7
2015,528,Netherlands,Aruba,3994,2037,1957
2015,124,Canada,Aruba,571,223,348
2015,840,United States of America,Aruba,6591,2669,3922
2019,608,Philippines,Aruba,64,36,28
2019,28,Antigua and Barbuda,Aruba,5,3,2
2019,535,"Bonaire, Sint Eustatius and Saba",Aruba,899,416,483
2019,531,Curaçao,Aruba,1856,688,1168
2019,212,Dominica,Aruba,47,17,30
2019,214,Dominican Republic,Aruba,165,101,64
2019,662,Saint Lucia,Aruba,28,11,17
2019,534,Sint Maarten (Dutch part),Aruba,1331,583,748
2019,850,United States Virgin Islands,Aruba,501,239,262
2019,188,Costa Rica,Aruba,32,21,11
2019,32,Argentina,Aruba,1,0,1
2019,68,Bolivia (Plurinational State of),Aruba,2,1,1
2019,152,Chile,Aruba,16,11,5
2019,170,Colombia,Aruba,328,182,146
2019,862,Venezuela (Bolivarian Republic of),Aruba,476,195,281
2019,36,Australia,Aruba,74,38,36
2019,100,Bulgaria,Aruba,4,3,1
2019,352,Iceland,Aruba,1,1,0
2019,372,Ireland,Aruba,7,3,4
2019,826,United Kingdom,Aruba,1008,436,572
2019,250,France,Aruba,11,4,7
2019,528,Netherlands,Aruba,5058,2588,2470
2019,124,Canada,Aruba,611,239,372
2019,840,United States of America,Aruba,7117,2838,4279
1990,690,Seychelles,Australia,67,30,37
1990,894,Zambia,Australia,81,39,42
1990,140,Central African Republic,Australia,9,9,0
1990,72,Botswana,Australia,120,61,59
1990,748,Eswatini,Australia,8,8,0
1990,516,Namibia,Australia,793,304,489
1990,710,South Africa,Australia,4199,1728,2471
1990,288,Ghana,Australia,17,5,12
1990,818,Egypt,Australia,525,282,243
1990,434,Libya,Australia,1499,809,690
1990,196,Cyprus,Australia,741,378,363
1990,376,Israel,Australia,2102,970,1132
1990,400,Jordan,Australia,188,86,102
1990,792,Turkey,Australia,2910,1404,1506
1990,64,Bhutan,Australia,12,10,2
1990,356,India,Australia,3116,1344,1772
1990,462,Maldives,Australia,37,20,17
1990,144,Sri Lanka,Australia,51,32,19
1990,156,China,Australia,2417,1426,991
1990,344,"China, Hong Kong SAR",Australia,6092,3509,2583
1990,408,Dem. People's Republic of Korea,Australia,96,53,43
1990,392,Japan,Australia,3976,2026,1950
1990,496,Mongolia,Australia,3,2,1
1990,410,Republic of Korea,Australia,315,178,137
1990,96,Brunei Darussalam,Australia,262,140,122
1990,116,Cambodia,Australia,54,34,20
1990,360,Indonesia,Australia,5963,3492,2471
1990,418,Lao People's Democratic Republic,Australia,18,10,8
1990,458,Malaysia,Australia,1851,906,945
1990,608,Philippines,Australia,943,597,346
1990,702,Singapore,Australia,2913,1614,1299
1990,764,Thailand,Australia,593,409,184
1990,626,Timor-Leste,Australia,425,201,224
1990,704,Viet Nam,Australia,16,8,8
1990,28,Antigua and Barbuda,Australia,7,3,4
1990,44,Bahamas,Australia,27,14,13
1990,52,Barbados,Australia,24,12,12
1990,92,British Virgin Islands,Australia,12,3,9
1990,136,Cayman Islands,Australia,23,14,9
1990,212,Dominica,Australia,3,1,2
1990,214,Dominican Republic,Australia,67,47,20
1990,662,Saint Lucia,Australia,7,2,5
1990,188,Costa Rica,Australia,73,31,42
1990,222,El Salvador,Australia,33,13,20
1990,320,Guatemala,Australia,47,19,28
1990,484,Mexico,Australia,116,12,104
1990,591,Panama,Australia,115,67,48
1990,32,Argentina,Australia,625,272,353
1990,68,Bolivia (Plurinational State of),Australia,74,33,41
1990,76,Brazil,Australia,297,212,85
1990,152,Chile,Australia,675,349,326
1990,170,Colombia,Australia,202,91,111
1990,218,Ecuador,Australia,125,69,56
1990,238,Falkland Islands (Malvinas),Australia,7,5,2
1990,604,Peru,Australia,366,206,160
1990,862,Venezuela (Bolivarian Republic of),Australia,131,68,63
1990,554,New Zealand,Australia,47778,22335,25443
1990,242,Fiji,Australia,1306,687,619
1990,540,New Caledonia,Australia,226,102,124
1990,598,Papua New Guinea,Australia,13916,8115,5801
1990,90,Solomon Islands,Australia,360,204,156
1990,548,Vanuatu,Australia,442,262,180
1990,296,Kiribati,Australia,64,40,24
1990,520,Nauru,Australia,202,118,84
1990,184,Cook Islands,Australia,115,71,44
1990,258,French Polynesia,Australia,63,31,32
1990,570,Niue,Australia,11,8,3
1990,882,Samoa,Australia,236,135,101
1990,772,Tokelau,Australia,7,3,4
1990,112,Belarus,Australia,21,12,9
1990,100,Bulgaria,Australia,13,9,4
1990,203,Czechia,Australia,56,32,24
1990,348,Hungary,Australia,832,419,413
1990,616,Poland,Australia,863,459,404
1990,642,Romania,Australia,17,10,7
1990,643,Russian Federation,Australia,761,373,388
1990,703,Slovakia,Australia,18,8,10
1990,208,Denmark,Australia,981,458,523
1990,246,Finland,Australia,452,233,219
1990,352,Iceland,Australia,60,23,37
1990,372,Ireland,Australia,532,262,270
1990,833,Isle of Man,Australia,123,57,66
1990,428,Latvia,Australia,45,26,19
1990,440,Lithuania,Australia,22,13,9
1990,578,Norway,Australia,797,355,442
1990,752,Sweden,Australia,1760,1065,695
1990,826,United Kingdom,Australia,72426,32613,39813
1990,20,Andorra,Australia,36,19,17
1990,191,Croatia,Australia,694,266,428
1990,300,Greece,Australia,19643,10494,9149
1990,380,Italy,Australia,8059,2555,5504
1990,470,Malta,Australia,3435,1618,1817
1990,620,Portugal,Australia,348,158,190
1990,688,Serbia,Australia,82,46,36
1990,705,Slovenia,Australia,226,103,123
1990,724,Spain,Australia,2358,1107,1251
1990,40,Austria,Australia,1371,685,686
1990,56,Belgium,Australia,681,361,320
1990,250,France,Australia,3931,1750,2181
1990,276,Germany,Australia,6205,3105,3100
1990,442,Luxembourg,Australia,74,35,39
1990,528,Netherlands,Australia,7853,3935,3918
1990,756,Switzerland,Australia,3033,1468,1565
1990,60,Bermuda,Australia,37,19,18
1990,124,Canada,Australia,13390,6518,6872
1990,840,United States of America,Australia,42267,14292,27975
1995,690,Seychelles,Australia,59,31,28
1995,894,Zambia,Australia,81,39,42
1995,140,Central African Republic,Australia,13,9,4
1995,72,Botswana,Australia,111,55,56
1995,748,Eswatini,Australia,6,5,1
1995,516,Namibia,Australia,758,294,464
1995,710,South Africa,Australia,3145,1381,1764
1995,288,Ghana,Australia,17,6,11
1995,818,Egypt,Australia,418,224,194
1995,434,Libya,Australia,1016,569,447
1995,196,Cyprus,Australia,1048,514,534
1995,376,Israel,Australia,2435,1124,1311
1995,400,Jordan,Australia,246,118,128
1995,792,Turkey,Australia,2817,1316,1501
1995,64,Bhutan,Australia,15,12,3
1995,356,India,Australia,1964,871,1093
1995,462,Maldives,Australia,43,21,22
1995,144,Sri Lanka,Australia,100,69,31
1995,156,China,Australia,3091,1799,1292
1995,344,"China, Hong Kong SAR",Australia,6799,3896,2903
1995,408,Dem. People's Republic of Korea,Australia,112,61,51
1995,392,Japan,Australia,6119,2937,3182
1995,496,Mongolia,Australia,3,3,0
1995,410,Republic of Korea,Australia,631,348,283
1995,96,Brunei Darussalam,Australia,372,201,171
1995,116,Cambodia,Australia,142,89,53
1995,360,Indonesia,Australia,3945,2353,1592
1995,418,Lao People's Democratic Republic,Australia,18,10,8
1995,458,Malaysia,Australia,2118,1040,1078
1995,608,Philippines,Australia,1269,795,474
1995,702,Singapore,Australia,3577,1961,1616
1995,764,Thailand,Australia,991,673,318
1995,626,Timor-Leste,Australia,451,204,247
1995,704,Viet Nam,Australia,28,15,13
1995,28,Antigua and Barbuda,Australia,7,3,4
1995,44,Bahamas,Australia,46,23,23
1995,52,Barbados,Australia,26,13,13
1995,92,British Virgin Islands,Australia,14,3,11
1995,136,Cayman Islands,Australia,45,27,18
1995,212,Dominica,Australia,4,1,3
1995,214,Dominican Republic,Australia,75,52,23
1995,662,Saint Lucia,Australia,9,3,6
1995,188,Costa Rica,Australia,50,23,27
1995,222,El Salvador,Australia,27,10,17
1995,320,Guatemala,Australia,46,22,24
1995,484,Mexico,Australia,256,89,167
1995,591,Panama,Australia,79,47,32
1995,32,Argentina,Australia,600,283,317
1995,68,Bolivia (Plurinational State of),Australia,115,53,62
1995,76,Brazil,Australia,372,216,156
1995,152,Chile,Australia,825,428,397
1995,170,Colombia,Australia,197,89,108
1995,218,Ecuador,Australia,140,77,63
1995,238,Falkland Islands (Malvinas),Australia,9,6,3
1995,604,Peru,Australia,367,204,163
1995,862,Venezuela (Bolivarian Republic of),Australia,129,67,62
1995,554,New Zealand,Australia,53227,24935,28292
1995,242,Fiji,Australia,1405,741,664
1995,540,New Caledonia,Australia,262,116,146
1995,598,Papua New Guinea,Australia,14258,8672,5586
1995,90,Solomon Islands,Australia,356,202,154
1995,548,Vanuatu,Australia,445,235,210
1995,296,Kiribati,Australia,75,42,33
1995,520,Nauru,Australia,186,109,77
1995,184,Cook Islands,Australia,120,74,46
1995,258,French Polynesia,Australia,69,34,35
1995,570,Niue,Australia,13,6,7
1995,882,Samoa,Australia,330,188,142
1995,772,Tokelau,Australia,6,3,3
1995,112,Belarus,Australia,25,12,13
1995,100,Bulgaria,Australia,40,23,17
1995,203,Czechia,Australia,85,50,35
1995,348,Hungary,Australia,737,365,372
1995,616,Poland,Australia,737,387,350
1995,642,Romania,Australia,50,31,19
1995,643,Russian Federation,Australia,743,391,352
1995,703,Slovakia,Australia,85,43,42
1995,208,Denmark,Australia,1310,651,659
1995,246,Finland,Australia,502,272,230
1995,352,Iceland,Australia,61,24,37
1995,372,Ireland,Australia,1882,897,985
1995,833,Isle of Man,Australia,140,65,75
1995,428,Latvia,Australia,69,40,29
1995,440,Lithuania,Australia,25,14,11
1995,578,Norway,Australia,878,397,481
1995,752,Sweden,Australia,2088,1257,831
1995,826,United Kingdom,Australia,87623,39437,48186
1995,20,Andorra,Australia,39,20,19
1995,191,Croatia,Australia,764,306,458
1995,300,Greece,Australia,19792,9927,9865
1995,380,Italy,Australia,6643,2135,4508
1995,470,Malta,Australia,4022,1926,2096
1995,620,Portugal,Australia,751,341,410
1995,688,Serbia,Australia,525,289,236
1995,705,Slovenia,Australia,220,105,115
1995,724,Spain,Australia,2727,1315,1412
1995,40,Austria,Australia,1547,786,761
1995,56,Belgium,Australia,941,482,459
1995,250,France,Australia,4058,1768,2290
1995,276,Germany,Australia,6836,3286,3550
1995,442,Luxembourg,Australia,70,34,36
1995,528,Netherlands,Australia,8368,4118,4250
1995,756,Switzerland,Australia,3559,1865,1694
1995,60,Bermuda,Australia,44,23,21
1995,124,Canada,Australia,15871,7684,8187
1995,840,United States of America,Australia,52306,18023,34283
2000,690,Seychelles,Australia,51,32,19
2000,894,Zambia,Australia,83,40,43
2000,140,Central African Republic,Australia,16,8,8
2000,72,Botswana,Australia,114,56,58
2000,748,Eswatini,Australia,16,9,7
2000,516,Namibia,Australia,705,275,430
2000,710,South Africa,Australia,3028,1372,1656
2000,288,Ghana,Australia,19,6,13
2000,818,Egypt,Australia,344,183,161
2000,434,Libya,Australia,551,349,202
2000,196,Cyprus,Australia,1355,650,705
2000,376,Israel,Australia,2631,1229,1402
2000,400,Jordan,Australia,303,150,153
2000,792,Turkey,Australia,2736,1230,1506
2000,64,Bhutan,Australia,17,14,3
2000,356,India,Australia,812,398,414
2000,462,Maldives,Australia,48,26,22
2000,144,Sri Lanka,Australia,150,96,54
2000,156,China,Australia,3765,2172,1593
2000,344,"China, Hong Kong SAR",Australia,7506,4284,3222
2000,408,Dem. People's Republic of Korea,Australia,127,68,59
2000,392,Japan,Australia,9189,4245,4944
2000,496,Mongolia,Australia,4,3,1
2000,410,Republic of Korea,Australia,1148,645,503
2000,96,Brunei Darussalam,Australia,482,262,220
2000,116,Cambodia,Australia,229,144,85
2000,360,Indonesia,Australia,1928,1215,713
2000,418,Lao People's Democratic Republic,Australia,17,9,8
2000,458,Malaysia,Australia,2989,1461,1528
2000,608,Philippines,Australia,2396,1381,1015
2000,702,Singapore,Australia,4588,2469,2119
2000,764,Thailand,Australia,1595,1069,526
2000,626,Timor-Leste,Australia,482,209,273
2000,704,Viet Nam,Australia,45,25,20
2000,28,Antigua and Barbuda,Australia,6,3,3
2000,44,Bahamas,Australia,65,33,32
2000,52,Barbados,Australia,29,15,14
2000,92,British Virgin Islands,Australia,16,3,13
2000,136,Cayman Islands,Australia,77,45,32
2000,212,Dominica,Australia,5,1,4
2000,214,Dominican Republic,Australia,82,56,26
2000,662,Saint Lucia,Australia,13,4,9
2000,188,Costa Rica,Australia,51,25,26
2000,222,El Salvador,Australia,21,8,13
2000,320,Guatemala,Australia,44,24,20
2000,484,Mexico,Australia,408,170,238
2000,591,Panama,Australia,48,28,20
2000,32,Argentina,Australia,575,295,280
2000,68,Bolivia (Plurinational State of),Australia,154,71,83
2000,76,Brazil,Australia,447,221,226
2000,152,Chile,Australia,976,503,473
2000,170,Colombia,Australia,191,86,105
2000,218,Ecuador,Australia,155,86,69
2000,238,Falkland Islands (Malvinas),Australia,10,6,4
2000,604,Peru,Australia,430,237,193
2000,862,Venezuela (Bolivarian Republic of),Australia,127,66,61
2000,554,New Zealand,Australia,54744,26608,28136
2000,242,Fiji,Australia,1489,781,708
2000,540,New Caledonia,Australia,298,130,168
2000,598,Papua New Guinea,Australia,10675,6878,3797
2000,90,Solomon Islands,Australia,340,193,147
2000,548,Vanuatu,Australia,450,227,223
2000,296,Kiribati,Australia,86,44,42
2000,520,Nauru,Australia,171,100,71
2000,184,Cook Islands,Australia,124,77,47
2000,258,French Polynesia,Australia,74,35,39
2000,570,Niue,Australia,16,5,11
2000,882,Samoa,Australia,422,239,183
2000,772,Tokelau,Australia,21,19,2
2000,112,Belarus,Australia,28,12,16
2000,100,Bulgaria,Australia,66,37,29
2000,203,Czechia,Australia,113,67,46
2000,348,Hungary,Australia,642,311,331
2000,616,Poland,Australia,631,327,304
2000,642,Romania,Australia,85,52,33
2000,643,Russian Federation,Australia,699,395,304
2000,703,Slovakia,Australia,176,90,86
2000,208,Denmark,Australia,1638,844,794
2000,246,Finland,Australia,552,311,241
2000,352,Iceland,Australia,61,25,36
2000,372,Ireland,Australia,4267,2104,2163
2000,833,Isle of Man,Australia,157,73,84
2000,428,Latvia,Australia,93,54,39
2000,440,Lithuania,Australia,19,11,8
2000,578,Norway,Australia,977,506,471
2000,752,Sweden,Australia,2240,1342,898
2000,826,United Kingdom,Australia,104295,46800,57495
2000,20,Andorra,Australia,41,21,20
2000,191,Croatia,Australia,753,320,433
2000,300,Greece,Australia,20267,9345,10922
2000,380,Italy,Australia,5226,1715,3511
2000,470,Malta,Australia,4128,1886,2242
2000,620,Portugal,Australia,1185,539,646
2000,688,Serbia,Australia,715,387,328
2000,705,Slovenia,Australia,303,150,153
2000,724,Spain,Australia,4271,2128,2143
2000,40,Austria,Australia,1723,887,836
2000,56,Belgium,Australia,1173,591,582
2000,250,France,Australia,4185,1787,2398
2000,276,Germany,Australia,7467,3468,3999
2000,442,Luxembourg,Australia,67,32,35
2000,528,Netherlands,Australia,9177,4434,4743
2000,756,Switzerland,Australia,4099,2274,1825
2000,60,Bermuda,Australia,50,26,24
2000,124,Canada,Australia,18729,9035,9694
2000,840,United States of America,Australia,62513,21865,40648
2005,690,Seychelles,Australia,48,27,21
2005,894,Zambia,Australia,148,72,76
2005,140,Central African Republic,Australia,12,6,6
2005,72,Botswana,Australia,225,109,116
2005,748,Eswatini,Australia,30,17,13
2005,516,Namibia,Australia,557,215,342
2005,710,South Africa,Australia,3983,1707,2276
2005,288,Ghana,Australia,27,10,17
2005,818,Egypt,Australia,410,230,180
2005,434,Libya,Australia,607,425,182
2005,196,Cyprus,Australia,1983,944,1039
2005,376,Israel,Australia,2882,1373,1509
2005,400,Jordan,Australia,438,243,195
2005,792,Turkey,Australia,2819,1232,1587
2005,64,Bhutan,Australia,21,17,4
2005,356,India,Australia,750,366,384
2005,462,Maldives,Australia,56,33,23
2005,144,Sri Lanka,Australia,253,126,127
2005,156,China,Australia,4153,2581,1572
2005,344,"China, Hong Kong SAR",Australia,8195,4501,3694
2005,408,Dem. People's Republic of Korea,Australia,155,83,72
2005,392,Japan,Australia,9202,4191,5011
2005,496,Mongolia,Australia,91,59,32
2005,410,Republic of Korea,Australia,2155,1717,438
2005,96,Brunei Darussalam,Australia,493,269,224
2005,116,Cambodia,Australia,179,114,65
2005,360,Indonesia,Australia,5679,3486,2193
2005,418,Lao People's Democratic Republic,Australia,16,9,7
2005,458,Malaysia,Australia,4005,2056,1949
2005,608,Philippines,Australia,1939,1131,808
2005,702,Singapore,Australia,6466,3423,3043
2005,764,Thailand,Australia,1402,919,483
2005,626,Timor-Leste,Australia,522,238,284
2005,704,Viet Nam,Australia,36,22,14
2005,28,Antigua and Barbuda,Australia,7,4,3
2005,44,Bahamas,Australia,71,36,35
2005,52,Barbados,Australia,25,13,12
2005,92,British Virgin Islands,Australia,19,4,15
2005,136,Cayman Islands,Australia,119,68,51
2005,212,Dominica,Australia,5,1,4
2005,214,Dominican Republic,Australia,60,41,19
2005,662,Saint Lucia,Australia,13,4,9
2005,188,Costa Rica,Australia,33,16,17
2005,222,El Salvador,Australia,24,9,15
2005,320,Guatemala,Australia,53,31,22
2005,484,Mexico,Australia,397,184,213
2005,591,Panama,Australia,139,94,45
2005,32,Argentina,Australia,425,222,203
2005,68,Bolivia (Plurinational State of),Australia,175,89,86
2005,76,Brazil,Australia,519,333,186
2005,152,Chile,Australia,1464,766,698
2005,170,Colombia,Australia,182,83,99
2005,218,Ecuador,Australia,183,104,79
2005,238,Falkland Islands (Malvinas),Australia,14,9,5
2005,604,Peru,Australia,506,284,222
2005,862,Venezuela (Bolivarian Republic of),Australia,133,69,64
2005,554,New Zealand,Australia,60001,29123,30878
2005,242,Fiji,Australia,1706,901,805
2005,540,New Caledonia,Australia,317,140,177
2005,598,Papua New Guinea,Australia,10675,6996,3679
2005,90,Solomon Islands,Australia,309,175,134
2005,548,Vanuatu,Australia,549,275,274
2005,296,Kiribati,Australia,83,44,39
2005,520,Nauru,Australia,161,94,67
2005,184,Cook Islands,Australia,230,125,105
2005,258,French Polynesia,Australia,77,37,40
2005,570,Niue,Australia,19,8,11
2005,882,Samoa,Australia,396,222,174
2005,772,Tokelau,Australia,20,17,3
2005,112,Belarus,Australia,27,11,16
2005,100,Bulgaria,Australia,103,58,45
2005,203,Czechia,Australia,269,164,105
2005,348,Hungary,Australia,793,391,402
2005,616,Poland,Australia,774,430,344
2005,642,Romania,Australia,62,39,23
2005,643,Russian Federation,Australia,622,347,275
2005,703,Slovakia,Australia,198,103,95
2005,208,Denmark,Australia,2115,1104,1011
2005,246,Finland,Australia,779,458,321
2005,352,Iceland,Australia,75,33,42
2005,372,Ireland,Australia,5846,2971,2875
2005,833,Isle of Man,Australia,258,115,143
2005,428,Latvia,Australia,131,82,49
2005,440,Lithuania,Australia,33,25,8
2005,578,Norway,Australia,1214,678,536
2005,752,Sweden,Australia,2657,1633,1024
2005,826,United Kingdom,Australia,108178,49384,58794
2005,20,Andorra,Australia,59,31,28
2005,191,Croatia,Australia,1169,536,633
2005,300,Greece,Australia,20467,9360,11107
2005,380,Italy,Australia,12537,5274,7263
2005,470,Malta,Australia,4016,1796,2220
2005,620,Portugal,Australia,1224,561,663
2005,688,Serbia,Australia,706,378,328
2005,705,Slovenia,Australia,335,162,173
2005,724,Spain,Australia,4630,2329,2301
2005,40,Austria,Australia,1926,969,957
2005,56,Belgium,Australia,1277,616,661
2005,250,France,Australia,5406,2460,2946
2005,276,Germany,Australia,9538,4827,4711
2005,442,Luxembourg,Australia,58,30,28
2005,528,Netherlands,Australia,10113,4959,5154
2005,756,Switzerland,Australia,5347,2735,2612
2005,60,Bermuda,Australia,59,32,27
2005,124,Canada,Australia,21053,10463,10590
2005,840,United States of America,Australia,67499,23852,43647
2010,690,Seychelles,Australia,46,23,23
2010,894,Zambia,Australia,264,136,128
2010,140,Central African Republic,Australia,12,6,6
2010,72,Botswana,Australia,337,163,174
2010,748,Eswatini,Australia,44,24,20
2010,516,Namibia,Australia,536,208,328
2010,710,South Africa,Australia,6238,2660,3578
2010,288,Ghana,Australia,27,11,16
2010,818,Egypt,Australia,442,240,202
2010,434,Libya,Australia,664,467,197
2010,196,Cyprus,Australia,3247,1567,1680
2010,376,Israel,Australia,3167,1530,1637
2010,400,Jordan,Australia,563,326,237
2010,792,Turkey,Australia,2904,1232,1672
2010,64,Bhutan,Australia,25,20,5
2010,356,India,Australia,688,335,353
2010,462,Maldives,Australia,67,51,16
2010,144,Sri Lanka,Australia,465,229,236
2010,156,China,Australia,4542,2990,1552
2010,344,"China, Hong Kong SAR",Australia,8903,4729,4174
2010,408,Dem. People's Republic of Korea,Australia,183,98,85
2010,392,Japan,Australia,9756,4387,5369
2010,496,Mongolia,Australia,189,124,65
2010,410,Republic of Korea,Australia,4016,3441,575
2010,96,Brunei Darussalam,Australia,504,276,228
2010,116,Cambodia,Australia,129,85,44
2010,360,Indonesia,Australia,9796,5744,4052
2010,418,Lao People's Democratic Republic,Australia,110,76,34
2010,458,Malaysia,Australia,4766,2523,2243
2010,608,Philippines,Australia,3932,2226,1706
2010,702,Singapore,Australia,8706,4565,4141
2010,764,Thailand,Australia,1310,845,465
2010,626,Timor-Leste,Australia,543,256,287
2010,704,Viet Nam,Australia,32,17,15
2010,28,Antigua and Barbuda,Australia,7,4,3
2010,44,Bahamas,Australia,77,39,38
2010,52,Barbados,Australia,23,11,12
2010,92,British Virgin Islands,Australia,21,4,17
2010,136,Cayman Islands,Australia,173,97,76
2010,212,Dominica,Australia,6,2,4
2010,214,Dominican Republic,Australia,38,26,12
2010,662,Saint Lucia,Australia,13,4,9
2010,188,Costa Rica,Australia,66,33,33
2010,222,El Salvador,Australia,26,10,16
2010,320,Guatemala,Australia,61,37,24
2010,484,Mexico,Australia,434,221,213
2010,591,Panama,Australia,237,165,72
2010,32,Argentina,Australia,274,148,126
2010,68,Bolivia (Plurinational State of),Australia,196,108,88
2010,76,Brazil,Australia,584,441,143
2010,152,Chile,Australia,1953,1030,923
2010,170,Colombia,Australia,205,96,109
2010,218,Ecuador,Australia,257,143,114
2010,238,Falkland Islands (Malvinas),Australia,38,23,15
2010,604,Peru,Australia,565,316,249
2010,862,Venezuela (Bolivarian Republic of),Australia,141,74,67
2010,554,New Zealand,Australia,63086,30570,32516
2010,242,Fiji,Australia,1832,980,852
2010,540,New Caledonia,Australia,337,150,187
2010,598,Papua New Guinea,Australia,9056,6092,2964
2010,90,Solomon Islands,Australia,298,167,131
2010,548,Vanuatu,Australia,612,305,307
2010,296,Kiribati,Australia,81,45,36
2010,520,Nauru,Australia,24,14,10
2010,184,Cook Islands,Australia,336,173,163
2010,258,French Polynesia,Australia,74,36,38
2010,570,Niue,Australia,16,7,9
2010,882,Samoa,Australia,346,192,154
2010,772,Tokelau,Australia,33,28,5
2010,112,Belarus,Australia,26,10,16
2010,100,Bulgaria,Australia,136,76,60
2010,203,Czechia,Australia,399,249,150
2010,348,Hungary,Australia,944,471,473
2010,616,Poland,Australia,942,543,399
2010,642,Romania,Australia,48,31,17
2010,643,Russian Federation,Australia,533,291,242
2010,703,Slovakia,Australia,222,117,105
2010,208,Denmark,Australia,2545,1340,1205
2010,233,Estonia,Australia,63,44,19
2010,246,Finland,Australia,1190,670,520
2010,352,Iceland,Australia,87,40,47
2010,372,Ireland,Australia,6462,2983,3479
2010,833,Isle of Man,Australia,356,156,200
2010,428,Latvia,Australia,166,106,60
2010,440,Lithuania,Australia,44,35,9
2010,578,Norway,Australia,1794,1059,735
2010,752,Sweden,Australia,3369,2156,1213
2010,826,United Kingdom,Australia,123443,64228,59215
2010,20,Andorra,Australia,70,37,33
2010,191,Croatia,Australia,1585,752,833
2010,300,Greece,Australia,21503,9759,11744
2010,380,Italy,Australia,20127,8873,11254
2010,470,Malta,Australia,3461,1593,1868
2010,499,Montenegro,Australia,122,39,83
2010,620,Portugal,Australia,1061,491,570
2010,688,Serbia,Australia,691,370,321
2010,705,Slovenia,Australia,393,202,191
2010,724,Spain,Australia,5594,2820,2774
2010,40,Austria,Australia,2129,1052,1077
2010,56,Belgium,Australia,1368,706,662
2010,250,France,Australia,7839,3487,4352
2010,276,Germany,Australia,11239,5951,5288
2010,442,Luxembourg,Australia,50,27,23
2010,528,Netherlands,Australia,10021,4902,5119
2010,756,Switzerland,Australia,5416,2737,2679
2010,60,Bermuda,Australia,68,39,29
2010,124,Canada,Australia,18970,9661,9309
2010,840,United States of America,Australia,74689,25729,48960
2015,690,Seychelles,Australia,51,27,24
2015,894,Zambia,Australia,232,119,113
2015,140,Central African Republic,Australia,10,5,5
2015,72,Botswana,Australia,367,177,190
2015,748,Eswatini,Australia,55,32,23
2015,516,Namibia,Australia,524,204,320
2015,710,South Africa,Australia,11252,4470,6782
2015,288,Ghana,Australia,33,14,19
2015,324,Guinea,Australia,10,7,3
2015,818,Egypt,Australia,327,197,130
2015,434,Libya,Australia,748,523,225
2015,196,Cyprus,Australia,3119,1516,1603
2015,376,Israel,Australia,3266,1569,1697
2015,400,Jordan,Australia,242,118,124
2015,792,Turkey,Australia,2947,1212,1735
2015,64,Bhutan,Australia,27,22,5
2015,356,India,Australia,662,322,340
2015,462,Maldives,Australia,78,69,9
2015,144,Sri Lanka,Australia,472,228,244
2015,156,China,Australia,5227,3523,1704
2015,344,"China, Hong Kong SAR",Australia,9091,4662,4429
2015,408,Dem. People's Republic of Korea,Australia,202,109,93
2015,392,Japan,Australia,9843,4390,5453
2015,496,Mongolia,Australia,233,131,102
2015,410,Republic of Korea,Australia,4989,4258,731
2015,96,Brunei Darussalam,Australia,515,283,232
2015,116,Cambodia,Australia,116,77,39
2015,360,Indonesia,Australia,10844,6456,4388
2015,418,Lao People's Democratic Republic,Australia,205,144,61
2015,458,Malaysia,Australia,5811,3122,2689
2015,608,Philippines,Australia,3993,2264,1729
2015,702,Singapore,Australia,10129,5303,4826
2015,764,Thailand,Australia,1416,912,504
2015,626,Timor-Leste,Australia,562,349,213
2015,704,Viet Nam,Australia,37,19,18
2015,28,Antigua and Barbuda,Australia,7,4,3
2015,44,Bahamas,Australia,83,42,41
2015,52,Barbados,Australia,24,12,12
2015,92,British Virgin Islands,Australia,23,4,19
2015,136,Cayman Islands,Australia,187,105,82
2015,212,Dominica,Australia,7,2,5
2015,214,Dominican Republic,Australia,40,28,12
2015,662,Saint Lucia,Australia,12,4,8
2015,188,Costa Rica,Australia,67,34,33
2015,222,El Salvador,Australia,27,10,17
2015,320,Guatemala,Australia,70,43,27
2015,484,Mexico,Australia,460,232,228
2015,591,Panama,Australia,279,194,85
2015,32,Argentina,Australia,275,148,127
2015,68,Bolivia (Plurinational State of),Australia,228,126,102
2015,76,Brazil,Australia,703,531,172
2015,152,Chile,Australia,2958,1530,1428
2015,170,Colombia,Australia,229,109,120
2015,218,Ecuador,Australia,373,206,167
2015,238,Falkland Islands (Malvinas),Australia,42,25,17
2015,604,Peru,Australia,601,343,258
2015,862,Venezuela (Bolivarian Republic of),Australia,148,76,72
2015,554,New Zealand,Australia,65161,31511,33650
2015,242,Fiji,Australia,1887,1019,868
2015,540,New Caledonia,Australia,258,98,160
2015,598,Papua New Guinea,Australia,9183,6223,2960
2015,90,Solomon Islands,Australia,279,157,122
2015,548,Vanuatu,Australia,629,313,316
2015,296,Kiribati,Australia,82,46,36
2015,520,Nauru,Australia,38,23,15
2015,184,Cook Islands,Australia,309,159,150
2015,258,French Polynesia,Australia,70,34,36
2015,570,Niue,Australia,15,7,8
2015,882,Samoa,Australia,287,160,127
2015,772,Tokelau,Australia,39,32,7
2015,112,Belarus,Australia,28,12,16
2015,100,Bulgaria,Australia,228,132,96
2015,203,Czechia,Australia,551,347,204
2015,348,Hungary,Australia,968,513,455
2015,616,Poland,Australia,908,531,377
2015,642,Romania,Australia,73,41,32
2015,643,Russian Federation,Australia,543,296,247
2015,703,Slovakia,Australia,288,158,130
2015,208,Denmark,Australia,3141,1632,1509
2015,233,Estonia,Australia,98,75,23
2015,246,Finland,Australia,1337,798,539
2015,352,Iceland,Australia,121,60,61
2015,372,Ireland,Australia,6601,3003,3598
2015,833,Isle of Man,Australia,188,91,97
2015,428,Latvia,Australia,83,59,24
2015,440,Lithuania,Australia,41,32,9
2015,578,Norway,Australia,2230,1363,867
2015,752,Sweden,Australia,3988,2531,1457
2015,826,United Kingdom,Australia,128295,65105,63190
2015,20,Andorra,Australia,65,65,0
2015,191,Croatia,Australia,1595,754,841
2015,300,Greece,Australia,20182,8690,11492
2015,380,Italy,Australia,19386,8540,10846
2015,470,Malta,Australia,6006,3053,2953
2015,499,Montenegro,Australia,137,45,92
2015,620,Portugal,Australia,1202,523,679
2015,688,Serbia,Australia,675,361,314
2015,705,Slovenia,Australia,363,201,162
2015,724,Spain,Australia,6376,3253,3123
2015,40,Austria,Australia,2490,1237,1253
2015,56,Belgium,Australia,1487,764,723
2015,250,France,Australia,8684,3730,4954
2015,276,Germany,Australia,11710,6187,5523
2015,442,Luxembourg,Australia,76,42,34
2015,528,Netherlands,Australia,10366,5097,5269
2015,756,Switzerland,Australia,6186,3090,3096
2015,60,Bermuda,Australia,69,40,29
2015,124,Canada,Australia,20980,10819,10161
2015,840,United States of America,Australia,89293,30461,58832
2019,690,Seychelles,Australia,51,27,24
2019,894,Zambia,Australia,298,153,145
2019,140,Central African Republic,Australia,11,6,5
2019,72,Botswana,Australia,393,190,203
2019,748,Eswatini,Australia,54,31,23
2019,516,Namibia,Australia,554,216,338
2019,710,South Africa,Australia,12611,5018,7593
2019,288,Ghana,Australia,37,16,21
2019,324,Guinea,Australia,9,7,2
2019,818,Egypt,Australia,466,259,207
2019,434,Libya,Australia,793,555,238
2019,196,Cyprus,Australia,3117,1532,1585
2019,376,Israel,Australia,3176,1526,1650
2019,400,Jordan,Australia,260,127,133
2019,792,Turkey,Australia,3984,1662,2322
2019,64,Bhutan,Australia,28,23,5
2019,356,India,Australia,651,317,334
2019,462,Maldives,Australia,84,75,9
2019,144,Sri Lanka,Australia,475,230,245
2019,156,China,Australia,5509,3713,1796
2019,344,"China, Hong Kong SAR",Australia,11778,5868,5910
2019,408,Dem. People's Republic of Korea,Australia,205,111,94
2019,392,Japan,Australia,10892,4858,6034
2019,496,Mongolia,Australia,247,139,108
2019,410,Republic of Korea,Australia,5078,4334,744
2019,96,Brunei Darussalam,Australia,554,305,249
2019,116,Cambodia,Australia,123,82,41
2019,360,Indonesia,Australia,11325,6743,4582
2019,418,Lao People's Democratic Republic,Australia,217,153,64
2019,458,Malaysia,Australia,6076,3285,2791
2019,608,Philippines,Australia,4118,2335,1783
2019,702,Singapore,Australia,8584,4490,4094
2019,764,Thailand,Australia,1476,951,525
2019,626,Timor-Leste,Australia,555,345,210
2019,704,Viet Nam,Australia,38,20,18
2019,28,Antigua and Barbuda,Australia,7,4,3
2019,44,Bahamas,Australia,88,45,43
2019,52,Barbados,Australia,24,12,12
2019,92,British Virgin Islands,Australia,24,4,20
2019,136,Cayman Islands,Australia,207,117,90
2019,212,Dominica,Australia,7,2,5
2019,214,Dominican Republic,Australia,41,29,12
2019,662,Saint Lucia,Australia,11,4,7
2019,188,Costa Rica,Australia,67,34,33
2019,222,El Salvador,Australia,27,10,17
2019,320,Guatemala,Australia,71,44,27
2019,484,Mexico,Australia,474,239,235
2019,591,Panama,Australia,296,207,89
2019,32,Argentina,Australia,279,150,129
2019,68,Bolivia (Plurinational State of),Australia,248,137,111
2019,76,Brazil,Australia,791,598,193
2019,152,Chile,Australia,3952,1938,2014
2019,170,Colombia,Australia,234,112,122
2019,218,Ecuador,Australia,367,203,164
2019,238,Falkland Islands (Malvinas),Australia,50,30,20
2019,604,Peru,Australia,716,422,294
2019,862,Venezuela (Bolivarian Republic of),Australia,144,74,70
2019,554,New Zealand,Australia,66978,32390,34588
2019,242,Fiji,Australia,1926,1040,886
2019,540,New Caledonia,Australia,271,102,169
2019,598,Papua New Guinea,Australia,9263,6288,2975
2019,90,Solomon Islands,Australia,273,154,119
2019,548,Vanuatu,Australia,640,319,321
2019,296,Kiribati,Australia,84,47,37
2019,520,Nauru,Australia,42,26,16
2019,184,Cook Islands,Australia,310,160,150
2019,258,French Polynesia,Australia,72,35,37
2019,570,Niue,Australia,15,7,8
2019,882,Samoa,Australia,272,152,120
2019,772,Tokelau,Australia,40,33,7
2019,112,Belarus,Australia,27,12,15
2019,100,Bulgaria,Australia,287,162,125
2019,203,Czechia,Australia,645,412,233
2019,348,Hungary,Australia,1060,561,499
2019,616,Poland,Australia,961,578,383
2019,642,Romania,Australia,242,140,102
2019,643,Russian Federation,Australia,542,296,246
2019,703,Slovakia,Australia,348,189,159
2019,208,Denmark,Australia,3820,2053,1767
2019,233,Estonia,Australia,127,91,36
2019,246,Finland,Australia,1538,919,619
2019,352,Iceland,Australia,147,74,73
2019,372,Ireland,Australia,7247,3309,3938
2019,833,Isle of Man,Australia,190,92,98
2019,428,Latvia,Australia,93,67,26
2019,440,Lithuania,Australia,35,29,6
2019,578,Norway,Australia,2472,1498,974
2019,752,Sweden,Australia,5195,3241,1954
2019,826,United Kingdom,Australia,145692,74115,71577
2019,20,Andorra,Australia,69,69,0
2019,191,Croatia,Australia,1472,694,778
2019,300,Greece,Australia,19710,8912,10798
2019,380,Italy,Australia,20217,9019,11198
2019,470,Malta,Australia,9691,4959,4732
2019,499,Montenegro,Australia,137,46,91
2019,620,Portugal,Australia,1222,533,689
2019,688,Serbia,Australia,685,367,318
2019,705,Slovenia,Australia,359,199,160
2019,724,Spain,Australia,6606,3293,3313
2019,40,Austria,Australia,2939,1486,1453
2019,56,Belgium,Australia,1611,844,767
2019,250,France,Australia,9192,3937,5255
2019,276,Germany,Australia,12845,7161,5684
2019,442,Luxembourg,Australia,279,126,153
2019,528,Netherlands,Australia,11920,5956,5964
2019,756,Switzerland,Australia,6601,3307,3294
2019,60,Bermuda,Australia,69,40,29
2019,124,Canada,Australia,22482,11594,10888
2019,840,United States of America,Australia,96426,32211,64215
1990,140,Central African Republic,Austria,20,13,7
1990,516,Namibia,Austria,901,483,418
1990,710,South Africa,Austria,3523,1514,2009
1990,818,Egypt,Austria,716,330,386
1990,434,Libya,Austria,2044,947,1097
1990,196,Cyprus,Austria,88,39,49
1990,376,Israel,Austria,6373,3030,3343
1990,400,Jordan,Austria,78,34,44
1990,792,Turkey,Austria,6979,3440,3539
1990,762,Tajikistan,Austria,98,44,54
1990,462,Maldives,Austria,50,27,23
1990,392,Japan,Austria,309,157,152
1990,496,Mongolia,Austria,3,1,2
1990,608,Philippines,Austria,92,58,34
1990,44,Bahamas,Austria,15,4,11
1990,136,Cayman Islands,Austria,15,13,2
1990,214,Dominican Republic,Austria,965,810,155
1990,332,Haiti,Austria,170,142,28
1990,662,Saint Lucia,Austria,6,3,3
1990,188,Costa Rica,Austria,80,54,26
1990,222,El Salvador,Austria,18,7,11
1990,484,Mexico,Austria,429,209,220
1990,558,Nicaragua,Austria,54,33,21
1990,591,Panama,Austria,41,26,15
1990,32,Argentina,Austria,4256,1777,2479
1990,68,Bolivia (Plurinational State of),Austria,170,86,84
1990,76,Brazil,Austria,4756,2174,2582
1990,152,Chile,Austria,594,275,319
1990,170,Colombia,Austria,280,142,138
1990,218,Ecuador,Austria,182,102,80
1990,604,Peru,Austria,122,68,54
1990,862,Venezuela (Bolivarian Republic of),Austria,1020,511,509
1990,36,Australia,Austria,22977,12541,10436
1990,554,New Zealand,Austria,655,359,296
1990,112,Belarus,Austria,44,21,23
1990,100,Bulgaria,Austria,26,14,12
1990,203,Czechia,Austria,1811,818,993
1990,348,Hungary,Austria,5206,2313,2893
1990,616,Poland,Austria,6119,3030,3089
1990,642,Romania,Austria,722,312,410
1990,643,Russian Federation,Austria,3776,1853,1923
1990,703,Slovakia,Austria,281,111,170
1990,208,Denmark,Austria,1275,574,701
1990,246,Finland,Austria,253,148,105
1990,352,Iceland,Austria,52,24,28
1990,372,Ireland,Austria,49,24,25
1990,428,Latvia,Austria,50,27,23
1990,440,Lithuania,Austria,48,24,24
1990,578,Norway,Austria,997,520,477
1990,752,Sweden,Austria,4731,2671,2060
1990,826,United Kingdom,Austria,20222,5498,14724
1990,70,Bosnia and Herzegovina,Austria,310,141,169
1990,191,Croatia,Austria,1265,490,775
1990,300,Greece,Austria,3523,1369,2154
1990,380,Italy,Austria,16037,3097,12940
1990,470,Malta,Austria,18,7,11
1990,620,Portugal,Austria,113,53,60
1990,688,Serbia,Austria,860,441,419
1990,705,Slovenia,Austria,4461,1828,2633
1990,724,Spain,Austria,2259,1003,1256
1990,56,Belgium,Austria,1293,689,604
1990,250,France,Austria,11675,4000,7675
1990,276,Germany,Austria,189349,108397,80952
1990,438,Liechtenstein,Austria,2021,967,1054
1990,442,Luxembourg,Austria,512,201,311
1990,528,Netherlands,Austria,6902,2965,3937
1990,756,Switzerland,Austria,48450,17775,30675
1990,60,Bermuda,Austria,26,8,18
1990,124,Canada,Austria,25600,12463,13137
1990,840,United States of America,Austria,87673,31407,56266
1995,140,Central African Republic,Austria,27,18,9
1995,516,Namibia,Austria,861,464,397
1995,710,South Africa,Austria,2520,1256,1264
1995,818,Egypt,Austria,557,249,308
1995,434,Libya,Austria,1288,581,707
1995,196,Cyprus,Austria,125,53,72
1995,376,Israel,Austria,6471,3012,3459
1995,400,Jordan,Austria,110,57,53
1995,792,Turkey,Austria,10148,5040,5108
1995,762,Tajikistan,Austria,79,35,44
1995,462,Maldives,Austria,36,18,18
1995,392,Japan,Austria,390,187,203
1995,496,Mongolia,Austria,3,2,1
1995,608,Philippines,Austria,123,77,46
1995,44,Bahamas,Austria,18,7,11
1995,136,Cayman Islands,Austria,30,24,6
1995,214,Dominican Republic,Austria,1072,895,177
1995,332,Haiti,Austria,161,135,26
1995,662,Saint Lucia,Austria,8,4,4
1995,188,Costa Rica,Austria,71,50,21
1995,222,El Salvador,Austria,14,5,9
1995,484,Mexico,Austria,569,284,285
1995,558,Nicaragua,Austria,43,26,17
1995,591,Panama,Austria,45,29,16
1995,32,Argentina,Austria,3201,1354,1847
1995,68,Bolivia (Plurinational State of),Austria,169,80,89
1995,76,Brazil,Austria,3988,1826,2162
1995,152,Chile,Austria,558,275,283
1995,170,Colombia,Austria,246,126,120
1995,218,Ecuador,Austria,205,115,90
1995,604,Peru,Austria,123,67,56
1995,862,Venezuela (Bolivarian Republic of),Austria,908,457,451
1995,36,Australia,Austria,23165,12535,10630
1995,554,New Zealand,Austria,807,424,383
1995,112,Belarus,Austria,53,20,33
1995,100,Bulgaria,Austria,62,35,27
1995,203,Czechia,Austria,2717,1269,1448
1995,348,Hungary,Austria,5365,2625,2740
1995,616,Poland,Austria,5234,2552,2682
1995,642,Romania,Austria,631,299,332
1995,643,Russian Federation,Austria,3905,1943,1962
1995,703,Slovakia,Austria,1033,550,483
1995,208,Denmark,Austria,1400,662,738
1995,246,Finland,Austria,258,151,107
1995,352,Iceland,Austria,62,29,33
1995,372,Ireland,Austria,175,83,92
1995,428,Latvia,Austria,77,42,35
1995,440,Lithuania,Austria,53,25,28
1995,578,Norway,Austria,936,474,462
1995,752,Sweden,Austria,5614,3151,2463
1995,826,United Kingdom,Austria,19373,5577,13796
1995,70,Bosnia and Herzegovina,Austria,292,133,159
1995,191,Croatia,Austria,1440,579,861
1995,300,Greece,Austria,2854,1050,1804
1995,380,Italy,Austria,13068,2668,10400
1995,470,Malta,Austria,22,9,13
1995,620,Portugal,Austria,245,115,130
1995,688,Serbia,Austria,5461,2743,2718
1995,705,Slovenia,Austria,3564,1498,2066
1995,724,Spain,Austria,3212,1477,1735
1995,56,Belgium,Austria,1917,968,949
1995,250,France,Austria,12052,3995,8057
1995,276,Germany,Austria,185418,101898,83520
1995,438,Liechtenstein,Austria,2334,1074,1260
1995,442,Luxembourg,Austria,487,198,289
1995,528,Netherlands,Austria,6701,2816,3885
1995,756,Switzerland,Austria,46395,18625,27770
1995,60,Bermuda,Austria,27,12,15
1995,124,Canada,Austria,23600,11439,12161
1995,840,United States of America,Austria,76673,27812,48861
2000,140,Central African Republic,Austria,32,21,11
2000,516,Namibia,Austria,801,433,368
2000,710,South Africa,Austria,2265,1319,946
2000,818,Egypt,Austria,442,188,254
2000,434,Libya,Austria,554,242,312
2000,196,Cyprus,Austria,161,66,95
2000,268,Georgia,Austria,26,14,12
2000,376,Israel,Austria,6206,2862,3344
2000,400,Jordan,Austria,141,80,61
2000,792,Turkey,Austria,13354,6649,6705
2000,762,Tajikistan,Austria,69,32,37
2000,462,Maldives,Austria,21,11,10
2000,392,Japan,Austria,476,220,256
2000,496,Mongolia,Austria,4,2,2
2000,608,Philippines,Austria,1657,921,736
2000,44,Bahamas,Austria,22,12,10
2000,136,Cayman Islands,Austria,52,41,11
2000,214,Dominican Republic,Austria,1179,981,198
2000,332,Haiti,Austria,152,128,24
2000,662,Saint Lucia,Austria,11,6,5
2000,188,Costa Rica,Austria,98,70,28
2000,222,El Salvador,Austria,10,4,6
2000,484,Mexico,Austria,735,374,361
2000,558,Nicaragua,Austria,38,23,15
2000,591,Panama,Austria,53,33,20
2000,32,Argentina,Austria,2146,932,1214
2000,68,Bolivia (Plurinational State of),Austria,166,72,94
2000,76,Brazil,Austria,3220,1479,1741
2000,152,Chile,Austria,523,256,267
2000,170,Colombia,Austria,212,110,102
2000,218,Ecuador,Austria,227,128,99
2000,604,Peru,Austria,144,78,66
2000,862,Venezuela (Bolivarian Republic of),Austria,802,404,398
2000,36,Australia,Austria,21640,11571,10069
2000,554,New Zealand,Austria,1170,570,600
2000,112,Belarus,Austria,61,18,43
2000,100,Bulgaria,Austria,98,57,41
2000,203,Czechia,Austria,3623,1720,1903
2000,348,Hungary,Austria,5523,2937,2586
2000,616,Poland,Austria,4477,2148,2329
2000,642,Romania,Austria,536,284,252
2000,643,Russian Federation,Austria,3894,1963,1931
2000,703,Slovakia,Austria,2070,1140,930
2000,208,Denmark,Austria,1525,751,774
2000,246,Finland,Austria,262,154,108
2000,352,Iceland,Austria,72,34,38
2000,372,Ireland,Austria,397,195,202
2000,428,Latvia,Austria,104,56,48
2000,440,Lithuania,Austria,41,20,21
2000,578,Norway,Austria,1058,556,502
2000,752,Sweden,Austria,6021,3362,2659
2000,826,United Kingdom,Austria,18851,5715,13136
2000,70,Bosnia and Herzegovina,Austria,273,125,148
2000,191,Croatia,Austria,1461,618,843
2000,300,Greece,Austria,2232,715,1517
2000,380,Italy,Austria,10099,2239,7860
2000,470,Malta,Austria,55,23,32
2000,620,Portugal,Austria,388,182,206
2000,688,Serbia,Austria,7425,3652,3773
2000,705,Slovenia,Austria,5745,2510,3235
2000,724,Spain,Austria,5548,2634,2914
2000,56,Belgium,Austria,2486,1223,1263
2000,250,France,Austria,12429,3991,8438
2000,276,Germany,Austria,181487,95399,86088
2000,438,Liechtenstein,Austria,2608,1147,1461
2000,442,Luxembourg,Austria,469,199,270
2000,528,Netherlands,Austria,6742,2759,3983
2000,756,Switzerland,Austria,44509,19623,24886
2000,60,Bermuda,Austria,28,16,12
2000,124,Canada,Austria,22161,10690,11471
2000,840,United States of America,Austria,65264,24116,41148
2005,140,Central African Republic,Austria,24,16,8
2005,516,Namibia,Austria,633,341,292
2005,710,South Africa,Austria,2980,1682,1298
2005,818,Egypt,Austria,526,242,284
2005,434,Libya,Austria,610,328,282
2005,196,Cyprus,Austria,236,96,140
2005,268,Georgia,Austria,24,13,11
2005,376,Israel,Austria,5525,2518,3007
2005,400,Jordan,Austria,204,127,77
2005,792,Turkey,Austria,13761,6696,7065
2005,762,Tajikistan,Austria,66,30,36
2005,462,Maldives,Austria,17,10,7
2005,392,Japan,Austria,537,245,292
2005,496,Mongolia,Austria,8,6,2
2005,608,Philippines,Austria,1341,755,586
2005,44,Bahamas,Austria,30,16,14
2005,136,Cayman Islands,Austria,47,37,10
2005,214,Dominican Republic,Austria,690,555,135
2005,332,Haiti,Austria,144,122,22
2005,662,Saint Lucia,Austria,11,6,5
2005,188,Costa Rica,Austria,64,46,18
2005,222,El Salvador,Austria,11,5,6
2005,484,Mexico,Austria,584,297,287
2005,558,Nicaragua,Austria,34,20,14
2005,591,Panama,Austria,70,40,30
2005,32,Argentina,Austria,1583,701,882
2005,68,Bolivia (Plurinational State of),Austria,152,67,85
2005,76,Brazil,Austria,2789,1273,1516
2005,152,Chile,Austria,784,390,394
2005,170,Colombia,Austria,187,99,88
2005,218,Ecuador,Austria,268,154,114
2005,604,Peru,Austria,169,92,77
2005,862,Venezuela (Bolivarian Republic of),Austria,802,404,398
2005,36,Australia,Austria,21040,11172,9868
2005,554,New Zealand,Austria,1279,621,658
2005,112,Belarus,Austria,59,17,42
2005,100,Bulgaria,Austria,149,89,60
2005,203,Czechia,Austria,3043,1843,1200
2005,348,Hungary,Austria,6822,3685,3137
2005,616,Poland,Austria,4138,2004,2134
2005,642,Romania,Austria,626,337,289
2005,643,Russian Federation,Austria,3430,1689,1741
2005,703,Slovakia,Austria,2322,1297,1025
2005,208,Denmark,Austria,1652,815,837
2005,246,Finland,Austria,399,224,175
2005,352,Iceland,Austria,109,47,62
2005,372,Ireland,Austria,634,270,364
2005,428,Latvia,Austria,124,67,57
2005,440,Lithuania,Austria,54,30,24
2005,578,Norway,Austria,1073,551,522
2005,752,Sweden,Austria,5866,3272,2594
2005,826,United Kingdom,Austria,18336,5974,12362
2005,70,Bosnia and Herzegovina,Austria,188,87,101
2005,191,Croatia,Austria,3288,1603,1685
2005,300,Greece,Austria,2267,729,1538
2005,380,Italy,Austria,13214,3648,9566
2005,470,Malta,Austria,89,37,52
2005,620,Portugal,Austria,454,218,236
2005,688,Serbia,Austria,7325,3561,3764
2005,705,Slovenia,Austria,5190,2332,2858
2005,724,Spain,Austria,6332,3022,3310
2005,56,Belgium,Austria,2946,1422,1524
2005,250,France,Austria,12167,4787,7380
2005,276,Germany,Austria,196503,98695,97808
2005,438,Liechtenstein,Austria,3109,1326,1783
2005,442,Luxembourg,Austria,548,233,315
2005,528,Netherlands,Austria,6514,2788,3726
2005,756,Switzerland,Austria,49468,20538,28930
2005,60,Bermuda,Austria,30,17,13
2005,124,Canada,Austria,19097,9343,9754
2005,840,United States of America,Austria,59792,22303,37489
2010,140,Central African Republic,Austria,24,16,8
2010,516,Namibia,Austria,609,329,280
2010,710,South Africa,Austria,4667,2627,2040
2010,818,Egypt,Austria,568,250,318
2010,434,Libya,Austria,667,361,306
2010,196,Cyprus,Austria,386,160,226
2010,268,Georgia,Austria,24,13,11
2010,376,Israel,Austria,4910,2197,2713
2010,400,Jordan,Austria,262,168,94
2010,792,Turkey,Austria,14180,6735,7445
2010,762,Tajikistan,Austria,65,30,35
2010,462,Maldives,Austria,20,15,5
2010,392,Japan,Austria,569,256,313
2010,496,Mongolia,Austria,13,9,4
2010,608,Philippines,Austria,495,270,225
2010,44,Bahamas,Austria,37,19,18
2010,136,Cayman Islands,Austria,47,37,10
2010,214,Dominican Republic,Austria,197,126,71
2010,332,Haiti,Austria,151,128,23
2010,662,Saint Lucia,Austria,11,6,5
2010,188,Costa Rica,Austria,127,91,36
2010,222,El Salvador,Austria,11,5,6
2010,484,Mexico,Austria,501,255,246
2010,558,Nicaragua,Austria,36,22,14
2010,591,Panama,Austria,92,50,42
2010,32,Argentina,Austria,1019,470,549
2010,68,Bolivia (Plurinational State of),Austria,137,62,75
2010,76,Brazil,Austria,2318,1047,1271
2010,152,Chile,Austria,1046,525,521
2010,170,Colombia,Austria,195,106,89
2010,218,Ecuador,Austria,376,212,164
2010,604,Peru,Austria,189,103,86
2010,862,Venezuela (Bolivarian Republic of),Austria,811,408,403
2010,36,Australia,Austria,20160,10687,9473
2010,554,New Zealand,Austria,1320,640,680
2010,112,Belarus,Austria,56,16,40
2010,100,Bulgaria,Austria,194,118,76
2010,203,Czechia,Austria,2192,1853,339
2010,348,Hungary,Austria,8121,4433,3688
2010,616,Poland,Austria,3930,1909,2021
2010,642,Romania,Austria,816,441,375
2010,643,Russian Federation,Austria,2897,1382,1515
2010,703,Slovakia,Austria,2604,1470,1134
2010,208,Denmark,Austria,1747,865,882
2010,233,Estonia,Austria,70,33,37
2010,246,Finland,Austria,644,334,310
2010,352,Iceland,Austria,145,60,85
2010,372,Ireland,Austria,767,255,512
2010,428,Latvia,Austria,142,76,66
2010,440,Lithuania,Austria,60,34,26
2010,578,Norway,Austria,1307,671,636
2010,752,Sweden,Austria,5829,3207,2622
2010,826,United Kingdom,Austria,19316,6561,12755
2010,70,Bosnia and Herzegovina,Austria,211,101,110
2010,191,Croatia,Austria,5115,2588,2527
2010,300,Greece,Austria,2395,775,1620
2010,380,Italy,Austria,17060,5238,11822
2010,470,Malta,Austria,90,46,44
2010,499,Montenegro,Austria,245,75,170
2010,620,Portugal,Austria,445,217,228
2010,688,Serbia,Austria,7160,3477,3683
2010,705,Slovenia,Austria,5475,2580,2895
2010,724,Spain,Austria,8714,4070,4644
2010,56,Belgium,Austria,3252,1350,1902
2010,250,France,Austria,11793,3607,8186
2010,276,Germany,Austria,208395,101076,107319
2010,438,Liechtenstein,Austria,3615,1500,2115
2010,442,Luxembourg,Austria,634,269,365
2010,528,Netherlands,Austria,6530,2829,3701
2010,756,Switzerland,Austria,58803,22278,36525
2010,60,Bermuda,Austria,32,19,13
2010,124,Canada,Austria,17095,8542,8553
2010,840,United States of America,Austria,56016,20412,35604
2015,140,Central African Republic,Austria,21,14,7
2015,516,Namibia,Austria,596,323,273
2015,710,South Africa,Austria,8417,4551,3866
2015,324,Guinea,Austria,1,1,0
2015,818,Egypt,Austria,421,216,205
2015,434,Libya,Austria,752,403,349
2015,196,Cyprus,Austria,370,155,215
2015,268,Georgia,Austria,25,14,11
2015,376,Israel,Austria,5064,2252,2812
2015,400,Jordan,Austria,113,64,49
2015,792,Turkey,Austria,14394,6666,7728
2015,762,Tajikistan,Austria,63,29,34
2015,462,Maldives,Austria,23,20,3
2015,392,Japan,Austria,548,245,303
2015,496,Mongolia,Austria,16,10,6
2015,608,Philippines,Austria,503,275,228
2015,44,Bahamas,Austria,40,20,20
2015,136,Cayman Islands,Austria,50,41,9
2015,214,Dominican Republic,Austria,207,133,74
2015,332,Haiti,Austria,158,134,24
2015,662,Saint Lucia,Austria,10,6,4
2015,188,Costa Rica,Austria,128,92,36
2015,222,El Salvador,Austria,11,5,6
2015,484,Mexico,Austria,531,268,263
2015,558,Nicaragua,Austria,38,23,15
2015,591,Panama,Austria,108,59,49
2015,32,Argentina,Austria,1022,471,551
2015,68,Bolivia (Plurinational State of),Austria,159,72,87
2015,76,Brazil,Austria,2791,1260,1531
2015,152,Chile,Austria,1584,778,806
2015,170,Colombia,Austria,218,120,98
2015,218,Ecuador,Austria,546,306,240
2015,604,Peru,Austria,200,111,89
2015,862,Venezuela (Bolivarian Republic of),Austria,828,410,418
2015,36,Australia,Austria,17990,9428,8562
2015,554,New Zealand,Austria,1340,648,692
2015,112,Belarus,Austria,59,18,41
2015,100,Bulgaria,Austria,918,528,390
2015,203,Czechia,Austria,2618,2210,408
2015,348,Hungary,Austria,9297,5155,4142
2015,616,Poland,Austria,3789,1878,1911
2015,642,Romania,Austria,509,287,222
2015,643,Russian Federation,Austria,2953,1401,1552
2015,703,Slovakia,Austria,3361,2001,1360
2015,208,Denmark,Austria,1990,966,1024
2015,233,Estonia,Austria,118,53,65
2015,246,Finland,Austria,732,381,351
2015,352,Iceland,Austria,126,58,68
2015,372,Ireland,Austria,784,255,529
2015,428,Latvia,Austria,90,52,38
2015,440,Lithuania,Austria,60,34,26
2015,578,Norway,Austria,1595,833,762
2015,752,Sweden,Austria,5772,3152,2620
2015,826,United Kingdom,Austria,24702,7907,16795
2015,70,Bosnia and Herzegovina,Austria,209,100,109
2015,191,Croatia,Austria,5148,2598,2550
2015,300,Greece,Austria,2247,662,1585
2015,380,Italy,Austria,15788,4784,11004
2015,470,Malta,Austria,153,83,70
2015,499,Montenegro,Austria,257,80,177
2015,620,Portugal,Austria,504,234,270
2015,688,Serbia,Austria,6998,3389,3609
2015,705,Slovenia,Austria,2820,1358,1462
2015,724,Spain,Austria,8844,4063,4781
2015,56,Belgium,Austria,3296,1406,1890
2015,250,France,Austria,10904,4276,6628
2015,276,Germany,Austria,217137,105052,112085
2015,438,Liechtenstein,Austria,3829,1619,2210
2015,442,Luxembourg,Austria,967,419,548
2015,528,Netherlands,Austria,6671,2916,3755
2015,756,Switzerland,Austria,60069,23826,36243
2015,60,Bermuda,Austria,32,19,13
2015,124,Canada,Austria,15747,7475,8272
2015,840,United States of America,Austria,51129,18465,32664
2019,140,Central African Republic,Austria,23,16,7
2019,516,Namibia,Austria,630,342,288
2019,710,South Africa,Austria,9433,5104,4329
2019,818,Egypt,Austria,600,274,326
2019,434,Libya,Austria,797,427,370
2019,196,Cyprus,Austria,369,157,212
2019,268,Georgia,Austria,25,14,11
2019,376,Israel,Austria,4924,2190,2734
2019,400,Jordan,Austria,121,69,52
2019,792,Turkey,Austria,19463,9118,10345
2019,762,Tajikistan,Austria,62,29,33
2019,462,Maldives,Austria,24,21,3
2019,392,Japan,Austria,612,274,338
2019,496,Mongolia,Austria,16,10,6
2019,608,Philippines,Austria,518,283,235
2019,44,Bahamas,Austria,42,21,21
2019,136,Cayman Islands,Austria,55,45,10
2019,214,Dominican Republic,Austria,213,137,76
2019,332,Haiti,Austria,164,140,24
2019,662,Saint Lucia,Austria,9,6,3
2019,188,Costa Rica,Austria,129,93,36
2019,222,El Salvador,Austria,11,5,6
2019,484,Mexico,Austria,547,276,271
2019,558,Nicaragua,Austria,39,24,15
2019,591,Panama,Austria,114,63,51
2019,32,Argentina,Austria,1039,478,561
2019,68,Bolivia (Plurinational State of),Austria,173,79,94
2019,76,Brazil,Austria,3143,1419,1724
2019,152,Chile,Austria,2116,980,1136
2019,170,Colombia,Austria,222,122,100
2019,218,Ecuador,Austria,537,301,236
2019,604,Peru,Austria,238,138,100
2019,862,Venezuela (Bolivarian Republic of),Austria,811,400,411
2019,36,Australia,Austria,18091,9481,8610
2019,554,New Zealand,Austria,1377,666,711
2019,112,Belarus,Austria,58,18,40
2019,100,Bulgaria,Austria,1512,865,647
2019,203,Czechia,Austria,2738,2311,427
2019,348,Hungary,Austria,10297,5577,4720
2019,616,Poland,Austria,4012,2066,1946
2019,642,Romania,Austria,2120,1204,916
2019,643,Russian Federation,Austria,2952,1401,1551
2019,703,Slovakia,Austria,4051,2400,1651
2019,208,Denmark,Austria,2076,999,1077
2019,233,Estonia,Austria,135,64,71
2019,246,Finland,Austria,845,441,404
2019,352,Iceland,Austria,159,75,84
2019,372,Ireland,Austria,860,281,579
2019,428,Latvia,Austria,87,49,38
2019,440,Lithuania,Austria,61,36,25
2019,578,Norway,Austria,1770,917,853
2019,752,Sweden,Austria,5826,3037,2789
2019,826,United Kingdom,Austria,28051,9027,19024
2019,70,Bosnia and Herzegovina,Austria,193,92,101
2019,191,Croatia,Austria,4753,2392,2361
2019,300,Greece,Austria,2194,705,1489
2019,380,Italy,Austria,16063,5011,11052
2019,470,Malta,Austria,246,134,112
2019,499,Montenegro,Austria,257,81,176
2019,620,Portugal,Austria,512,239,273
2019,688,Serbia,Austria,7109,3446,3663
2019,705,Slovenia,Austria,2702,1333,1369
2019,724,Spain,Austria,9163,4091,5072
2019,56,Belgium,Austria,3474,1507,1967
2019,250,France,Austria,11541,4510,7031
2019,276,Germany,Austria,238191,123062,115129
2019,438,Liechtenstein,Austria,4014,1717,2297
2019,442,Luxembourg,Austria,1127,510,617
2019,528,Netherlands,Austria,7193,3146,4047
2019,756,Switzerland,Austria,60862,24557,36305
2019,60,Bermuda,Austria,32,19,13
2019,124,Canada,Austria,16874,8010,8864
2019,840,United States of America,Austria,55214,19562,35652
1990,818,Egypt,Azerbaijan,24,22,2
1990,51,Armenia,Azerbaijan,464459,195541,268918
1990,196,Cyprus,Azerbaijan,9,4,5
1990,268,Georgia,Azerbaijan,7911,3642,4269
1990,376,Israel,Azerbaijan,14696,7009,7687
1990,792,Turkey,Azerbaijan,4062,2202,1860
1990,398,Kazakhstan,Azerbaijan,35789,19393,16396
1990,417,Kyrgyzstan,Azerbaijan,14455,6372,8083
1990,762,Tajikistan,Azerbaijan,257,114,143
1990,795,Turkmenistan,Azerbaijan,11793,5282,6511
1990,860,Uzbekistan,Azerbaijan,23261,11682,11579
1990,364,Iran (Islamic Republic of),Azerbaijan,817,468,349
1990,188,Costa Rica,Azerbaijan,2,1,1
1990,152,Chile,Azerbaijan,3,0,3
1990,36,Australia,Azerbaijan,99,44,55
1990,112,Belarus,Azerbaijan,15651,8959,6692
1990,100,Bulgaria,Azerbaijan,8,4,4
1990,203,Czechia,Azerbaijan,45,25,20
1990,348,Hungary,Azerbaijan,134,65,69
1990,616,Poland,Azerbaijan,356,164,192
1990,498,Republic of Moldova,Azerbaijan,3748,2369,1379
1990,643,Russian Federation,Azerbaijan,936852,459725,477127
1990,703,Slovakia,Azerbaijan,4,3,1
1990,804,Ukraine,Azerbaijan,81482,34915,46567
1990,208,Denmark,Azerbaijan,84,27,57
1990,233,Estonia,Azerbaijan,2211,1358,853
1990,352,Iceland,Azerbaijan,2,1,1
1990,372,Ireland,Azerbaijan,10,6,4
1990,428,Latvia,Azerbaijan,1399,1002,397
1990,440,Lithuania,Azerbaijan,2193,1508,685
1990,752,Sweden,Azerbaijan,148,44,104
1990,826,United Kingdom,Azerbaijan,77,46,31
1990,300,Greece,Azerbaijan,171,94,77
1990,380,Italy,Azerbaijan,6,2,4
1990,620,Portugal,Azerbaijan,2,1,1
1990,724,Spain,Azerbaijan,35,15,20
1990,40,Austria,Azerbaijan,592,306,286
1990,56,Belgium,Azerbaijan,8,4,4
1990,250,France,Azerbaijan,400,203,197
1990,276,Germany,Azerbaijan,600,325,275
1990,528,Netherlands,Azerbaijan,40,17,23
1990,756,Switzerland,Azerbaijan,119,57,62
1990,124,Canada,Azerbaijan,1041,507,534
1990,840,United States of America,Azerbaijan,9026,4415,4611
1995,818,Egypt,Azerbaijan,23,22,1
1995,51,Armenia,Azerbaijan,560521,235987,324534
1995,196,Cyprus,Azerbaijan,13,5,8
1995,268,Georgia,Azerbaijan,6433,3131,3302
1995,376,Israel,Azerbaijan,15271,7180,8091
1995,792,Turkey,Azerbaijan,9832,5143,4689
1995,398,Kazakhstan,Azerbaijan,35661,19146,16515
1995,417,Kyrgyzstan,Azerbaijan,11702,5495,6207
1995,762,Tajikistan,Azerbaijan,209,81,128
1995,795,Turkmenistan,Azerbaijan,9633,4794,4839
1995,860,Uzbekistan,Azerbaijan,22987,11422,11565
1995,364,Iran (Islamic Republic of),Azerbaijan,898,515,383
1995,188,Costa Rica,Azerbaijan,2,1,1
1995,68,Bolivia (Plurinational State of),Azerbaijan,1,0,1
1995,152,Chile,Azerbaijan,2,1,1
1995,36,Australia,Azerbaijan,128,54,74
1995,112,Belarus,Azerbaijan,14826,8516,6310
1995,100,Bulgaria,Azerbaijan,466,210,256
1995,203,Czechia,Azerbaijan,68,38,30
1995,348,Hungary,Azerbaijan,119,57,62
1995,616,Poland,Azerbaijan,304,138,166
1995,498,Republic of Moldova,Azerbaijan,2530,1575,955
1995,643,Russian Federation,Azerbaijan,905728,481763,423965
1995,703,Slovakia,Azerbaijan,11,4,7
1995,804,Ukraine,Azerbaijan,87250,43333,43917
1995,208,Denmark,Azerbaijan,90,29,61
1995,233,Estonia,Azerbaijan,1824,1106,718
1995,246,Finland,Azerbaijan,4,1,3
1995,352,Iceland,Azerbaijan,3,1,2
1995,372,Ireland,Azerbaijan,27,14,13
1995,428,Latvia,Azerbaijan,2254,1435,819
1995,440,Lithuania,Azerbaijan,1711,1178,533
1995,578,Norway,Azerbaijan,3,0,3
1995,752,Sweden,Azerbaijan,176,51,125
1995,826,United Kingdom,Azerbaijan,307,152,155
1995,300,Greece,Azerbaijan,277,124,153
1995,380,Italy,Azerbaijan,52,20,32
1995,620,Portugal,Azerbaijan,5,3,2
1995,724,Spain,Azerbaijan,54,24,30
1995,40,Austria,Azerbaijan,668,351,317
1995,56,Belgium,Azerbaijan,6,3,3
1995,250,France,Azerbaijan,413,206,207
1995,276,Germany,Azerbaijan,6621,3367,3254
1995,528,Netherlands,Azerbaijan,58,23,35
1995,756,Switzerland,Azerbaijan,225,110,115
1995,124,Canada,Azerbaijan,1045,506,539
1995,840,United States of America,Azerbaijan,11770,5818,5952
2000,818,Egypt,Azerbaijan,24,23,1
2000,51,Armenia,Azerbaijan,525188,221595,303593
2000,196,Cyprus,Azerbaijan,16,6,10
2000,268,Georgia,Azerbaijan,5780,1985,3795
2000,376,Israel,Azerbaijan,14990,7034,7956
2000,792,Turkey,Azerbaijan,15638,8093,7545
2000,398,Kazakhstan,Azerbaijan,35532,18899,16633
2000,417,Kyrgyzstan,Azerbaijan,8631,4453,4178
2000,762,Tajikistan,Azerbaijan,180,70,110
2000,795,Turkmenistan,Azerbaijan,7809,3768,4041
2000,860,Uzbekistan,Azerbaijan,22744,11201,11543
2000,364,Iran (Islamic Republic of),Azerbaijan,937,555,382
2000,188,Costa Rica,Azerbaijan,2,1,1
2000,68,Bolivia (Plurinational State of),Azerbaijan,2,1,1
2000,152,Chile,Azerbaijan,2,0,2
2000,36,Australia,Azerbaijan,190,81,109
2000,112,Belarus,Azerbaijan,14000,8073,5927
2000,100,Bulgaria,Azerbaijan,923,415,508
2000,203,Czechia,Azerbaijan,91,52,39
2000,348,Hungary,Azerbaijan,103,48,55
2000,616,Poland,Azerbaijan,260,115,145
2000,498,Republic of Moldova,Azerbaijan,1708,1046,662
2000,643,Russian Federation,Azerbaijan,841759,486490,355269
2000,703,Slovakia,Azerbaijan,23,8,15
2000,804,Ukraine,Azerbaijan,94083,52279,41804
2000,208,Denmark,Azerbaijan,95,30,65
2000,233,Estonia,Azerbaijan,1437,855,582
2000,246,Finland,Azerbaijan,8,3,5
2000,352,Iceland,Azerbaijan,3,1,2
2000,372,Ireland,Azerbaijan,59,32,27
2000,428,Latvia,Azerbaijan,3109,1868,1241
2000,440,Lithuania,Azerbaijan,1340,922,418
2000,578,Norway,Azerbaijan,63,25,38
2000,752,Sweden,Azerbaijan,189,54,135
2000,826,United Kingdom,Azerbaijan,544,260,284
2000,300,Greece,Azerbaijan,387,153,234
2000,380,Italy,Azerbaijan,98,39,59
2000,620,Portugal,Azerbaijan,10,5,5
2000,724,Spain,Azerbaijan,655,324,331
2000,40,Austria,Azerbaijan,744,396,348
2000,56,Belgium,Azerbaijan,5,3,2
2000,250,France,Azerbaijan,426,210,216
2000,276,Germany,Azerbaijan,12642,6409,6233
2000,528,Netherlands,Azerbaijan,81,31,50
2000,756,Switzerland,Azerbaijan,333,164,169
2000,124,Canada,Azerbaijan,1074,518,556
2000,840,United States of America,Azerbaijan,14565,7256,7309
2005,818,Egypt,Azerbaijan,29,28,1
2005,51,Armenia,Azerbaijan,376174,155701,220473
2005,196,Cyprus,Azerbaijan,24,9,15
2005,268,Georgia,Azerbaijan,5490,1885,3605
2005,376,Israel,Azerbaijan,13969,6567,7402
2005,792,Turkey,Azerbaijan,16114,8164,7950
2005,398,Kazakhstan,Azerbaijan,40508,22048,18460
2005,417,Kyrgyzstan,Azerbaijan,7024,3603,3421
2005,762,Tajikistan,Azerbaijan,173,65,108
2005,795,Turkmenistan,Azerbaijan,7745,3778,3967
2005,860,Uzbekistan,Azerbaijan,22504,11378,11126
2005,364,Iran (Islamic Republic of),Azerbaijan,1124,666,458
2005,188,Costa Rica,Azerbaijan,1,0,1
2005,68,Bolivia (Plurinational State of),Azerbaijan,2,1,1
2005,152,Chile,Azerbaijan,3,1,2
2005,36,Australia,Azerbaijan,300,126,174
2005,112,Belarus,Azerbaijan,13806,7960,5846
2005,100,Bulgaria,Azerbaijan,1526,706,820
2005,203,Czechia,Azerbaijan,406,224,182
2005,348,Hungary,Azerbaijan,127,59,68
2005,616,Poland,Azerbaijan,263,131,132
2005,498,Republic of Moldova,Azerbaijan,1180,714,466
2005,643,Russian Federation,Azerbaijan,805658,457244,348414
2005,703,Slovakia,Azerbaijan,26,9,17
2005,804,Ukraine,Azerbaijan,85967,47823,38144
2005,208,Denmark,Azerbaijan,187,77,110
2005,233,Estonia,Azerbaijan,1525,901,624
2005,246,Finland,Azerbaijan,48,19,29
2005,352,Iceland,Azerbaijan,5,1,4
2005,372,Ireland,Azerbaijan,59,34,25
2005,428,Latvia,Azerbaijan,2806,1674,1132
2005,440,Lithuania,Azerbaijan,1271,859,412
2005,578,Norway,Azerbaijan,188,81,107
2005,752,Sweden,Azerbaijan,713,295,418
2005,826,United Kingdom,Azerbaijan,1598,743,855
2005,300,Greece,Azerbaijan,453,178,275
2005,380,Italy,Azerbaijan,404,128,276
2005,620,Portugal,Azerbaijan,37,22,15
2005,705,Slovenia,Azerbaijan,1,1,0
2005,724,Spain,Azerbaijan,315,153,162
2005,40,Austria,Azerbaijan,832,433,399
2005,56,Belgium,Azerbaijan,71,32,39
2005,250,France,Azerbaijan,2560,1189,1371
2005,276,Germany,Azerbaijan,14234,7208,7026
2005,528,Netherlands,Azerbaijan,539,270,269
2005,756,Switzerland,Azerbaijan,408,191,217
2005,124,Canada,Azerbaijan,1960,974,986
2005,840,United States of America,Azerbaijan,15759,7895,7864
2010,818,Egypt,Azerbaijan,31,30,1
2010,51,Armenia,Azerbaijan,130855,54162,76693
2010,196,Cyprus,Azerbaijan,39,15,24
2010,268,Georgia,Azerbaijan,5544,1903,3641
2010,376,Israel,Azerbaijan,13118,6165,6953
2010,792,Turkey,Azerbaijan,16605,8228,8377
2010,398,Kazakhstan,Azerbaijan,45483,25197,20286
2010,417,Kyrgyzstan,Azerbaijan,5311,2689,2622
2010,762,Tajikistan,Azerbaijan,172,65,107
2010,795,Turkmenistan,Azerbaijan,7515,3519,3996
2010,860,Uzbekistan,Azerbaijan,21360,11100,10260
2010,364,Iran (Islamic Republic of),Azerbaijan,12128,7427,4701
2010,188,Costa Rica,Azerbaijan,3,2,1
2010,68,Bolivia (Plurinational State of),Azerbaijan,1,0,1
2010,152,Chile,Azerbaijan,4,1,3
2010,36,Australia,Azerbaijan,420,176,244
2010,112,Belarus,Azerbaijan,13611,7846,5765
2010,100,Bulgaria,Azerbaijan,2064,965,1099
2010,203,Czechia,Azerbaijan,681,381,300
2010,348,Hungary,Azerbaijan,151,71,80
2010,616,Poland,Azerbaijan,276,150,126
2010,498,Republic of Moldova,Azerbaijan,896,547,349
2010,643,Russian Federation,Azerbaijan,752975,418800,334175
2010,703,Slovakia,Azerbaijan,29,10,19
2010,804,Ukraine,Azerbaijan,82025,45681,36344
2010,208,Denmark,Azerbaijan,273,122,151
2010,233,Estonia,Azerbaijan,1600,937,663
2010,246,Finland,Azerbaijan,102,37,65
2010,352,Iceland,Azerbaijan,7,2,5
2010,372,Ireland,Azerbaijan,49,26,23
2010,428,Latvia,Azerbaijan,2433,1422,1011
2010,440,Lithuania,Azerbaijan,1031,660,371
2010,578,Norway,Azerbaijan,368,156,212
2010,752,Sweden,Azerbaijan,2107,996,1111
2010,826,United Kingdom,Azerbaijan,1683,801,882
2010,300,Greece,Azerbaijan,538,210,328
2010,380,Italy,Azerbaijan,668,214,454
2010,620,Portugal,Azerbaijan,58,35,23
2010,705,Slovenia,Azerbaijan,4,3,1
2010,724,Spain,Azerbaijan,499,238,261
2010,40,Austria,Azerbaijan,919,470,449
2010,56,Belgium,Azerbaijan,122,69,53
2010,250,France,Azerbaijan,3860,1858,2002
2010,276,Germany,Azerbaijan,15517,7847,7670
2010,528,Netherlands,Azerbaijan,594,301,293
2010,756,Switzerland,Azerbaijan,440,191,249
2010,124,Canada,Azerbaijan,2930,1475,1455
2010,840,United States of America,Azerbaijan,17468,8632,8836
2015,324,Guinea,Azerbaijan,5,5,0
2015,818,Egypt,Azerbaijan,22,22,0
2015,51,Armenia,Azerbaijan,78908,32661,46247
2015,196,Cyprus,Azerbaijan,37,15,22
2015,268,Georgia,Azerbaijan,5821,1998,3823
2015,376,Israel,Azerbaijan,13529,6323,7206
2015,792,Turkey,Azerbaijan,16856,8160,8696
2015,398,Kazakhstan,Azerbaijan,48377,27154,21223
2015,417,Kyrgyzstan,Azerbaijan,4678,2355,2323
2015,762,Tajikistan,Azerbaijan,169,64,105
2015,795,Turkmenistan,Azerbaijan,7654,3732,3922
2015,860,Uzbekistan,Azerbaijan,20357,10745,9612
2015,364,Iran (Islamic Republic of),Azerbaijan,12007,7306,4701
2015,188,Costa Rica,Azerbaijan,3,2,1
2015,68,Bolivia (Plurinational State of),Azerbaijan,1,0,1
2015,152,Chile,Azerbaijan,6,2,4
2015,36,Australia,Azerbaijan,650,273,377
2015,112,Belarus,Azerbaijan,13493,7781,5712
2015,100,Bulgaria,Azerbaijan,1886,848,1038
2015,203,Czechia,Azerbaijan,1142,663,479
2015,348,Hungary,Azerbaijan,214,115,99
2015,616,Poland,Azerbaijan,266,147,119
2015,498,Republic of Moldova,Azerbaijan,741,455,286
2015,643,Russian Federation,Azerbaijan,767339,425084,342255
2015,703,Slovakia,Azerbaijan,37,15,22
2015,804,Ukraine,Azerbaijan,82299,45884,36415
2015,208,Denmark,Azerbaijan,321,139,182
2015,233,Estonia,Azerbaijan,1484,856,628
2015,246,Finland,Azerbaijan,152,63,89
2015,352,Iceland,Azerbaijan,13,4,9
2015,372,Ireland,Azerbaijan,50,26,24
2015,428,Latvia,Azerbaijan,1922,1099,823
2015,440,Lithuania,Azerbaijan,878,562,316
2015,578,Norway,Azerbaijan,526,231,295
2015,752,Sweden,Azerbaijan,2935,1409,1526
2015,826,United Kingdom,Azerbaijan,2152,991,1161
2015,300,Greece,Azerbaijan,504,184,320
2015,380,Italy,Azerbaijan,700,208,492
2015,620,Portugal,Azerbaijan,65,37,28
2015,705,Slovenia,Azerbaijan,10,7,3
2015,724,Spain,Azerbaijan,616,283,333
2015,40,Austria,Azerbaijan,1076,554,522
2015,56,Belgium,Azerbaijan,202,117,85
2015,250,France,Azerbaijan,4276,1997,2279
2015,276,Germany,Azerbaijan,16168,8158,8010
2015,528,Netherlands,Azerbaijan,728,386,342
2015,756,Switzerland,Azerbaijan,765,360,405
2015,124,Canada,Azerbaijan,3821,1684,2137
2015,840,United States of America,Azerbaijan,21961,10797,11164
2019,324,Guinea,Azerbaijan,4,4,0
2019,818,Egypt,Azerbaijan,31,31,0
2019,51,Armenia,Azerbaijan,78478,32884,45594
2019,196,Cyprus,Azerbaijan,36,15,21
2019,268,Georgia,Azerbaijan,5999,2058,3941
2019,376,Israel,Azerbaijan,13156,6149,7007
2019,792,Turkey,Azerbaijan,22792,11151,11641
2019,398,Kazakhstan,Azerbaijan,50552,28375,22177
2019,417,Kyrgyzstan,Azerbaijan,4583,2307,2276
2019,762,Tajikistan,Azerbaijan,168,64,104
2019,795,Turkmenistan,Azerbaijan,7605,3757,3848
2019,860,Uzbekistan,Azerbaijan,20313,10729,9584
2019,364,Iran (Islamic Republic of),Azerbaijan,11812,7188,4624
2019,188,Costa Rica,Azerbaijan,3,2,1
2019,68,Bolivia (Plurinational State of),Azerbaijan,1,0,1
2019,152,Chile,Azerbaijan,8,3,5
2019,36,Australia,Azerbaijan,740,334,406
2019,112,Belarus,Azerbaijan,13324,7684,5640
2019,100,Bulgaria,Azerbaijan,2103,951,1152
2019,203,Czechia,Azerbaijan,1357,800,557
2019,348,Hungary,Azerbaijan,404,232,172
2019,616,Poland,Azerbaijan,281,160,121
2019,498,Republic of Moldova,Azerbaijan,729,448,281
2019,643,Russian Federation,Azerbaijan,767159,424984,342175
2019,703,Slovakia,Azerbaijan,43,20,23
2019,804,Ukraine,Azerbaijan,83121,46342,36779
2019,208,Denmark,Azerbaijan,382,162,220
2019,233,Estonia,Azerbaijan,1468,850,618
2019,246,Finland,Azerbaijan,204,94,110
2019,352,Iceland,Azerbaijan,16,7,9
2019,372,Ireland,Azerbaijan,54,28,26
2019,428,Latvia,Azerbaijan,1788,1031,757
2019,440,Lithuania,Azerbaijan,619,361,258
2019,578,Norway,Azerbaijan,579,251,328
2019,752,Sweden,Azerbaijan,3654,1789,1865
2019,826,United Kingdom,Azerbaijan,2443,1128,1315
2019,300,Greece,Azerbaijan,492,192,300
2019,380,Italy,Azerbaijan,811,238,573
2019,620,Portugal,Azerbaijan,66,38,28
2019,705,Slovenia,Azerbaijan,21,12,9
2019,724,Spain,Azerbaijan,638,285,353
2019,40,Austria,Azerbaijan,1270,665,605
2019,56,Belgium,Azerbaijan,237,133,104
2019,250,France,Azerbaijan,4526,2109,2417
2019,276,Germany,Azerbaijan,22245,11788,10457
2019,528,Netherlands,Azerbaijan,892,477,415
2019,756,Switzerland,Azerbaijan,851,407,444
2019,124,Canada,Azerbaijan,4094,1804,2290
2019,840,United States of America,Azerbaijan,23715,11530,12185
1990,516,Namibia,Bahamas,74,19,55
1990,818,Egypt,Bahamas,11,1,10
1990,28,Antigua and Barbuda,Bahamas,5,2,3
1990,52,Barbados,Bahamas,55,25,30
1990,92,British Virgin Islands,Bahamas,14,5,9
1990,535,"Bonaire, Sint Eustatius and Saba",Bahamas,44,21,23
1990,136,Cayman Islands,Bahamas,58,31,27
1990,212,Dominica,Bahamas,5,2,3
1990,214,Dominican Republic,Bahamas,91,39,52
1990,308,Grenada,Bahamas,17,8,9
1990,388,Jamaica,Bahamas,518,255,263
1990,659,Saint Kitts and Nevis,Bahamas,5,2,3
1990,662,Saint Lucia,Bahamas,6,4,2
1990,796,Turks and Caicos Islands,Bahamas,840,435,405
1990,188,Costa Rica,Bahamas,10,7,3
1990,558,Nicaragua,Bahamas,23,12,11
1990,68,Bolivia (Plurinational State of),Bahamas,9,7,2
1990,152,Chile,Bahamas,1,1,0
1990,218,Ecuador,Bahamas,16,9,7
1990,328,Guyana,Bahamas,4,2,2
1990,36,Australia,Bahamas,178,92,86
1990,100,Bulgaria,Bahamas,1,1,0
1990,348,Hungary,Bahamas,1,1,0
1990,208,Denmark,Bahamas,5,1,4
1990,246,Finland,Bahamas,1,0,1
1990,352,Iceland,Bahamas,1,0,1
1990,372,Ireland,Bahamas,5,3,2
1990,578,Norway,Bahamas,7,4,3
1990,752,Sweden,Bahamas,12,10,2
1990,826,United Kingdom,Bahamas,250,150,100
1990,300,Greece,Bahamas,21,12,9
1990,380,Italy,Bahamas,6,2,4
1990,724,Spain,Bahamas,5,3,2
1990,40,Austria,Bahamas,13,7,6
1990,56,Belgium,Bahamas,13,7,6
1990,250,France,Bahamas,64,26,38
1990,528,Netherlands,Bahamas,24,15,9
1990,756,Switzerland,Bahamas,75,38,37
1990,124,Canada,Bahamas,1061,517,544
1990,840,United States of America,Bahamas,21633,8852,12781
1995,516,Namibia,Bahamas,70,18,52
1995,818,Egypt,Bahamas,11,2,9
1995,28,Antigua and Barbuda,Bahamas,4,2,2
1995,52,Barbados,Bahamas,59,27,32
1995,92,British Virgin Islands,Bahamas,16,5,11
1995,535,"Bonaire, Sint Eustatius and Saba",Bahamas,91,43,48
1995,136,Cayman Islands,Bahamas,110,57,53
1995,212,Dominica,Bahamas,6,2,4
1995,214,Dominican Republic,Bahamas,101,42,59
1995,308,Grenada,Bahamas,22,11,11
1995,388,Jamaica,Bahamas,616,302,314
1995,659,Saint Kitts and Nevis,Bahamas,8,4,4
1995,662,Saint Lucia,Bahamas,7,5,2
1995,796,Turks and Caicos Islands,Bahamas,649,342,307
1995,188,Costa Rica,Bahamas,8,6,2
1995,558,Nicaragua,Bahamas,19,10,9
1995,68,Bolivia (Plurinational State of),Bahamas,5,4,1
1995,152,Chile,Bahamas,1,1,0
1995,218,Ecuador,Bahamas,18,10,8
1995,328,Guyana,Bahamas,6,3,3
1995,36,Australia,Bahamas,230,109,121
1995,100,Bulgaria,Bahamas,2,1,1
1995,348,Hungary,Bahamas,3,2,1
1995,208,Denmark,Bahamas,7,1,6
1995,246,Finland,Bahamas,2,0,2
1995,352,Iceland,Bahamas,1,0,1
1995,372,Ireland,Bahamas,14,7,7
1995,578,Norway,Bahamas,8,4,4
1995,752,Sweden,Bahamas,14,12,2
1995,826,United Kingdom,Bahamas,984,481,503
1995,300,Greece,Bahamas,21,10,11
1995,380,Italy,Bahamas,17,5,12
1995,724,Spain,Bahamas,9,5,4
1995,40,Austria,Bahamas,15,8,7
1995,56,Belgium,Bahamas,13,7,6
1995,250,France,Bahamas,67,27,40
1995,528,Netherlands,Bahamas,34,21,13
1995,756,Switzerland,Bahamas,79,43,36
1995,124,Canada,Bahamas,1153,559,594
1995,840,United States of America,Bahamas,25186,10444,14742
2000,516,Namibia,Bahamas,67,17,50
2000,818,Egypt,Bahamas,11,2,9
2000,28,Antigua and Barbuda,Bahamas,2,1,1
2000,52,Barbados,Bahamas,64,29,35
2000,92,British Virgin Islands,Bahamas,18,5,13
2000,535,"Bonaire, Sint Eustatius and Saba",Bahamas,139,65,74
2000,136,Cayman Islands,Bahamas,190,99,91
2000,212,Dominica,Bahamas,7,2,5
2000,214,Dominican Republic,Bahamas,111,45,66
2000,308,Grenada,Bahamas,27,13,14
2000,388,Jamaica,Bahamas,713,348,365
2000,659,Saint Kitts and Nevis,Bahamas,11,6,5
2000,662,Saint Lucia,Bahamas,10,7,3
2000,796,Turks and Caicos Islands,Bahamas,459,249,210
2000,188,Costa Rica,Bahamas,9,7,2
2000,558,Nicaragua,Bahamas,45,23,22
2000,152,Chile,Bahamas,1,1,0
2000,218,Ecuador,Bahamas,20,11,9
2000,328,Guyana,Bahamas,8,4,4
2000,36,Australia,Bahamas,270,126,144
2000,100,Bulgaria,Bahamas,2,0,2
2000,348,Hungary,Bahamas,5,3,2
2000,208,Denmark,Bahamas,9,2,7
2000,246,Finland,Bahamas,3,1,2
2000,352,Iceland,Bahamas,1,0,1
2000,372,Ireland,Bahamas,31,16,15
2000,578,Norway,Bahamas,9,4,5
2000,752,Sweden,Bahamas,16,13,3
2000,826,United Kingdom,Bahamas,1735,818,917
2000,300,Greece,Bahamas,21,8,13
2000,380,Italy,Bahamas,27,8,19
2000,724,Spain,Bahamas,116,65,51
2000,40,Austria,Bahamas,16,9,7
2000,56,Belgium,Bahamas,6,0,6
2000,250,France,Bahamas,69,27,42
2000,528,Netherlands,Bahamas,48,28,20
2000,756,Switzerland,Bahamas,84,47,37
2000,124,Canada,Bahamas,1273,615,658
2000,840,United States of America,Bahamas,28788,12079,16709
2005,516,Namibia,Bahamas,52,13,39
2005,818,Egypt,Bahamas,13,3,10
2005,28,Antigua and Barbuda,Bahamas,2,1,1
2005,52,Barbados,Bahamas,55,25,30
2005,92,British Virgin Islands,Bahamas,21,6,15
2005,535,"Bonaire, Sint Eustatius and Saba",Bahamas,148,70,78
2005,136,Cayman Islands,Bahamas,172,90,82
2005,212,Dominica,Bahamas,8,3,5
2005,214,Dominican Republic,Bahamas,74,36,38
2005,308,Grenada,Bahamas,28,14,14
2005,388,Jamaica,Bahamas,695,341,354
2005,659,Saint Kitts and Nevis,Bahamas,19,11,8
2005,662,Saint Lucia,Bahamas,11,8,3
2005,796,Turks and Caicos Islands,Bahamas,346,183,163
2005,188,Costa Rica,Bahamas,6,5,1
2005,558,Nicaragua,Bahamas,73,36,37
2005,76,Brazil,Bahamas,7,2,5
2005,152,Chile,Bahamas,1,1,0
2005,218,Ecuador,Bahamas,24,14,10
2005,328,Guyana,Bahamas,11,5,6
2005,36,Australia,Bahamas,270,121,149
2005,100,Bulgaria,Bahamas,3,0,3
2005,348,Hungary,Bahamas,6,4,2
2005,208,Denmark,Bahamas,12,4,8
2005,246,Finland,Bahamas,6,3,3
2005,352,Iceland,Bahamas,3,1,2
2005,372,Ireland,Bahamas,31,17,14
2005,578,Norway,Bahamas,8,4,4
2005,752,Sweden,Bahamas,26,19,7
2005,826,United Kingdom,Bahamas,1719,802,917
2005,300,Greece,Bahamas,22,9,13
2005,380,Italy,Bahamas,60,21,39
2005,724,Spain,Bahamas,56,31,25
2005,40,Austria,Bahamas,18,10,8
2005,56,Belgium,Bahamas,26,13,13
2005,250,France,Bahamas,42,16,26
2005,528,Netherlands,Bahamas,54,30,24
2005,756,Switzerland,Bahamas,96,52,44
2005,124,Canada,Bahamas,1556,792,764
2005,840,United States of America,Bahamas,29086,12299,16787
2010,516,Namibia,Bahamas,50,13,37
2010,818,Egypt,Bahamas,14,3,11
2010,28,Antigua and Barbuda,Bahamas,2,1,1
2010,52,Barbados,Bahamas,47,20,27
2010,92,British Virgin Islands,Bahamas,23,6,17
2010,535,"Bonaire, Sint Eustatius and Saba",Bahamas,19,5,14
2010,136,Cayman Islands,Bahamas,171,90,81
2010,531,Curaçao,Bahamas,75,37,38
2010,212,Dominica,Bahamas,10,4,6
2010,214,Dominican Republic,Bahamas,37,28,9
2010,308,Grenada,Bahamas,30,15,15
2010,388,Jamaica,Bahamas,677,335,342
2010,659,Saint Kitts and Nevis,Bahamas,21,13,8
2010,662,Saint Lucia,Bahamas,12,9,3
2010,796,Turks and Caicos Islands,Bahamas,251,130,121
2010,188,Costa Rica,Bahamas,12,9,3
2010,558,Nicaragua,Bahamas,78,39,39
2010,76,Brazil,Bahamas,15,5,10
2010,152,Chile,Bahamas,2,2,0
2010,218,Ecuador,Bahamas,33,19,14
2010,328,Guyana,Bahamas,13,6,7
2010,36,Australia,Bahamas,280,120,160
2010,100,Bulgaria,Bahamas,4,0,4
2010,348,Hungary,Bahamas,7,5,2
2010,208,Denmark,Bahamas,13,6,7
2010,246,Finland,Bahamas,11,4,7
2010,352,Iceland,Bahamas,4,2,2
2010,372,Ireland,Bahamas,26,14,12
2010,578,Norway,Bahamas,14,8,6
2010,752,Sweden,Bahamas,27,20,7
2010,826,United Kingdom,Bahamas,1810,864,946
2010,300,Greece,Bahamas,23,11,12
2010,380,Italy,Bahamas,90,34,56
2010,724,Spain,Bahamas,53,27,26
2010,40,Austria,Bahamas,19,10,9
2010,56,Belgium,Bahamas,13,8,5
2010,250,France,Bahamas,42,16,26
2010,528,Netherlands,Bahamas,54,28,26
2010,756,Switzerland,Bahamas,111,56,55
2010,124,Canada,Bahamas,1525,805,720
2010,840,United States of America,Bahamas,30286,12566,17720
2015,516,Namibia,Bahamas,48,12,36
2015,324,Guinea,Bahamas,13,6,7
2015,818,Egypt,Bahamas,10,3,7
2015,28,Antigua and Barbuda,Bahamas,2,1,1
2015,52,Barbados,Bahamas,49,21,28
2015,92,British Virgin Islands,Bahamas,25,6,19
2015,535,"Bonaire, Sint Eustatius and Saba",Bahamas,21,6,15
2015,136,Cayman Islands,Bahamas,185,97,88
2015,531,Curaçao,Bahamas,81,40,41
2015,212,Dominica,Bahamas,12,5,7
2015,214,Dominican Republic,Bahamas,39,30,9
2015,308,Grenada,Bahamas,30,15,15
2015,388,Jamaica,Bahamas,662,327,335
2015,659,Saint Kitts and Nevis,Bahamas,24,15,9
2015,662,Saint Lucia,Bahamas,11,9,2
2015,796,Turks and Caicos Islands,Bahamas,273,142,131
2015,188,Costa Rica,Bahamas,12,9,3
2015,558,Nicaragua,Bahamas,84,43,41
2015,76,Brazil,Bahamas,18,6,12
2015,152,Chile,Bahamas,3,3,0
2015,218,Ecuador,Bahamas,48,28,20
2015,328,Guyana,Bahamas,15,7,8
2015,36,Australia,Bahamas,310,144,166
2015,100,Bulgaria,Bahamas,4,0,4
2015,348,Hungary,Bahamas,6,4,2
2015,208,Denmark,Bahamas,18,8,10
2015,246,Finland,Bahamas,9,6,3
2015,352,Iceland,Bahamas,6,3,3
2015,372,Ireland,Bahamas,27,15,12
2015,578,Norway,Bahamas,21,11,10
2015,752,Sweden,Bahamas,30,22,8
2015,826,United Kingdom,Bahamas,2314,1069,1245
2015,300,Greece,Bahamas,21,10,11
2015,380,Italy,Bahamas,260,95,165
2015,724,Spain,Bahamas,58,28,30
2015,40,Austria,Bahamas,22,12,10
2015,56,Belgium,Bahamas,15,8,7
2015,250,France,Bahamas,46,17,29
2015,528,Netherlands,Bahamas,56,33,23
2015,756,Switzerland,Bahamas,131,67,64
2015,124,Canada,Bahamas,1624,779,845
2015,840,United States of America,Bahamas,36504,15038,21466
2019,516,Namibia,Bahamas,50,12,38
2019,324,Guinea,Bahamas,12,6,6
2019,818,Egypt,Bahamas,14,3,11
2019,28,Antigua and Barbuda,Bahamas,2,1,1
2019,52,Barbados,Bahamas,49,21,28
2019,92,British Virgin Islands,Bahamas,27,7,20
2019,535,"Bonaire, Sint Eustatius and Saba",Bahamas,25,8,17
2019,136,Cayman Islands,Bahamas,204,107,97
2019,531,Curaçao,Bahamas,88,44,44
2019,212,Dominica,Bahamas,12,5,7
2019,214,Dominican Republic,Bahamas,40,31,9
2019,308,Grenada,Bahamas,30,15,15
2019,388,Jamaica,Bahamas,670,331,339
2019,659,Saint Kitts and Nevis,Bahamas,24,15,9
2019,662,Saint Lucia,Bahamas,10,9,1
2019,796,Turks and Caicos Islands,Bahamas,294,153,141
2019,188,Costa Rica,Bahamas,12,9,3
2019,558,Nicaragua,Bahamas,87,45,42
2019,76,Brazil,Bahamas,20,7,13
2019,152,Chile,Bahamas,4,4,0
2019,218,Ecuador,Bahamas,47,28,19
2019,328,Guyana,Bahamas,15,7,8
2019,36,Australia,Bahamas,327,152,175
2019,100,Bulgaria,Bahamas,4,0,4
2019,348,Hungary,Bahamas,5,4,1
2019,208,Denmark,Bahamas,21,9,12
2019,246,Finland,Bahamas,10,5,5
2019,352,Iceland,Bahamas,6,3,3
2019,372,Ireland,Bahamas,29,16,13
2019,578,Norway,Bahamas,23,13,10
2019,752,Sweden,Bahamas,37,27,10
2019,826,United Kingdom,Bahamas,2627,1217,1410
2019,300,Greece,Bahamas,20,10,10
2019,380,Italy,Bahamas,114,57,57
2019,724,Spain,Bahamas,60,29,31
2019,40,Austria,Bahamas,25,14,11
2019,56,Belgium,Bahamas,13,6,7
2019,250,France,Bahamas,48,18,30
2019,528,Netherlands,Bahamas,64,34,30
2019,756,Switzerland,Bahamas,144,76,68
2019,124,Canada,Bahamas,1740,835,905
2019,840,United States of America,Bahamas,39420,15989,23431
1990,516,Namibia,Bahrain,72,20,52
1990,710,South Africa,Bahrain,161,86,75
1990,818,Egypt,Bahrain,382,153,229
1990,434,Libya,Bahrain,1091,442,649
1990,196,Cyprus,Bahrain,27,15,12
1990,400,Jordan,Bahrain,143,61,82
1990,414,Kuwait,Bahrain,189,19,170
1990,422,Lebanon,Bahrain,65,28,37
1990,512,Oman,Bahrain,106,50,56
1990,634,Qatar,Bahrain,54,15,39
1990,275,State of Palestine,Bahrain,8351,4064,4287
1990,784,United Arab Emirates,Bahrain,231,58,173
1990,50,Bangladesh,Bahrain,89,49,40
1990,144,Sri Lanka,Bahrain,4,2,2
1990,608,Philippines,Bahrain,19,13,6
1990,214,Dominican Republic,Bahrain,21,18,3
1990,188,Costa Rica,Bahrain,1,1,0
1990,32,Argentina,Bahrain,28,19,9
1990,152,Chile,Bahrain,3,2,1
1990,36,Australia,Bahrain,493,248,245
1990,100,Bulgaria,Bahrain,1,1,0
1990,203,Czechia,Bahrain,6,5,1
1990,348,Hungary,Bahrain,13,8,5
1990,208,Denmark,Bahrain,67,35,32
1990,246,Finland,Bahrain,2,1,1
1990,372,Ireland,Bahrain,16,8,8
1990,578,Norway,Bahrain,6,3,3
1990,752,Sweden,Bahrain,42,26,16
1990,826,United Kingdom,Bahrain,583,364,219
1990,300,Greece,Bahrain,5,3,2
1990,724,Spain,Bahrain,3,2,1
1990,40,Austria,Bahrain,12,6,6
1990,56,Belgium,Bahrain,55,55,0
1990,250,France,Bahrain,55,27,28
1990,528,Netherlands,Bahrain,49,24,25
1990,756,Switzerland,Bahrain,78,44,34
1990,124,Canada,Bahrain,297,145,152
1995,516,Namibia,Bahrain,68,19,49
1995,710,South Africa,Bahrain,100,44,56
1995,818,Egypt,Bahrain,325,140,185
1995,434,Libya,Bahrain,894,465,429
1995,196,Cyprus,Bahrain,38,20,18
1995,400,Jordan,Bahrain,330,186,144
1995,414,Kuwait,Bahrain,231,48,183
1995,422,Lebanon,Bahrain,150,80,70
1995,512,Oman,Bahrain,294,139,155
1995,634,Qatar,Bahrain,91,37,54
1995,275,State of Palestine,Bahrain,8161,3951,4210
1995,784,United Arab Emirates,Bahrain,498,169,329
1995,50,Bangladesh,Bahrain,10375,5603,4772
1995,144,Sri Lanka,Bahrain,50,40,10
1995,608,Philippines,Bahrain,25,17,8
1995,214,Dominican Republic,Bahrain,24,20,4
1995,188,Costa Rica,Bahrain,1,1,0
1995,32,Argentina,Bahrain,27,18,9
1995,68,Bolivia (Plurinational State of),Bahrain,1,1,0
1995,152,Chile,Bahrain,2,2,0
1995,36,Australia,Bahrain,650,338,312
1995,100,Bulgaria,Bahrain,3,2,1
1995,203,Czechia,Bahrain,9,8,1
1995,348,Hungary,Bahrain,12,7,5
1995,208,Denmark,Bahrain,81,41,40
1995,246,Finland,Bahrain,3,1,2
1995,352,Iceland,Bahrain,1,1,0
1995,372,Ireland,Bahrain,44,21,23
1995,578,Norway,Bahrain,12,6,6
1995,752,Sweden,Bahrain,50,31,19
1995,826,United Kingdom,Bahrain,2295,1195,1100
1995,300,Greece,Bahrain,15,8,7
1995,380,Italy,Bahrain,2,0,2
1995,724,Spain,Bahrain,6,4,2
1995,40,Austria,Bahrain,13,6,7
1995,56,Belgium,Bahrain,55,55,0
1995,250,France,Bahrain,57,27,30
1995,528,Netherlands,Bahrain,71,34,37
1995,756,Switzerland,Bahrain,150,83,67
1995,124,Canada,Bahrain,802,387,415
2000,516,Namibia,Bahrain,65,18,47
2000,710,South Africa,Bahrain,70,12,58
2000,818,Egypt,Bahrain,294,139,155
2000,434,Libya,Bahrain,712,505,207
2000,196,Cyprus,Bahrain,49,26,23
2000,400,Jordan,Bahrain,515,311,204
2000,414,Kuwait,Bahrain,363,97,266
2000,422,Lebanon,Bahrain,234,132,102
2000,512,Oman,Bahrain,400,205,195
2000,634,Qatar,Bahrain,116,55,61
2000,275,State of Palestine,Bahrain,7971,3837,4134
2000,784,United Arab Emirates,Bahrain,795,286,509
2000,50,Bangladesh,Bahrain,20661,11157,9504
2000,144,Sri Lanka,Bahrain,97,68,29
2000,608,Philippines,Bahrain,8381,4150,4231
2000,214,Dominican Republic,Bahrain,26,22,4
2000,188,Costa Rica,Bahrain,1,1,0
2000,32,Argentina,Bahrain,26,17,9
2000,68,Bolivia (Plurinational State of),Bahrain,1,1,0
2000,152,Chile,Bahrain,2,2,0
2000,36,Australia,Bahrain,770,414,356
2000,100,Bulgaria,Bahrain,4,2,2
2000,203,Czechia,Bahrain,12,11,1
2000,348,Hungary,Bahrain,10,5,5
2000,208,Denmark,Bahrain,95,47,48
2000,246,Finland,Bahrain,3,1,2
2000,352,Iceland,Bahrain,1,1,0
2000,372,Ireland,Bahrain,96,47,49
2000,578,Norway,Bahrain,18,10,8
2000,752,Sweden,Bahrain,54,33,21
2000,826,United Kingdom,Bahrain,4047,2043,2004
2000,300,Greece,Bahrain,26,13,13
2000,380,Italy,Bahrain,3,0,3
2000,724,Spain,Bahrain,72,48,24
2000,40,Austria,Bahrain,14,7,7
2000,56,Belgium,Bahrain,27,27,0
2000,250,France,Bahrain,58,27,31
2000,528,Netherlands,Bahrain,98,45,53
2000,756,Switzerland,Bahrain,224,122,102
2000,124,Canada,Bahrain,1327,640,687
2005,516,Namibia,Bahrain,51,14,37
2005,710,South Africa,Bahrain,91,13,78
2005,818,Egypt,Bahrain,350,177,173
2005,434,Libya,Bahrain,784,597,187
2005,196,Cyprus,Bahrain,72,38,34
2005,400,Jordan,Bahrain,745,487,258
2005,414,Kuwait,Bahrain,537,177,360
2005,422,Lebanon,Bahrain,183,106,77
2005,512,Oman,Bahrain,366,193,173
2005,634,Qatar,Bahrain,275,143,132
2005,275,State of Palestine,Bahrain,8305,3976,4329
2005,784,United Arab Emirates,Bahrain,831,329,502
2005,50,Bangladesh,Bahrain,24592,13280,11312
2005,144,Sri Lanka,Bahrain,194,100,94
2005,608,Philippines,Bahrain,6783,3412,3371
2005,214,Dominican Republic,Bahrain,23,19,4
2005,188,Costa Rica,Bahrain,1,1,0
2005,32,Argentina,Bahrain,19,12,7
2005,68,Bolivia (Plurinational State of),Bahrain,1,1,0
2005,76,Brazil,Bahrain,13,13,0
2005,152,Chile,Bahrain,3,3,0
2005,36,Australia,Bahrain,1080,603,477
2005,100,Bulgaria,Bahrain,6,3,3
2005,203,Czechia,Bahrain,15,13,2
2005,348,Hungary,Bahrain,12,6,6
2005,208,Denmark,Bahrain,88,44,44
2005,246,Finland,Bahrain,10,7,3
2005,352,Iceland,Bahrain,1,1,0
2005,372,Ireland,Bahrain,96,50,46
2005,578,Norway,Bahrain,21,11,10
2005,752,Sweden,Bahrain,54,34,20
2005,826,United Kingdom,Bahrain,4621,2352,2269
2005,300,Greece,Bahrain,25,14,11
2005,380,Italy,Bahrain,27,12,15
2005,724,Spain,Bahrain,35,23,12
2005,40,Austria,Bahrain,16,8,8
2005,56,Belgium,Bahrain,55,55,0
2005,250,France,Bahrain,143,72,71
2005,528,Netherlands,Bahrain,112,50,62
2005,756,Switzerland,Bahrain,240,128,112
2005,124,Canada,Bahrain,1681,870,811
2010,516,Namibia,Bahrain,49,14,35
2010,710,South Africa,Bahrain,142,20,122
2010,818,Egypt,Bahrain,378,184,194
2010,434,Libya,Bahrain,859,656,203
2010,196,Cyprus,Bahrain,117,63,54
2010,400,Jordan,Bahrain,958,645,313
2010,414,Kuwait,Bahrain,847,307,540
2010,422,Lebanon,Bahrain,132,81,51
2010,512,Oman,Bahrain,393,220,173
2010,634,Qatar,Bahrain,659,420,239
2010,275,State of Palestine,Bahrain,8640,4116,4524
2010,784,United Arab Emirates,Bahrain,1679,758,921
2010,50,Bangladesh,Bahrain,28471,15375,13096
2010,144,Sri Lanka,Bahrain,393,206,187
2010,608,Philippines,Bahrain,110,54,56
2010,214,Dominican Republic,Bahrain,20,17,3
2010,188,Costa Rica,Bahrain,1,1,0
2010,32,Argentina,Bahrain,12,8,4
2010,76,Brazil,Bahrain,26,26,0
2010,152,Chile,Bahrain,4,4,0
2010,36,Australia,Bahrain,1330,737,593
2010,100,Bulgaria,Bahrain,8,4,4
2010,203,Czechia,Bahrain,16,14,2
2010,348,Hungary,Bahrain,14,8,6
2010,208,Denmark,Bahrain,79,40,39
2010,233,Estonia,Bahrain,1,0,1
2010,246,Finland,Bahrain,18,13,5
2010,352,Iceland,Bahrain,1,1,0
2010,372,Ireland,Bahrain,80,38,42
2010,578,Norway,Bahrain,25,12,13
2010,752,Sweden,Bahrain,70,43,27
2010,826,United Kingdom,Bahrain,4868,2527,2341
2010,300,Greece,Bahrain,24,15,9
2010,380,Italy,Bahrain,39,19,20
2010,724,Spain,Bahrain,43,28,15
2010,40,Austria,Bahrain,18,9,9
2010,56,Belgium,Bahrain,55,31,24
2010,250,France,Bahrain,151,68,83
2010,528,Netherlands,Bahrain,104,50,54
2010,756,Switzerland,Bahrain,296,146,150
2010,124,Canada,Bahrain,1995,1080,915
2015,516,Namibia,Bahrain,47,13,34
2015,710,South Africa,Bahrain,255,25,230
2015,324,Guinea,Bahrain,3,2,1
2015,818,Egypt,Bahrain,280,155,125
2015,434,Libya,Bahrain,968,736,232
2015,196,Cyprus,Bahrain,112,61,51
2015,400,Jordan,Bahrain,412,247,165
2015,414,Kuwait,Bahrain,1297,357,940
2015,422,Lebanon,Bahrain,111,54,57
2015,512,Oman,Bahrain,893,559,334
2015,634,Qatar,Bahrain,764,506,258
2015,275,State of Palestine,Bahrain,8555,4065,4490
2015,784,United Arab Emirates,Bahrain,1834,788,1046
2015,50,Bangladesh,Bahrain,30160,16287,13873
2015,144,Sri Lanka,Bahrain,400,206,194
2015,608,Philippines,Bahrain,111,54,57
2015,214,Dominican Republic,Bahrain,21,18,3
2015,188,Costa Rica,Bahrain,1,1,0
2015,32,Argentina,Bahrain,12,8,4
2015,76,Brazil,Bahrain,31,31,0
2015,152,Chile,Bahrain,6,6,0
2015,36,Australia,Bahrain,1730,933,797
2015,100,Bulgaria,Bahrain,15,6,9
2015,203,Czechia,Bahrain,14,9,5
2015,348,Hungary,Bahrain,14,8,6
2015,208,Denmark,Bahrain,95,53,42
2015,233,Estonia,Bahrain,2,0,2
2015,246,Finland,Bahrain,24,19,5
2015,352,Iceland,Bahrain,1,1,0
2015,372,Ireland,Bahrain,82,39,43
2015,428,Latvia,Bahrain,1,1,0
2015,578,Norway,Bahrain,32,16,16
2015,752,Sweden,Bahrain,88,52,36
2015,826,United Kingdom,Bahrain,6225,3143,3082
2015,300,Greece,Bahrain,22,14,8
2015,380,Italy,Bahrain,294,162,132
2015,724,Spain,Bahrain,56,34,22
2015,40,Austria,Bahrain,21,11,10
2015,56,Belgium,Bahrain,52,30,22
2015,250,France,Bahrain,166,71,95
2015,528,Netherlands,Bahrain,121,61,60
2015,756,Switzerland,Bahrain,236,117,119
2015,124,Canada,Bahrain,2375,1282,1093
2019,516,Namibia,Bahrain,49,14,35
2019,710,South Africa,Bahrain,285,28,257
2019,324,Guinea,Bahrain,2,2,0
2019,818,Egypt,Bahrain,399,200,199
2019,434,Libya,Bahrain,1027,781,246
2019,196,Cyprus,Bahrain,111,61,50
2019,400,Jordan,Bahrain,443,266,177
2019,414,Kuwait,Bahrain,1373,378,995
2019,422,Lebanon,Bahrain,104,51,53
2019,512,Oman,Bahrain,1099,688,411
2019,634,Qatar,Bahrain,779,498,281
2019,275,State of Palestine,Bahrain,8495,4037,4458
2019,784,United Arab Emirates,Bahrain,1969,846,1123
2019,50,Bangladesh,Bahrain,30556,9318,21238
2019,144,Sri Lanka,Bahrain,403,208,195
2019,608,Philippines,Bahrain,114,56,58
2019,214,Dominican Republic,Bahrain,21,18,3
2019,188,Costa Rica,Bahrain,1,1,0
2019,32,Argentina,Bahrain,12,8,4
2019,76,Brazil,Bahrain,34,34,0
2019,152,Chile,Bahrain,8,8,0
2019,36,Australia,Bahrain,2020,1103,917
2019,100,Bulgaria,Bahrain,21,11,10
2019,203,Czechia,Bahrain,18,13,5
2019,348,Hungary,Bahrain,26,16,10
2019,208,Denmark,Bahrain,115,61,54
2019,233,Estonia,Bahrain,1,0,1
2019,246,Finland,Bahrain,29,22,7
2019,352,Iceland,Bahrain,1,1,0
2019,372,Ireland,Bahrain,90,43,47
2019,578,Norway,Bahrain,34,18,16
2019,752,Sweden,Bahrain,117,81,36
2019,826,United Kingdom,Bahrain,7069,3578,3491
2019,300,Greece,Bahrain,21,14,7
2019,380,Italy,Bahrain,63,33,30
2019,724,Spain,Bahrain,58,35,23
2019,40,Austria,Bahrain,24,13,11
2019,56,Belgium,Bahrain,54,29,25
2019,250,France,Bahrain,175,75,100
2019,528,Netherlands,Bahrain,161,81,80
2019,756,Switzerland,Bahrain,237,119,118
2019,124,Canada,Bahrain,2545,1374,1171
1990,480,Mauritius,Bangladesh,71,21,50
1990,690,Seychelles,Bangladesh,11,4,7
1990,800,Uganda,Bangladesh,49,10,39
1990,516,Namibia,Bangladesh,48,30,18
1990,710,South Africa,Bangladesh,2469,1763,706
1990,818,Egypt,Bangladesh,112,89,23
1990,434,Libya,Bangladesh,318,252,66
1990,48,Bahrain,Bangladesh,20442,18393,2049
1990,196,Cyprus,Bangladesh,162,159,3
1990,400,Jordan,Bangladesh,948,651,297
1990,414,Kuwait,Bangladesh,126783,109188,17595
1990,422,Lebanon,Bangladesh,433,297,136
1990,512,Oman,Bangladesh,50041,49323,718
1990,634,Qatar,Bangladesh,36556,33076,3480
1990,682,Saudi Arabia,Bangladesh,479380,357396,121984
1990,792,Turkey,Bangladesh,79,73,6
1990,784,United Arab Emirates,Bangladesh,154869,139177,15692
1990,64,Bhutan,Bangladesh,24,16,8
1990,356,India,Bangladesh,4375155,2324893,2050262
1990,462,Maldives,Bangladesh,1623,892,731
1990,524,Nepal,Bangladesh,500,43,457
1990,144,Sri Lanka,Bangladesh,7,5,2
1990,156,China,Bangladesh,1858,631,1227
1990,344,"China, Hong Kong SAR",Bangladesh,297,194,103
1990,408,Dem. People's Republic of Korea,Bangladesh,74,21,53
1990,392,Japan,Bangladesh,2110,1075,1035
1990,410,Republic of Korea,Bangladesh,658,654,4
1990,96,Brunei Darussalam,Bangladesh,659,593,66
1990,458,Malaysia,Bangladesh,23930,22967,963
1990,104,Myanmar,Bangladesh,1370,1158,212
1990,608,Philippines,Bangladesh,70,39,31
1990,702,Singapore,Bangladesh,8818,5840,2978
1990,764,Thailand,Bangladesh,725,438,287
1990,626,Timor-Leste,Bangladesh,103,60,43
1990,704,Viet Nam,Bangladesh,225,215,10
1990,188,Costa Rica,Bangladesh,13,1,12
1990,222,El Salvador,Bangladesh,11,11,0
1990,484,Mexico,Bangladesh,35,23,12
1990,591,Panama,Bangladesh,7,7,0
1990,68,Bolivia (Plurinational State of),Bangladesh,5,3,2
1990,36,Australia,Bangladesh,2315,1388,927
1990,554,New Zealand,Bangladesh,252,164,88
1990,242,Fiji,Bangladesh,1368,654,714
1990,580,Northern Mariana Islands,Bangladesh,434,421,13
1990,100,Bulgaria,Bangladesh,22,18,4
1990,203,Czechia,Bangladesh,8,7,1
1990,348,Hungary,Bangladesh,60,52,8
1990,616,Poland,Bangladesh,60,57,3
1990,642,Romania,Bangladesh,3,2,1
1990,643,Russian Federation,Bangladesh,1280,628,652
1990,208,Denmark,Bangladesh,241,78,163
1990,246,Finland,Bangladesh,115,93,22
1990,372,Ireland,Bangladesh,157,77,80
1990,428,Latvia,Bangladesh,3,3,0
1990,578,Norway,Bangladesh,558,350,208
1990,752,Sweden,Bangladesh,2307,1254,1053
1990,826,United Kingdom,Bangladesh,102380,54463,47917
1990,300,Greece,Bangladesh,7665,4245,3420
1990,380,Italy,Bangladesh,5421,4827,594
1990,470,Malta,Bangladesh,6,3,3
1990,620,Portugal,Bangladesh,76,72,4
1990,724,Spain,Bangladesh,248,205,43
1990,40,Austria,Bangladesh,1508,1007,501
1990,56,Belgium,Bangladesh,554,370,184
1990,250,France,Bangladesh,2198,1432,766
1990,276,Germany,Bangladesh,4767,4373,394
1990,442,Luxembourg,Bangladesh,29,17,12
1990,528,Netherlands,Bangladesh,401,145,256
1990,756,Switzerland,Bangladesh,730,571,159
1990,124,Canada,Bangladesh,4203,2046,2157
1990,840,United States of America,Bangladesh,21414,14219,7195
1995,480,Mauritius,Bangladesh,150,55,95
1995,690,Seychelles,Bangladesh,14,8,6
1995,800,Uganda,Bangladesh,46,8,38
1995,516,Namibia,Bangladesh,45,28,17
1995,710,South Africa,Bangladesh,1540,1136,404
1995,818,Egypt,Bangladesh,143,121,22
1995,434,Libya,Bangladesh,613,554,59
1995,48,Bahrain,Bangladesh,24630,21000,3630
1995,196,Cyprus,Bangladesh,229,224,5
1995,400,Jordan,Bangladesh,4677,3329,1348
1995,414,Kuwait,Bangladesh,110044,91689,18355
1995,422,Lebanon,Bangladesh,2124,1460,664
1995,512,Oman,Bangladesh,82653,78117,4536
1995,634,Qatar,Bangladesh,43199,38020,5179
1995,682,Saudi Arabia,Bangladesh,491297,366551,124746
1995,792,Turkey,Bangladesh,192,177,15
1995,784,United Arab Emirates,Bangladesh,219911,188280,31631
1995,64,Bhutan,Bangladesh,28,19,9
1995,356,India,Bangladesh,4127135,2180615,1946520
1995,462,Maldives,Bangladesh,3574,1788,1786
1995,524,Nepal,Bangladesh,577,109,468
1995,144,Sri Lanka,Bangladesh,85,75,10
1995,156,China,Bangladesh,2376,896,1480
1995,344,"China, Hong Kong SAR",Bangladesh,332,216,116
1995,408,Dem. People's Republic of Korea,Bangladesh,86,27,59
1995,392,Japan,Bangladesh,5003,2402,2601
1995,410,Republic of Korea,Bangladesh,4103,4078,25
1995,96,Brunei Darussalam,Bangladesh,908,818,90
1995,458,Malaysia,Bangladesh,33453,23327,10126
1995,104,Myanmar,Bangladesh,1557,1236,321
1995,608,Philippines,Bangladesh,94,52,42
1995,702,Singapore,Bangladesh,18587,12247,6340
1995,764,Thailand,Bangladesh,1211,714,497
1995,626,Timor-Leste,Bangladesh,112,62,50
1995,704,Viet Nam,Bangladesh,523,355,168
1995,188,Costa Rica,Bangladesh,6,1,5
1995,222,El Salvador,Bangladesh,9,9,0
1995,484,Mexico,Bangladesh,24,16,8
1995,591,Panama,Bangladesh,9,9,0
1995,68,Bolivia (Plurinational State of),Bangladesh,11,9,2
1995,152,Chile,Bangladesh,3,3,0
1995,36,Australia,Bangladesh,5562,3322,2240
1995,554,New Zealand,Bangladesh,791,456,335
1995,242,Fiji,Bangladesh,1334,654,680
1995,580,Northern Mariana Islands,Bangladesh,590,563,27
1995,100,Bulgaria,Bangladesh,150,81,69
1995,203,Czechia,Bangladesh,12,10,2
1995,348,Hungary,Bangladesh,53,46,7
1995,616,Poland,Bangladesh,51,49,2
1995,642,Romania,Bangladesh,5,4,1
1995,643,Russian Federation,Bangladesh,1035,658,377
1995,208,Denmark,Bangladesh,320,124,196
1995,246,Finland,Bangladesh,231,167,64
1995,372,Ireland,Bangladesh,557,265,292
1995,428,Latvia,Bangladesh,4,4,0
1995,578,Norway,Bangladesh,492,245,247
1995,752,Sweden,Bangladesh,2738,1479,1259
1995,826,United Kingdom,Bangladesh,124761,64825,59936
1995,300,Greece,Bangladesh,6129,4374,1755
1995,380,Italy,Bangladesh,14361,10172,4189
1995,470,Malta,Bangladesh,8,4,4
1995,620,Portugal,Bangladesh,165,155,10
1995,724,Spain,Bangladesh,387,311,76
1995,40,Austria,Bangladesh,1701,1145,556
1995,56,Belgium,Bangladesh,820,546,274
1995,250,France,Bangladesh,2269,1465,804
1995,276,Germany,Bangladesh,5304,4507,797
1995,442,Luxembourg,Bangladesh,27,16,11
1995,528,Netherlands,Bangladesh,590,205,385
1995,756,Switzerland,Bangladesh,1055,789,266
1995,124,Canada,Bangladesh,13101,6328,6773
1995,840,United States of America,Bangladesh,59134,39530,19604
2000,480,Mauritius,Bangladesh,313,102,211
2000,690,Seychelles,Bangladesh,17,12,5
2000,800,Uganda,Bangladesh,131,23,108
2000,516,Namibia,Bangladesh,44,27,17
2000,710,South Africa,Bangladesh,1064,826,238
2000,818,Egypt,Bangladesh,186,164,22
2000,434,Libya,Bangladesh,919,866,53
2000,48,Bahrain,Bangladesh,28889,23621,5268
2000,196,Cyprus,Bangladesh,296,290,6
2000,400,Jordan,Bangladesh,8402,6014,2388
2000,414,Kuwait,Bangladesh,136047,110012,26035
2000,422,Lebanon,Bangladesh,3814,2622,1192
2000,512,Oman,Bangladesh,92034,85448,6586
2000,634,Qatar,Bangladesh,43402,37323,6079
2000,682,Saudi Arabia,Bangladesh,504790,377555,127235
2000,792,Turkey,Bangladesh,307,282,25
2000,784,United Arab Emirates,Bangladesh,297620,247853,49767
2000,64,Bhutan,Bangladesh,33,23,10
2000,356,India,Bangladesh,3879114,2036336,1842778
2000,462,Maldives,Bangladesh,5286,2914,2372
2000,524,Nepal,Bangladesh,522,174,348
2000,144,Sri Lanka,Bangladesh,164,136,28
2000,156,China,Bangladesh,2895,1161,1734
2000,344,"China, Hong Kong SAR",Bangladesh,366,238,128
2000,408,Dem. People's Republic of Korea,Bangladesh,97,33,64
2000,392,Japan,Bangladesh,7177,3316,3861
2000,410,Republic of Korea,Bangladesh,8855,8802,53
2000,96,Brunei Darussalam,Bangladesh,1156,1042,114
2000,458,Malaysia,Bangladesh,53272,29945,23327
2000,104,Myanmar,Bangladesh,1359,1043,316
2000,608,Philippines,Bangladesh,754,342,412
2000,702,Singapore,Bangladesh,30155,19725,10430
2000,764,Thailand,Bangladesh,1949,1127,822
2000,626,Timor-Leste,Bangladesh,122,64,58
2000,704,Viet Nam,Bangladesh,1244,719,525
2000,188,Costa Rica,Bangladesh,2,2,0
2000,222,El Salvador,Bangladesh,6,6,0
2000,484,Mexico,Bangladesh,15,10,5
2000,591,Panama,Bangladesh,13,13,0
2000,68,Bolivia (Plurinational State of),Bangladesh,16,15,1
2000,152,Chile,Bangladesh,6,5,1
2000,36,Australia,Bangladesh,8490,5075,3415
2000,554,New Zealand,Bangladesh,1155,563,592
2000,242,Fiji,Bangladesh,1287,642,645
2000,580,Northern Mariana Islands,Bangladesh,783,755,28
2000,100,Bulgaria,Bangladesh,278,144,134
2000,203,Czechia,Bangladesh,16,13,3
2000,348,Hungary,Bangladesh,46,40,6
2000,616,Poland,Bangladesh,44,42,2
2000,642,Romania,Bangladesh,7,6,1
2000,643,Russian Federation,Bangladesh,753,664,89
2000,208,Denmark,Bangladesh,398,170,228
2000,246,Finland,Bangladesh,347,242,105
2000,372,Ireland,Bangladesh,1264,623,641
2000,428,Latvia,Bangladesh,5,5,0
2000,578,Norway,Bangladesh,485,223,262
2000,752,Sweden,Bangladesh,2937,1577,1360
2000,826,United Kingdom,Bangladesh,149241,76122,73119
2000,300,Greece,Bangladesh,4694,4544,150
2000,380,Italy,Bangladesh,23300,15516,7784
2000,470,Malta,Bangladesh,9,5,4
2000,620,Portugal,Bangladesh,261,244,17
2000,705,Slovenia,Bangladesh,3,2,1
2000,724,Spain,Bangladesh,693,551,142
2000,40,Austria,Bangladesh,1894,1283,611
2000,56,Belgium,Bangladesh,1064,709,355
2000,250,France,Bangladesh,2340,1498,842
2000,276,Germany,Bangladesh,5841,4641,1200
2000,442,Luxembourg,Bangladesh,26,15,11
2000,528,Netherlands,Bangladesh,800,270,530
2000,756,Switzerland,Bangladesh,1385,1010,375
2000,124,Canada,Bangladesh,22310,10762,11548
2000,840,United States of America,Bangladesh,97713,65460,32253
2005,480,Mauritius,Bangladesh,3672,1190,2482
2005,690,Seychelles,Bangladesh,107,84,23
2005,800,Uganda,Bangladesh,126,20,106
2005,516,Namibia,Bangladesh,34,21,13
2005,710,South Africa,Bangladesh,1400,1074,326
2005,818,Egypt,Bangladesh,221,196,25
2005,434,Libya,Bangladesh,1013,966,47
2005,48,Bahrain,Bangladesh,49900,42486,7414
2005,196,Cyprus,Bangladesh,433,424,9
2005,400,Jordan,Bangladesh,17487,13212,4275
2005,414,Kuwait,Bangladesh,175015,146554,28461
2005,422,Lebanon,Bangladesh,3717,2619,1098
2005,512,Oman,Bangladesh,92947,86008,6939
2005,634,Qatar,Bangladesh,75689,66805,8884
2005,682,Saudi Arabia,Bangladesh,623564,470864,152700
2005,792,Turkey,Bangladesh,316,290,26
2005,784,United Arab Emirates,Bangladesh,408976,350939,58037
2005,64,Bhutan,Bangladesh,41,28,13
2005,356,India,Bangladesh,3584076,1877540,1706536
2005,462,Maldives,Bangladesh,20163,12447,7716
2005,524,Nepal,Bangladesh,452,122,330
2005,144,Sri Lanka,Bangladesh,326,240,86
2005,156,China,Bangladesh,3193,1482,1711
2005,344,"China, Hong Kong SAR",Bangladesh,400,253,147
2005,408,Dem. People's Republic of Korea,Bangladesh,118,44,74
2005,392,Japan,Bangladesh,9597,4371,5226
2005,410,Republic of Korea,Bangladesh,7318,7108,210
2005,96,Brunei Darussalam,Bangladesh,1182,1066,116
2005,458,Malaysia,Bangladesh,202874,115387,87487
2005,104,Myanmar,Bangladesh,1154,889,265
2005,608,Philippines,Bangladesh,610,282,328
2005,702,Singapore,Bangladesh,47991,28036,19955
2005,764,Thailand,Bangladesh,1567,898,669
2005,626,Timor-Leste,Bangladesh,130,73,57
2005,704,Viet Nam,Bangladesh,4129,2399,1730
2005,188,Costa Rica,Bangladesh,1,1,0
2005,222,El Salvador,Bangladesh,6,6,0
2005,484,Mexico,Bangladesh,30,23,7
2005,591,Panama,Bangladesh,23,20,3
2005,68,Bolivia (Plurinational State of),Bangladesh,20,19,1
2005,76,Brazil,Bangladesh,22,22,0
2005,152,Chile,Bangladesh,9,8,1
2005,36,Australia,Bangladesh,16130,9915,6215
2005,554,New Zealand,Bangladesh,1374,667,707
2005,242,Fiji,Bangladesh,1235,652,583
2005,580,Northern Mariana Islands,Bangladesh,698,670,28
2005,100,Bulgaria,Bangladesh,450,235,215
2005,203,Czechia,Bangladesh,70,61,9
2005,348,Hungary,Bangladesh,57,50,7
2005,616,Poland,Bangladesh,72,64,8
2005,642,Romania,Bangladesh,8,8,0
2005,643,Russian Federation,Bangladesh,614,538,76
2005,208,Denmark,Bangladesh,553,266,287
2005,246,Finland,Bangladesh,881,636,245
2005,372,Ireland,Bangladesh,2413,1615,798
2005,428,Latvia,Bangladesh,6,6,0
2005,578,Norway,Bangladesh,558,248,310
2005,752,Sweden,Bangladesh,3924,2207,1717
2005,826,United Kingdom,Bangladesh,170124,87859,82265
2005,300,Greece,Bangladesh,7361,6981,380
2005,380,Italy,Bangladesh,60160,43594,16566
2005,470,Malta,Bangladesh,13,6,7
2005,620,Portugal,Bangladesh,849,658,191
2005,724,Spain,Bangladesh,4383,3698,685
2005,40,Austria,Bangladesh,2117,1417,700
2005,56,Belgium,Bangladesh,1614,969,645
2005,250,France,Bangladesh,3164,2041,1123
2005,276,Germany,Bangladesh,6009,4308,1701
2005,442,Luxembourg,Bangladesh,22,14,8
2005,528,Netherlands,Bangladesh,994,342,652
2005,756,Switzerland,Bangladesh,1576,1116,460
2005,124,Canada,Bangladesh,33080,16809,16271
2005,840,United States of America,Bangladesh,126308,63267,63041
2010,480,Mauritius,Bangladesh,7235,2463,4772
2010,690,Seychelles,Bangladesh,197,155,42
2010,800,Uganda,Bangladesh,133,23,110
2010,516,Namibia,Bangladesh,32,20,12
2010,710,South Africa,Bangladesh,2192,1681,511
2010,818,Egypt,Bangladesh,239,211,28
2010,434,Libya,Bangladesh,1109,1058,51
2010,48,Bahrain,Bangladesh,81920,70746,11174
2010,196,Cyprus,Bangladesh,709,695,14
2010,400,Jordan,Bangladesh,26192,20025,6167
2010,414,Kuwait,Bangladesh,257626,219990,37636
2010,422,Lebanon,Bangladesh,3619,2616,1003
2010,512,Oman,Bangladesh,108861,100762,8099
2010,634,Qatar,Bangladesh,169370,155268,14102
2010,682,Saudi Arabia,Bangladesh,808485,626506,181979
2010,792,Turkey,Bangladesh,325,298,27
2010,784,United Arab Emirates,Bangladesh,919365,803842,115523
2010,64,Bhutan,Bangladesh,49,33,16
2010,356,India,Bangladesh,3289037,1718743,1570294
2010,462,Maldives,Bangladesh,28598,24501,4097
2010,524,Nepal,Bangladesh,243,123,120
2010,144,Sri Lanka,Bangladesh,658,488,170
2010,156,China,Bangladesh,3492,1803,1689
2010,344,"China, Hong Kong SAR",Bangladesh,435,269,166
2010,408,Dem. People's Republic of Korea,Bangladesh,138,54,84
2010,392,Japan,Bangladesh,10175,4576,5599
2010,410,Republic of Korea,Bangladesh,8670,8206,464
2010,96,Brunei Darussalam,Bangladesh,1208,1090,118
2010,458,Malaysia,Bangladesh,351422,202317,149105
2010,104,Myanmar,Bangladesh,1065,826,239
2010,608,Philippines,Bangladesh,156,69,87
2010,702,Singapore,Bangladesh,68502,37883,30619
2010,764,Thailand,Bangladesh,1299,748,551
2010,626,Timor-Leste,Bangladesh,133,78,55
2010,704,Viet Nam,Bangladesh,6540,3596,2944
2010,188,Costa Rica,Bangladesh,3,3,0
2010,222,El Salvador,Bangladesh,6,6,0
2010,484,Mexico,Bangladesh,49,38,11
2010,591,Panama,Bangladesh,35,28,7
2010,68,Bolivia (Plurinational State of),Bangladesh,24,23,1
2010,76,Brazil,Bangladesh,45,45,0
2010,152,Chile,Bangladesh,12,11,1
2010,36,Australia,Bangladesh,29550,17597,11953
2010,554,New Zealand,Bangladesh,1463,709,754
2010,242,Fiji,Bangladesh,1326,709,617
2010,580,Northern Mariana Islands,Bangladesh,413,392,21
2010,100,Bulgaria,Bangladesh,603,316,287
2010,203,Czechia,Bangladesh,117,104,13
2010,348,Hungary,Bangladesh,68,60,8
2010,616,Poland,Bangladesh,103,88,15
2010,642,Romania,Bangladesh,11,8,3
2010,643,Russian Federation,Bangladesh,463,401,62
2010,208,Denmark,Bangladesh,695,357,338
2010,233,Estonia,Bangladesh,12,10,2
2010,246,Finland,Bangladesh,1556,1093,463
2010,372,Ireland,Bangladesh,3164,2240,924
2010,428,Latvia,Bangladesh,8,8,0
2010,578,Norway,Bangladesh,718,348,370
2010,752,Sweden,Bangladesh,6289,3969,2320
2010,826,United Kingdom,Bangladesh,209581,108066,101515
2010,300,Greece,Bangladesh,10432,9799,633
2010,380,Italy,Bangladesh,89149,65079,24070
2010,470,Malta,Bangladesh,13,7,6
2010,620,Portugal,Bangladesh,1297,963,334
2010,705,Slovenia,Bangladesh,3,2,1
2010,724,Spain,Bangladesh,10533,8567,1966
2010,40,Austria,Bangladesh,2340,1552,788
2010,56,Belgium,Bangladesh,1962,1200,762
2010,250,France,Bangladesh,4690,2964,1726
2010,276,Germany,Bangladesh,6129,4024,2105
2010,442,Luxembourg,Bangladesh,20,13,7
2010,528,Netherlands,Bangladesh,1121,434,687
2010,756,Switzerland,Bangladesh,1831,1280,551
2010,124,Canada,Bangladesh,45325,23644,21681
2010,840,United States of America,Bangladesh,159527,78811,80716
2015,480,Mauritius,Bangladesh,8327,3103,5224
2015,690,Seychelles,Bangladesh,220,176,44
2015,800,Uganda,Bangladesh,126,18,108
2015,516,Namibia,Bangladesh,31,20,11
2015,710,South Africa,Bangladesh,3953,2985,968
2015,324,Guinea,Bangladesh,1,1,0
2015,818,Egypt,Bangladesh,177,159,18
2015,434,Libya,Bangladesh,1250,1192,58
2015,48,Bahrain,Bangladesh,78396,67542,10854
2015,196,Cyprus,Bangladesh,681,668,13
2015,400,Jordan,Bangladesh,11275,8023,3252
2015,414,Kuwait,Bangladesh,350229,292017,58212
2015,422,Lebanon,Bangladesh,3047,1459,1588
2015,512,Oman,Bangladesh,247568,231922,15646
2015,634,Qatar,Bangladesh,160183,147723,12460
2015,682,Saudi Arabia,Bangladesh,1022812,777664,245148
2015,792,Turkey,Bangladesh,329,301,28
2015,784,United Arab Emirates,Bangladesh,1004611,873398,131213
2015,64,Bhutan,Bangladesh,52,35,17
2015,356,India,Bangladesh,3155579,1645358,1510221
2015,462,Maldives,Bangladesh,37034,36556,478
2015,524,Nepal,Bangladesh,233,118,115
2015,144,Sri Lanka,Bangladesh,669,494,175
2015,156,China,Bangladesh,4018,2163,1855
2015,344,"China, Hong Kong SAR",Bangladesh,444,268,176
2015,408,Dem. People's Republic of Korea,Bangladesh,152,60,92
2015,392,Japan,Bangladesh,10835,4834,6001
2015,410,Republic of Korea,Bangladesh,10772,10183,589
2015,96,Brunei Darussalam,Bangladesh,1234,1114,120
2015,458,Malaysia,Bangladesh,392295,228434,163861
2015,104,Myanmar,Bangladesh,1024,797,227
2015,608,Philippines,Bangladesh,158,69,89
2015,702,Singapore,Bangladesh,80747,44153,36594
2015,764,Thailand,Bangladesh,1404,807,597
2015,626,Timor-Leste,Bangladesh,69,53,16
2015,704,Viet Nam,Bangladesh,7895,4306,3589
2015,188,Costa Rica,Bangladesh,3,3,0
2015,222,El Salvador,Bangladesh,6,6,0
2015,484,Mexico,Bangladesh,51,40,11
2015,591,Panama,Bangladesh,42,33,9
2015,68,Bolivia (Plurinational State of),Bangladesh,28,27,1
2015,76,Brazil,Bangladesh,54,54,0
2015,152,Chile,Bangladesh,18,17,1
2015,36,Australia,Bangladesh,43090,24012,19078
2015,554,New Zealand,Bangladesh,1530,740,790
2015,242,Fiji,Bangladesh,1366,738,628
2015,580,Northern Mariana Islands,Bangladesh,370,352,18
2015,100,Bulgaria,Bangladesh,545,284,261
2015,203,Czechia,Bangladesh,183,160,23
2015,348,Hungary,Bangladesh,71,57,14
2015,616,Poland,Bangladesh,99,85,14
2015,642,Romania,Bangladesh,100,97,3
2015,643,Russian Federation,Bangladesh,471,407,64
2015,208,Denmark,Bangladesh,1130,608,522
2015,233,Estonia,Bangladesh,35,32,3
2015,246,Finland,Bangladesh,2436,1614,822
2015,352,Iceland,Bangladesh,4,4,0
2015,372,Ireland,Bangladesh,3232,2276,956
2015,428,Latvia,Bangladesh,5,4,1
2015,578,Norway,Bangladesh,1008,551,457
2015,752,Sweden,Bangladesh,7363,4269,3094
2015,826,United Kingdom,Bangladesh,215757,114107,101650
2015,300,Greece,Bangladesh,9791,9172,619
2015,380,Italy,Bangladesh,105481,77938,27543
2015,470,Malta,Bangladesh,11,6,5
2015,620,Portugal,Bangladesh,1470,1073,397
2015,705,Slovenia,Bangladesh,3,3,0
2015,724,Spain,Bangladesh,9836,7072,2764
2015,40,Austria,Bangladesh,2737,1821,916
2015,56,Belgium,Bangladesh,2706,1732,974
2015,250,France,Bangladesh,7723,3766,3957
2015,276,Germany,Bangladesh,6386,4187,2199
2015,442,Luxembourg,Bangladesh,30,20,10
2015,528,Netherlands,Bangladesh,1335,544,791
2015,756,Switzerland,Bangladesh,2414,1510,904
2015,124,Canada,Bangladesh,58374,29673,28701
2015,840,United States of America,Bangladesh,222616,109401,113215
2019,480,Mauritius,Bangladesh,8403,3132,5271
2019,690,Seychelles,Bangladesh,222,178,44
2019,800,Uganda,Bangladesh,126,18,108
2019,516,Namibia,Bangladesh,32,21,11
2019,710,South Africa,Bangladesh,4430,3347,1083
2019,818,Egypt,Bangladesh,252,224,28
2019,434,Libya,Bangladesh,1326,1265,61
2019,48,Bahrain,Bangladesh,82518,71094,11424
2019,196,Cyprus,Bangladesh,680,668,12
2019,400,Jordan,Bangladesh,12125,8628,3497
2019,414,Kuwait,Bangladesh,370844,309206,61638
2019,422,Lebanon,Bangladesh,2878,1378,1500
2019,512,Oman,Bangladesh,304917,285647,19270
2019,634,Qatar,Bangladesh,263086,243160,19926
2019,682,Saudi Arabia,Bangladesh,1246052,940815,305237
2019,792,Turkey,Bangladesh,444,407,37
2019,784,United Arab Emirates,Bangladesh,1079013,938059,140954
2019,64,Bhutan,Bangladesh,54,37,17
2019,356,India,Bangladesh,3103664,1620066,1483598
2019,462,Maldives,Bangladesh,39901,39387,514
2019,524,Nepal,Bangladesh,224,113,111
2019,144,Sri Lanka,Bangladesh,674,498,176
2019,156,China,Bangladesh,4235,2280,1955
2019,344,"China, Hong Kong SAR",Bangladesh,575,341,234
2019,408,Dem. People's Republic of Korea,Bangladesh,154,61,93
2019,392,Japan,Bangladesh,12976,5790,7186
2019,410,Republic of Korea,Bangladesh,10965,10366,599
2019,96,Brunei Darussalam,Bangladesh,1328,1199,129
2019,458,Malaysia,Bangladesh,410195,240114,170081
2019,104,Myanmar,Bangladesh,1061,826,235
2019,608,Philippines,Bangladesh,162,71,91
2019,702,Singapore,Bangladesh,68430,37380,31050
2019,764,Thailand,Bangladesh,1463,841,622
2019,626,Timor-Leste,Bangladesh,68,53,15
2019,704,Viet Nam,Bangladesh,8254,4502,3752
2019,188,Costa Rica,Bangladesh,3,3,0
2019,222,El Salvador,Bangladesh,6,6,0
2019,484,Mexico,Bangladesh,52,41,11
2019,591,Panama,Bangladesh,44,36,8
2019,68,Bolivia (Plurinational State of),Bangladesh,30,29,1
2019,76,Brazil,Bangladesh,60,60,0
2019,152,Chile,Bangladesh,24,23,1
2019,36,Australia,Bangladesh,51968,29042,22926
2019,554,New Zealand,Bangladesh,1572,760,812
2019,242,Fiji,Bangladesh,1394,753,641
2019,580,Northern Mariana Islands,Bangladesh,372,354,18
2019,100,Bulgaria,Bangladesh,606,319,287
2019,203,Czechia,Bangladesh,285,255,30
2019,348,Hungary,Bangladesh,82,62,20
2019,616,Poland,Bangladesh,104,90,14
2019,642,Romania,Bangladesh,159,154,5
2019,643,Russian Federation,Bangladesh,470,407,63
2019,208,Denmark,Bangladesh,1894,1075,819
2019,233,Estonia,Bangladesh,111,93,18
2019,246,Finland,Bangladesh,3216,2096,1120
2019,352,Iceland,Bangladesh,3,3,0
2019,372,Ireland,Bangladesh,3548,2502,1046
2019,428,Latvia,Bangladesh,4,4,0
2019,578,Norway,Bangladesh,1181,632,549
2019,752,Sweden,Bangladesh,10147,5943,4204
2019,826,United Kingdom,Bangladesh,245014,129872,115142
2019,300,Greece,Bangladesh,1862,909,953
2019,380,Italy,Bangladesh,123894,93621,30273
2019,470,Malta,Bangladesh,17,9,8
2019,620,Portugal,Bangladesh,1494,1092,402
2019,705,Slovenia,Bangladesh,12,11,1
2019,724,Spain,Bangladesh,10986,7549,3437
2019,40,Austria,Bangladesh,3231,2169,1062
2019,56,Belgium,Bangladesh,2796,1673,1123
2019,250,France,Bangladesh,8174,3976,4198
2019,276,Germany,Bangladesh,11346,8256,3090
2019,442,Luxembourg,Bangladesh,114,71,43
2019,528,Netherlands,Bangladesh,1715,797,918
2019,756,Switzerland,Bangladesh,2701,1669,1032
2019,124,Canada,Bangladesh,62554,31798,30756
2019,840,United States of America,Bangladesh,240404,116827,123577
1990,710,South Africa,Barbados,30,19,11
1990,28,Antigua and Barbuda,Barbados,204,98,106
1990,44,Bahamas,Barbados,234,149,85
1990,92,British Virgin Islands,Barbados,94,60,34
1990,535,"Bonaire, Sint Eustatius and Saba",Barbados,142,44,98
1990,136,Cayman Islands,Barbados,64,47,17
1990,212,Dominica,Barbados,61,33,28
1990,308,Grenada,Barbados,101,50,51
1990,388,Jamaica,Barbados,418,205,213
1990,659,Saint Kitts and Nevis,Barbados,41,17,24
1990,662,Saint Lucia,Barbados,324,164,160
1990,670,Saint Vincent and the Grenadines,Barbados,303,171,132
1990,780,Trinidad and Tobago,Barbados,2411,1253,1158
1990,850,United States Virgin Islands,Barbados,289,149,140
1990,188,Costa Rica,Barbados,8,6,2
1990,222,El Salvador,Barbados,64,31,33
1990,591,Panama,Barbados,137,53,84
1990,32,Argentina,Barbados,16,0,16
1990,68,Bolivia (Plurinational State of),Barbados,7,5,2
1990,152,Chile,Barbados,23,11,12
1990,328,Guyana,Barbados,156,80,76
1990,862,Venezuela (Bolivarian Republic of),Barbados,241,116,125
1990,36,Australia,Barbados,301,169,132
1990,100,Bulgaria,Barbados,1,0,1
1990,203,Czechia,Barbados,3,1,2
1990,208,Denmark,Barbados,17,11,6
1990,246,Finland,Barbados,4,4,0
1990,372,Ireland,Barbados,4,2,2
1990,428,Latvia,Barbados,2,1,1
1990,578,Norway,Barbados,9,5,4
1990,752,Sweden,Barbados,79,57,22
1990,826,United Kingdom,Barbados,21736,10751,10985
1990,300,Greece,Barbados,6,3,3
1990,380,Italy,Barbados,3,1,2
1990,724,Spain,Barbados,3,1,2
1990,40,Austria,Barbados,12,6,6
1990,56,Belgium,Barbados,20,4,16
1990,250,France,Barbados,42,19,23
1990,528,Netherlands,Barbados,37,23,14
1990,756,Switzerland,Barbados,44,23,21
1990,124,Canada,Barbados,14225,6926,7299
1990,840,United States of America,Barbados,43015,19387,23628
1995,710,South Africa,Barbados,18,12,6
1995,28,Antigua and Barbuda,Barbados,226,122,104
1995,44,Bahamas,Barbados,171,107,64
1995,92,British Virgin Islands,Barbados,111,70,41
1995,535,"Bonaire, Sint Eustatius and Saba",Barbados,296,91,205
1995,136,Cayman Islands,Barbados,121,88,33
1995,212,Dominica,Barbados,80,43,37
1995,308,Grenada,Barbados,131,65,66
1995,388,Jamaica,Barbados,497,243,254
1995,659,Saint Kitts and Nevis,Barbados,56,24,32
1995,662,Saint Lucia,Barbados,437,223,214
1995,670,Saint Vincent and the Grenadines,Barbados,315,178,137
1995,780,Trinidad and Tobago,Barbados,2188,1135,1053
1995,850,United States Virgin Islands,Barbados,324,167,157
1995,188,Costa Rica,Barbados,6,4,2
1995,222,El Salvador,Barbados,50,24,26
1995,591,Panama,Barbados,88,34,54
1995,32,Argentina,Barbados,16,0,16
1995,68,Bolivia (Plurinational State of),Barbados,4,3,1
1995,152,Chile,Barbados,13,4,9
1995,328,Guyana,Barbados,186,96,90
1995,862,Venezuela (Bolivarian Republic of),Barbados,142,69,73
1995,36,Australia,Barbados,345,195,150
1995,100,Bulgaria,Barbados,2,0,2
1995,203,Czechia,Barbados,5,1,4
1995,348,Hungary,Barbados,2,1,1
1995,208,Denmark,Barbados,21,13,8
1995,246,Finland,Barbados,6,5,1
1995,352,Iceland,Barbados,1,1,0
1995,372,Ireland,Barbados,11,5,6
1995,428,Latvia,Barbados,2,1,1
1995,578,Norway,Barbados,14,9,5
1995,752,Sweden,Barbados,94,68,26
1995,826,United Kingdom,Barbados,21135,10371,10764
1995,300,Greece,Barbados,7,4,3
1995,380,Italy,Barbados,13,7,6
1995,724,Spain,Barbados,6,3,3
1995,40,Austria,Barbados,13,6,7
1995,56,Belgium,Barbados,20,4,16
1995,250,France,Barbados,44,20,24
1995,528,Netherlands,Barbados,54,33,21
1995,756,Switzerland,Barbados,47,27,20
1995,124,Canada,Barbados,14373,6965,7408
1995,840,United States of America,Barbados,48230,21977,26253
2000,710,South Africa,Barbados,13,11,2
2000,28,Antigua and Barbuda,Barbados,248,146,102
2000,44,Bahamas,Barbados,108,66,42
2000,92,British Virgin Islands,Barbados,127,80,47
2000,535,"Bonaire, Sint Eustatius and Saba",Barbados,451,139,312
2000,136,Cayman Islands,Barbados,209,151,58
2000,212,Dominica,Barbados,95,51,44
2000,308,Grenada,Barbados,161,80,81
2000,388,Jamaica,Barbados,575,281,294
2000,659,Saint Kitts and Nevis,Barbados,79,35,44
2000,662,Saint Lucia,Barbados,600,308,292
2000,670,Saint Vincent and the Grenadines,Barbados,328,186,142
2000,780,Trinidad and Tobago,Barbados,1573,795,778
2000,850,United States Virgin Islands,Barbados,361,186,175
2000,188,Costa Rica,Barbados,8,5,3
2000,222,El Salvador,Barbados,35,17,18
2000,591,Panama,Barbados,46,17,29
2000,32,Argentina,Barbados,16,1,15
2000,152,Chile,Barbados,4,1,3
2000,328,Guyana,Barbados,216,113,103
2000,862,Venezuela (Bolivarian Republic of),Barbados,83,40,43
2000,36,Australia,Barbados,370,207,163
2000,100,Bulgaria,Barbados,2,0,2
2000,203,Czechia,Barbados,7,2,5
2000,348,Hungary,Barbados,3,1,2
2000,208,Denmark,Barbados,24,14,10
2000,246,Finland,Barbados,7,5,2
2000,352,Iceland,Barbados,1,1,0
2000,372,Ireland,Barbados,23,11,12
2000,428,Latvia,Barbados,3,2,1
2000,578,Norway,Barbados,20,12,8
2000,752,Sweden,Barbados,101,72,29
2000,826,United Kingdom,Barbados,20891,10138,10753
2000,300,Greece,Barbados,8,5,3
2000,380,Italy,Barbados,22,12,10
2000,724,Spain,Barbados,72,36,36
2000,40,Austria,Barbados,14,7,7
2000,56,Belgium,Barbados,20,4,16
2000,250,France,Barbados,45,20,25
2000,528,Netherlands,Barbados,74,44,30
2000,756,Switzerland,Barbados,52,32,20
2000,124,Canada,Barbados,14862,7170,7692
2000,840,United States of America,Barbados,53496,24628,28868
2005,710,South Africa,Barbados,16,13,3
2005,28,Antigua and Barbuda,Barbados,266,156,110
2005,44,Bahamas,Barbados,164,103,61
2005,92,British Virgin Islands,Barbados,146,92,54
2005,535,"Bonaire, Sint Eustatius and Saba",Barbados,480,148,332
2005,136,Cayman Islands,Barbados,180,124,56
2005,212,Dominica,Barbados,117,63,54
2005,308,Grenada,Barbados,168,84,84
2005,388,Jamaica,Barbados,560,275,285
2005,659,Saint Kitts and Nevis,Barbados,87,39,48
2005,662,Saint Lucia,Barbados,540,272,268
2005,670,Saint Vincent and the Grenadines,Barbados,339,191,148
2005,534,Sint Maarten (Dutch part),Barbados,35,17,18
2005,780,Trinidad and Tobago,Barbados,1688,852,836
2005,850,United States Virgin Islands,Barbados,364,189,175
2005,188,Costa Rica,Barbados,5,3,2
2005,222,El Salvador,Barbados,37,18,19
2005,591,Panama,Barbados,36,15,21
2005,32,Argentina,Barbados,12,1,11
2005,76,Brazil,Barbados,13,3,10
2005,152,Chile,Barbados,6,2,4
2005,328,Guyana,Barbados,223,118,105
2005,862,Venezuela (Bolivarian Republic of),Barbados,43,22,21
2005,36,Australia,Barbados,380,209,171
2005,100,Bulgaria,Barbados,3,0,3
2005,203,Czechia,Barbados,4,1,3
2005,348,Hungary,Barbados,4,2,2
2005,208,Denmark,Barbados,29,18,11
2005,246,Finland,Barbados,10,8,2
2005,352,Iceland,Barbados,2,1,1
2005,372,Ireland,Barbados,22,11,11
2005,428,Latvia,Barbados,1,1,0
2005,578,Norway,Barbados,21,11,10
2005,752,Sweden,Barbados,107,77,30
2005,826,United Kingdom,Barbados,18706,9021,9685
2005,300,Greece,Barbados,10,7,3
2005,380,Italy,Barbados,36,18,18
2005,724,Spain,Barbados,35,17,18
2005,40,Austria,Barbados,16,8,8
2005,56,Belgium,Barbados,28,8,20
2005,250,France,Barbados,69,34,35
2005,528,Netherlands,Barbados,75,42,33
2005,756,Switzerland,Barbados,61,36,25
2005,124,Canada,Barbados,14688,6922,7766
2005,840,United States of America,Barbados,53672,24870,28802
2010,710,South Africa,Barbados,25,21,4
2010,28,Antigua and Barbuda,Barbados,284,167,117
2010,44,Bahamas,Barbados,220,141,79
2010,92,British Virgin Islands,Barbados,164,103,61
2010,535,"Bonaire, Sint Eustatius and Saba",Barbados,57,47,10
2010,136,Cayman Islands,Barbados,169,109,60
2010,531,Curaçao,Barbados,176,31,145
2010,212,Dominica,Barbados,143,78,65
2010,308,Grenada,Barbados,176,88,88
2010,388,Jamaica,Barbados,545,269,276
2010,659,Saint Kitts and Nevis,Barbados,94,43,51
2010,662,Saint Lucia,Barbados,440,218,222
2010,670,Saint Vincent and the Grenadines,Barbados,346,197,149
2010,534,Sint Maarten (Dutch part),Barbados,70,34,36
2010,780,Trinidad and Tobago,Barbados,1029,485,544
2010,850,United States Virgin Islands,Barbados,368,192,176
2010,188,Costa Rica,Barbados,11,7,4
2010,222,El Salvador,Barbados,38,19,19
2010,591,Panama,Barbados,28,14,14
2010,32,Argentina,Barbados,7,1,6
2010,76,Brazil,Barbados,27,7,20
2010,152,Chile,Barbados,8,3,5
2010,328,Guyana,Barbados,229,122,107
2010,862,Venezuela (Bolivarian Republic of),Barbados,23,12,11
2010,36,Australia,Barbados,430,231,199
2010,100,Bulgaria,Barbados,4,1,3
2010,203,Czechia,Barbados,6,2,4
2010,348,Hungary,Barbados,5,3,2
2010,208,Denmark,Barbados,33,22,11
2010,233,Estonia,Barbados,1,1,0
2010,246,Finland,Barbados,14,12,2
2010,352,Iceland,Barbados,1,1,0
2010,372,Ireland,Barbados,18,8,10
2010,578,Norway,Barbados,20,12,8
2010,752,Sweden,Barbados,115,79,36
2010,826,United Kingdom,Barbados,19706,9713,9993
2010,300,Greece,Barbados,11,8,3
2010,380,Italy,Barbados,58,31,27
2010,724,Spain,Barbados,36,15,21
2010,40,Austria,Barbados,18,9,9
2010,56,Belgium,Barbados,24,9,15
2010,250,France,Barbados,72,32,40
2010,528,Netherlands,Barbados,67,38,29
2010,756,Switzerland,Barbados,69,39,30
2010,124,Canada,Barbados,15460,7142,8318
2010,840,United States of America,Barbados,55503,25309,30194
2015,710,South Africa,Barbados,44,38,6
2015,324,Guinea,Barbados,11,10,1
2015,28,Antigua and Barbuda,Barbados,302,177,125
2015,44,Bahamas,Barbados,238,152,86
2015,92,British Virgin Islands,Barbados,183,115,68
2015,535,"Bonaire, Sint Eustatius and Saba",Barbados,64,53,11
2015,136,Cayman Islands,Barbados,183,118,65
2015,531,Curaçao,Barbados,191,34,157
2015,212,Dominica,Barbados,167,91,76
2015,308,Grenada,Barbados,178,89,89
2015,388,Jamaica,Barbados,533,263,270
2015,659,Saint Kitts and Nevis,Barbados,96,45,51
2015,662,Saint Lucia,Barbados,421,208,213
2015,670,Saint Vincent and the Grenadines,Barbados,351,201,150
2015,534,Sint Maarten (Dutch part),Barbados,73,36,37
2015,780,Trinidad and Tobago,Barbados,1066,512,554
2015,850,United States Virgin Islands,Barbados,368,192,176
2015,188,Costa Rica,Barbados,11,7,4
2015,222,El Salvador,Barbados,40,20,20
2015,591,Panama,Barbados,32,15,17
2015,32,Argentina,Barbados,7,1,6
2015,76,Brazil,Barbados,33,9,24
2015,152,Chile,Barbados,12,5,7
2015,328,Guyana,Barbados,268,143,125
2015,862,Venezuela (Bolivarian Republic of),Barbados,7,5,2
2015,36,Australia,Barbados,450,246,204
2015,100,Bulgaria,Barbados,4,1,3
2015,203,Czechia,Barbados,9,3,6
2015,348,Hungary,Barbados,2,0,2
2015,208,Denmark,Barbados,35,24,11
2015,233,Estonia,Barbados,1,1,0
2015,246,Finland,Barbados,12,11,1
2015,352,Iceland,Barbados,1,1,0
2015,372,Ireland,Barbados,18,8,10
2015,428,Latvia,Barbados,2,0,2
2015,578,Norway,Barbados,23,16,7
2015,752,Sweden,Barbados,113,79,34
2015,826,United Kingdom,Barbados,25201,12043,13158
2015,300,Greece,Barbados,10,8,2
2015,380,Italy,Barbados,143,51,92
2015,724,Spain,Barbados,43,22,21
2015,40,Austria,Barbados,21,11,10
2015,56,Belgium,Barbados,17,5,12
2015,250,France,Barbados,79,35,44
2015,528,Netherlands,Barbados,82,44,38
2015,756,Switzerland,Barbados,79,48,31
2015,124,Canada,Barbados,14008,6367,7641
2015,840,United States of America,Barbados,58480,26505,31975
2019,710,South Africa,Barbados,48,42,6
2019,324,Guinea,Barbados,10,10,0
2019,28,Antigua and Barbuda,Barbados,314,185,129
2019,44,Bahamas,Barbados,252,161,91
2019,92,British Virgin Islands,Barbados,198,125,73
2019,535,"Bonaire, Sint Eustatius and Saba",Barbados,76,63,13
2019,136,Cayman Islands,Barbados,202,131,71
2019,531,Curaçao,Barbados,207,37,170
2019,212,Dominica,Barbados,170,93,77
2019,308,Grenada,Barbados,179,90,89
2019,388,Jamaica,Barbados,539,266,273
2019,659,Saint Kitts and Nevis,Barbados,97,46,51
2019,662,Saint Lucia,Barbados,406,200,206
2019,670,Saint Vincent and the Grenadines,Barbados,354,204,150
2019,534,Sint Maarten (Dutch part),Barbados,75,37,38
2019,780,Trinidad and Tobago,Barbados,1147,579,568
2019,850,United States Virgin Islands,Barbados,368,192,176
2019,188,Costa Rica,Barbados,11,7,4
2019,222,El Salvador,Barbados,40,20,20
2019,591,Panama,Barbados,33,17,16
2019,32,Argentina,Barbados,7,1,6
2019,76,Brazil,Barbados,37,10,27
2019,152,Chile,Barbados,16,7,9
2019,328,Guyana,Barbados,273,146,127
2019,862,Venezuela (Bolivarian Republic of),Barbados,6,5,1
2019,36,Australia,Barbados,476,267,209
2019,100,Bulgaria,Barbados,4,1,3
2019,203,Czechia,Barbados,13,4,9
2019,348,Hungary,Barbados,1,0,1
2019,208,Denmark,Barbados,51,34,17
2019,233,Estonia,Barbados,1,1,0
2019,246,Finland,Barbados,17,15,2
2019,352,Iceland,Barbados,1,1,0
2019,372,Ireland,Barbados,19,9,10
2019,428,Latvia,Barbados,1,0,1
2019,578,Norway,Barbados,24,16,8
2019,752,Sweden,Barbados,118,82,36
2019,826,United Kingdom,Barbados,28618,13714,14904
2019,300,Greece,Barbados,9,8,1
2019,380,Italy,Barbados,47,23,24
2019,724,Spain,Barbados,44,22,22
2019,40,Austria,Barbados,24,13,11
2019,56,Belgium,Barbados,21,10,11
2019,250,France,Barbados,83,37,46
2019,528,Netherlands,Barbados,96,50,46
2019,756,Switzerland,Barbados,84,52,32
2019,124,Canada,Barbados,15011,6823,8188
2019,840,United States of America,Barbados,63152,28251,34901
1990,710,South Africa,Belarus,113,55,58
1990,818,Egypt,Belarus,246,105,141
1990,434,Libya,Belarus,702,301,401
1990,51,Armenia,Belarus,1280,380,900
1990,31,Azerbaijan,Belarus,626,114,512
1990,196,Cyprus,Belarus,84,21,63
1990,268,Georgia,Belarus,16521,7161,9360
1990,376,Israel,Belarus,33049,15568,17481
1990,792,Turkey,Belarus,72,20,52
1990,398,Kazakhstan,Belarus,72545,34517,38028
1990,417,Kyrgyzstan,Belarus,30187,12466,17721
1990,762,Tajikistan,Belarus,893,393,500
1990,795,Turkmenistan,Belarus,3259,2029,1230
1990,860,Uzbekistan,Belarus,37057,17213,19844
1990,188,Costa Rica,Belarus,5,3,2
1990,32,Argentina,Belarus,669,284,385
1990,152,Chile,Belarus,6,2,4
1990,36,Australia,Belarus,260,128,132
1990,100,Bulgaria,Belarus,89,17,72
1990,203,Czechia,Belarus,322,138,184
1990,348,Hungary,Belarus,91,46,45
1990,616,Poland,Belarus,148245,62588,85657
1990,498,Republic of Moldova,Belarus,12664,4964,7700
1990,642,Romania,Belarus,9,4,5
1990,643,Russian Federation,Belarus,809353,397159,412194
1990,703,Slovakia,Belarus,60,18,42
1990,804,Ukraine,Belarus,403448,172877,230571
1990,208,Denmark,Belarus,125,33,92
1990,233,Estonia,Belarus,23870,11343,12527
1990,372,Ireland,Belarus,117,52,65
1990,428,Latvia,Belarus,60530,26196,34334
1990,440,Lithuania,Belarus,80249,34760,45489
1990,752,Sweden,Belarus,352,122,230
1990,826,United Kingdom,Belarus,310,204,106
1990,300,Greece,Belarus,592,327,265
1990,380,Italy,Belarus,93,32,61
1990,470,Malta,Belarus,3,0,3
1990,620,Portugal,Belarus,38,24,14
1990,688,Serbia,Belarus,16,3,13
1990,705,Slovenia,Belarus,16,8,8
1990,724,Spain,Belarus,54,19,35
1990,40,Austria,Belarus,918,240,678
1990,56,Belgium,Belarus,150,53,97
1990,250,France,Belarus,1126,452,674
1990,276,Germany,Belarus,1190,437,753
1990,442,Luxembourg,Belarus,42,3,39
1990,528,Netherlands,Belarus,14,9,5
1990,756,Switzerland,Belarus,140,47,93
1990,124,Canada,Belarus,4227,2058,2169
1990,840,United States of America,Belarus,21579,10556,11023
1995,710,South Africa,Belarus,93,47,46
1995,818,Egypt,Belarus,216,90,126
1995,434,Libya,Belarus,625,289,336
1995,51,Armenia,Belarus,929,294,635
1995,31,Azerbaijan,Belarus,549,127,422
1995,196,Cyprus,Belarus,119,26,93
1995,268,Georgia,Belarus,2118,404,1714
1995,376,Israel,Belarus,32968,15187,17781
1995,792,Turkey,Belarus,175,43,132
1995,398,Kazakhstan,Belarus,61663,29155,32508
1995,417,Kyrgyzstan,Belarus,24823,9986,14837
1995,762,Tajikistan,Belarus,771,317,454
1995,795,Turkmenistan,Belarus,2662,1748,914
1995,860,Uzbekistan,Belarus,33291,15469,17822
1995,188,Costa Rica,Belarus,4,2,2
1995,32,Argentina,Belarus,653,281,372
1995,68,Bolivia (Plurinational State of),Belarus,2,1,1
1995,152,Chile,Belarus,6,4,2
1995,36,Australia,Belarus,829,379,450
1995,100,Bulgaria,Belarus,198,39,159
1995,203,Czechia,Belarus,483,215,268
1995,348,Hungary,Belarus,125,49,76
1995,616,Poland,Belarus,126812,52423,74389
1995,498,Republic of Moldova,Belarus,8547,3215,5332
1995,642,Romania,Belarus,26,13,13
1995,643,Russian Federation,Belarus,886234,416615,469619
1995,703,Slovakia,Belarus,87,22,65
1995,804,Ukraine,Belarus,339992,142945,197047
1995,208,Denmark,Belarus,135,36,99
1995,233,Estonia,Belarus,19313,8802,10511
1995,246,Finland,Belarus,16,6,10
1995,352,Iceland,Belarus,1,1,0
1995,372,Ireland,Belarus,325,138,187
1995,428,Latvia,Belarus,69060,27849,41211
1995,440,Lithuania,Belarus,71602,31169,40433
1995,578,Norway,Belarus,36,19,17
1995,752,Sweden,Belarus,418,142,276
1995,826,United Kingdom,Belarus,703,343,360
1995,300,Greece,Belarus,573,244,329
1995,380,Italy,Belarus,884,106,778
1995,470,Malta,Belarus,4,0,4
1995,620,Portugal,Belarus,82,51,31
1995,688,Serbia,Belarus,104,16,88
1995,705,Slovenia,Belarus,34,13,21
1995,724,Spain,Belarus,145,54,91
1995,40,Austria,Belarus,1036,283,753
1995,56,Belgium,Belarus,149,52,97
1995,250,France,Belarus,1163,455,708
1995,276,Germany,Belarus,10522,3783,6739
1995,442,Luxembourg,Belarus,39,3,36
1995,528,Netherlands,Belarus,19,12,7
1995,756,Switzerland,Belarus,449,149,300
1995,124,Canada,Belarus,4245,2057,2188
1995,840,United States of America,Belarus,30442,15055,15387
2000,710,South Africa,Belarus,101,51,50
2000,818,Egypt,Belarus,204,82,122
2000,434,Libya,Belarus,560,290,270
2000,51,Armenia,Belarus,743,253,490
2000,31,Azerbaijan,Belarus,554,122,432
2000,196,Cyprus,Belarus,154,32,122
2000,268,Georgia,Belarus,1059,202,857
2000,376,Israel,Belarus,31040,14145,16895
2000,792,Turkey,Belarus,280,67,213
2000,398,Kazakhstan,Belarus,50780,23792,26988
2000,417,Kyrgyzstan,Belarus,18775,7211,11564
2000,762,Tajikistan,Belarus,720,298,422
2000,795,Turkmenistan,Belarus,2158,1395,763
2000,860,Uzbekistan,Belarus,28456,12998,15458
2000,188,Costa Rica,Belarus,4,2,2
2000,32,Argentina,Belarus,637,278,359
2000,68,Bolivia (Plurinational State of),Belarus,4,2,2
2000,152,Chile,Belarus,6,3,3
2000,36,Australia,Belarus,1360,614,746
2000,100,Bulgaria,Belarus,307,61,246
2000,203,Czechia,Belarus,644,292,352
2000,348,Hungary,Belarus,159,52,107
2000,616,Poland,Belarus,108478,43874,64604
2000,498,Republic of Moldova,Belarus,5768,2076,3692
2000,642,Romania,Belarus,45,22,23
2000,643,Russian Federation,Belarus,930977,421140,509837
2000,703,Slovakia,Belarus,140,33,107
2000,804,Ukraine,Belarus,280687,114758,165929
2000,208,Denmark,Belarus,144,39,105
2000,233,Estonia,Belarus,14756,6262,8494
2000,246,Finland,Belarus,32,13,19
2000,352,Iceland,Belarus,1,1,0
2000,372,Ireland,Belarus,712,314,398
2000,428,Latvia,Belarus,77583,29500,48083
2000,440,Lithuania,Belarus,56088,24352,31736
2000,578,Norway,Belarus,108,31,77
2000,752,Sweden,Belarus,449,151,298
2000,826,United Kingdom,Belarus,1108,487,621
2000,300,Greece,Belarus,564,160,404
2000,380,Italy,Belarus,1674,179,1495
2000,470,Malta,Belarus,10,0,10
2000,620,Portugal,Belarus,131,81,50
2000,688,Serbia,Belarus,142,19,123
2000,705,Slovenia,Belarus,31,10,21
2000,724,Spain,Belarus,300,115,185
2000,40,Austria,Belarus,1153,326,827
2000,56,Belgium,Belarus,144,51,93
2000,250,France,Belarus,1199,458,741
2000,276,Germany,Belarus,19854,7130,12724
2000,442,Luxembourg,Belarus,38,3,35
2000,528,Netherlands,Belarus,27,16,11
2000,756,Switzerland,Belarus,761,253,508
2000,124,Canada,Belarus,4363,2105,2258
2000,840,United States of America,Belarus,39480,19668,19812
2005,710,South Africa,Belarus,132,63,69
2005,818,Egypt,Belarus,243,107,136
2005,434,Libya,Belarus,617,373,244
2005,51,Armenia,Belarus,492,178,314
2005,31,Azerbaijan,Belarus,525,103,422
2005,196,Cyprus,Belarus,226,46,180
2005,268,Georgia,Belarus,1006,192,814
2005,376,Israel,Belarus,26567,11912,14655
2005,792,Turkey,Belarus,288,64,224
2005,398,Kazakhstan,Belarus,57891,27940,29951
2005,417,Kyrgyzstan,Belarus,15151,5773,9378
2005,762,Tajikistan,Belarus,694,283,411
2005,795,Turkmenistan,Belarus,2140,1391,749
2005,860,Uzbekistan,Belarus,28636,13382,15254
2005,188,Costa Rica,Belarus,3,2,1
2005,32,Argentina,Belarus,470,209,261
2005,68,Bolivia (Plurinational State of),Belarus,4,2,2
2005,76,Brazil,Belarus,4,4,0
2005,152,Chile,Belarus,9,5,4
2005,36,Australia,Belarus,1600,697,903
2005,100,Bulgaria,Belarus,465,102,363
2005,203,Czechia,Belarus,2344,988,1356
2005,348,Hungary,Belarus,196,66,130
2005,616,Poland,Belarus,92167,35936,56231
2005,498,Republic of Moldova,Belarus,3983,1386,2597
2005,642,Romania,Belarus,32,16,16
2005,643,Russian Federation,Belarus,849214,376057,473157
2005,703,Slovakia,Belarus,158,40,118
2005,804,Ukraine,Belarus,256474,105069,151405
2005,208,Denmark,Belarus,396,134,262
2005,233,Estonia,Belarus,13834,5724,8110
2005,246,Finland,Belarus,131,56,75
2005,352,Iceland,Belarus,21,6,15
2005,372,Ireland,Belarus,714,339,375
2005,428,Latvia,Belarus,67044,25008,42036
2005,440,Lithuania,Belarus,52280,22282,29998
2005,578,Norway,Belarus,399,109,290
2005,752,Sweden,Belarus,1099,403,696
2005,826,United Kingdom,Belarus,2557,881,1676
2005,191,Croatia,Belarus,47,8,39
2005,300,Greece,Belarus,1027,271,756
2005,380,Italy,Belarus,17026,8609,8417
2005,470,Malta,Belarus,19,2,17
2005,620,Portugal,Belarus,526,269,257
2005,688,Serbia,Belarus,141,18,123
2005,705,Slovenia,Belarus,72,28,44
2005,724,Spain,Belarus,2626,1089,1537
2005,40,Austria,Belarus,1289,342,947
2005,56,Belgium,Belarus,231,82,149
2005,250,France,Belarus,2388,731,1657
2005,276,Germany,Belarus,20329,7156,13173
2005,442,Luxembourg,Belarus,32,4,28
2005,528,Netherlands,Belarus,135,65,70
2005,756,Switzerland,Belarus,880,257,623
2005,124,Canada,Belarus,7180,3401,3779
2005,840,United States of America,Belarus,47057,23573,23484
2010,710,South Africa,Belarus,206,98,108
2010,818,Egypt,Belarus,262,110,152
2010,434,Libya,Belarus,675,411,264
2010,51,Armenia,Belarus,410,158,252
2010,31,Azerbaijan,Belarus,481,108,373
2010,196,Cyprus,Belarus,370,79,291
2010,268,Georgia,Belarus,1016,194,822
2010,376,Israel,Belarus,22417,9795,12622
2010,792,Turkey,Belarus,296,60,236
2010,398,Kazakhstan,Belarus,65001,32087,32914
2010,417,Kyrgyzstan,Belarus,11293,4218,7075
2010,762,Tajikistan,Belarus,692,284,408
2010,795,Turkmenistan,Belarus,2076,1322,754
2010,860,Uzbekistan,Belarus,27674,13228,14446
2010,188,Costa Rica,Belarus,5,2,3
2010,32,Argentina,Belarus,303,141,162
2010,68,Bolivia (Plurinational State of),Belarus,4,2,2
2010,76,Brazil,Belarus,8,8,0
2010,152,Chile,Belarus,12,7,5
2010,36,Australia,Belarus,1840,752,1088
2010,100,Bulgaria,Belarus,603,138,465
2010,203,Czechia,Belarus,3816,1645,2171
2010,348,Hungary,Belarus,233,80,153
2010,616,Poland,Belarus,78747,28755,49992
2010,498,Republic of Moldova,Belarus,2845,1008,1837
2010,642,Romania,Belarus,25,13,12
2010,643,Russian Federation,Belarus,749972,323523,426449
2010,703,Slovakia,Belarus,177,47,130
2010,804,Ukraine,Belarus,244715,100452,144263
2010,208,Denmark,Belarus,635,224,411
2010,233,Estonia,Belarus,12796,5106,7690
2010,246,Finland,Belarus,280,107,173
2010,352,Iceland,Belarus,40,12,28
2010,372,Ireland,Belarus,598,260,338
2010,428,Latvia,Belarus,54799,19259,35540
2010,440,Lithuania,Belarus,41370,15662,25708
2010,578,Norway,Belarus,683,194,489
2010,752,Sweden,Belarus,2049,781,1268
2010,826,United Kingdom,Belarus,2693,964,1729
2010,191,Croatia,Belarus,93,16,77
2010,300,Greece,Belarus,1549,397,1152
2010,380,Italy,Belarus,33171,17493,15678
2010,470,Malta,Belarus,23,2,21
2010,620,Portugal,Belarus,834,412,422
2010,688,Serbia,Belarus,138,17,121
2010,705,Slovenia,Belarus,104,29,75
2010,724,Spain,Belarus,3530,1222,2308
2010,40,Austria,Belarus,1425,359,1066
2010,56,Belgium,Belarus,366,198,168
2010,250,France,Belarus,3192,1174,2018
2010,276,Germany,Belarus,20656,7114,13542
2010,442,Luxembourg,Belarus,28,5,23
2010,528,Netherlands,Belarus,198,92,106
2010,756,Switzerland,Belarus,1006,260,746
2010,124,Canada,Belarus,10435,4915,5520
2010,840,United States of America,Belarus,56276,27805,28471
2015,710,South Africa,Belarus,370,167,203
2015,818,Egypt,Belarus,194,96,98
2015,434,Libya,Belarus,761,460,301
2015,51,Armenia,Belarus,306,118,188
2015,31,Azerbaijan,Belarus,459,111,348
2015,196,Cyprus,Belarus,355,78,277
2015,268,Georgia,Belarus,1066,203,863
2015,376,Israel,Belarus,23119,10038,13081
2015,792,Turkey,Belarus,300,56,244
2015,398,Kazakhstan,Belarus,69136,34701,34435
2015,417,Kyrgyzstan,Belarus,9947,3679,6268
2015,762,Tajikistan,Belarus,680,277,403
2015,795,Turkmenistan,Belarus,2059,1323,736
2015,860,Uzbekistan,Belarus,26532,12881,13651
2015,188,Costa Rica,Belarus,5,2,3
2015,32,Argentina,Belarus,304,141,163
2015,68,Bolivia (Plurinational State of),Belarus,5,3,2
2015,76,Brazil,Belarus,10,10,0
2015,152,Chile,Belarus,18,11,7
2015,36,Australia,Belarus,2180,900,1280
2015,100,Bulgaria,Belarus,803,205,598
2015,203,Czechia,Belarus,4097,1710,2387
2015,348,Hungary,Belarus,212,75,137
2015,616,Poland,Belarus,75925,28635,47290
2015,498,Republic of Moldova,Belarus,2115,763,1352
2015,642,Romania,Belarus,39,16,23
2015,643,Russian Federation,Belarus,764279,327520,436759
2015,703,Slovakia,Belarus,223,70,153
2015,804,Ukraine,Belarus,245534,100989,144545
2015,208,Denmark,Belarus,740,238,502
2015,233,Estonia,Belarus,11119,4309,6810
2015,246,Finland,Belarus,405,142,263
2015,352,Iceland,Belarus,41,10,31
2015,372,Ireland,Belarus,611,261,350
2015,428,Latvia,Belarus,48588,16745,31843
2015,440,Lithuania,Belarus,33613,12041,21572
2015,578,Norway,Belarus,1031,320,711
2015,752,Sweden,Belarus,2833,1100,1733
2015,826,United Kingdom,Belarus,3443,1167,2276
2015,191,Croatia,Belarus,94,16,78
2015,300,Greece,Belarus,1453,326,1127
2015,380,Italy,Belarus,31468,16332,15136
2015,470,Malta,Belarus,9,5,4
2015,620,Portugal,Belarus,946,443,503
2015,688,Serbia,Belarus,134,16,118
2015,705,Slovenia,Belarus,143,40,103
2015,724,Spain,Belarus,3886,1207,2679
2015,40,Austria,Belarus,1667,427,1240
2015,56,Belgium,Belarus,481,238,243
2015,250,France,Belarus,3536,1239,2297
2015,276,Germany,Belarus,21522,7379,14143
2015,442,Luxembourg,Belarus,42,8,34
2015,528,Netherlands,Belarus,284,132,152
2015,756,Switzerland,Belarus,1499,375,1124
2015,124,Canada,Belarus,11121,5245,5876
2015,840,United States of America,Belarus,60494,29733,30761
2019,710,South Africa,Belarus,414,188,226
2019,818,Egypt,Belarus,276,120,156
2019,434,Libya,Belarus,807,488,319
2019,51,Armenia,Belarus,304,119,185
2019,31,Azerbaijan,Belarus,441,107,334
2019,196,Cyprus,Belarus,354,80,274
2019,268,Georgia,Belarus,1098,209,889
2019,376,Israel,Belarus,22482,9762,12720
2019,792,Turkey,Belarus,405,79,326
2019,398,Kazakhstan,Belarus,72245,36262,35983
2019,417,Kyrgyzstan,Belarus,9746,3605,6141
2019,762,Tajikistan,Belarus,677,276,401
2019,795,Turkmenistan,Belarus,2045,1323,722
2019,860,Uzbekistan,Belarus,26475,12864,13611
2019,188,Costa Rica,Belarus,5,2,3
2019,32,Argentina,Belarus,309,143,166
2019,68,Bolivia (Plurinational State of),Belarus,5,3,2
2019,76,Brazil,Belarus,11,11,0
2019,152,Chile,Belarus,24,15,9
2019,36,Australia,Belarus,2391,952,1439
2019,100,Bulgaria,Belarus,1062,279,783
2019,203,Czechia,Belarus,4502,1898,2604
2019,348,Hungary,Belarus,214,76,138
2019,616,Poland,Belarus,80409,32249,48160
2019,498,Republic of Moldova,Belarus,2081,752,1329
2019,642,Romania,Belarus,110,47,63
2019,643,Russian Federation,Belarus,764120,327415,436705
2019,703,Slovakia,Belarus,236,76,160
2019,804,Ukraine,Belarus,247989,101999,145990
2019,208,Denmark,Belarus,809,253,556
2019,233,Estonia,Belarus,10572,4116,6456
2019,246,Finland,Belarus,518,179,339
2019,352,Iceland,Belarus,55,18,37
2019,372,Ireland,Belarus,670,287,383
2019,428,Latvia,Belarus,42944,14603,28341
2019,440,Lithuania,Belarus,27705,9494,18211
2019,578,Norway,Belarus,1150,341,809
2019,752,Sweden,Belarus,3470,1395,2075
2019,826,United Kingdom,Belarus,3909,1331,2578
2019,191,Croatia,Belarus,86,14,72
2019,300,Greece,Belarus,1419,361,1058
2019,380,Italy,Belarus,31526,16337,15189
2019,470,Malta,Belarus,14,8,6
2019,620,Portugal,Belarus,962,452,510
2019,688,Serbia,Belarus,136,17,119
2019,705,Slovenia,Belarus,166,55,111
2019,724,Spain,Belarus,4026,1184,2842
2019,40,Austria,Belarus,1967,529,1438
2019,56,Belgium,Belarus,540,262,278
2019,250,France,Belarus,3742,1306,2436
2019,276,Germany,Belarus,23608,7792,15816
2019,442,Luxembourg,Belarus,325,78,247
2019,528,Netherlands,Belarus,418,186,232
2019,756,Switzerland,Belarus,1620,415,1205
2019,124,Canada,Belarus,11917,5621,6296
2019,840,United States of America,Belarus,65327,31752,33575
1990,108,Burundi,Belgium,642,315,327
1990,480,Mauritius,Belgium,76,60,16
1990,690,Seychelles,Belgium,32,15,17
1990,800,Uganda,Belgium,44,25,19
1990,266,Gabon,Belgium,154,84,70
1990,516,Namibia,Belgium,272,136,136
1990,710,South Africa,Belgium,5864,2737,3127
1990,132,Cabo Verde,Belgium,14,7,7
1990,324,Guinea,Belgium,207,122,85
1990,478,Mauritania,Belgium,56,25,31
1990,768,Togo,Belgium,24,16,8
1990,818,Egypt,Belgium,672,337,335
1990,434,Libya,Belgium,1918,967,951
1990,504,Morocco,Belgium,959,508,451
1990,196,Cyprus,Belgium,65,32,33
1990,376,Israel,Belgium,3657,1642,2015
1990,400,Jordan,Belgium,33,17,16
1990,792,Turkey,Belgium,4703,2287,2416
1990,392,Japan,Belgium,402,205,197
1990,608,Philippines,Belgium,76,57,19
1990,44,Bahamas,Belgium,8,3,5
1990,136,Cayman Islands,Belgium,3,2,1
1990,214,Dominican Republic,Belgium,490,303,187
1990,312,Guadeloupe,Belgium,186,90,96
1990,474,Martinique,Belgium,58,28,30
1990,662,Saint Lucia,Belgium,5,3,2
1990,188,Costa Rica,Belgium,200,115,85
1990,222,El Salvador,Belgium,95,48,47
1990,340,Honduras,Belgium,19,13,6
1990,484,Mexico,Belgium,730,395,335
1990,558,Nicaragua,Belgium,52,36,16
1990,591,Panama,Belgium,26,19,7
1990,32,Argentina,Belgium,1151,585,566
1990,68,Bolivia (Plurinational State of),Belgium,268,163,105
1990,76,Brazil,Belgium,1887,1021,866
1990,152,Chile,Belgium,1013,520,493
1990,170,Colombia,Belgium,377,199,178
1990,218,Ecuador,Belgium,285,145,140
1990,254,French Guiana,Belgium,75,40,35
1990,604,Peru,Belgium,381,200,181
1990,862,Venezuela (Bolivarian Republic of),Belgium,514,275,239
1990,36,Australia,Belgium,4620,2294,2326
1990,112,Belarus,Belgium,28,20,8
1990,100,Bulgaria,Belgium,14,11,3
1990,203,Czechia,Belgium,186,105,81
1990,348,Hungary,Belgium,98,43,55
1990,616,Poland,Belgium,3969,1967,2002
1990,642,Romania,Belgium,273,109,164
1990,643,Russian Federation,Belgium,859,422,437
1990,703,Slovakia,Belgium,62,27,35
1990,208,Denmark,Belgium,727,333,394
1990,246,Finland,Belgium,114,61,53
1990,352,Iceland,Belgium,34,15,19
1990,372,Ireland,Belgium,471,230,241
1990,428,Latvia,Belgium,14,9,5
1990,440,Lithuania,Belgium,30,22,8
1990,578,Norway,Belgium,782,349,433
1990,752,Sweden,Belgium,943,487,456
1990,826,United Kingdom,Belgium,16085,5609,10476
1990,20,Andorra,Belgium,241,129,112
1990,191,Croatia,Belgium,192,89,103
1990,300,Greece,Belgium,5284,2304,2980
1990,380,Italy,Belgium,14298,3989,10309
1990,470,Malta,Belgium,19,9,10
1990,620,Portugal,Belgium,1464,657,807
1990,688,Serbia,Belgium,13,8,5
1990,705,Slovenia,Belgium,250,116,134
1990,724,Spain,Belgium,16881,7825,9056
1990,40,Austria,Belgium,1418,679,739
1990,250,France,Belgium,127976,54338,73638
1990,276,Germany,Belgium,21902,11095,10807
1990,438,Liechtenstein,Belgium,1,1,0
1990,442,Luxembourg,Belgium,11205,5322,5883
1990,528,Netherlands,Belgium,41730,18747,22983
1990,756,Switzerland,Belgium,9525,4339,5186
1990,60,Bermuda,Belgium,18,8,10
1990,124,Canada,Belgium,21575,10504,11071
1990,840,United States of America,Belgium,34366,11132,23234
1995,108,Burundi,Belgium,621,303,318
1995,480,Mauritius,Belgium,35,29,6
1995,690,Seychelles,Belgium,26,16,10
1995,800,Uganda,Belgium,41,23,18
1995,266,Gabon,Belgium,206,112,94
1995,516,Namibia,Belgium,260,131,129
1995,710,South Africa,Belgium,4009,2020,1989
1995,132,Cabo Verde,Belgium,19,10,9
1995,324,Guinea,Belgium,238,151,87
1995,478,Mauritania,Belgium,59,29,30
1995,768,Togo,Belgium,28,19,9
1995,818,Egypt,Belgium,521,256,265
1995,434,Libya,Belgium,1197,599,598
1995,504,Morocco,Belgium,880,459,421
1995,196,Cyprus,Belgium,92,43,49
1995,376,Israel,Belgium,4294,1902,2392
1995,400,Jordan,Belgium,61,29,32
1995,792,Turkey,Belgium,6415,3078,3337
1995,392,Japan,Belgium,433,208,225
1995,608,Philippines,Belgium,102,76,26
1995,44,Bahamas,Belgium,14,8,6
1995,136,Cayman Islands,Belgium,7,4,3
1995,214,Dominican Republic,Belgium,544,331,213
1995,312,Guadeloupe,Belgium,248,117,131
1995,474,Martinique,Belgium,87,40,47
1995,662,Saint Lucia,Belgium,5,3,2
1995,188,Costa Rica,Belgium,169,100,69
1995,222,El Salvador,Belgium,72,36,36
1995,340,Honduras,Belgium,19,13,6
1995,484,Mexico,Belgium,887,439,448
1995,558,Nicaragua,Belgium,42,29,13
1995,591,Panama,Belgium,23,17,6
1995,32,Argentina,Belgium,1138,558,580
1995,68,Bolivia (Plurinational State of),Belgium,320,183,137
1995,76,Brazil,Belgium,1649,942,707
1995,152,Chile,Belgium,920,464,456
1995,170,Colombia,Belgium,374,199,175
1995,218,Ecuador,Belgium,320,163,157
1995,254,French Guiana,Belgium,110,55,55
1995,604,Peru,Belgium,383,199,184
1995,862,Venezuela (Bolivarian Republic of),Belgium,450,241,209
1995,36,Australia,Belgium,5131,2525,2606
1995,112,Belarus,Belgium,33,21,12
1995,100,Bulgaria,Belgium,98,60,38
1995,203,Czechia,Belgium,279,161,118
1995,348,Hungary,Belgium,601,298,303
1995,616,Poland,Belgium,3395,1657,1738
1995,642,Romania,Belgium,254,121,133
1995,643,Russian Federation,Belgium,857,443,414
1995,703,Slovakia,Belgium,259,150,109
1995,208,Denmark,Belgium,980,478,502
1995,246,Finland,Belgium,144,82,62
1995,352,Iceland,Belgium,56,26,30
1995,372,Ireland,Belgium,507,239,268
1995,428,Latvia,Belgium,21,13,8
1995,440,Lithuania,Belgium,34,24,10
1995,578,Norway,Belgium,818,381,437
1995,752,Sweden,Belgium,1119,574,545
1995,826,United Kingdom,Belgium,18359,7036,11323
1995,20,Andorra,Belgium,241,128,113
1995,191,Croatia,Belgium,205,89,116
1995,300,Greece,Belgium,4916,2112,2804
1995,380,Italy,Belgium,11695,3452,8243
1995,470,Malta,Belgium,23,11,12
1995,620,Portugal,Belgium,2120,984,1136
1995,688,Serbia,Belgium,108,63,45
1995,705,Slovenia,Belgium,239,116,123
1995,724,Spain,Belgium,20333,9673,10660
1995,40,Austria,Belgium,1600,780,820
1995,250,France,Belgium,132113,54815,77298
1995,276,Germany,Belgium,22307,10953,11354
1995,438,Liechtenstein,Belgium,11,7,4
1995,442,Luxembourg,Belgium,11879,5818,6061
1995,528,Netherlands,Belgium,42604,18737,23867
1995,756,Switzerland,Belgium,10118,4964,5154
1995,60,Bermuda,Belgium,19,11,8
1995,124,Canada,Belgium,20648,10008,10640
1995,840,United States of America,Belgium,34586,11395,23191
2000,108,Burundi,Belgium,475,231,244
2000,480,Mauritius,Belgium,15,12,3
2000,690,Seychelles,Belgium,20,17,3
2000,800,Uganda,Belgium,40,20,20
2000,266,Gabon,Belgium,258,142,116
2000,516,Namibia,Belgium,242,122,120
2000,710,South Africa,Belgium,3340,1818,1522
2000,132,Cabo Verde,Belgium,24,13,11
2000,324,Guinea,Belgium,166,106,60
2000,478,Mauritania,Belgium,60,33,27
2000,768,Togo,Belgium,32,22,10
2000,818,Egypt,Belgium,411,196,215
2000,434,Libya,Belgium,496,254,242
2000,504,Morocco,Belgium,927,477,450
2000,196,Cyprus,Belgium,119,55,64
2000,268,Georgia,Belgium,23,9,14
2000,376,Israel,Belgium,4690,2080,2610
2000,400,Jordan,Belgium,88,41,47
2000,792,Turkey,Belgium,8152,3874,4278
2000,392,Japan,Belgium,525,243,282
2000,608,Philippines,Belgium,848,394,454
2000,44,Bahamas,Belgium,20,13,7
2000,136,Cayman Islands,Belgium,13,7,6
2000,214,Dominican Republic,Belgium,598,360,238
2000,312,Guadeloupe,Belgium,310,144,166
2000,474,Martinique,Belgium,116,52,64
2000,662,Saint Lucia,Belgium,10,6,4
2000,188,Costa Rica,Belgium,223,132,91
2000,222,El Salvador,Belgium,49,24,25
2000,340,Honduras,Belgium,19,13,6
2000,484,Mexico,Belgium,1083,505,578
2000,558,Nicaragua,Belgium,40,29,11
2000,591,Panama,Belgium,22,16,6
2000,32,Argentina,Belgium,1125,531,594
2000,68,Bolivia (Plurinational State of),Belgium,368,201,167
2000,76,Brazil,Belgium,1410,862,548
2000,152,Chile,Belgium,827,414,413
2000,170,Colombia,Belgium,370,199,171
2000,218,Ecuador,Belgium,355,181,174
2000,254,French Guiana,Belgium,145,71,74
2000,604,Peru,Belgium,448,233,215
2000,862,Venezuela (Bolivarian Republic of),Belgium,392,209,183
2000,36,Australia,Belgium,5320,2609,2711
2000,112,Belarus,Belgium,38,23,15
2000,100,Bulgaria,Belgium,181,109,72
2000,203,Czechia,Belgium,372,217,155
2000,348,Hungary,Belgium,1104,553,551
2000,616,Poland,Belgium,2904,1394,1510
2000,642,Romania,Belgium,235,133,102
2000,643,Russian Federation,Belgium,824,447,377
2000,703,Slovakia,Belgium,529,314,215
2000,208,Denmark,Belgium,1233,623,610
2000,246,Finland,Belgium,173,102,71
2000,352,Iceland,Belgium,77,36,41
2000,372,Ireland,Belgium,822,402,420
2000,428,Latvia,Belgium,28,17,11
2000,440,Lithuania,Belgium,26,19,7
2000,578,Norway,Belgium,886,424,462
2000,752,Sweden,Belgium,1201,612,589
2000,826,United Kingdom,Belgium,20943,8553,12390
2000,20,Andorra,Belgium,241,127,114
2000,191,Croatia,Belgium,197,81,116
2000,300,Greece,Belgium,4629,1905,2724
2000,380,Italy,Belgium,9092,2915,6177
2000,470,Malta,Belgium,58,29,29
2000,620,Portugal,Belgium,2862,1354,1508
2000,688,Serbia,Belgium,184,105,79
2000,705,Slovenia,Belgium,317,151,166
2000,724,Spain,Belgium,32533,15970,16563
2000,40,Austria,Belgium,1782,881,901
2000,250,France,Belgium,136250,55293,80957
2000,276,Germany,Belgium,22711,10810,11901
2000,438,Liechtenstein,Belgium,22,13,9
2000,442,Luxembourg,Belgium,12679,6385,6294
2000,528,Netherlands,Belgium,44982,19323,25659
2000,756,Switzerland,Belgium,10749,5623,5126
2000,60,Bermuda,Belgium,20,14,6
2000,124,Canada,Belgium,20211,9751,10460
2000,840,United States of America,Belgium,34755,11671,23084
2005,108,Burundi,Belgium,466,224,242
2005,480,Mauritius,Belgium,57,45,12
2005,690,Seychelles,Belgium,27,14,13
2005,800,Uganda,Belgium,38,19,19
2005,266,Gabon,Belgium,282,157,125
2005,516,Namibia,Belgium,191,96,95
2005,710,South Africa,Belgium,4394,2303,2091
2005,132,Cabo Verde,Belgium,17,9,8
2005,324,Guinea,Belgium,116,76,40
2005,478,Mauritania,Belgium,60,34,26
2005,768,Togo,Belgium,37,26,11
2005,818,Egypt,Belgium,489,249,240
2005,434,Libya,Belgium,547,329,218
2005,504,Morocco,Belgium,951,482,469
2005,196,Cyprus,Belgium,174,80,94
2005,268,Georgia,Belgium,21,8,13
2005,376,Israel,Belgium,5219,2325,2894
2005,400,Jordan,Belgium,127,68,59
2005,792,Turkey,Belgium,8400,3892,4508
2005,392,Japan,Belgium,657,300,357
2005,608,Philippines,Belgium,686,325,361
2005,44,Bahamas,Belgium,24,15,9
2005,136,Cayman Islands,Belgium,12,7,5
2005,214,Dominican Republic,Belgium,422,255,167
2005,312,Guadeloupe,Belgium,378,189,189
2005,474,Martinique,Belgium,121,53,68
2005,662,Saint Lucia,Belgium,10,6,4
2005,188,Costa Rica,Belgium,146,86,60
2005,222,El Salvador,Belgium,50,25,25
2005,340,Honduras,Belgium,19,13,6
2005,484,Mexico,Belgium,912,459,453
2005,558,Nicaragua,Belgium,39,29,10
2005,591,Panama,Belgium,123,85,38
2005,32,Argentina,Belgium,830,398,432
2005,68,Bolivia (Plurinational State of),Belgium,346,188,158
2005,76,Brazil,Belgium,1556,1041,515
2005,152,Chile,Belgium,1241,632,609
2005,170,Colombia,Belgium,357,195,162
2005,218,Ecuador,Belgium,419,218,201
2005,254,French Guiana,Belgium,137,65,72
2005,604,Peru,Belgium,527,276,251
2005,862,Venezuela (Bolivarian Republic of),Belgium,388,207,181
2005,36,Australia,Belgium,5790,2856,2934
2005,112,Belarus,Belgium,37,22,15
2005,100,Bulgaria,Belgium,293,177,116
2005,203,Czechia,Belgium,419,281,138
2005,348,Hungary,Belgium,1364,696,668
2005,616,Poland,Belgium,4094,2052,2042
2005,642,Romania,Belgium,583,307,276
2005,643,Russian Federation,Belgium,650,357,293
2005,703,Slovakia,Belgium,594,357,237
2005,208,Denmark,Belgium,1501,765,736
2005,246,Finland,Belgium,323,208,115
2005,352,Iceland,Belgium,92,45,47
2005,372,Ireland,Belgium,1321,659,662
2005,428,Latvia,Belgium,72,42,30
2005,440,Lithuania,Belgium,123,77,46
2005,578,Norway,Belgium,995,489,506
2005,752,Sweden,Belgium,1458,771,687
2005,826,United Kingdom,Belgium,22525,9719,12806
2005,20,Andorra,Belgium,255,135,120
2005,191,Croatia,Belgium,285,128,157
2005,300,Greece,Belgium,4933,2044,2889
2005,380,Italy,Belgium,27739,11579,16160
2005,470,Malta,Belgium,93,46,47
2005,620,Portugal,Belgium,3205,1549,1656
2005,688,Serbia,Belgium,228,129,99
2005,705,Slovenia,Belgium,314,151,163
2005,724,Spain,Belgium,37120,18455,18665
2005,40,Austria,Belgium,1992,961,1031
2005,250,France,Belgium,138343,60781,77562
2005,276,Germany,Belgium,25787,12588,13199
2005,438,Liechtenstein,Belgium,31,16,15
2005,442,Luxembourg,Belgium,12758,6422,6336
2005,528,Netherlands,Belgium,47034,20383,26651
2005,756,Switzerland,Belgium,12167,6064,6103
2005,60,Bermuda,Belgium,22,14,8
2005,124,Canada,Belgium,19853,9668,10185
2005,840,United States of America,Belgium,34287,17174,17113
2010,108,Burundi,Belgium,497,236,261
2010,480,Mauritius,Belgium,103,80,23
2010,690,Seychelles,Belgium,34,11,23
2010,800,Uganda,Belgium,38,19,19
2010,266,Gabon,Belgium,327,185,142
2010,516,Namibia,Belgium,184,93,91
2010,710,South Africa,Belgium,6883,3596,3287
2010,132,Cabo Verde,Belgium,10,6,4
2010,324,Guinea,Belgium,81,53,28
2010,478,Mauritania,Belgium,60,35,25
2010,768,Togo,Belgium,56,38,18
2010,818,Egypt,Belgium,528,259,269
2010,434,Libya,Belgium,599,363,236
2010,504,Morocco,Belgium,1064,537,527
2010,196,Cyprus,Belgium,284,132,152
2010,268,Georgia,Belgium,21,8,13
2010,376,Israel,Belgium,5811,2593,3218
2010,400,Jordan,Belgium,164,93,71
2010,792,Turkey,Belgium,8656,3906,4750
2010,392,Japan,Belgium,697,314,383
2010,608,Philippines,Belgium,524,236,288
2010,44,Bahamas,Belgium,28,17,11
2010,136,Cayman Islands,Belgium,12,6,6
2010,531,Curaçao,Belgium,84,38,46
2010,214,Dominican Republic,Belgium,243,149,94
2010,312,Guadeloupe,Belgium,446,234,212
2010,474,Martinique,Belgium,127,54,73
2010,662,Saint Lucia,Belgium,10,6,4
2010,188,Costa Rica,Belgium,288,169,119
2010,222,El Salvador,Belgium,50,25,25
2010,340,Honduras,Belgium,18,12,6
2010,484,Mexico,Belgium,847,466,381
2010,558,Nicaragua,Belgium,41,31,10
2010,591,Panama,Belgium,231,159,72
2010,32,Argentina,Belgium,535,266,269
2010,68,Bolivia (Plurinational State of),Belgium,324,175,149
2010,76,Brazil,Belgium,1679,1203,476
2010,152,Chile,Belgium,1655,849,806
2010,170,Colombia,Belgium,406,227,179
2010,218,Ecuador,Belgium,588,299,289
2010,254,French Guiana,Belgium,129,60,69
2010,604,Peru,Belgium,589,307,282
2010,862,Venezuela (Bolivarian Republic of),Belgium,389,208,181
2010,36,Australia,Belgium,6510,3234,3276
2010,112,Belarus,Belgium,35,21,14
2010,100,Bulgaria,Belgium,393,238,155
2010,203,Czechia,Belgium,427,324,103
2010,348,Hungary,Belgium,1624,839,785
2010,616,Poland,Belgium,5413,2760,2653
2010,642,Romania,Belgium,1026,530,496
2010,643,Russian Federation,Belgium,463,260,203
2010,703,Slovakia,Belgium,666,404,262
2010,208,Denmark,Belgium,1736,891,845
2010,233,Estonia,Belgium,117,68,49
2010,246,Finland,Belgium,544,344,200
2010,352,Iceland,Belgium,105,54,51
2010,372,Ireland,Belgium,1603,725,878
2010,428,Latvia,Belgium,116,67,49
2010,440,Lithuania,Belgium,205,123,82
2010,578,Norway,Belgium,1306,663,643
2010,752,Sweden,Belgium,1904,1022,882
2010,826,United Kingdom,Belgium,23729,10516,13213
2010,20,Andorra,Belgium,231,122,109
2010,191,Croatia,Belgium,373,176,197
2010,300,Greece,Belgium,5447,2272,3175
2010,380,Italy,Belgium,46838,20219,26619
2010,470,Malta,Belgium,136,80,56
2010,620,Portugal,Belgium,3017,1491,1526
2010,688,Serbia,Belgium,223,126,97
2010,705,Slovenia,Belgium,367,172,195
2010,724,Spain,Belgium,41797,20980,20817
2010,40,Austria,Belgium,2201,1040,1161
2010,250,France,Belgium,143882,56471,87411
2010,276,Germany,Belgium,28273,14019,14254
2010,438,Liechtenstein,Belgium,41,19,22
2010,442,Luxembourg,Belgium,12979,6529,6450
2010,528,Netherlands,Belgium,49330,21613,27717
2010,756,Switzerland,Belgium,14201,6677,7524
2010,60,Bermuda,Belgium,23,13,10
2010,124,Canada,Belgium,19720,9716,10004
2010,840,United States of America,Belgium,34862,17223,17639
2015,108,Burundi,Belgium,605,288,317
2015,480,Mauritius,Belgium,118,93,25
2015,690,Seychelles,Belgium,38,14,24
2015,800,Uganda,Belgium,38,19,19
2015,266,Gabon,Belgium,457,285,172
2015,516,Namibia,Belgium,180,92,88
2015,710,South Africa,Belgium,12415,6184,6231
2015,132,Cabo Verde,Belgium,10,6,4
2015,324,Guinea,Belgium,40,26,14
2015,478,Mauritania,Belgium,60,36,24
2015,768,Togo,Belgium,65,44,21
2015,818,Egypt,Belgium,391,218,173
2015,434,Libya,Belgium,675,406,269
2015,504,Morocco,Belgium,1386,697,689
2015,196,Cyprus,Belgium,272,127,145
2015,268,Georgia,Belgium,22,9,13
2015,376,Israel,Belgium,5993,2658,3335
2015,400,Jordan,Belgium,70,34,36
2015,792,Turkey,Belgium,8787,3857,4930
2015,392,Japan,Belgium,685,307,378
2015,608,Philippines,Belgium,533,241,292
2015,44,Bahamas,Belgium,30,18,12
2015,136,Cayman Islands,Belgium,12,7,5
2015,531,Curaçao,Belgium,91,42,49
2015,214,Dominican Republic,Belgium,256,157,99
2015,312,Guadeloupe,Belgium,463,241,222
2015,474,Martinique,Belgium,131,55,76
2015,662,Saint Lucia,Belgium,9,6,3
2015,188,Costa Rica,Belgium,292,171,121
2015,222,El Salvador,Belgium,52,26,26
2015,340,Honduras,Belgium,25,17,8
2015,484,Mexico,Belgium,898,490,408
2015,558,Nicaragua,Belgium,44,34,10
2015,591,Panama,Belgium,271,186,85
2015,32,Argentina,Belgium,537,267,270
2015,68,Bolivia (Plurinational State of),Belgium,377,204,173
2015,76,Brazil,Belgium,2022,1449,573
2015,152,Chile,Belgium,2507,1260,1247
2015,170,Colombia,Belgium,454,256,198
2015,218,Ecuador,Belgium,855,432,423
2015,254,French Guiana,Belgium,130,60,70
2015,604,Peru,Belgium,626,335,291
2015,862,Venezuela (Bolivarian Republic of),Belgium,395,210,185
2015,36,Australia,Belgium,7290,3722,3568
2015,112,Belarus,Belgium,36,21,15
2015,100,Bulgaria,Belgium,1481,798,683
2015,203,Czechia,Belgium,613,468,145
2015,348,Hungary,Belgium,1981,1057,924
2015,616,Poland,Belgium,5219,2710,2509
2015,642,Romania,Belgium,1102,570,532
2015,643,Russian Federation,Belgium,471,263,208
2015,703,Slovakia,Belgium,828,528,300
2015,208,Denmark,Belgium,2135,1126,1009
2015,233,Estonia,Belgium,150,91,59
2015,246,Finland,Belgium,732,468,264
2015,352,Iceland,Belgium,120,58,62
2015,372,Ireland,Belgium,1638,730,908
2015,428,Latvia,Belgium,111,60,51
2015,440,Lithuania,Belgium,181,108,73
2015,578,Norway,Belgium,1678,875,803
2015,752,Sweden,Belgium,2490,1345,1145
2015,826,United Kingdom,Belgium,30345,12947,17398
2015,20,Andorra,Belgium,215,119,96
2015,191,Croatia,Belgium,375,176,199
2015,300,Greece,Belgium,5112,2005,3107
2015,380,Italy,Belgium,45458,19565,25893
2015,470,Malta,Belgium,230,141,89
2015,620,Portugal,Belgium,3421,1602,1819
2015,688,Serbia,Belgium,217,122,95
2015,705,Slovenia,Belgium,310,157,153
2015,724,Spain,Belgium,44130,22327,21803
2015,40,Austria,Belgium,2575,1225,1350
2015,250,France,Belgium,153018,69666,83352
2015,276,Germany,Belgium,29459,14572,14887
2015,438,Liechtenstein,Belgium,40,18,22
2015,442,Luxembourg,Belgium,19800,10112,9688
2015,528,Netherlands,Belgium,54038,24288,29750
2015,756,Switzerland,Belgium,16447,7874,8573
2015,60,Bermuda,Belgium,23,13,10
2015,124,Canada,Belgium,18823,9283,9540
2015,840,United States of America,Belgium,36906,18138,18768
2019,108,Burundi,Belgium,670,319,351
2019,480,Mauritius,Belgium,119,94,25
2019,690,Seychelles,Belgium,38,14,24
2019,800,Uganda,Belgium,38,19,19
2019,266,Gabon,Belgium,496,310,186
2019,516,Namibia,Belgium,190,97,93
2019,710,South Africa,Belgium,13915,6938,6977
2019,132,Cabo Verde,Belgium,10,6,4
2019,324,Guinea,Belgium,38,25,13
2019,478,Mauritania,Belgium,62,38,24
2019,768,Togo,Belgium,65,44,21
2019,818,Egypt,Belgium,557,282,275
2019,434,Libya,Belgium,716,431,285
2019,504,Morocco,Belgium,1478,744,734
2019,196,Cyprus,Belgium,271,128,143
2019,268,Georgia,Belgium,22,9,13
2019,376,Israel,Belgium,5828,2585,3243
2019,400,Jordan,Belgium,75,37,38
2019,792,Turkey,Belgium,11881,5282,6599
2019,392,Japan,Belgium,766,344,422
2019,608,Philippines,Belgium,549,248,301
2019,44,Bahamas,Belgium,31,19,12
2019,136,Cayman Islands,Belgium,13,8,5
2019,531,Curaçao,Belgium,98,45,53
2019,214,Dominican Republic,Belgium,264,162,102
2019,312,Guadeloupe,Belgium,470,245,225
2019,474,Martinique,Belgium,130,55,75
2019,662,Saint Lucia,Belgium,8,6,2
2019,188,Costa Rica,Belgium,296,175,121
2019,222,El Salvador,Belgium,52,26,26
2019,340,Honduras,Belgium,25,17,8
2019,484,Mexico,Belgium,925,505,420
2019,558,Nicaragua,Belgium,46,36,10
2019,591,Panama,Belgium,286,197,89
2019,32,Argentina,Belgium,546,271,275
2019,68,Bolivia (Plurinational State of),Belgium,411,223,188
2019,76,Brazil,Belgium,2277,1632,645
2019,152,Chile,Belgium,3349,1591,1758
2019,170,Colombia,Belgium,464,262,202
2019,218,Ecuador,Belgium,841,425,416
2019,254,French Guiana,Belgium,143,66,77
2019,604,Peru,Belgium,745,413,332
2019,862,Venezuela (Bolivarian Republic of),Belgium,386,204,182
2019,36,Australia,Belgium,7924,4014,3910
2019,112,Belarus,Belgium,35,21,14
2019,100,Bulgaria,Belgium,2199,1178,1021
2019,203,Czechia,Belgium,688,526,162
2019,348,Hungary,Belgium,2237,1182,1055
2019,616,Poland,Belgium,5527,2972,2555
2019,642,Romania,Belgium,2906,1542,1364
2019,643,Russian Federation,Belgium,470,263,207
2019,703,Slovakia,Belgium,948,612,336
2019,208,Denmark,Belgium,2467,1294,1173
2019,233,Estonia,Belgium,184,118,66
2019,246,Finland,Belgium,897,568,329
2019,352,Iceland,Belgium,161,83,78
2019,372,Ireland,Belgium,1798,805,993
2019,428,Latvia,Belgium,109,60,49
2019,440,Lithuania,Belgium,208,134,74
2019,578,Norway,Belgium,1904,1018,886
2019,752,Sweden,Belgium,3224,1748,1476
2019,826,United Kingdom,Belgium,34459,14752,19707
2019,20,Andorra,Belgium,229,128,101
2019,191,Croatia,Belgium,346,162,184
2019,300,Greece,Belgium,4992,2073,2919
2019,380,Italy,Belgium,47147,20547,26600
2019,470,Malta,Belgium,371,229,142
2019,620,Portugal,Belgium,3479,1634,1845
2019,688,Serbia,Belgium,220,124,96
2019,705,Slovenia,Belgium,299,146,153
2019,724,Spain,Belgium,47148,23648,23500
2019,40,Austria,Belgium,3039,1473,1566
2019,250,France,Belgium,161970,73540,88430
2019,276,Germany,Belgium,32315,17010,15305
2019,438,Liechtenstein,Belgium,40,18,22
2019,442,Luxembourg,Belgium,23686,12948,10738
2019,528,Netherlands,Belgium,60996,28042,32954
2019,756,Switzerland,Belgium,17553,8608,8945
2019,60,Bermuda,Belgium,23,13,10
2019,124,Canada,Belgium,20171,9948,10223
2019,840,United States of America,Belgium,39854,19368,20486
1990,28,Antigua and Barbuda,Belize,8,4,4
1990,44,Bahamas,Belize,31,10,21
1990,136,Cayman Islands,Belize,110,59,51
1990,388,Jamaica,Belize,6,2,4
1990,662,Saint Lucia,Belize,1,1,0
1990,188,Costa Rica,Belize,202,98,104
1990,222,El Salvador,Belize,244,113,131
1990,320,Guatemala,Belize,543,181,362
1990,340,Honduras,Belize,213,116,97
1990,484,Mexico,Belize,1415,596,819
1990,558,Nicaragua,Belize,60,33,27
1990,591,Panama,Belize,64,34,30
1990,32,Argentina,Belize,12,2,10
1990,68,Bolivia (Plurinational State of),Belize,991,536,455
1990,152,Chile,Belize,16,10,6
1990,862,Venezuela (Bolivarian Republic of),Belize,18,10,8
1990,36,Australia,Belize,34,13,21
1990,203,Czechia,Belize,1,0,1
1990,208,Denmark,Belize,5,1,4
1990,372,Ireland,Belize,1,1,0
1990,752,Sweden,Belize,4,4,0
1990,826,United Kingdom,Belize,1194,433,761
1990,300,Greece,Belize,5,3,2
1990,380,Italy,Belize,4,1,3
1990,724,Spain,Belize,3,2,1
1990,40,Austria,Belize,22,11,11
1990,250,France,Belize,7,2,5
1990,756,Switzerland,Belize,11,7,4
1990,124,Canada,Belize,935,455,480
1990,840,United States of America,Belize,29957,12356,17601
1995,28,Antigua and Barbuda,Belize,10,5,5
1995,44,Bahamas,Belize,22,7,15
1995,136,Cayman Islands,Belize,208,112,96
1995,388,Jamaica,Belize,7,3,4
1995,188,Costa Rica,Belize,123,66,57
1995,222,El Salvador,Belize,231,107,124
1995,320,Guatemala,Belize,561,223,338
1995,340,Honduras,Belize,242,127,115
1995,484,Mexico,Belize,1474,558,916
1995,558,Nicaragua,Belize,48,26,22
1995,591,Panama,Belize,72,39,33
1995,32,Argentina,Belize,12,2,10
1995,68,Bolivia (Plurinational State of),Belize,962,506,456
1995,152,Chile,Belize,9,9,0
1995,862,Venezuela (Bolivarian Republic of),Belize,17,9,8
1995,36,Australia,Belize,17,7,10
1995,100,Bulgaria,Belize,1,0,1
1995,203,Czechia,Belize,1,0,1
1995,348,Hungary,Belize,1,1,0
1995,208,Denmark,Belize,5,2,3
1995,246,Finland,Belize,1,0,1
1995,352,Iceland,Belize,1,0,1
1995,372,Ireland,Belize,2,1,1
1995,752,Sweden,Belize,5,5,0
1995,826,United Kingdom,Belize,1182,392,790
1995,300,Greece,Belize,3,2,1
1995,380,Italy,Belize,10,5,5
1995,724,Spain,Belize,5,3,2
1995,40,Austria,Belize,25,12,13
1995,250,France,Belize,7,1,6
1995,756,Switzerland,Belize,28,16,12
1995,124,Canada,Belize,1145,554,591
1995,840,United States of America,Belize,35522,14849,20673
2000,28,Antigua and Barbuda,Belize,11,6,5
2000,44,Bahamas,Belize,13,4,9
2000,136,Cayman Islands,Belize,359,194,165
2000,388,Jamaica,Belize,7,3,4
2000,662,Saint Lucia,Belize,1,1,0
2000,188,Costa Rica,Belize,106,64,42
2000,222,El Salvador,Belize,218,102,116
2000,320,Guatemala,Belize,579,266,313
2000,340,Honduras,Belize,271,139,132
2000,484,Mexico,Belize,1597,549,1048
2000,558,Nicaragua,Belize,34,18,16
2000,591,Panama,Belize,86,46,40
2000,32,Argentina,Belize,12,2,10
2000,68,Bolivia (Plurinational State of),Belize,922,469,453
2000,152,Chile,Belize,2,2,0
2000,862,Venezuela (Bolivarian Republic of),Belize,17,9,8
2000,36,Australia,Belize,50,25,25
2000,100,Bulgaria,Belize,1,0,1
2000,203,Czechia,Belize,1,0,1
2000,348,Hungary,Belize,1,1,0
2000,208,Denmark,Belize,5,3,2
2000,246,Finland,Belize,2,1,1
2000,352,Iceland,Belize,1,0,1
2000,372,Ireland,Belize,3,0,3
2000,752,Sweden,Belize,5,5,0
2000,826,United Kingdom,Belize,1191,356,835
2000,300,Greece,Belize,2,1,1
2000,380,Italy,Belize,16,9,7
2000,724,Spain,Belize,66,34,32
2000,40,Austria,Belize,28,14,14
2000,250,France,Belize,7,1,6
2000,756,Switzerland,Belize,47,25,22
2000,124,Canada,Belize,1382,667,715
2000,840,United States of America,Belize,41170,17407,23763
2005,28,Antigua and Barbuda,Belize,12,6,6
2005,44,Bahamas,Belize,27,9,18
2005,52,Barbados,Belize,15,7,8
2005,136,Cayman Islands,Belize,326,178,148
2005,388,Jamaica,Belize,7,3,4
2005,662,Saint Lucia,Belize,1,1,0
2005,188,Costa Rica,Belize,69,41,28
2005,222,El Salvador,Belize,272,128,144
2005,320,Guatemala,Belize,688,336,352
2005,340,Honduras,Belize,266,138,128
2005,484,Mexico,Belize,1847,767,1080
2005,558,Nicaragua,Belize,22,11,11
2005,591,Panama,Belize,77,45,32
2005,32,Argentina,Belize,9,1,8
2005,68,Bolivia (Plurinational State of),Belize,850,430,420
2005,76,Brazil,Belize,2,0,2
2005,152,Chile,Belize,3,3,0
2005,862,Venezuela (Bolivarian Republic of),Belize,17,9,8
2005,36,Australia,Belize,60,30,30
2005,100,Bulgaria,Belize,2,0,2
2005,203,Czechia,Belize,1,0,1
2005,348,Hungary,Belize,1,1,0
2005,208,Denmark,Belize,8,3,5
2005,246,Finland,Belize,2,1,1
2005,352,Iceland,Belize,2,1,1
2005,372,Ireland,Belize,3,0,3
2005,752,Sweden,Belize,6,5,1
2005,826,United Kingdom,Belize,1193,369,824
2005,300,Greece,Belize,4,1,3
2005,380,Italy,Belize,20,11,9
2005,724,Spain,Belize,32,16,16
2005,40,Austria,Belize,32,16,16
2005,250,France,Belize,12,11,1
2005,756,Switzerland,Belize,50,26,24
2005,124,Canada,Belize,1604,766,838
2005,840,United States of America,Belize,44349,18893,25456
2010,28,Antigua and Barbuda,Belize,13,7,6
2010,44,Bahamas,Belize,41,14,27
2010,52,Barbados,Belize,21,10,11
2010,136,Cayman Islands,Belize,323,178,145
2010,388,Jamaica,Belize,7,3,4
2010,662,Saint Lucia,Belize,1,1,0
2010,188,Costa Rica,Belize,137,82,55
2010,222,El Salvador,Belize,325,154,171
2010,320,Guatemala,Belize,796,405,391
2010,340,Honduras,Belize,260,137,123
2010,484,Mexico,Belize,2312,1076,1236
2010,558,Nicaragua,Belize,23,12,11
2010,591,Panama,Belize,73,47,26
2010,32,Argentina,Belize,6,1,5
2010,68,Bolivia (Plurinational State of),Belize,777,391,386
2010,76,Brazil,Belize,5,0,5
2010,152,Chile,Belize,4,4,0
2010,862,Venezuela (Bolivarian Republic of),Belize,19,10,9
2010,36,Australia,Belize,60,30,30
2010,100,Bulgaria,Belize,2,0,2
2010,203,Czechia,Belize,1,0,1
2010,348,Hungary,Belize,1,1,0
2010,208,Denmark,Belize,10,4,6
2010,233,Estonia,Belize,1,1,0
2010,246,Finland,Belize,2,1,1
2010,372,Ireland,Belize,2,0,2
2010,752,Sweden,Belize,11,9,2
2010,826,United Kingdom,Belize,1256,406,850
2010,300,Greece,Belize,5,0,5
2010,380,Italy,Belize,26,13,13
2010,705,Slovenia,Belize,1,1,0
2010,724,Spain,Belize,25,11,14
2010,40,Austria,Belize,35,17,18
2010,250,France,Belize,8,1,7
2010,756,Switzerland,Belize,63,30,33
2010,124,Canada,Belize,1705,810,895
2010,840,United States of America,Belize,48974,20477,28497
2015,324,Guinea,Belize,2,2,0
2015,28,Antigua and Barbuda,Belize,14,8,6
2015,44,Bahamas,Belize,44,15,29
2015,52,Barbados,Belize,22,11,11
2015,136,Cayman Islands,Belize,351,194,157
2015,388,Jamaica,Belize,7,3,4
2015,188,Costa Rica,Belize,139,83,56
2015,222,El Salvador,Belize,339,161,178
2015,320,Guatemala,Belize,916,473,443
2015,340,Honduras,Belize,365,194,171
2015,484,Mexico,Belize,1968,926,1042
2015,558,Nicaragua,Belize,24,13,11
2015,591,Panama,Belize,86,56,30
2015,32,Argentina,Belize,6,1,5
2015,68,Bolivia (Plurinational State of),Belize,905,456,449
2015,76,Brazil,Belize,6,0,6
2015,152,Chile,Belize,6,6,0
2015,862,Venezuela (Bolivarian Republic of),Belize,20,10,10
2015,36,Australia,Belize,80,45,35
2015,100,Bulgaria,Belize,2,0,2
2015,348,Hungary,Belize,3,2,1
2015,208,Denmark,Belize,7,4,3
2015,246,Finland,Belize,1,1,0
2015,372,Ireland,Belize,2,0,2
2015,752,Sweden,Belize,14,6,8
2015,826,United Kingdom,Belize,1606,487,1119
2015,300,Greece,Belize,4,0,4
2015,380,Italy,Belize,56,26,30
2015,705,Slovenia,Belize,2,2,0
2015,724,Spain,Belize,34,14,20
2015,40,Austria,Belize,41,20,21
2015,250,France,Belize,9,1,8
2015,756,Switzerland,Belize,53,27,26
2015,124,Canada,Belize,1982,953,1029
2015,840,United States of America,Belize,54147,22479,31668
2019,324,Guinea,Belize,1,1,0
2019,28,Antigua and Barbuda,Belize,14,8,6
2019,44,Bahamas,Belize,46,16,30
2019,52,Barbados,Belize,22,11,11
2019,136,Cayman Islands,Belize,389,216,173
2019,388,Jamaica,Belize,7,3,4
2019,188,Costa Rica,Belize,141,85,56
2019,222,El Salvador,Belize,343,163,180
2019,320,Guatemala,Belize,940,486,454
2019,340,Honduras,Belize,370,197,173
2019,484,Mexico,Belize,2029,955,1074
2019,558,Nicaragua,Belize,25,14,11
2019,591,Panama,Belize,90,60,30
2019,32,Argentina,Belize,6,1,5
2019,68,Bolivia (Plurinational State of),Belize,988,498,490
2019,76,Brazil,Belize,6,0,6
2019,152,Chile,Belize,8,8,0
2019,862,Venezuela (Bolivarian Republic of),Belize,19,10,9
2019,36,Australia,Belize,84,43,41
2019,100,Bulgaria,Belize,2,0,2
2019,203,Czechia,Belize,1,1,0
2019,348,Hungary,Belize,3,2,1
2019,208,Denmark,Belize,8,3,5
2019,246,Finland,Belize,1,1,0
2019,372,Ireland,Belize,2,0,2
2019,752,Sweden,Belize,15,7,8
2019,826,United Kingdom,Belize,1823,556,1267
2019,300,Greece,Belize,3,0,3
2019,380,Italy,Belize,27,14,13
2019,705,Slovenia,Belize,4,3,1
2019,724,Spain,Belize,35,14,21
2019,40,Austria,Belize,48,24,24
2019,250,France,Belize,9,1,8
2019,756,Switzerland,Belize,47,25,22
2019,124,Canada,Belize,2123,1021,1102
2019,840,United States of America,Belize,58472,23907,34565
1990,178,Congo,Benin,4357,2084,2273
1990,266,Gabon,Benin,16141,8142,7999
1990,516,Namibia,Benin,230,99,131
1990,710,South Africa,Benin,192,123,69
1990,854,Burkina Faso,Benin,2054,1026,1028
1990,384,Côte d'Ivoire,Benin,51216,28003,23213
1990,288,Ghana,Benin,8959,4483,4476
1990,324,Guinea,Benin,2351,1272,1079
1990,430,Liberia,Benin,63,38,25
1990,466,Mali,Benin,542,315,227
1990,478,Mauritania,Benin,491,231,260
1990,562,Niger,Benin,8948,3822,5126
1990,566,Nigeria,Benin,96599,54193,42406
1990,686,Senegal,Benin,2984,1519,1465
1990,694,Sierra Leone,Benin,262,102,160
1990,768,Togo,Benin,24038,13235,10803
1990,818,Egypt,Benin,46,44,2
1990,196,Cyprus,Benin,2,2,0
1990,188,Costa Rica,Benin,1,0,1
1990,36,Australia,Benin,17,14,3
1990,100,Bulgaria,Benin,2,2,0
1990,203,Czechia,Benin,7,6,1
1990,348,Hungary,Benin,11,11,0
1990,643,Russian Federation,Benin,317,156,161
1990,208,Denmark,Benin,14,9,5
1990,246,Finland,Benin,1,1,0
1990,372,Ireland,Benin,6,2,4
1990,578,Norway,Benin,11,11,0
1990,752,Sweden,Benin,17,11,6
1990,826,United Kingdom,Benin,32,21,11
1990,300,Greece,Benin,5,3,2
1990,380,Italy,Benin,107,37,70
1990,620,Portugal,Benin,7,6,1
1990,724,Spain,Benin,30,21,9
1990,40,Austria,Benin,44,30,14
1990,56,Belgium,Benin,1748,1137,611
1990,250,France,Benin,11476,6325,5151
1990,276,Germany,Benin,610,503,107
1990,528,Netherlands,Benin,53,35,18
1990,756,Switzerland,Benin,174,106,68
1990,124,Canada,Benin,149,72,77
1995,178,Congo,Benin,5250,2521,2729
1995,266,Gabon,Benin,21584,10879,10705
1995,516,Namibia,Benin,219,95,124
1995,710,South Africa,Benin,119,78,41
1995,854,Burkina Faso,Benin,2554,1278,1276
1995,384,Côte d'Ivoire,Benin,57138,31052,26086
1995,288,Ghana,Benin,8928,4895,4033
1995,324,Guinea,Benin,2710,1602,1108
1995,430,Liberia,Benin,61,36,25
1995,466,Mali,Benin,566,330,236
1995,478,Mauritania,Benin,524,273,251
1995,562,Niger,Benin,12961,5049,7912
1995,566,Nigeria,Benin,117556,65530,52026
1995,686,Senegal,Benin,3120,1579,1541
1995,694,Sierra Leone,Benin,257,97,160
1995,768,Togo,Benin,26058,14385,11673
1995,818,Egypt,Benin,35,34,1
1995,196,Cyprus,Benin,3,3,0
1995,188,Costa Rica,Benin,1,0,1
1995,36,Australia,Benin,13,12,1
1995,100,Bulgaria,Benin,9,6,3
1995,203,Czechia,Benin,10,9,1
1995,348,Hungary,Benin,15,13,2
1995,643,Russian Federation,Benin,324,164,160
1995,208,Denmark,Benin,24,16,8
1995,246,Finland,Benin,1,1,0
1995,372,Ireland,Benin,18,7,11
1995,578,Norway,Benin,3,3,0
1995,752,Sweden,Benin,20,12,8
1995,826,United Kingdom,Benin,127,68,59
1995,300,Greece,Benin,7,5,2
1995,380,Italy,Benin,656,352,304
1995,620,Portugal,Benin,15,13,2
1995,724,Spain,Benin,49,32,17
1995,40,Austria,Benin,50,34,16
1995,56,Belgium,Benin,1380,841,539
1995,250,France,Benin,11847,6440,5407
1995,276,Germany,Benin,859,666,193
1995,528,Netherlands,Benin,77,50,27
1995,756,Switzerland,Benin,276,178,98
1995,124,Canada,Benin,272,131,141
2000,178,Congo,Benin,7549,3627,3922
2000,266,Gabon,Benin,26999,13703,13296
2000,516,Namibia,Benin,206,90,116
2000,710,South Africa,Benin,82,56,26
2000,854,Burkina Faso,Benin,3071,1561,1510
2000,384,Côte d'Ivoire,Benin,59538,32340,27198
2000,288,Ghana,Benin,9987,5062,4925
2000,324,Guinea,Benin,1897,1122,775
2000,430,Liberia,Benin,61,35,26
2000,466,Mali,Benin,520,304,216
2000,478,Mauritania,Benin,541,309,232
2000,562,Niger,Benin,17081,6316,10765
2000,566,Nigeria,Benin,143212,79318,63894
2000,686,Senegal,Benin,2820,1361,1459
2000,694,Sierra Leone,Benin,248,88,160
2000,768,Togo,Benin,36908,19837,17071
2000,818,Egypt,Benin,27,26,1
2000,196,Cyprus,Benin,4,4,0
2000,188,Costa Rica,Benin,1,0,1
2000,152,Chile,Benin,1,1,0
2000,36,Australia,Benin,30,15,15
2000,100,Bulgaria,Benin,15,9,6
2000,203,Czechia,Benin,13,12,1
2000,348,Hungary,Benin,18,15,3
2000,643,Russian Federation,Benin,320,165,155
2000,208,Denmark,Benin,33,23,10
2000,246,Finland,Benin,1,1,0
2000,372,Ireland,Benin,39,15,24
2000,578,Norway,Benin,7,4,3
2000,752,Sweden,Benin,22,13,9
2000,826,United Kingdom,Benin,226,117,109
2000,300,Greece,Benin,9,6,3
2000,380,Italy,Benin,1205,668,537
2000,620,Portugal,Benin,25,21,4
2000,724,Spain,Benin,91,58,33
2000,40,Austria,Benin,55,38,17
2000,56,Belgium,Benin,972,522,450
2000,250,France,Benin,12218,6555,5663
2000,276,Germany,Benin,1108,829,279
2000,528,Netherlands,Benin,106,67,39
2000,756,Switzerland,Benin,380,250,130
2000,124,Canada,Benin,401,193,208
2005,120,Cameroon,Benin,2414,1348,1066
2005,178,Congo,Benin,7171,3814,3357
2005,266,Gabon,Benin,29441,15088,14353
2005,516,Namibia,Benin,162,70,92
2005,710,South Africa,Benin,107,70,37
2005,854,Burkina Faso,Benin,3540,1808,1732
2005,384,Côte d'Ivoire,Benin,62329,33856,28473
2005,288,Ghana,Benin,14044,7534,6510
2005,324,Guinea,Benin,1327,911,416
2005,430,Liberia,Benin,32,24,8
2005,466,Mali,Benin,2118,1210,908
2005,478,Mauritania,Benin,545,320,225
2005,562,Niger,Benin,17388,6418,10970
2005,566,Nigeria,Benin,284523,165669,118854
2005,686,Senegal,Benin,3034,1519,1515
2005,694,Sierra Leone,Benin,5,2,3
2005,768,Togo,Benin,51174,26802,24372
2005,818,Egypt,Benin,32,31,1
2005,196,Cyprus,Benin,6,6,0
2005,188,Costa Rica,Benin,1,0,1
2005,68,Bolivia (Plurinational State of),Benin,1,0,1
2005,76,Brazil,Benin,13,9,4
2005,152,Chile,Benin,1,1,0
2005,36,Australia,Benin,30,15,15
2005,100,Bulgaria,Benin,23,13,10
2005,203,Czechia,Benin,28,24,4
2005,348,Hungary,Benin,22,18,4
2005,643,Russian Federation,Benin,208,119,89
2005,208,Denmark,Benin,44,30,14
2005,246,Finland,Benin,4,3,1
2005,372,Ireland,Benin,39,16,23
2005,578,Norway,Benin,8,4,4
2005,752,Sweden,Benin,32,19,13
2005,826,United Kingdom,Benin,398,210,188
2005,300,Greece,Benin,9,6,3
2005,380,Italy,Benin,1886,1108,778
2005,620,Portugal,Benin,29,27,2
2005,724,Spain,Benin,312,236,76
2005,40,Austria,Benin,62,42,20
2005,56,Belgium,Benin,631,403,228
2005,250,France,Benin,17643,9664,7979
2005,276,Germany,Benin,1451,1045,406
2005,528,Netherlands,Benin,274,194,80
2005,756,Switzerland,Benin,426,273,153
2005,124,Canada,Benin,1086,640,446
2010,120,Cameroon,Benin,1921,1111,810
2010,178,Congo,Benin,11432,6245,5187
2010,266,Gabon,Benin,34101,17795,16306
2010,516,Namibia,Benin,156,68,88
2010,710,South Africa,Benin,167,109,58
2010,854,Burkina Faso,Benin,3996,2032,1964
2010,384,Côte d'Ivoire,Benin,65120,35360,29760
2010,288,Ghana,Benin,13963,7715,6248
2010,324,Guinea,Benin,928,637,291
2010,430,Liberia,Benin,25,19,6
2010,466,Mali,Benin,1307,756,551
2010,478,Mauritania,Benin,549,327,222
2010,562,Niger,Benin,17669,6507,11162
2010,566,Nigeria,Benin,290214,168982,121232
2010,686,Senegal,Benin,3393,1772,1621
2010,694,Sierra Leone,Benin,18,10,8
2010,768,Togo,Benin,67695,32772,34923
2010,818,Egypt,Benin,35,34,1
2010,196,Cyprus,Benin,9,9,0
2010,188,Costa Rica,Benin,1,0,1
2010,68,Bolivia (Plurinational State of),Benin,1,0,1
2010,76,Brazil,Benin,26,18,8
2010,152,Chile,Benin,2,2,0
2010,36,Australia,Benin,80,40,40
2010,100,Bulgaria,Benin,31,18,13
2010,203,Czechia,Benin,41,34,7
2010,348,Hungary,Benin,26,21,5
2010,643,Russian Federation,Benin,93,70,23
2010,208,Denmark,Benin,54,37,17
2010,246,Finland,Benin,5,3,2
2010,372,Ireland,Benin,33,12,21
2010,578,Norway,Benin,18,9,9
2010,752,Sweden,Benin,78,54,24
2010,826,United Kingdom,Benin,419,226,193
2010,300,Greece,Benin,8,5,3
2010,380,Italy,Benin,2528,1535,993
2010,620,Portugal,Benin,29,29,0
2010,724,Spain,Benin,420,309,111
2010,40,Austria,Benin,68,46,22
2010,56,Belgium,Benin,900,534,366
2010,250,France,Benin,19169,10084,9085
2010,276,Germany,Benin,1733,1223,510
2010,528,Netherlands,Benin,263,176,87
2010,756,Switzerland,Benin,503,311,192
2010,124,Canada,Benin,1605,986,619
2015,120,Cameroon,Benin,2454,1280,1174
2015,178,Congo,Benin,15194,8006,7188
2015,266,Gabon,Benin,47682,28069,19613
2015,516,Namibia,Benin,152,67,85
2015,710,South Africa,Benin,300,191,109
2015,854,Burkina Faso,Benin,4178,2124,2054
2015,384,Côte d'Ivoire,Benin,67911,36876,31035
2015,288,Ghana,Benin,17183,9492,7691
2015,324,Guinea,Benin,408,280,128
2015,430,Liberia,Benin,28,22,6
2015,466,Mali,Benin,1619,937,682
2015,478,Mauritania,Benin,551,331,220
2015,562,Niger,Benin,17908,6589,11319
2015,566,Nigeria,Benin,351985,193115,158870
2015,686,Senegal,Benin,3621,1890,1731
2015,694,Sierra Leone,Benin,65,40,25
2015,768,Togo,Benin,71638,34247,37391
2015,818,Egypt,Benin,25,25,0
2015,196,Cyprus,Benin,8,8,0
2015,188,Costa Rica,Benin,1,0,1
2015,68,Bolivia (Plurinational State of),Benin,1,0,1
2015,76,Brazil,Benin,31,21,10
2015,152,Chile,Benin,3,3,0
2015,36,Australia,Benin,110,76,34
2015,100,Bulgaria,Benin,27,16,11
2015,203,Czechia,Benin,43,31,12
2015,348,Hungary,Benin,9,7,2
2015,643,Russian Federation,Benin,94,71,23
2015,208,Denmark,Benin,49,28,21
2015,246,Finland,Benin,22,17,5
2015,352,Iceland,Benin,1,1,0
2015,372,Ireland,Benin,34,12,22
2015,428,Latvia,Benin,2,2,0
2015,578,Norway,Benin,28,15,13
2015,752,Sweden,Benin,90,65,25
2015,826,United Kingdom,Benin,535,281,254
2015,300,Greece,Benin,7,5,2
2015,380,Italy,Benin,2538,1526,1012
2015,620,Portugal,Benin,33,32,1
2015,705,Slovenia,Benin,2,1,1
2015,724,Spain,Benin,398,273,125
2015,40,Austria,Benin,80,55,25
2015,56,Belgium,Benin,1387,822,565
2015,250,France,Benin,21235,10895,10340
2015,276,Germany,Benin,1805,1273,532
2015,528,Netherlands,Benin,288,184,104
2015,756,Switzerland,Benin,619,378,241
2015,124,Canada,Benin,2748,1600,1148
2019,120,Cameroon,Benin,2441,1274,1167
2019,178,Congo,Benin,15661,8248,7413
2019,266,Gabon,Benin,51809,30480,21329
2019,516,Namibia,Benin,160,71,89
2019,710,South Africa,Benin,336,215,121
2019,854,Burkina Faso,Benin,4308,2191,2117
2019,384,Côte d'Ivoire,Benin,70144,38089,32055
2019,288,Ghana,Benin,19338,10701,8637
2019,324,Guinea,Benin,389,267,122
2019,430,Liberia,Benin,23,19,4
2019,466,Mali,Benin,1802,1043,759
2019,478,Mauritania,Benin,572,344,228
2019,562,Niger,Benin,19364,7125,12239
2019,566,Nigeria,Benin,368802,202342,166460
2019,686,Senegal,Benin,3743,1953,1790
2019,694,Sierra Leone,Benin,108,70,38
2019,768,Togo,Benin,72092,34698,37394
2019,818,Egypt,Benin,35,35,0
2019,196,Cyprus,Benin,7,7,0
2019,188,Costa Rica,Benin,1,0,1
2019,68,Bolivia (Plurinational State of),Benin,1,0,1
2019,76,Brazil,Benin,34,23,11
2019,152,Chile,Benin,4,4,0
2019,36,Australia,Benin,116,82,34
2019,100,Bulgaria,Benin,30,18,12
2019,203,Czechia,Benin,41,28,13
2019,348,Hungary,Benin,12,9,3
2019,643,Russian Federation,Benin,93,71,22
2019,208,Denmark,Benin,62,34,28
2019,246,Finland,Benin,22,17,5
2019,352,Iceland,Benin,2,1,1
2019,372,Ireland,Benin,37,13,24
2019,428,Latvia,Benin,1,1,0
2019,578,Norway,Benin,32,16,16
2019,752,Sweden,Benin,116,87,29
2019,826,United Kingdom,Benin,607,320,287
2019,300,Greece,Benin,6,5,1
2019,380,Italy,Benin,2960,1860,1100
2019,620,Portugal,Benin,33,32,1
2019,705,Slovenia,Benin,1,1,0
2019,724,Spain,Benin,412,280,132
2019,40,Austria,Benin,94,65,29
2019,56,Belgium,Benin,1542,895,647
2019,250,France,Benin,22477,11508,10969
2019,276,Germany,Benin,2552,1863,689
2019,528,Netherlands,Benin,320,201,119
2019,756,Switzerland,Benin,681,413,268
2019,124,Canada,Benin,2944,1714,1230
1990,710,South Africa,Bermuda,61,23,38
1990,28,Antigua and Barbuda,Bermuda,9,4,5
1990,44,Bahamas,Bermuda,34,19,15
1990,136,Cayman Islands,Bermuda,10,9,1
1990,214,Dominican Republic,Bermuda,9,9,0
1990,662,Saint Lucia,Bermuda,3,1,2
1990,188,Costa Rica,Bermuda,5,3,2
1990,152,Chile,Bermuda,21,12,9
1990,36,Australia,Bermuda,351,180,171
1990,203,Czechia,Bermuda,1,1,0
1990,208,Denmark,Bermuda,9,3,6
1990,352,Iceland,Bermuda,1,0,1
1990,372,Ireland,Bermuda,11,5,6
1990,826,United Kingdom,Bermuda,61457,29689,31768
1990,300,Greece,Bermuda,2,2,0
1990,40,Austria,Bermuda,10,4,6
1990,250,France,Bermuda,53,19,34
1990,528,Netherlands,Bermuda,9,5,4
1990,124,Canada,Bermuda,1674,815,859
1990,840,United States of America,Bermuda,7972,3900,4072
1995,710,South Africa,Bermuda,38,18,20
1995,28,Antigua and Barbuda,Bermuda,10,5,5
1995,44,Bahamas,Bermuda,23,11,12
1995,136,Cayman Islands,Bermuda,20,16,4
1995,214,Dominican Republic,Bermuda,10,10,0
1995,662,Saint Lucia,Bermuda,3,1,2
1995,188,Costa Rica,Bermuda,5,3,2
1995,68,Bolivia (Plurinational State of),Bermuda,1,0,1
1995,152,Chile,Bermuda,13,8,5
1995,36,Australia,Bermuda,392,196,196
1995,203,Czechia,Bermuda,1,1,0
1995,348,Hungary,Bermuda,1,0,1
1995,208,Denmark,Bermuda,5,2,3
1995,352,Iceland,Bermuda,2,1,1
1995,372,Ireland,Bermuda,30,13,17
1995,826,United Kingdom,Bermuda,31906,15445,16461
1995,300,Greece,Bermuda,4,4,0
1995,40,Austria,Bermuda,12,5,7
1995,250,France,Bermuda,55,19,36
1995,528,Netherlands,Bermuda,13,7,6
1995,124,Canada,Bermuda,1772,859,913
1995,840,United States of America,Bermuda,8284,4089,4195
2000,710,South Africa,Bermuda,26,16,10
2000,28,Antigua and Barbuda,Bermuda,11,7,4
2000,44,Bahamas,Bermuda,13,4,9
2000,136,Cayman Islands,Bermuda,34,26,8
2000,214,Dominican Republic,Bermuda,11,11,0
2000,662,Saint Lucia,Bermuda,5,2,3
2000,188,Costa Rica,Bermuda,8,4,4
2000,68,Bolivia (Plurinational State of),Bermuda,1,0,1
2000,152,Chile,Bermuda,5,3,2
2000,36,Australia,Bermuda,410,200,210
2000,203,Czechia,Bermuda,1,1,0
2000,348,Hungary,Bermuda,1,0,1
2000,352,Iceland,Bermuda,2,1,1
2000,372,Ireland,Bermuda,66,30,36
2000,826,United Kingdom,Bermuda,2892,1418,1474
2000,300,Greece,Bermuda,6,5,1
2000,40,Austria,Bermuda,13,6,7
2000,250,France,Bermuda,57,20,37
2000,528,Netherlands,Bermuda,19,8,11
2000,124,Canada,Bermuda,1912,923,989
2000,840,United States of America,Bermuda,8591,4280,4311
2005,710,South Africa,Bermuda,33,21,12
2005,28,Antigua and Barbuda,Bermuda,12,7,5
2005,44,Bahamas,Bermuda,25,9,16
2005,52,Barbados,Bermuda,20,10,10
2005,136,Cayman Islands,Bermuda,31,24,7
2005,214,Dominican Republic,Bermuda,13,12,1
2005,662,Saint Lucia,Bermuda,4,2,2
2005,188,Costa Rica,Bermuda,5,2,3
2005,68,Bolivia (Plurinational State of),Bermuda,1,0,1
2005,152,Chile,Bermuda,7,5,2
2005,36,Australia,Bermuda,460,226,234
2005,100,Bulgaria,Bermuda,1,0,1
2005,203,Czechia,Bermuda,2,1,1
2005,348,Hungary,Bermuda,1,0,1
2005,352,Iceland,Bermuda,2,1,1
2005,372,Ireland,Bermuda,66,32,34
2005,752,Sweden,Bermuda,6,2,4
2005,826,United Kingdom,Bermuda,3357,1641,1716
2005,300,Greece,Bermuda,7,4,3
2005,40,Austria,Bermuda,15,7,8
2005,250,France,Bermuda,96,27,69
2005,528,Netherlands,Bermuda,20,11,9
2005,124,Canada,Bermuda,2312,1135,1177
2005,840,United States of America,Bermuda,8425,4221,4204
2010,710,South Africa,Bermuda,51,33,18
2010,28,Antigua and Barbuda,Bermuda,13,8,5
2010,44,Bahamas,Bermuda,36,14,22
2010,52,Barbados,Bermuda,27,13,14
2010,136,Cayman Islands,Bermuda,32,24,8
2010,214,Dominican Republic,Bermuda,15,13,2
2010,662,Saint Lucia,Bermuda,3,2,1
2010,188,Costa Rica,Bermuda,11,6,5
2010,152,Chile,Bermuda,10,7,3
2010,36,Australia,Bermuda,520,262,258
2010,100,Bulgaria,Bermuda,1,0,1
2010,203,Czechia,Bermuda,3,1,2
2010,348,Hungary,Bermuda,1,0,1
2010,352,Iceland,Bermuda,1,1,0
2010,372,Ireland,Bermuda,56,26,30
2010,752,Sweden,Bermuda,9,5,4
2010,826,United Kingdom,Bermuda,3536,1766,1770
2010,300,Greece,Bermuda,8,4,4
2010,40,Austria,Bermuda,16,7,9
2010,250,France,Bermuda,107,36,71
2010,528,Netherlands,Bermuda,29,14,15
2010,124,Canada,Bermuda,2280,1135,1145
2010,840,United States of America,Bermuda,8516,4209,4307
2015,710,South Africa,Bermuda,91,58,33
2015,28,Antigua and Barbuda,Bermuda,14,9,5
2015,44,Bahamas,Bermuda,39,15,24
2015,52,Barbados,Bermuda,28,14,14
2015,136,Cayman Islands,Bermuda,34,27,7
2015,214,Dominican Republic,Bermuda,15,13,2
2015,662,Saint Lucia,Bermuda,2,2,0
2015,188,Costa Rica,Bermuda,11,6,5
2015,152,Chile,Bermuda,15,11,4
2015,36,Australia,Bermuda,580,290,290
2015,100,Bulgaria,Bermuda,1,0,1
2015,203,Czechia,Bermuda,4,2,2
2015,348,Hungary,Bermuda,1,0,1
2015,246,Finland,Bermuda,4,4,0
2015,352,Iceland,Bermuda,3,2,1
2015,372,Ireland,Bermuda,57,26,31
2015,752,Sweden,Bermuda,19,9,10
2015,826,United Kingdom,Bermuda,4522,2192,2330
2015,300,Greece,Bermuda,7,4,3
2015,40,Austria,Bermuda,19,9,10
2015,250,France,Bermuda,118,38,80
2015,528,Netherlands,Bermuda,35,17,18
2015,124,Canada,Bermuda,1833,958,875
2015,840,United States of America,Bermuda,9068,4459,4609
2019,710,South Africa,Bermuda,101,65,36
2019,28,Antigua and Barbuda,Bermuda,14,9,5
2019,44,Bahamas,Bermuda,41,16,25
2019,52,Barbados,Bermuda,28,14,14
2019,136,Cayman Islands,Bermuda,36,28,8
2019,214,Dominican Republic,Bermuda,15,13,2
2019,662,Saint Lucia,Bermuda,1,1,0
2019,188,Costa Rica,Bermuda,11,6,5
2019,152,Chile,Bermuda,20,15,5
2019,36,Australia,Bermuda,613,297,316
2019,100,Bulgaria,Bermuda,2,0,2
2019,203,Czechia,Bermuda,4,2,2
2019,348,Hungary,Bermuda,1,0,1
2019,352,Iceland,Bermuda,3,2,1
2019,372,Ireland,Bermuda,62,29,33
2019,752,Sweden,Bermuda,16,10,6
2019,826,United Kingdom,Bermuda,5135,2496,2639
2019,300,Greece,Bermuda,6,4,2
2019,40,Austria,Bermuda,22,11,11
2019,250,France,Bermuda,124,40,84
2019,528,Netherlands,Bermuda,46,21,25
2019,124,Canada,Bermuda,1964,1027,937
2019,840,United States of America,Bermuda,9792,4762,5030
1990,356,India,Bhutan,11088,5491,5597
1990,524,Nepal,Bhutan,16805,8065,8740
1990,144,Sri Lanka,Bhutan,2,1,1
1990,214,Dominican Republic,Bhutan,9,9,0
1990,188,Costa Rica,Bhutan,3,2,1
1990,152,Chile,Bhutan,4,4,0
1990,36,Australia,Bhutan,25,19,6
1990,100,Bulgaria,Bhutan,1,1,0
1990,208,Denmark,Bhutan,7,6,1
1990,372,Ireland,Bhutan,1,1,0
1990,578,Norway,Bhutan,5,5,0
1990,752,Sweden,Bhutan,7,6,1
1990,826,United Kingdom,Bhutan,11,9,2
1990,300,Greece,Bhutan,6,3,3
1990,380,Italy,Bhutan,12,4,8
1990,40,Austria,Bhutan,14,8,6
1990,56,Belgium,Bhutan,158,99,59
1990,250,France,Bhutan,240,151,89
1990,528,Netherlands,Bhutan,9,8,1
1990,756,Switzerland,Bhutan,58,33,25
1995,356,India,Bhutan,9610,4868,4742
1995,524,Nepal,Bhutan,107664,54530,53134
1995,144,Sri Lanka,Bhutan,28,23,5
1995,214,Dominican Republic,Bhutan,10,10,0
1995,188,Costa Rica,Bhutan,2,1,1
1995,152,Chile,Bhutan,4,4,0
1995,36,Australia,Bhutan,33,25,8
1995,100,Bulgaria,Bhutan,7,4,3
1995,208,Denmark,Bhutan,8,7,1
1995,372,Ireland,Bhutan,4,3,1
1995,578,Norway,Bhutan,8,8,0
1995,752,Sweden,Bhutan,9,8,1
1995,826,United Kingdom,Bhutan,48,33,15
1995,300,Greece,Bhutan,4,3,1
1995,380,Italy,Bhutan,24,14,10
1995,40,Austria,Bhutan,16,9,7
1995,56,Belgium,Bhutan,158,99,59
1995,250,France,Bhutan,248,154,94
1995,528,Netherlands,Bhutan,13,12,1
1995,756,Switzerland,Bhutan,56,32,24
1995,124,Canada,Bhutan,17,8,9
2000,356,India,Bhutan,8131,4244,3887
2000,524,Nepal,Bhutan,111196,56629,54567
2000,144,Sri Lanka,Bhutan,56,41,15
2000,214,Dominican Republic,Bhutan,11,11,0
2000,188,Costa Rica,Bhutan,3,2,1
2000,152,Chile,Bhutan,4,4,0
2000,36,Australia,Bhutan,70,35,35
2000,100,Bulgaria,Bhutan,13,7,6
2000,208,Denmark,Bhutan,9,8,1
2000,372,Ireland,Bhutan,8,5,3
2000,578,Norway,Bhutan,15,11,4
2000,752,Sweden,Bhutan,10,8,2
2000,826,United Kingdom,Bhutan,86,56,30
2000,300,Greece,Bhutan,3,3,0
2000,380,Italy,Bhutan,36,24,12
2000,40,Austria,Bhutan,18,11,7
2000,56,Belgium,Bhutan,153,97,56
2000,250,France,Bhutan,255,157,98
2000,528,Netherlands,Bhutan,19,16,3
2000,756,Switzerland,Bhutan,56,32,24
2000,124,Canada,Bhutan,35,17,18
2005,356,India,Bhutan,7513,3913,3600
2005,524,Nepal,Bhutan,108240,55032,53208
2005,144,Sri Lanka,Bhutan,113,63,50
2005,214,Dominican Republic,Bhutan,10,10,0
2005,188,Costa Rica,Bhutan,2,1,1
2005,152,Chile,Bhutan,6,6,0
2005,36,Australia,Bhutan,130,79,51
2005,100,Bulgaria,Bhutan,21,12,9
2005,203,Czechia,Bhutan,2,1,1
2005,208,Denmark,Bhutan,148,76,72
2005,246,Finland,Bhutan,2,1,1
2005,372,Ireland,Bhutan,8,5,3
2005,578,Norway,Bhutan,22,19,3
2005,752,Sweden,Bhutan,19,12,7
2005,826,United Kingdom,Bhutan,239,155,84
2005,300,Greece,Bhutan,3,3,0
2005,380,Italy,Bhutan,36,24,12
2005,40,Austria,Bhutan,20,12,8
2005,56,Belgium,Bhutan,236,161,75
2005,250,France,Bhutan,44,35,9
2005,528,Netherlands,Bhutan,48,34,14
2005,756,Switzerland,Bhutan,58,32,26
2005,124,Canada,Bhutan,1111,552,559
2010,356,India,Bhutan,6894,3582,3312
2010,524,Nepal,Bhutan,73598,37643,35955
2010,144,Sri Lanka,Bhutan,229,130,99
2010,214,Dominican Republic,Bhutan,8,8,0
2010,188,Costa Rica,Bhutan,4,3,1
2010,152,Chile,Bhutan,8,8,0
2010,36,Australia,Bhutan,1690,845,845
2010,100,Bulgaria,Bhutan,28,16,12
2010,203,Czechia,Bhutan,3,1,2
2010,208,Denmark,Bhutan,280,141,139
2010,246,Finland,Bhutan,3,2,1
2010,372,Ireland,Bhutan,7,5,2
2010,578,Norway,Bhutan,233,109,124
2010,752,Sweden,Bhutan,30,21,9
2010,826,United Kingdom,Bhutan,251,165,86
2010,300,Greece,Bhutan,2,2,0
2010,380,Italy,Bhutan,33,21,12
2010,40,Austria,Bhutan,21,12,9
2010,56,Belgium,Bhutan,272,194,78
2010,250,France,Bhutan,81,49,32
2010,528,Netherlands,Bhutan,194,108,86
2010,756,Switzerland,Bhutan,75,39,36
2010,124,Canada,Bhutan,2210,1101,1109
2015,324,Guinea,Bhutan,3,2,1
2015,356,India,Bhutan,6642,3448,3194
2015,524,Nepal,Bhutan,28740,14760,13980
2015,144,Sri Lanka,Bhutan,232,130,102
2015,214,Dominican Republic,Bhutan,8,8,0
2015,188,Costa Rica,Bhutan,4,3,1
2015,152,Chile,Bhutan,12,12,0
2015,36,Australia,Bhutan,5850,3017,2833
2015,100,Bulgaria,Bhutan,23,14,9
2015,203,Czechia,Bhutan,2,1,1
2015,208,Denmark,Bhutan,639,331,308
2015,246,Finland,Bhutan,3,1,2
2015,372,Ireland,Bhutan,7,5,2
2015,578,Norway,Bhutan,369,162,207
2015,752,Sweden,Bhutan,28,20,8
2015,826,United Kingdom,Bhutan,320,207,113
2015,300,Greece,Bhutan,1,1,0
2015,380,Italy,Bhutan,39,25,14
2015,40,Austria,Bhutan,24,14,10
2015,56,Belgium,Bhutan,280,193,87
2015,250,France,Bhutan,149,73,76
2015,528,Netherlands,Bhutan,327,169,158
2015,756,Switzerland,Bhutan,77,43,34
2015,124,Canada,Bhutan,4218,2116,2102
2019,324,Guinea,Bhutan,2,2,0
2019,356,India,Bhutan,6532,3391,3141
2019,524,Nepal,Bhutan,27686,14134,13552
2019,144,Sri Lanka,Bhutan,233,131,102
2019,214,Dominican Republic,Bhutan,8,8,0
2019,188,Costa Rica,Bhutan,4,3,1
2019,152,Chile,Bhutan,16,16,0
2019,36,Australia,Bhutan,7797,3965,3832
2019,100,Bulgaria,Bhutan,26,16,10
2019,203,Czechia,Bhutan,3,1,2
2019,208,Denmark,Bhutan,669,347,322
2019,246,Finland,Bhutan,4,2,2
2019,372,Ireland,Bhutan,7,5,2
2019,578,Norway,Bhutan,404,175,229
2019,752,Sweden,Bhutan,47,29,18
2019,826,United Kingdom,Bhutan,363,236,127
2019,380,Italy,Bhutan,39,24,15
2019,40,Austria,Bhutan,28,17,11
2019,56,Belgium,Bhutan,284,199,85
2019,250,France,Bhutan,157,77,80
2019,528,Netherlands,Bhutan,324,164,160
2019,756,Switzerland,Bhutan,80,38,42
2019,124,Canada,Bhutan,4520,2268,2252
1990,710,South Africa,Bolivia (Plurinational State of),158,69,89
1990,196,Cyprus,Bolivia (Plurinational State of),3,2,1
1990,608,Philippines,Bolivia (Plurinational State of),108,61,47
1990,192,Cuba,Bolivia (Plurinational State of),128,74,54
1990,214,Dominican Republic,Bolivia (Plurinational State of),363,194,169
1990,630,Puerto Rico,Bolivia (Plurinational State of),109,52,57
1990,188,Costa Rica,Bolivia (Plurinational State of),269,159,110
1990,222,El Salvador,Bolivia (Plurinational State of),73,48,25
1990,320,Guatemala,Bolivia (Plurinational State of),67,22,45
1990,340,Honduras,Bolivia (Plurinational State of),112,84,28
1990,484,Mexico,Bolivia (Plurinational State of),1519,954,565
1990,558,Nicaragua,Bolivia (Plurinational State of),47,29,18
1990,591,Panama,Bolivia (Plurinational State of),213,108,105
1990,32,Argentina,Bolivia (Plurinational State of),147234,76050,71184
1990,76,Brazil,Bolivia (Plurinational State of),15996,9177,6819
1990,152,Chile,Bolivia (Plurinational State of),7277,3455,3822
1990,170,Colombia,Bolivia (Plurinational State of),634,304,330
1990,218,Ecuador,Bolivia (Plurinational State of),509,270,239
1990,600,Paraguay,Bolivia (Plurinational State of),809,420,389
1990,604,Peru,Bolivia (Plurinational State of),3569,1591,1978
1990,862,Venezuela (Bolivarian Republic of),Bolivia (Plurinational State of),2224,1161,1063
1990,36,Australia,Bolivia (Plurinational State of),509,245,264
1990,100,Bulgaria,Bolivia (Plurinational State of),1,1,0
1990,203,Czechia,Bolivia (Plurinational State of),12,9,3
1990,348,Hungary,Bolivia (Plurinational State of),14,13,1
1990,616,Poland,Bolivia (Plurinational State of),35,23,12
1990,643,Russian Federation,Bolivia (Plurinational State of),392,192,200
1990,208,Denmark,Bolivia (Plurinational State of),60,32,28
1990,246,Finland,Bolivia (Plurinational State of),24,15,9
1990,352,Iceland,Bolivia (Plurinational State of),6,2,4
1990,372,Ireland,Bolivia (Plurinational State of),3,1,2
1990,578,Norway,Bolivia (Plurinational State of),117,61,56
1990,752,Sweden,Bolivia (Plurinational State of),1845,990,855
1990,826,United Kingdom,Bolivia (Plurinational State of),158,90,68
1990,300,Greece,Bolivia (Plurinational State of),9,4,5
1990,380,Italy,Bolivia (Plurinational State of),94,33,61
1990,620,Portugal,Bolivia (Plurinational State of),15,8,7
1990,724,Spain,Bolivia (Plurinational State of),1806,821,985
1990,40,Austria,Bolivia (Plurinational State of),280,127,153
1990,56,Belgium,Bolivia (Plurinational State of),778,325,453
1990,250,France,Bolivia (Plurinational State of),1287,567,720
1990,276,Germany,Bolivia (Plurinational State of),1634,881,753
1990,528,Netherlands,Bolivia (Plurinational State of),216,101,115
1990,756,Switzerland,Bolivia (Plurinational State of),1129,557,572
1990,124,Canada,Bolivia (Plurinational State of),1545,752,793
1990,840,United States of America,Bolivia (Plurinational State of),31303,15312,15991
1995,710,South Africa,Bolivia (Plurinational State of),98,37,61
1995,196,Cyprus,Bolivia (Plurinational State of),4,2,2
1995,608,Philippines,Bolivia (Plurinational State of),145,81,64
1995,192,Cuba,Bolivia (Plurinational State of),97,54,43
1995,214,Dominican Republic,Bolivia (Plurinational State of),403,211,192
1995,630,Puerto Rico,Bolivia (Plurinational State of),115,55,60
1995,188,Costa Rica,Bolivia (Plurinational State of),220,136,84
1995,222,El Salvador,Bolivia (Plurinational State of),59,37,22
1995,320,Guatemala,Bolivia (Plurinational State of),77,30,47
1995,340,Honduras,Bolivia (Plurinational State of),111,82,29
1995,484,Mexico,Bolivia (Plurinational State of),1725,1011,714
1995,558,Nicaragua,Bolivia (Plurinational State of),38,23,15
1995,591,Panama,Bolivia (Plurinational State of),194,100,94
1995,32,Argentina,Bolivia (Plurinational State of),186685,95917,90768
1995,76,Brazil,Bolivia (Plurinational State of),18217,10223,7994
1995,152,Chile,Bolivia (Plurinational State of),8926,4122,4804
1995,170,Colombia,Bolivia (Plurinational State of),653,328,325
1995,218,Ecuador,Bolivia (Plurinational State of),572,304,268
1995,600,Paraguay,Bolivia (Plurinational State of),976,508,468
1995,604,Peru,Bolivia (Plurinational State of),3572,1568,2004
1995,862,Venezuela (Bolivarian Republic of),Bolivia (Plurinational State of),2031,1062,969
1995,36,Australia,Bolivia (Plurinational State of),622,300,322
1995,100,Bulgaria,Bolivia (Plurinational State of),6,4,2
1995,203,Czechia,Bolivia (Plurinational State of),18,13,5
1995,348,Hungary,Bolivia (Plurinational State of),27,21,6
1995,616,Poland,Bolivia (Plurinational State of),30,20,10
1995,643,Russian Federation,Bolivia (Plurinational State of),368,201,167
1995,208,Denmark,Bolivia (Plurinational State of),105,52,53
1995,246,Finland,Bolivia (Plurinational State of),34,19,15
1995,352,Iceland,Bolivia (Plurinational State of),9,3,6
1995,372,Ireland,Bolivia (Plurinational State of),10,4,6
1995,578,Norway,Bolivia (Plurinational State of),171,96,75
1995,752,Sweden,Bolivia (Plurinational State of),2190,1168,1022
1995,826,United Kingdom,Bolivia (Plurinational State of),625,281,344
1995,300,Greece,Bolivia (Plurinational State of),13,4,9
1995,380,Italy,Bolivia (Plurinational State of),1018,319,699
1995,620,Portugal,Bolivia (Plurinational State of),32,17,15
1995,724,Spain,Bolivia (Plurinational State of),2467,1112,1355
1995,40,Austria,Bolivia (Plurinational State of),316,146,170
1995,56,Belgium,Bolivia (Plurinational State of),778,325,453
1995,250,France,Bolivia (Plurinational State of),1329,573,756
1995,276,Germany,Bolivia (Plurinational State of),1653,815,838
1995,528,Netherlands,Bolivia (Plurinational State of),317,144,173
1995,756,Switzerland,Bolivia (Plurinational State of),1680,805,875
1995,124,Canada,Bolivia (Plurinational State of),1948,943,1005
1995,840,United States of America,Bolivia (Plurinational State of),42856,21190,21666
2000,710,South Africa,Bolivia (Plurinational State of),69,13,56
2000,196,Cyprus,Bolivia (Plurinational State of),5,3,2
2000,608,Philippines,Bolivia (Plurinational State of),531,273,258
2000,192,Cuba,Bolivia (Plurinational State of),66,35,31
2000,214,Dominican Republic,Bolivia (Plurinational State of),443,228,215
2000,630,Puerto Rico,Bolivia (Plurinational State of),122,58,64
2000,188,Costa Rica,Bolivia (Plurinational State of),282,178,104
2000,222,El Salvador,Bolivia (Plurinational State of),44,26,18
2000,320,Guatemala,Bolivia (Plurinational State of),86,37,49
2000,340,Honduras,Bolivia (Plurinational State of),110,81,29
2000,484,Mexico,Bolivia (Plurinational State of),2007,1116,891
2000,558,Nicaragua,Bolivia (Plurinational State of),46,28,18
2000,591,Panama,Bolivia (Plurinational State of),189,98,91
2000,32,Argentina,Bolivia (Plurinational State of),226137,115786,110351
2000,76,Brazil,Bolivia (Plurinational State of),20437,11268,9169
2000,152,Chile,Bolivia (Plurinational State of),10568,4849,5719
2000,170,Colombia,Bolivia (Plurinational State of),671,351,320
2000,218,Ecuador,Bolivia (Plurinational State of),634,338,296
2000,600,Paraguay,Bolivia (Plurinational State of),1140,590,550
2000,604,Peru,Bolivia (Plurinational State of),4174,1842,2332
2000,862,Venezuela (Bolivarian Republic of),Bolivia (Plurinational State of),1838,961,877
2000,36,Australia,Bolivia (Plurinational State of),700,339,361
2000,100,Bulgaria,Bolivia (Plurinational State of),10,6,4
2000,203,Czechia,Bolivia (Plurinational State of),24,17,7
2000,348,Hungary,Bolivia (Plurinational State of),40,29,11
2000,616,Poland,Bolivia (Plurinational State of),26,17,9
2000,643,Russian Federation,Bolivia (Plurinational State of),331,203,128
2000,208,Denmark,Bolivia (Plurinational State of),149,72,77
2000,246,Finland,Bolivia (Plurinational State of),44,23,21
2000,352,Iceland,Bolivia (Plurinational State of),11,3,8
2000,372,Ireland,Bolivia (Plurinational State of),22,10,12
2000,578,Norway,Bolivia (Plurinational State of),263,145,118
2000,752,Sweden,Bolivia (Plurinational State of),2349,1245,1104
2000,826,United Kingdom,Bolivia (Plurinational State of),1103,475,628
2000,300,Greece,Bolivia (Plurinational State of),18,5,13
2000,380,Italy,Bolivia (Plurinational State of),1942,605,1337
2000,620,Portugal,Bolivia (Plurinational State of),51,26,25
2000,724,Spain,Bolivia (Plurinational State of),4190,1918,2272
2000,40,Austria,Bolivia (Plurinational State of),352,166,186
2000,56,Belgium,Bolivia (Plurinational State of),752,315,437
2000,250,France,Bolivia (Plurinational State of),1370,579,791
2000,276,Germany,Bolivia (Plurinational State of),1671,749,922
2000,528,Netherlands,Bolivia (Plurinational State of),431,192,239
2000,756,Switzerland,Bolivia (Plurinational State of),2238,1058,1180
2000,124,Canada,Bolivia (Plurinational State of),2397,1156,1241
2000,840,United States of America,Bolivia (Plurinational State of),54630,27213,27417
2005,710,South Africa,Bolivia (Plurinational State of),90,14,76
2005,196,Cyprus,Bolivia (Plurinational State of),7,4,3
2005,608,Philippines,Bolivia (Plurinational State of),429,224,205
2005,192,Cuba,Bolivia (Plurinational State of),44,24,20
2005,214,Dominican Republic,Bolivia (Plurinational State of),304,163,141
2005,630,Puerto Rico,Bolivia (Plurinational State of),96,46,50
2005,188,Costa Rica,Bolivia (Plurinational State of),185,116,69
2005,222,El Salvador,Bolivia (Plurinational State of),48,27,21
2005,320,Guatemala,Bolivia (Plurinational State of),102,45,57
2005,340,Honduras,Bolivia (Plurinational State of),108,79,29
2005,484,Mexico,Bolivia (Plurinational State of),1888,1016,872
2005,558,Nicaragua,Bolivia (Plurinational State of),57,34,23
2005,591,Panama,Bolivia (Plurinational State of),280,139,141
2005,32,Argentina,Bolivia (Plurinational State of),294640,147845,146795
2005,76,Brazil,Bolivia (Plurinational State of),29671,16067,13604
2005,152,Chile,Bolivia (Plurinational State of),17859,8357,9502
2005,170,Colombia,Bolivia (Plurinational State of),660,354,306
2005,218,Ecuador,Bolivia (Plurinational State of),748,406,342
2005,600,Paraguay,Bolivia (Plurinational State of),1086,563,523
2005,604,Peru,Bolivia (Plurinational State of),4904,2183,2721
2005,862,Venezuela (Bolivarian Republic of),Bolivia (Plurinational State of),1864,976,888
2005,36,Australia,Bolivia (Plurinational State of),770,363,407
2005,100,Bulgaria,Bolivia (Plurinational State of),16,9,7
2005,203,Czechia,Bolivia (Plurinational State of),49,36,13
2005,348,Hungary,Bolivia (Plurinational State of),49,36,13
2005,616,Poland,Bolivia (Plurinational State of),37,27,10
2005,643,Russian Federation,Bolivia (Plurinational State of),209,132,77
2005,208,Denmark,Bolivia (Plurinational State of),293,144,149
2005,246,Finland,Bolivia (Plurinational State of),89,43,46
2005,352,Iceland,Bolivia (Plurinational State of),12,4,8
2005,372,Ireland,Bolivia (Plurinational State of),21,10,11
2005,578,Norway,Bolivia (Plurinational State of),338,182,156
2005,752,Sweden,Bolivia (Plurinational State of),2681,1407,1274
2005,826,United Kingdom,Bolivia (Plurinational State of),2260,1022,1238
2005,191,Croatia,Bolivia (Plurinational State of),16,9,7
2005,300,Greece,Bolivia (Plurinational State of),21,8,13
2005,380,Italy,Bolivia (Plurinational State of),8819,3202,5617
2005,620,Portugal,Bolivia (Plurinational State of),130,34,96
2005,724,Spain,Bolivia (Plurinational State of),92918,41201,51717
2005,40,Austria,Bolivia (Plurinational State of),394,181,213
2005,56,Belgium,Bolivia (Plurinational State of),935,406,529
2005,250,France,Bolivia (Plurinational State of),2106,907,1199
2005,276,Germany,Bolivia (Plurinational State of),3128,1418,1710
2005,528,Netherlands,Bolivia (Plurinational State of),588,243,345
2005,756,Switzerland,Bolivia (Plurinational State of),2548,1124,1424
2005,124,Canada,Bolivia (Plurinational State of),3625,1683,1942
2005,840,United States of America,Bolivia (Plurinational State of),66661,33393,33268
2010,710,South Africa,Bolivia (Plurinational State of),140,21,119
2010,196,Cyprus,Bolivia (Plurinational State of),11,7,4
2010,608,Philippines,Bolivia (Plurinational State of),34,18,16
2010,192,Cuba,Bolivia (Plurinational State of),24,13,11
2010,214,Dominican Republic,Bolivia (Plurinational State of),162,96,66
2010,630,Puerto Rico,Bolivia (Plurinational State of),58,27,31
2010,188,Costa Rica,Bolivia (Plurinational State of),364,228,136
2010,222,El Salvador,Bolivia (Plurinational State of),51,28,23
2010,320,Guatemala,Bolivia (Plurinational State of),118,54,64
2010,340,Honduras,Bolivia (Plurinational State of),105,77,28
2010,484,Mexico,Bolivia (Plurinational State of),1988,1035,953
2010,558,Nicaragua,Bolivia (Plurinational State of),60,36,24
2010,591,Panama,Bolivia (Plurinational State of),386,189,197
2010,32,Argentina,Bolivia (Plurinational State of),363142,179904,183238
2010,76,Brazil,Bolivia (Plurinational State of),38479,20619,17860
2010,152,Chile,Bolivia (Plurinational State of),25143,11864,13279
2010,170,Colombia,Bolivia (Plurinational State of),764,424,340
2010,218,Ecuador,Bolivia (Plurinational State of),1051,559,492
2010,600,Paraguay,Bolivia (Plurinational State of),1034,535,499
2010,604,Peru,Bolivia (Plurinational State of),7026,3341,3685
2010,862,Venezuela (Bolivarian Republic of),Bolivia (Plurinational State of),1910,1001,909
2010,36,Australia,Bolivia (Plurinational State of),860,404,456
2010,100,Bulgaria,Bolivia (Plurinational State of),21,11,10
2010,203,Czechia,Bolivia (Plurinational State of),69,51,18
2010,348,Hungary,Bolivia (Plurinational State of),57,42,15
2010,616,Poland,Bolivia (Plurinational State of),50,38,12
2010,643,Russian Federation,Bolivia (Plurinational State of),83,57,26
2010,208,Denmark,Bolivia (Plurinational State of),429,213,216
2010,233,Estonia,Bolivia (Plurinational State of),1,0,1
2010,246,Finland,Bolivia (Plurinational State of),161,69,92
2010,352,Iceland,Bolivia (Plurinational State of),12,4,8
2010,372,Ireland,Bolivia (Plurinational State of),17,7,10
2010,578,Norway,Bolivia (Plurinational State of),424,221,203
2010,752,Sweden,Bolivia (Plurinational State of),3762,1936,1826
2010,826,United Kingdom,Bolivia (Plurinational State of),2380,1103,1277
2010,191,Croatia,Bolivia (Plurinational State of),32,19,13
2010,300,Greece,Bolivia (Plurinational State of),24,11,13
2010,380,Italy,Bolivia (Plurinational State of),15410,5537,9873
2010,620,Portugal,Bolivia (Plurinational State of),188,36,152
2010,724,Spain,Bolivia (Plurinational State of),216020,91453,124567
2010,40,Austria,Bolivia (Plurinational State of),435,195,240
2010,56,Belgium,Bolivia (Plurinational State of),945,402,543
2010,250,France,Bolivia (Plurinational State of),2954,1210,1744
2010,276,Germany,Bolivia (Plurinational State of),4337,1989,2348
2010,528,Netherlands,Bolivia (Plurinational State of),760,314,446
2010,756,Switzerland,Bolivia (Plurinational State of),2958,1225,1733
2010,124,Canada,Bolivia (Plurinational State of),4605,2105,2500
2010,840,United States of America,Bolivia (Plurinational State of),81051,40044,41007
2015,710,South Africa,Bolivia (Plurinational State of),251,27,224
2015,324,Guinea,Bolivia (Plurinational State of),5,2,3
2015,196,Cyprus,Bolivia (Plurinational State of),10,7,3
2015,608,Philippines,Bolivia (Plurinational State of),35,18,17
2015,192,Cuba,Bolivia (Plurinational State of),19,11,8
2015,214,Dominican Republic,Bolivia (Plurinational State of),170,101,69
2015,630,Puerto Rico,Bolivia (Plurinational State of),56,27,29
2015,188,Costa Rica,Bolivia (Plurinational State of),369,231,138
2015,222,El Salvador,Bolivia (Plurinational State of),53,29,24
2015,320,Guatemala,Bolivia (Plurinational State of),136,63,73
2015,340,Honduras,Bolivia (Plurinational State of),147,108,39
2015,484,Mexico,Bolivia (Plurinational State of),1622,694,928
2015,558,Nicaragua,Bolivia (Plurinational State of),64,39,25
2015,591,Panama,Bolivia (Plurinational State of),454,223,231
2015,32,Argentina,Bolivia (Plurinational State of),419048,207475,211573
2015,76,Brazil,Bolivia (Plurinational State of),46336,24829,21507
2015,152,Chile,Bolivia (Plurinational State of),53244,24514,28730
2015,170,Colombia,Bolivia (Plurinational State of),855,479,376
2015,218,Ecuador,Bolivia (Plurinational State of),1528,808,720
2015,600,Paraguay,Bolivia (Plurinational State of),1009,522,487
2015,604,Peru,Bolivia (Plurinational State of),16767,9112,7655
2015,862,Venezuela (Bolivarian Republic of),Bolivia (Plurinational State of),1967,1018,949
2015,36,Australia,Bolivia (Plurinational State of),1050,500,550
2015,100,Bulgaria,Bolivia (Plurinational State of),18,11,7
2015,203,Czechia,Bolivia (Plurinational State of),78,54,24
2015,348,Hungary,Bolivia (Plurinational State of),49,34,15
2015,616,Poland,Bolivia (Plurinational State of),48,37,11
2015,643,Russian Federation,Bolivia (Plurinational State of),84,58,26
2015,208,Denmark,Bolivia (Plurinational State of),481,240,241
2015,233,Estonia,Bolivia (Plurinational State of),2,1,1
2015,246,Finland,Bolivia (Plurinational State of),177,76,101
2015,352,Iceland,Bolivia (Plurinational State of),14,4,10
2015,372,Ireland,Bolivia (Plurinational State of),17,7,10
2015,578,Norway,Bolivia (Plurinational State of),540,285,255
2015,752,Sweden,Bolivia (Plurinational State of),4450,2261,2189
2015,826,United Kingdom,Bolivia (Plurinational State of),3043,1362,1681
2015,191,Croatia,Bolivia (Plurinational State of),32,19,13
2015,300,Greece,Bolivia (Plurinational State of),22,10,12
2015,380,Italy,Bolivia (Plurinational State of),15664,5685,9979
2015,620,Portugal,Bolivia (Plurinational State of),213,31,182
2015,724,Spain,Bolivia (Plurinational State of),150680,58927,91753
2015,40,Austria,Bolivia (Plurinational State of),509,231,278
2015,56,Belgium,Bolivia (Plurinational State of),1152,461,691
2015,250,France,Bolivia (Plurinational State of),3273,1289,1984
2015,276,Germany,Bolivia (Plurinational State of),4520,2068,2452
2015,528,Netherlands,Bolivia (Plurinational State of),881,355,526
2015,756,Switzerland,Bolivia (Plurinational State of),3803,1466,2337
2015,124,Canada,Bolivia (Plurinational State of),4368,2106,2262
2015,840,United States of America,Bolivia (Plurinational State of),86529,42527,44002
2019,710,South Africa,Bolivia (Plurinational State of),280,30,250
2019,324,Guinea,Bolivia (Plurinational State of),4,2,2
2019,196,Cyprus,Bolivia (Plurinational State of),9,7,2
2019,608,Philippines,Bolivia (Plurinational State of),36,19,17
2019,192,Cuba,Bolivia (Plurinational State of),17,10,7
2019,214,Dominican Republic,Bolivia (Plurinational State of),175,104,71
2019,630,Puerto Rico,Bolivia (Plurinational State of),53,26,27
2019,188,Costa Rica,Bolivia (Plurinational State of),374,235,139
2019,222,El Salvador,Bolivia (Plurinational State of),53,29,24
2019,320,Guatemala,Bolivia (Plurinational State of),139,65,74
2019,340,Honduras,Bolivia (Plurinational State of),149,110,39
2019,484,Mexico,Bolivia (Plurinational State of),1672,716,956
2019,558,Nicaragua,Bolivia (Plurinational State of),67,41,26
2019,591,Panama,Bolivia (Plurinational State of),480,236,244
2019,32,Argentina,Bolivia (Plurinational State of),426394,210758,215636
2019,76,Brazil,Bolivia (Plurinational State of),52184,27963,24221
2019,152,Chile,Bolivia (Plurinational State of),80813,40289,40524
2019,170,Colombia,Bolivia (Plurinational State of),874,490,384
2019,218,Ecuador,Bolivia (Plurinational State of),1504,795,709
2019,600,Paraguay,Bolivia (Plurinational State of),1035,536,499
2019,604,Peru,Bolivia (Plurinational State of),17986,9332,8654
2019,862,Venezuela (Bolivarian Republic of),Bolivia (Plurinational State of),1926,993,933
2019,36,Australia,Bolivia (Plurinational State of),1163,548,615
2019,100,Bulgaria,Bolivia (Plurinational State of),21,11,10
2019,203,Czechia,Bolivia (Plurinational State of),89,65,24
2019,348,Hungary,Bolivia (Plurinational State of),57,38,19
2019,616,Poland,Bolivia (Plurinational State of),50,39,11
2019,643,Russian Federation,Bolivia (Plurinational State of),83,58,25
2019,208,Denmark,Bolivia (Plurinational State of),499,237,262
2019,233,Estonia,Bolivia (Plurinational State of),2,2,0
2019,246,Finland,Bolivia (Plurinational State of),206,83,123
2019,352,Iceland,Bolivia (Plurinational State of),20,7,13
2019,372,Ireland,Bolivia (Plurinational State of),18,8,10
2019,578,Norway,Bolivia (Plurinational State of),593,307,286
2019,752,Sweden,Bolivia (Plurinational State of),4690,2333,2357
2019,826,United Kingdom,Bolivia (Plurinational State of),3455,1551,1904
2019,191,Croatia,Bolivia (Plurinational State of),29,17,12
2019,300,Greece,Bolivia (Plurinational State of),21,10,11
2019,380,Italy,Bolivia (Plurinational State of),15794,5837,9957
2019,620,Portugal,Bolivia (Plurinational State of),216,32,184
2019,724,Spain,Bolivia (Plurinational State of),151235,57955,93280
2019,40,Austria,Bolivia (Plurinational State of),600,278,322
2019,56,Belgium,Bolivia (Plurinational State of),1245,503,742
2019,250,France,Bolivia (Plurinational State of),3464,1360,2104
2019,276,Germany,Bolivia (Plurinational State of),4958,2288,2670
2019,528,Netherlands,Bolivia (Plurinational State of),1006,389,617
2019,756,Switzerland,Bolivia (Plurinational State of),4368,1649,2719
2019,124,Canada,Bolivia (Plurinational State of),4680,2257,2423
2019,840,United States of America,Bolivia (Plurinational State of),93442,45413,48029
1990,28,Antigua and Barbuda,"Bonaire, Sint Eustatius and Saba",4,2,2
1990,533,Aruba,"Bonaire, Sint Eustatius and Saba",53,28,25
1990,670,Saint Vincent and the Grenadines,"Bonaire, Sint Eustatius and Saba",175,96,79
1990,850,United States Virgin Islands,"Bonaire, Sint Eustatius and Saba",16,8,8
1990,68,Bolivia (Plurinational State of),"Bonaire, Sint Eustatius and Saba",13,6,7
1990,862,Venezuela (Bolivarian Republic of),"Bonaire, Sint Eustatius and Saba",45,22,23
1990,250,France,"Bonaire, Sint Eustatius and Saba",82,36,46
1990,528,Netherlands,"Bonaire, Sint Eustatius and Saba",2761,1401,1360
1990,124,Canada,"Bonaire, Sint Eustatius and Saba",57,28,29
1995,28,Antigua and Barbuda,"Bonaire, Sint Eustatius and Saba",7,3,4
1995,533,Aruba,"Bonaire, Sint Eustatius and Saba",133,70,63
1995,670,Saint Vincent and the Grenadines,"Bonaire, Sint Eustatius and Saba",182,100,82
1995,850,United States Virgin Islands,"Bonaire, Sint Eustatius and Saba",18,9,9
1995,68,Bolivia (Plurinational State of),"Bonaire, Sint Eustatius and Saba",17,9,8
1995,862,Venezuela (Bolivarian Republic of),"Bonaire, Sint Eustatius and Saba",44,21,23
1995,250,France,"Bonaire, Sint Eustatius and Saba",85,36,49
1995,528,Netherlands,"Bonaire, Sint Eustatius and Saba",3199,1592,1607
1995,124,Canada,"Bonaire, Sint Eustatius and Saba",54,26,28
2000,28,Antigua and Barbuda,"Bonaire, Sint Eustatius and Saba",9,4,5
2000,533,Aruba,"Bonaire, Sint Eustatius and Saba",212,112,100
2000,670,Saint Vincent and the Grenadines,"Bonaire, Sint Eustatius and Saba",189,100,89
2000,850,United States Virgin Islands,"Bonaire, Sint Eustatius and Saba",20,10,10
2000,68,Bolivia (Plurinational State of),"Bonaire, Sint Eustatius and Saba",33,17,16
2000,862,Venezuela (Bolivarian Republic of),"Bonaire, Sint Eustatius and Saba",43,20,23
2000,250,France,"Bonaire, Sint Eustatius and Saba",88,37,51
2000,528,Netherlands,"Bonaire, Sint Eustatius and Saba",3748,1835,1913
2000,124,Canada,"Bonaire, Sint Eustatius and Saba",53,26,27
2005,28,Antigua and Barbuda,"Bonaire, Sint Eustatius and Saba",10,4,6
2005,533,Aruba,"Bonaire, Sint Eustatius and Saba",249,131,118
2005,670,Saint Vincent and the Grenadines,"Bonaire, Sint Eustatius and Saba",193,104,89
2005,534,Sint Maarten (Dutch part),"Bonaire, Sint Eustatius and Saba",79,37,42
2005,850,United States Virgin Islands,"Bonaire, Sint Eustatius and Saba",20,11,9
2005,68,Bolivia (Plurinational State of),"Bonaire, Sint Eustatius and Saba",17,9,8
2005,862,Venezuela (Bolivarian Republic of),"Bonaire, Sint Eustatius and Saba",46,22,24
2005,250,France,"Bonaire, Sint Eustatius and Saba",87,36,51
2005,528,Netherlands,"Bonaire, Sint Eustatius and Saba",4409,2155,2254
2005,124,Canada,"Bonaire, Sint Eustatius and Saba",52,24,28
2010,28,Antigua and Barbuda,"Bonaire, Sint Eustatius and Saba",10,4,6
2010,533,Aruba,"Bonaire, Sint Eustatius and Saba",282,149,133
2010,531,Curaçao,"Bonaire, Sint Eustatius and Saba",2148,875,1273
2010,670,Saint Vincent and the Grenadines,"Bonaire, Sint Eustatius and Saba",198,107,91
2010,534,Sint Maarten (Dutch part),"Bonaire, Sint Eustatius and Saba",158,74,84
2010,850,United States Virgin Islands,"Bonaire, Sint Eustatius and Saba",19,10,9
2010,68,Bolivia (Plurinational State of),"Bonaire, Sint Eustatius and Saba",18,9,9
2010,862,Venezuela (Bolivarian Republic of),"Bonaire, Sint Eustatius and Saba",48,23,25
2010,250,France,"Bonaire, Sint Eustatius and Saba",87,36,51
2010,528,Netherlands,"Bonaire, Sint Eustatius and Saba",4316,2124,2192
2010,124,Canada,"Bonaire, Sint Eustatius and Saba",4095,1862,2233
2015,28,Antigua and Barbuda,"Bonaire, Sint Eustatius and Saba",11,5,6
2015,533,Aruba,"Bonaire, Sint Eustatius and Saba",297,157,140
2015,531,Curaçao,"Bonaire, Sint Eustatius and Saba",2334,953,1381
2015,670,Saint Vincent and the Grenadines,"Bonaire, Sint Eustatius and Saba",201,109,92
2015,534,Sint Maarten (Dutch part),"Bonaire, Sint Eustatius and Saba",165,77,88
2015,850,United States Virgin Islands,"Bonaire, Sint Eustatius and Saba",19,10,9
2015,68,Bolivia (Plurinational State of),"Bonaire, Sint Eustatius and Saba",20,10,10
2015,862,Venezuela (Bolivarian Republic of),"Bonaire, Sint Eustatius and Saba",51,24,27
2015,250,France,"Bonaire, Sint Eustatius and Saba",96,38,58
2015,528,Netherlands,"Bonaire, Sint Eustatius and Saba",4380,2166,2214
2015,124,Canada,"Bonaire, Sint Eustatius and Saba",4069,1849,2220
2019,28,Antigua and Barbuda,"Bonaire, Sint Eustatius and Saba",11,5,6
2019,533,Aruba,"Bonaire, Sint Eustatius and Saba",300,159,141
2019,531,Curaçao,"Bonaire, Sint Eustatius and Saba",2537,1036,1501
2019,670,Saint Vincent and the Grenadines,"Bonaire, Sint Eustatius and Saba",202,110,92
2019,534,Sint Maarten (Dutch part),"Bonaire, Sint Eustatius and Saba",170,79,91
2019,850,United States Virgin Islands,"Bonaire, Sint Eustatius and Saba",19,10,9
2019,68,Bolivia (Plurinational State of),"Bonaire, Sint Eustatius and Saba",21,11,10
2019,862,Venezuela (Bolivarian Republic of),"Bonaire, Sint Eustatius and Saba",50,24,26
2019,250,France,"Bonaire, Sint Eustatius and Saba",101,40,61
2019,528,Netherlands,"Bonaire, Sint Eustatius and Saba",5008,2507,2501
2019,124,Canada,"Bonaire, Sint Eustatius and Saba",4360,1982,2378
1990,710,South Africa,Bosnia and Herzegovina,147,42,105
1990,818,Egypt,Bosnia and Herzegovina,23,12,11
1990,434,Libya,Bosnia and Herzegovina,66,33,33
1990,196,Cyprus,Bosnia and Herzegovina,17,8,9
1990,400,Jordan,Bosnia and Herzegovina,320,150,170
1990,792,Turkey,Bosnia and Herzegovina,6811,3781,3030
1990,214,Dominican Republic,Bosnia and Herzegovina,6,6,0
1990,152,Chile,Bosnia and Herzegovina,6,3,3
1990,862,Venezuela (Bolivarian Republic of),Bosnia and Herzegovina,21,12,9
1990,36,Australia,Bosnia and Herzegovina,22312,11394,10918
1990,100,Bulgaria,Bosnia and Herzegovina,18,11,7
1990,203,Czechia,Bosnia and Herzegovina,355,220,135
1990,348,Hungary,Bosnia and Herzegovina,381,227,154
1990,616,Poland,Bosnia and Herzegovina,4625,2092,2533
1990,642,Romania,Bosnia and Herzegovina,25,12,13
1990,643,Russian Federation,Bosnia and Herzegovina,876,430,446
1990,703,Slovakia,Bosnia and Herzegovina,47,33,14
1990,208,Denmark,Bosnia and Herzegovina,16411,8344,8067
1990,352,Iceland,Bosnia and Herzegovina,9,5,4
1990,372,Ireland,Bosnia and Herzegovina,123,59,64
1990,428,Latvia,Bosnia and Herzegovina,2,2,0
1990,578,Norway,Bosnia and Herzegovina,3,3,0
1990,752,Sweden,Bosnia and Herzegovina,40488,20385,20103
1990,826,United Kingdom,Bosnia and Herzegovina,1816,1217,599
1990,191,Croatia,Bosnia and Herzegovina,312821,148847,163974
1990,300,Greece,Bosnia and Herzegovina,487,269,218
1990,380,Italy,Bosnia and Herzegovina,4034,1402,2632
1990,470,Malta,Bosnia and Herzegovina,25,16,9
1990,807,North Macedonia,Bosnia and Herzegovina,4365,1820,2545
1990,620,Portugal,Bosnia and Herzegovina,13,7,6
1990,688,Serbia,Bosnia and Herzegovina,42141,19925,22216
1990,705,Slovenia,Bosnia and Herzegovina,68549,35036,33513
1990,724,Spain,Bosnia and Herzegovina,643,309,334
1990,40,Austria,Bosnia and Herzegovina,92349,46141,46208
1990,56,Belgium,Bosnia and Herzegovina,308,156,152
1990,250,France,Bosnia and Herzegovina,8357,4202,4155
1990,276,Germany,Bosnia and Herzegovina,108349,58816,49533
1990,438,Liechtenstein,Bosnia and Herzegovina,297,145,152
1990,442,Luxembourg,Bosnia and Herzegovina,2334,1183,1151
1990,528,Netherlands,Bosnia and Herzegovina,131,71,60
1990,756,Switzerland,Bosnia and Herzegovina,41166,21232,19934
1990,124,Canada,Bosnia and Herzegovina,25135,12236,12899
1990,840,United States of America,Bosnia and Herzegovina,55354,27076,28278
1995,710,South Africa,Bosnia and Herzegovina,91,31,60
1995,818,Egypt,Bosnia and Herzegovina,33,17,16
1995,434,Libya,Bosnia and Herzegovina,153,91,62
1995,196,Cyprus,Bosnia and Herzegovina,24,11,13
1995,400,Jordan,Bosnia and Herzegovina,197,92,105
1995,792,Turkey,Bosnia and Herzegovina,7000,3816,3184
1995,214,Dominican Republic,Bosnia and Herzegovina,7,7,0
1995,152,Chile,Bosnia and Herzegovina,8,5,3
1995,862,Venezuela (Bolivarian Republic of),Bosnia and Herzegovina,20,11,9
1995,36,Australia,Bosnia and Herzegovina,26278,13418,12860
1995,100,Bulgaria,Bosnia and Herzegovina,36,23,13
1995,203,Czechia,Bosnia and Herzegovina,533,336,197
1995,348,Hungary,Bosnia and Herzegovina,323,189,134
1995,616,Poland,Bosnia and Herzegovina,3955,1755,2200
1995,642,Romania,Bosnia and Herzegovina,73,36,37
1995,643,Russian Federation,Bosnia and Herzegovina,776,451,325
1995,703,Slovakia,Bosnia and Herzegovina,133,91,42
1995,208,Denmark,Bosnia and Herzegovina,17628,8973,8655
1995,246,Finland,Bosnia and Herzegovina,100,53,47
1995,352,Iceland,Bosnia and Herzegovina,14,8,6
1995,372,Ireland,Bosnia and Herzegovina,342,159,183
1995,428,Latvia,Bosnia and Herzegovina,2,2,0
1995,578,Norway,Bosnia and Herzegovina,9401,4651,4750
1995,752,Sweden,Bosnia and Herzegovina,48046,24009,24037
1995,826,United Kingdom,Bosnia and Herzegovina,4108,2074,2034
1995,191,Croatia,Bosnia and Herzegovina,506365,240940,265425
1995,300,Greece,Bosnia and Herzegovina,422,205,217
1995,380,Italy,Bosnia and Herzegovina,15437,7507,7930
1995,470,Malta,Bosnia and Herzegovina,30,19,11
1995,807,North Macedonia,Bosnia and Herzegovina,5989,2497,3492
1995,620,Portugal,Bosnia and Herzegovina,27,13,14
1995,688,Serbia,Bosnia and Herzegovina,266909,122940,143969
1995,705,Slovenia,Bosnia and Herzegovina,68327,36538,31789
1995,724,Spain,Bosnia and Herzegovina,867,435,432
1995,40,Austria,Bosnia and Herzegovina,104186,52909,51277
1995,56,Belgium,Bosnia and Herzegovina,306,155,151
1995,250,France,Bosnia and Herzegovina,8628,4266,4362
1995,276,Germany,Bosnia and Herzegovina,129718,66856,62862
1995,438,Liechtenstein,Bosnia and Herzegovina,361,169,192
1995,442,Luxembourg,Bosnia and Herzegovina,2220,1120,1100
1995,528,Netherlands,Bosnia and Herzegovina,288,150,138
1995,756,Switzerland,Bosnia and Herzegovina,39843,20852,18991
1995,124,Canada,Bosnia and Herzegovina,25240,12229,13011
1995,840,United States of America,Bosnia and Herzegovina,78090,38616,39474
2000,710,South Africa,Bosnia and Herzegovina,79,39,40
2000,818,Egypt,Bosnia and Herzegovina,46,23,23
2000,434,Libya,Bosnia and Herzegovina,243,152,91
2000,196,Cyprus,Bosnia and Herzegovina,31,14,17
2000,400,Jordan,Bosnia and Herzegovina,74,34,40
2000,792,Turkey,Bosnia and Herzegovina,2839,1441,1398
2000,214,Dominican Republic,Bosnia and Herzegovina,7,7,0
2000,152,Chile,Bosnia and Herzegovina,11,6,5
2000,862,Venezuela (Bolivarian Republic of),Bosnia and Herzegovina,20,11,9
2000,36,Australia,Bosnia and Herzegovina,28650,14675,13975
2000,100,Bulgaria,Bosnia and Herzegovina,54,35,19
2000,203,Czechia,Bosnia and Herzegovina,711,452,259
2000,348,Hungary,Bosnia and Herzegovina,264,151,113
2000,616,Poland,Bosnia and Herzegovina,3383,1472,1911
2000,642,Romania,Bosnia and Herzegovina,122,59,63
2000,643,Russian Federation,Bosnia and Herzegovina,648,454,194
2000,703,Slovakia,Bosnia and Herzegovina,257,174,83
2000,208,Denmark,Bosnia and Herzegovina,18844,9602,9242
2000,246,Finland,Bosnia and Herzegovina,200,106,94
2000,352,Iceland,Bosnia and Herzegovina,18,10,8
2000,372,Ireland,Bosnia and Herzegovina,748,359,389
2000,428,Latvia,Bosnia and Herzegovina,3,3,0
2000,578,Norway,Bosnia and Herzegovina,11573,5695,5878
2000,752,Sweden,Bosnia and Herzegovina,51526,25580,25946
2000,826,United Kingdom,Bosnia and Herzegovina,6470,2960,3510
2000,191,Croatia,Bosnia and Herzegovina,430399,205693,224706
2000,300,Greece,Bosnia and Herzegovina,363,139,224
2000,380,Italy,Bosnia and Herzegovina,26839,13612,13227
2000,470,Malta,Bosnia and Herzegovina,77,50,27
2000,807,North Macedonia,Bosnia and Herzegovina,7614,3175,4439
2000,620,Portugal,Bosnia and Herzegovina,44,21,23
2000,688,Serbia,Bosnia and Herzegovina,380524,178164,202360
2000,705,Slovenia,Bosnia and Herzegovina,77361,42772,34589
2000,724,Spain,Bosnia and Herzegovina,1466,761,705
2000,40,Austria,Bosnia and Herzegovina,116023,59678,56345
2000,56,Belgium,Bosnia and Herzegovina,295,149,146
2000,250,France,Bosnia and Herzegovina,8898,4330,4568
2000,276,Germany,Bosnia and Herzegovina,151087,74897,76190
2000,438,Liechtenstein,Bosnia and Herzegovina,419,188,231
2000,442,Luxembourg,Bosnia and Herzegovina,2130,1071,1059
2000,528,Netherlands,Bosnia and Herzegovina,458,236,222
2000,756,Switzerland,Bosnia and Herzegovina,38666,20603,18063
2000,124,Canada,Bosnia and Herzegovina,25945,12516,13429
2000,840,United States of America,Bosnia and Herzegovina,101273,50447,50826
2005,710,South Africa,Bosnia and Herzegovina,112,45,67
2005,818,Egypt,Bosnia and Herzegovina,55,29,26
2005,434,Libya,Bosnia and Herzegovina,267,186,81
2005,196,Cyprus,Bosnia and Herzegovina,45,20,25
2005,400,Jordan,Bosnia and Herzegovina,107,56,51
2005,792,Turkey,Bosnia and Herzegovina,2285,1109,1176
2005,214,Dominican Republic,Bosnia and Herzegovina,6,6,0
2005,68,Bolivia (Plurinational State of),Bosnia and Herzegovina,5,4,1
2005,76,Brazil,Bosnia and Herzegovina,34,16,18
2005,152,Chile,Bosnia and Herzegovina,16,9,7
2005,862,Venezuela (Bolivarian Republic of),Bosnia and Herzegovina,20,11,9
2005,36,Australia,Bosnia and Herzegovina,38400,19456,18944
2005,100,Bulgaria,Bosnia and Herzegovina,80,52,28
2005,203,Czechia,Bosnia and Herzegovina,1713,1123,590
2005,348,Hungary,Bosnia and Herzegovina,326,189,137
2005,616,Poland,Bosnia and Herzegovina,3440,1425,2015
2005,642,Romania,Bosnia and Herzegovina,89,44,45
2005,643,Russian Federation,Bosnia and Herzegovina,582,453,129
2005,703,Slovakia,Bosnia and Herzegovina,289,197,92
2005,208,Denmark,Bosnia and Herzegovina,18867,9528,9339
2005,246,Finland,Bosnia and Herzegovina,406,215,191
2005,352,Iceland,Bosnia and Herzegovina,83,43,40
2005,372,Ireland,Bosnia and Herzegovina,749,382,367
2005,428,Latvia,Bosnia and Herzegovina,4,4,0
2005,578,Norway,Bosnia and Herzegovina,12605,6252,6353
2005,752,Sweden,Bosnia and Herzegovina,54813,27068,27745
2005,826,United Kingdom,Bosnia and Herzegovina,6731,2984,3747
2005,191,Croatia,Bosnia and Herzegovina,416359,198019,218340
2005,300,Greece,Bosnia and Herzegovina,407,142,265
2005,380,Italy,Bosnia and Herzegovina,18972,7998,10974
2005,470,Malta,Bosnia and Herzegovina,122,78,44
2005,807,North Macedonia,Bosnia and Herzegovina,7828,3266,4562
2005,620,Portugal,Bosnia and Herzegovina,44,16,28
2005,688,Serbia,Bosnia and Herzegovina,351671,157221,194450
2005,705,Slovenia,Bosnia and Herzegovina,79262,45418,33844
2005,724,Spain,Bosnia and Herzegovina,1888,981,907
2005,40,Austria,Bosnia and Herzegovina,124345,63386,60959
2005,56,Belgium,Bosnia and Herzegovina,215,111,104
2005,250,France,Bosnia and Herzegovina,11323,5678,5645
2005,276,Germany,Bosnia and Herzegovina,157145,78386,78759
2005,438,Liechtenstein,Bosnia and Herzegovina,357,156,201
2005,442,Luxembourg,Bosnia and Herzegovina,1848,984,864
2005,528,Netherlands,Bosnia and Herzegovina,670,337,333
2005,756,Switzerland,Bosnia and Herzegovina,43394,22113,21281
2005,124,Canada,Bosnia and Herzegovina,29787,14821,14966
2005,840,United States of America,Bosnia and Herzegovina,109203,54701,54502
2010,710,South Africa,Bosnia and Herzegovina,175,70,105
2010,818,Egypt,Bosnia and Herzegovina,59,30,29
2010,434,Libya,Bosnia and Herzegovina,292,204,88
2010,196,Cyprus,Bosnia and Herzegovina,73,33,40
2010,400,Jordan,Bosnia and Herzegovina,137,75,62
2010,792,Turkey,Bosnia and Herzegovina,2341,1107,1234
2010,214,Dominican Republic,Bosnia and Herzegovina,5,5,0
2010,68,Bolivia (Plurinational State of),Bosnia and Herzegovina,9,7,2
2010,76,Brazil,Bosnia and Herzegovina,68,31,37
2010,152,Chile,Bosnia and Herzegovina,22,13,9
2010,862,Venezuela (Bolivarian Republic of),Bosnia and Herzegovina,22,12,10
2010,36,Australia,Bosnia and Herzegovina,39730,19885,19845
2010,100,Bulgaria,Bosnia and Herzegovina,103,68,35
2010,203,Czechia,Bosnia and Herzegovina,2550,1711,839
2010,348,Hungary,Bosnia and Herzegovina,388,227,161
2010,616,Poland,Bosnia and Herzegovina,3606,1410,2196
2010,642,Romania,Bosnia and Herzegovina,70,36,34
2010,643,Russian Federation,Bosnia and Herzegovina,505,443,62
2010,703,Slovakia,Bosnia and Herzegovina,324,222,102
2010,208,Denmark,Bosnia and Herzegovina,18556,9292,9264
2010,233,Estonia,Bosnia and Herzegovina,2,1,1
2010,246,Finland,Bosnia and Herzegovina,724,351,373
2010,352,Iceland,Bosnia and Herzegovina,146,75,71
2010,372,Ireland,Bosnia and Herzegovina,627,296,331
2010,428,Latvia,Bosnia and Herzegovina,6,6,0
2010,578,Norway,Bosnia and Herzegovina,12989,6417,6572
2010,752,Sweden,Bosnia and Herzegovina,56183,27704,28479
2010,826,United Kingdom,Bosnia and Herzegovina,7090,3224,3866
2010,191,Croatia,Bosnia and Herzegovina,402318,190345,211973
2010,300,Greece,Bosnia and Herzegovina,468,150,318
2010,380,Italy,Bosnia and Herzegovina,10348,2143,8205
2010,470,Malta,Bosnia and Herzegovina,134,90,44
2010,499,Montenegro,Bosnia and Herzegovina,34304,13816,20488
2010,807,North Macedonia,Bosnia and Herzegovina,8043,3357,4686
2010,620,Portugal,Bosnia and Herzegovina,37,8,29
2010,688,Serbia,Bosnia and Herzegovina,343743,151536,192207
2010,705,Slovenia,Bosnia and Herzegovina,102915,64154,38761
2010,724,Spain,Bosnia and Herzegovina,2162,1100,1062
2010,40,Austria,Bosnia and Herzegovina,132666,67093,65573
2010,56,Belgium,Bosnia and Herzegovina,267,149,118
2010,250,France,Bosnia and Herzegovina,13089,6219,6870
2010,276,Germany,Bosnia and Herzegovina,161676,80809,80867
2010,438,Liechtenstein,Bosnia and Herzegovina,297,123,174
2010,442,Luxembourg,Bosnia and Herzegovina,1587,908,679
2010,528,Netherlands,Bosnia and Herzegovina,757,381,376
2010,756,Switzerland,Bosnia and Herzegovina,51084,24572,26512
2010,124,Canada,Bosnia and Herzegovina,35885,18295,17590
2010,840,United States of America,Bosnia and Herzegovina,120693,59627,61066
2015,710,South Africa,Bosnia and Herzegovina,314,116,198
2015,324,Guinea,Bosnia and Herzegovina,2,2,0
2015,818,Egypt,Bosnia and Herzegovina,43,25,18
2015,434,Libya,Bosnia and Herzegovina,329,229,100
2015,196,Cyprus,Bosnia and Herzegovina,70,32,38
2015,400,Jordan,Bosnia and Herzegovina,58,26,32
2015,792,Turkey,Bosnia and Herzegovina,2376,1095,1281
2015,214,Dominican Republic,Bosnia and Herzegovina,5,5,0
2015,68,Bolivia (Plurinational State of),Bosnia and Herzegovina,10,8,2
2015,76,Brazil,Bosnia and Herzegovina,82,37,45
2015,152,Chile,Bosnia and Herzegovina,33,20,13
2015,862,Venezuela (Bolivarian Republic of),Bosnia and Herzegovina,24,13,11
2015,36,Australia,Bosnia and Herzegovina,36750,18404,18346
2015,100,Bulgaria,Bosnia and Herzegovina,116,77,39
2015,203,Czechia,Bosnia and Herzegovina,2504,1661,843
2015,348,Hungary,Bosnia and Herzegovina,250,155,95
2015,616,Poland,Bosnia and Herzegovina,3476,1399,2077
2015,642,Romania,Bosnia and Herzegovina,11,6,5
2015,643,Russian Federation,Bosnia and Herzegovina,515,452,63
2015,703,Slovakia,Bosnia and Herzegovina,394,281,113
2015,208,Denmark,Bosnia and Herzegovina,19499,9855,9644
2015,233,Estonia,Bosnia and Herzegovina,5,2,3
2015,246,Finland,Bosnia and Herzegovina,842,412,430
2015,352,Iceland,Bosnia and Herzegovina,150,79,71
2015,372,Ireland,Bosnia and Herzegovina,640,298,342
2015,428,Latvia,Bosnia and Herzegovina,7,6,1
2015,578,Norway,Bosnia and Herzegovina,13348,6575,6773
2015,752,Sweden,Bosnia and Herzegovina,57705,28533,29172
2015,826,United Kingdom,Bosnia and Herzegovina,9067,3977,5090
2015,191,Croatia,Bosnia and Herzegovina,404874,190941,213933
2015,300,Greece,Bosnia and Herzegovina,439,128,311
2015,380,Italy,Bosnia and Herzegovina,11359,2380,8979
2015,470,Malta,Bosnia and Herzegovina,227,157,70
2015,499,Montenegro,Bosnia and Herzegovina,32042,12819,19223
2015,807,North Macedonia,Bosnia and Herzegovina,8713,3623,5090
2015,620,Portugal,Bosnia and Herzegovina,42,7,35
2015,688,Serbia,Bosnia and Herzegovina,335992,147578,188414
2015,705,Slovenia,Bosnia and Herzegovina,100880,61384,39496
2015,724,Spain,Bosnia and Herzegovina,2119,1028,1091
2015,40,Austria,Bosnia and Herzegovina,155164,78890,76274
2015,56,Belgium,Bosnia and Herzegovina,521,263,258
2015,250,France,Bosnia and Herzegovina,14499,6680,7819
2015,276,Germany,Bosnia and Herzegovina,168458,84000,84458
2015,438,Liechtenstein,Bosnia and Herzegovina,306,133,173
2015,442,Luxembourg,Bosnia and Herzegovina,2421,1402,1019
2015,528,Netherlands,Bosnia and Herzegovina,813,413,400
2015,756,Switzerland,Bosnia and Herzegovina,55231,26201,29030
2015,124,Canada,Bosnia and Herzegovina,35908,17926,17982
2015,840,United States of America,Bosnia and Herzegovina,127501,62661,64840
2019,710,South Africa,Bosnia and Herzegovina,351,131,220
2019,324,Guinea,Bosnia and Herzegovina,1,1,0
2019,818,Egypt,Bosnia and Herzegovina,61,33,28
2019,434,Libya,Bosnia and Herzegovina,349,243,106
2019,196,Cyprus,Bosnia and Herzegovina,69,32,37
2019,400,Jordan,Bosnia and Herzegovina,62,28,34
2019,792,Turkey,Bosnia and Herzegovina,3212,1498,1714
2019,214,Dominican Republic,Bosnia and Herzegovina,5,5,0
2019,68,Bolivia (Plurinational State of),Bosnia and Herzegovina,10,8,2
2019,76,Brazil,Bosnia and Herzegovina,92,42,50
2019,152,Chile,Bosnia and Herzegovina,44,26,18
2019,862,Venezuela (Bolivarian Republic of),Bosnia and Herzegovina,23,13,10
2019,36,Australia,Bosnia and Herzegovina,37802,18845,18957
2019,100,Bulgaria,Bosnia and Herzegovina,140,94,46
2019,203,Czechia,Bosnia and Herzegovina,2772,1930,842
2019,348,Hungary,Bosnia and Herzegovina,293,183,110
2019,616,Poland,Bosnia and Herzegovina,3681,1566,2115
2019,642,Romania,Bosnia and Herzegovina,110,68,42
2019,643,Russian Federation,Bosnia and Herzegovina,514,452,62
2019,703,Slovakia,Bosnia and Herzegovina,438,323,115
2019,208,Denmark,Bosnia and Herzegovina,18196,9042,9154
2019,233,Estonia,Bosnia and Herzegovina,2,1,1
2019,246,Finland,Bosnia and Herzegovina,995,500,495
2019,352,Iceland,Bosnia and Herzegovina,200,113,87
2019,372,Ireland,Bosnia and Herzegovina,702,328,374
2019,428,Latvia,Bosnia and Herzegovina,5,5,0
2019,578,Norway,Bosnia and Herzegovina,14762,7250,7512
2019,752,Sweden,Bosnia and Herzegovina,59939,29692,30247
2019,826,United Kingdom,Bosnia and Herzegovina,10296,4531,5765
2019,191,Croatia,Bosnia and Herzegovina,373838,175717,198121
2019,300,Greece,Bosnia and Herzegovina,428,136,292
2019,380,Italy,Bosnia and Herzegovina,12825,2762,10063
2019,470,Malta,Bosnia and Herzegovina,366,254,112
2019,499,Montenegro,Bosnia and Herzegovina,32081,12900,19181
2019,807,North Macedonia,Bosnia and Herzegovina,8742,3635,5107
2019,620,Portugal,Bosnia and Herzegovina,42,7,35
2019,688,Serbia,Bosnia and Herzegovina,341347,150086,191261
2019,705,Slovenia,Bosnia and Herzegovina,104738,63548,41190
2019,724,Spain,Bosnia and Herzegovina,2195,1038,1157
2019,40,Austria,Bosnia and Herzegovina,183169,94678,88491
2019,56,Belgium,Bosnia and Herzegovina,615,302,313
2019,250,France,Bosnia and Herzegovina,15347,7052,8295
2019,276,Germany,Bosnia and Herzegovina,184792,97309,87483
2019,438,Liechtenstein,Bosnia and Herzegovina,307,130,177
2019,442,Luxembourg,Bosnia and Herzegovina,2732,1372,1360
2019,528,Netherlands,Bosnia and Herzegovina,966,497,469
2019,756,Switzerland,Bosnia and Herzegovina,57373,27233,30140
2019,124,Canada,Bosnia and Herzegovina,38479,19210,19269
2019,840,United States of America,Bosnia and Herzegovina,137688,66913,70775
1990,834,United Republic of Tanzania,Botswana,80,54,26
1990,894,Zambia,Botswana,469,175,294
1990,716,Zimbabwe,Botswana,2945,1681,1264
1990,748,Eswatini,Botswana,161,91,70
1990,426,Lesotho,Botswana,103,49,54
1990,516,Namibia,Botswana,975,471,504
1990,710,South Africa,Botswana,18470,15195,3275
1990,196,Cyprus,Botswana,2,1,1
1990,152,Chile,Botswana,5,2,3
1990,36,Australia,Botswana,153,85,68
1990,100,Bulgaria,Botswana,7,5,2
1990,348,Hungary,Botswana,1,1,0
1990,643,Russian Federation,Botswana,194,95,99
1990,208,Denmark,Botswana,34,15,19
1990,246,Finland,Botswana,1,1,0
1990,372,Ireland,Botswana,15,8,7
1990,578,Norway,Botswana,35,14,21
1990,752,Sweden,Botswana,38,14,24
1990,826,United Kingdom,Botswana,1955,1078,877
1990,300,Greece,Botswana,3,1,2
1990,380,Italy,Botswana,1,0,1
1990,40,Austria,Botswana,15,7,8
1990,56,Belgium,Botswana,24,12,12
1990,250,France,Botswana,182,86,96
1990,528,Netherlands,Botswana,89,46,43
1990,756,Switzerland,Botswana,19,11,8
1990,124,Canada,Botswana,77,37,40
1995,834,United Republic of Tanzania,Botswana,108,74,34
1995,894,Zambia,Botswana,228,86,142
1995,716,Zimbabwe,Botswana,2924,1668,1256
1995,748,Eswatini,Botswana,64,35,29
1995,426,Lesotho,Botswana,104,48,56
1995,516,Namibia,Botswana,932,454,478
1995,710,South Africa,Botswana,15678,11601,4077
1995,196,Cyprus,Botswana,3,1,2
1995,152,Chile,Botswana,5,3,2
1995,36,Australia,Botswana,413,229,184
1995,100,Bulgaria,Botswana,11,7,4
1995,203,Czechia,Botswana,1,1,0
1995,348,Hungary,Botswana,3,2,1
1995,643,Russian Federation,Botswana,195,100,95
1995,208,Denmark,Botswana,48,21,27
1995,246,Finland,Botswana,2,1,1
1995,372,Ireland,Botswana,42,22,20
1995,578,Norway,Botswana,36,17,19
1995,752,Sweden,Botswana,45,16,29
1995,826,United Kingdom,Botswana,1948,1043,905
1995,300,Greece,Botswana,3,1,2
1995,380,Italy,Botswana,6,3,3
1995,40,Austria,Botswana,17,8,9
1995,56,Belgium,Botswana,24,12,12
1995,250,France,Botswana,188,87,101
1995,528,Netherlands,Botswana,130,66,64
1995,756,Switzerland,Botswana,31,18,13
1995,124,Canada,Botswana,131,63,68
2000,834,United Republic of Tanzania,Botswana,116,79,37
2000,894,Zambia,Botswana,111,42,69
2000,716,Zimbabwe,Botswana,4012,2288,1724
2000,748,Eswatini,Botswana,83,35,48
2000,426,Lesotho,Botswana,102,45,57
2000,516,Namibia,Botswana,865,424,441
2000,710,South Africa,Botswana,17593,11279,6314
2000,196,Cyprus,Botswana,4,2,2
2000,152,Chile,Botswana,5,2,3
2000,36,Australia,Botswana,670,355,315
2000,100,Bulgaria,Botswana,15,10,5
2000,203,Czechia,Botswana,1,1,0
2000,348,Hungary,Botswana,4,2,2
2000,643,Russian Federation,Botswana,189,101,88
2000,208,Denmark,Botswana,61,27,34
2000,246,Finland,Botswana,3,1,2
2000,372,Ireland,Botswana,93,51,42
2000,578,Norway,Botswana,82,45,37
2000,752,Sweden,Botswana,49,17,32
2000,826,United Kingdom,Botswana,1975,1024,951
2000,300,Greece,Botswana,3,0,3
2000,380,Italy,Botswana,10,5,5
2000,40,Austria,Botswana,18,8,10
2000,56,Belgium,Botswana,21,9,12
2000,250,France,Botswana,194,88,106
2000,528,Netherlands,Botswana,177,87,90
2000,756,Switzerland,Botswana,44,24,20
2000,124,Canada,Botswana,188,91,97
2005,834,United Republic of Tanzania,Botswana,132,91,41
2005,894,Zambia,Botswana,319,121,198
2005,716,Zimbabwe,Botswana,4134,2358,1776
2005,748,Eswatini,Botswana,69,30,39
2005,426,Lesotho,Botswana,104,46,58
2005,516,Namibia,Botswana,683,333,350
2005,710,South Africa,Botswana,23147,14477,8670
2005,196,Cyprus,Botswana,6,3,3
2005,44,Bahamas,Botswana,7,4,3
2005,152,Chile,Botswana,7,3,4
2005,36,Australia,Botswana,970,546,424
2005,100,Bulgaria,Botswana,21,13,8
2005,203,Czechia,Botswana,40,24,16
2005,348,Hungary,Botswana,5,3,2
2005,643,Russian Federation,Botswana,109,55,54
2005,208,Denmark,Botswana,66,28,38
2005,246,Finland,Botswana,8,5,3
2005,372,Ireland,Botswana,93,53,40
2005,578,Norway,Botswana,96,52,44
2005,752,Sweden,Botswana,61,22,39
2005,826,United Kingdom,Botswana,2451,1198,1253
2005,300,Greece,Botswana,6,2,4
2005,380,Italy,Botswana,27,13,14
2005,40,Austria,Botswana,20,8,12
2005,56,Belgium,Botswana,30,9,21
2005,250,France,Botswana,48,22,26
2005,528,Netherlands,Botswana,202,100,102
2005,756,Switzerland,Botswana,52,29,23
2005,124,Canada,Botswana,383,175,208
2010,834,United Republic of Tanzania,Botswana,136,94,42
2010,894,Zambia,Botswana,918,423,495
2010,716,Zimbabwe,Botswana,3705,2113,1592
2010,748,Eswatini,Botswana,54,25,29
2010,426,Lesotho,Botswana,106,47,59
2010,516,Namibia,Botswana,658,322,336
2010,710,South Africa,Botswana,36259,22627,13632
2010,196,Cyprus,Botswana,9,5,4
2010,44,Bahamas,Botswana,13,8,5
2010,152,Chile,Botswana,10,5,5
2010,36,Australia,Botswana,1120,588,532
2010,100,Bulgaria,Botswana,27,17,10
2010,203,Czechia,Botswana,74,44,30
2010,348,Hungary,Botswana,6,4,2
2010,643,Russian Federation,Botswana,27,8,19
2010,208,Denmark,Botswana,69,29,40
2010,246,Finland,Botswana,14,9,5
2010,372,Ireland,Botswana,78,42,36
2010,578,Norway,Botswana,112,57,55
2010,752,Sweden,Botswana,82,33,49
2010,826,United Kingdom,Botswana,2582,1290,1292
2010,300,Greece,Botswana,8,3,5
2010,380,Italy,Botswana,46,24,22
2010,705,Slovenia,Botswana,1,1,0
2010,40,Austria,Botswana,22,9,13
2010,56,Belgium,Botswana,30,17,13
2010,250,France,Botswana,38,17,21
2010,528,Netherlands,Botswana,214,106,108
2010,756,Switzerland,Botswana,59,29,30
2010,124,Canada,Botswana,355,161,194
2015,834,United Republic of Tanzania,Botswana,141,99,42
2015,894,Zambia,Botswana,808,371,437
2015,716,Zimbabwe,Botswana,3725,2099,1626
2015,748,Eswatini,Botswana,41,14,27
2015,426,Lesotho,Botswana,108,48,60
2015,516,Namibia,Botswana,644,317,327
2015,710,South Africa,Botswana,65404,39563,25841
2015,324,Guinea,Botswana,50,30,20
2015,196,Cyprus,Botswana,8,5,3
2015,44,Bahamas,Botswana,14,9,5
2015,152,Chile,Botswana,15,8,7
2015,36,Australia,Botswana,1320,668,652
2015,100,Bulgaria,Botswana,26,16,10
2015,203,Czechia,Botswana,97,62,35
2015,348,Hungary,Botswana,3,3,0
2015,643,Russian Federation,Botswana,28,9,19
2015,208,Denmark,Botswana,69,27,42
2015,246,Finland,Botswana,18,11,7
2015,372,Ireland,Botswana,80,43,37
2015,578,Norway,Botswana,119,57,62
2015,752,Sweden,Botswana,110,44,66
2015,826,United Kingdom,Botswana,3301,1600,1701
2015,300,Greece,Botswana,7,3,4
2015,380,Italy,Botswana,46,23,23
2015,705,Slovenia,Botswana,2,2,0
2015,40,Austria,Botswana,25,10,15
2015,56,Belgium,Botswana,45,20,25
2015,250,France,Botswana,41,17,24
2015,528,Netherlands,Botswana,235,117,118
2015,756,Switzerland,Botswana,71,32,39
2015,124,Canada,Botswana,844,347,497
2019,834,United Republic of Tanzania,Botswana,126,89,37
2019,894,Zambia,Botswana,1041,480,561
2019,716,Zimbabwe,Botswana,3825,2174,1651
2019,748,Eswatini,Botswana,40,13,27
2019,426,Lesotho,Botswana,113,50,63
2019,516,Namibia,Botswana,681,335,346
2019,710,South Africa,Botswana,73310,44374,28936
2019,324,Guinea,Botswana,47,28,19
2019,196,Cyprus,Botswana,7,5,2
2019,44,Bahamas,Botswana,14,9,5
2019,152,Chile,Botswana,20,11,9
2019,36,Australia,Botswana,1512,749,763
2019,100,Bulgaria,Botswana,27,17,10
2019,203,Czechia,Botswana,84,54,30
2019,348,Hungary,Botswana,4,3,1
2019,643,Russian Federation,Botswana,27,9,18
2019,208,Denmark,Botswana,70,26,44
2019,246,Finland,Botswana,22,14,8
2019,372,Ireland,Botswana,87,47,40
2019,578,Norway,Botswana,128,59,69
2019,752,Sweden,Botswana,134,58,76
2019,826,United Kingdom,Botswana,3748,1822,1926
2019,300,Greece,Botswana,6,3,3
2019,380,Italy,Botswana,62,36,26
2019,705,Slovenia,Botswana,1,1,0
2019,40,Austria,Botswana,29,12,17
2019,56,Belgium,Botswana,42,22,20
2019,250,France,Botswana,43,18,25
2019,528,Netherlands,Botswana,259,127,132
2019,756,Switzerland,Botswana,91,42,49
2019,124,Canada,Botswana,904,372,532
1990,516,Namibia,Brazil,790,326,464
1990,710,South Africa,Brazil,979,270,709
1990,132,Cabo Verde,Brazil,77,38,39
1990,288,Ghana,Brazil,7,3,4
1990,324,Guinea,Brazil,248,153,95
1990,478,Mauritania,Brazil,143,74,69
1990,686,Senegal,Brazil,536,258,278
1990,818,Egypt,Brazil,137,55,82
1990,434,Libya,Brazil,390,157,233
1990,196,Cyprus,Brazil,15,6,9
1990,376,Israel,Brazil,5866,2567,3299
1990,400,Jordan,Brazil,101,38,63
1990,792,Turkey,Brazil,83,35,48
1990,50,Bangladesh,Brazil,552,299,253
1990,156,China,Brazil,12090,6683,5407
1990,408,Dem. People's Republic of Korea,Brazil,479,244,235
1990,392,Japan,Brazil,56445,28756,27689
1990,608,Philippines,Brazil,123,54,69
1990,626,Timor-Leste,Brazil,152,59,93
1990,44,Bahamas,Brazil,36,16,20
1990,136,Cayman Islands,Brazil,21,10,11
1990,214,Dominican Republic,Brazil,950,442,508
1990,312,Guadeloupe,Brazil,35,12,23
1990,474,Martinique,Brazil,16,6,10
1990,630,Puerto Rico,Brazil,185,88,97
1990,662,Saint Lucia,Brazil,5,3,2
1990,188,Costa Rica,Brazil,346,163,183
1990,222,El Salvador,Brazil,329,126,203
1990,320,Guatemala,Brazil,77,16,61
1990,340,Honduras,Brazil,179,77,102
1990,484,Mexico,Brazil,1682,782,900
1990,558,Nicaragua,Brazil,138,53,85
1990,591,Panama,Brazil,633,247,386
1990,32,Argentina,Brazil,34359,14973,19386
1990,68,Bolivia (Plurinational State of),Brazil,10558,5564,4994
1990,152,Chile,Brazil,4332,2039,2293
1990,170,Colombia,Brazil,1728,753,975
1990,218,Ecuador,Brazil,968,415,553
1990,254,French Guiana,Brazil,6204,3311,2893
1990,328,Guyana,Brazil,485,292,193
1990,600,Paraguay,Brazil,111355,59366,51989
1990,604,Peru,Brazil,3030,1345,1685
1990,740,Suriname,Brazil,2100,1133,967
1990,858,Uruguay,Brazil,10581,7392,3189
1990,862,Venezuela (Bolivarian Republic of),Brazil,4323,2130,2193
1990,36,Australia,Brazil,2926,1456,1470
1990,554,New Zealand,Brazil,718,347,371
1990,112,Belarus,Brazil,69,32,37
1990,100,Bulgaria,Brazil,8,4,4
1990,203,Czechia,Brazil,28,17,11
1990,348,Hungary,Brazil,68,26,42
1990,616,Poland,Brazil,299,123,176
1990,642,Romania,Brazil,2,1,1
1990,643,Russian Federation,Brazil,577,283,294
1990,703,Slovakia,Brazil,4,2,2
1990,208,Denmark,Brazil,765,284,481
1990,234,Faroe Islands,Brazil,6,4,2
1990,246,Finland,Brazil,162,70,92
1990,352,Iceland,Brazil,11,4,7
1990,372,Ireland,Brazil,380,187,193
1990,428,Latvia,Brazil,8,4,4
1990,440,Lithuania,Brazil,75,36,39
1990,578,Norway,Brazil,576,215,361
1990,752,Sweden,Brazil,2747,1058,1689
1990,826,United Kingdom,Brazil,9560,4076,5484
1990,191,Croatia,Brazil,122,45,77
1990,300,Greece,Brazil,1460,705,755
1990,380,Italy,Brazil,25441,3993,21448
1990,470,Malta,Brazil,27,10,17
1990,620,Portugal,Brazil,23722,10256,13466
1990,674,San Marino,Brazil,18,0,18
1990,688,Serbia,Brazil,5,2,3
1990,705,Slovenia,Brazil,7,4,3
1990,724,Spain,Brazil,13454,5362,8092
1990,40,Austria,Brazil,2857,1008,1849
1990,56,Belgium,Brazil,1585,701,884
1990,250,France,Brazil,20435,8421,12014
1990,276,Germany,Brazil,11446,4590,6856
1990,438,Liechtenstein,Brazil,36,11,25
1990,442,Luxembourg,Brazil,288,94,194
1990,528,Netherlands,Brazil,3820,1618,2202
1990,756,Switzerland,Brazil,13295,4149,9146
1990,124,Canada,Brazil,7028,3421,3607
1990,840,United States of America,Brazil,82489,32922,49567
1995,516,Namibia,Brazil,755,315,440
1995,710,South Africa,Brazil,960,387,573
1995,132,Cabo Verde,Brazil,104,53,51
1995,288,Ghana,Brazil,7,4,3
1995,324,Guinea,Brazil,285,188,97
1995,478,Mauritania,Brazil,152,86,66
1995,686,Senegal,Brazil,560,268,292
1995,818,Egypt,Brazil,112,44,68
1995,434,Libya,Brazil,286,124,162
1995,196,Cyprus,Brazil,21,8,13
1995,376,Israel,Brazil,6759,2915,3844
1995,400,Jordan,Brazil,115,50,65
1995,792,Turkey,Brazil,201,80,121
1995,50,Bangladesh,Brazil,5387,2909,2478
1995,156,China,Brazil,32797,17625,15172
1995,408,Dem. People's Republic of Korea,Brazil,1140,559,581
1995,392,Japan,Brazil,178865,85853,93012
1995,608,Philippines,Brazil,165,71,94
1995,626,Timor-Leste,Brazil,165,67,98
1995,44,Bahamas,Brazil,41,18,23
1995,136,Cayman Islands,Brazil,42,20,22
1995,214,Dominican Republic,Brazil,1055,477,578
1995,312,Guadeloupe,Brazil,39,16,23
1995,474,Martinique,Brazil,41,16,25
1995,630,Puerto Rico,Brazil,195,93,102
1995,662,Saint Lucia,Brazil,6,4,2
1995,188,Costa Rica,Brazil,304,150,154
1995,222,El Salvador,Brazil,264,106,158
1995,320,Guatemala,Brazil,114,42,72
1995,340,Honduras,Brazil,178,73,105
1995,484,Mexico,Brazil,2482,1080,1402
1995,558,Nicaragua,Brazil,110,42,68
1995,591,Panama,Brazil,695,273,422
1995,32,Argentina,Brazil,33642,14479,19163
1995,68,Bolivia (Plurinational State of),Brazil,12746,6642,6104
1995,152,Chile,Brazil,5611,2659,2952
1995,170,Colombia,Brazil,1809,786,1023
1995,218,Ecuador,Brazil,1035,462,573
1995,254,French Guiana,Brazil,7022,3593,3429
1995,328,Guyana,Brazil,780,471,309
1995,600,Paraguay,Brazil,97450,51742,45708
1995,604,Peru,Brazil,3033,1326,1707
1995,740,Suriname,Brazil,2594,1404,1190
1995,858,Uruguay,Brazil,11084,6380,4704
1995,862,Venezuela (Bolivarian Republic of),Brazil,4590,2268,2322
1995,36,Australia,Brazil,3960,1858,2102
1995,554,New Zealand,Brazil,885,416,469
1995,112,Belarus,Brazil,83,29,54
1995,100,Bulgaria,Brazil,25,11,14
1995,203,Czechia,Brazil,42,26,16
1995,348,Hungary,Brazil,207,105,102
1995,616,Poland,Brazil,255,103,152
1995,642,Romania,Brazil,3,2,1
1995,643,Russian Federation,Brazil,594,297,297
1995,703,Slovakia,Brazil,30,11,19
1995,208,Denmark,Brazil,1154,405,749
1995,234,Faroe Islands,Brazil,6,4,2
1995,246,Finland,Brazil,203,88,115
1995,352,Iceland,Brazil,20,7,13
1995,372,Ireland,Brazil,1341,638,703
1995,428,Latvia,Brazil,12,6,6
1995,440,Lithuania,Brazil,84,39,45
1995,578,Norway,Brazil,895,343,552
1995,752,Sweden,Brazil,3259,1240,2019
1995,826,United Kingdom,Brazil,12033,4962,7071
1995,191,Croatia,Brazil,119,38,81
1995,300,Greece,Brazil,1763,708,1055
1995,380,Italy,Brazil,27162,4877,22285
1995,470,Malta,Brazil,32,12,20
1995,620,Portugal,Brazil,35931,16918,19013
1995,674,San Marino,Brazil,20,1,19
1995,688,Serbia,Brazil,42,17,25
1995,705,Slovenia,Brazil,14,4,10
1995,724,Spain,Brazil,17132,6747,10385
1995,40,Austria,Brazil,3223,1171,2052
1995,56,Belgium,Brazil,2304,855,1449
1995,250,France,Brazil,21096,8485,12611
1995,276,Germany,Brazil,17392,5041,12351
1995,438,Liechtenstein,Brazil,50,15,35
1995,442,Luxembourg,Brazil,273,88,185
1995,528,Netherlands,Brazil,5699,2339,3360
1995,756,Switzerland,Brazil,18838,6459,12379
1995,124,Canada,Brazil,10058,4867,5191
1995,840,United States of America,Brazil,149432,58786,90646
2000,516,Namibia,Brazil,702,294,408
2000,710,South Africa,Brazil,1233,599,634
2000,132,Cabo Verde,Brazil,130,67,63
2000,288,Ghana,Brazil,8,4,4
2000,324,Guinea,Brazil,199,132,67
2000,478,Mauritania,Brazil,157,96,61
2000,686,Senegal,Brazil,506,229,277
2000,818,Egypt,Brazil,96,37,59
2000,434,Libya,Brazil,188,97,91
2000,196,Cyprus,Brazil,27,10,17
2000,376,Israel,Brazil,7274,3142,4132
2000,400,Jordan,Brazil,129,62,67
2000,792,Turkey,Brazil,320,124,196
2000,50,Bangladesh,Brazil,10221,5520,4701
2000,156,China,Brazil,53504,28567,24937
2000,408,Dem. People's Republic of Korea,Brazil,1801,874,927
2000,392,Japan,Brazil,254413,117533,136880
2000,608,Philippines,Brazil,4146,2061,2085
2000,626,Timor-Leste,Brazil,181,76,105
2000,44,Bahamas,Brazil,47,21,26
2000,136,Cayman Islands,Brazil,73,34,39
2000,214,Dominican Republic,Brazil,1160,512,648
2000,312,Guadeloupe,Brazil,42,19,23
2000,474,Martinique,Brazil,67,27,40
2000,630,Puerto Rico,Brazil,207,99,108
2000,662,Saint Lucia,Brazil,9,6,3
2000,188,Costa Rica,Brazil,415,207,208
2000,222,El Salvador,Brazil,198,85,113
2000,320,Guatemala,Brazil,151,69,82
2000,340,Honduras,Brazil,176,69,107
2000,484,Mexico,Brazil,3391,1434,1957
2000,558,Nicaragua,Brazil,107,45,62
2000,591,Panama,Brazil,802,313,489
2000,32,Argentina,Brazil,32925,13985,18940
2000,68,Bolivia (Plurinational State of),Brazil,14801,7647,7154
2000,152,Chile,Brazil,6886,3243,3643
2000,170,Colombia,Brazil,1889,818,1071
2000,218,Ecuador,Brazil,1101,509,592
2000,254,French Guiana,Brazil,7840,3876,3964
2000,328,Guyana,Brazil,1074,649,425
2000,600,Paraguay,Brazil,83208,43666,39542
2000,604,Peru,Brazil,3545,1560,1985
2000,740,Suriname,Brazil,3204,1735,1469
2000,858,Uruguay,Brazil,11507,4684,6823
2000,862,Venezuela (Bolivarian Republic of),Brazil,4828,2388,2440
2000,36,Australia,Brazil,4750,2151,2599
2000,554,New Zealand,Brazil,638,310,328
2000,112,Belarus,Brazil,97,27,70
2000,100,Bulgaria,Brazil,42,18,24
2000,203,Czechia,Brazil,56,35,21
2000,348,Hungary,Brazil,346,184,162
2000,616,Poland,Brazil,219,86,133
2000,642,Romania,Brazil,4,3,1
2000,643,Russian Federation,Brazil,590,300,290
2000,703,Slovakia,Brazil,66,23,43
2000,208,Denmark,Brazil,1542,525,1017
2000,234,Faroe Islands,Brazil,6,3,3
2000,246,Finland,Brazil,243,105,138
2000,352,Iceland,Brazil,28,10,18
2000,372,Ireland,Brazil,3040,1496,1544
2000,428,Latvia,Brazil,17,8,9
2000,440,Lithuania,Brazil,65,30,35
2000,578,Norway,Brazil,1260,486,774
2000,752,Sweden,Brazil,3496,1316,2180
2000,826,United Kingdom,Brazil,14710,5913,8797
2000,191,Croatia,Brazil,103,27,76
2000,300,Greece,Brazil,2094,702,1392
2000,380,Italy,Brazil,28883,5762,23121
2000,470,Malta,Brazil,40,15,25
2000,620,Portugal,Brazil,49599,24339,25260
2000,674,San Marino,Brazil,23,1,22
2000,688,Serbia,Brazil,72,28,44
2000,705,Slovenia,Brazil,20,7,13
2000,724,Spain,Brazil,28179,11312,16867
2000,40,Austria,Brazil,3589,1334,2255
2000,56,Belgium,Brazil,2958,992,1966
2000,250,France,Brazil,21756,8548,13208
2000,276,Germany,Brazil,23338,5492,17846
2000,438,Liechtenstein,Brazil,65,20,45
2000,442,Luxembourg,Brazil,262,84,178
2000,528,Netherlands,Brazil,7770,3130,4640
2000,756,Switzerland,Brazil,24450,8829,15621
2000,124,Canada,Brazil,13327,6429,6898
2000,840,United States of America,Brazil,217822,85377,132445
2005,516,Namibia,Brazil,555,231,324
2005,710,South Africa,Brazil,1622,750,872
2005,132,Cabo Verde,Brazil,203,99,104
2005,288,Ghana,Brazil,11,6,5
2005,324,Guinea,Brazil,139,101,38
2005,478,Mauritania,Brazil,158,99,59
2005,686,Senegal,Brazil,544,257,287
2005,818,Egypt,Brazil,114,48,66
2005,434,Libya,Brazil,207,126,81
2005,196,Cyprus,Brazil,39,14,25
2005,376,Israel,Brazil,7919,3439,4480
2005,400,Jordan,Brazil,186,101,85
2005,792,Turkey,Brazil,329,123,206
2005,50,Bangladesh,Brazil,12165,6570,5595
2005,156,China,Brazil,59028,34411,24617
2005,408,Dem. People's Republic of Korea,Brazil,2163,1068,1095
2005,392,Japan,Brazil,217455,99050,118405
2005,608,Philippines,Brazil,3355,1694,1661
2005,626,Timor-Leste,Brazil,192,76,116
2005,44,Bahamas,Brazil,80,38,42
2005,136,Cayman Islands,Brazil,66,31,35
2005,214,Dominican Republic,Brazil,889,409,480
2005,312,Guadeloupe,Brazil,52,24,28
2005,474,Martinique,Brazil,70,27,43
2005,630,Puerto Rico,Brazil,162,77,85
2005,662,Saint Lucia,Brazil,9,6,3
2005,188,Costa Rica,Brazil,272,134,138
2005,222,El Salvador,Brazil,215,97,118
2005,320,Guatemala,Brazil,180,95,85
2005,340,Honduras,Brazil,173,69,104
2005,484,Mexico,Brazil,3744,1616,2128
2005,558,Nicaragua,Brazil,107,48,59
2005,591,Panama,Brazil,1223,539,684
2005,32,Argentina,Brazil,37604,15911,21693
2005,68,Bolivia (Plurinational State of),Brazil,18453,9584,8869
2005,152,Chile,Brazil,8477,4056,4421
2005,170,Colombia,Brazil,1873,818,1055
2005,218,Ecuador,Brazil,1299,615,684
2005,254,French Guiana,Brazil,11989,6038,5951
2005,328,Guyana,Brazil,1448,880,568
2005,600,Paraguay,Brazil,79266,41600,37666
2005,604,Peru,Brazil,4164,1847,2317
2005,740,Suriname,Brazil,3921,2136,1785
2005,858,Uruguay,Brazil,12923,5261,7662
2005,862,Venezuela (Bolivarian Republic of),Brazil,5214,2576,2638
2005,36,Australia,Brazil,7530,3527,4003
2005,554,New Zealand,Brazil,1686,819,867
2005,112,Belarus,Brazil,93,25,68
2005,100,Bulgaria,Brazil,66,29,37
2005,203,Czechia,Brazil,188,107,81
2005,348,Hungary,Brazil,427,230,197
2005,616,Poland,Brazil,240,118,122
2005,642,Romania,Brazil,4,4,0
2005,643,Russian Federation,Brazil,512,268,244
2005,703,Slovakia,Brazil,75,27,48
2005,208,Denmark,Brazil,2280,777,1503
2005,234,Faroe Islands,Brazil,18,14,4
2005,246,Finland,Brazil,635,272,363
2005,352,Iceland,Brazil,67,18,49
2005,372,Ireland,Brazil,7146,4233,2913
2005,428,Latvia,Brazil,27,18,9
2005,440,Lithuania,Brazil,72,33,39
2005,578,Norway,Brazil,1985,721,1264
2005,752,Sweden,Brazil,4457,1634,2823
2005,826,United Kingdom,Brazil,31040,13474,17566
2005,191,Croatia,Brazil,148,47,101
2005,300,Greece,Brazil,2180,712,1468
2005,380,Italy,Brazil,66536,21344,45192
2005,470,Malta,Brazil,48,19,29
2005,620,Portugal,Brazil,91614,41207,50407
2005,674,San Marino,Brazil,23,2,21
2005,688,Serbia,Brazil,89,33,56
2005,705,Slovenia,Brazil,33,11,22
2005,724,Spain,Brazil,68502,26199,42303
2005,40,Austria,Brazil,4012,1431,2581
2005,56,Belgium,Brazil,4967,1755,3212
2005,250,France,Brazil,42128,18887,23241
2005,276,Germany,Brazil,38846,12138,26708
2005,438,Liechtenstein,Brazil,103,30,73
2005,442,Luxembourg,Brazil,227,82,145
2005,528,Netherlands,Brazil,10187,3782,6405
2005,756,Switzerland,Brazil,32115,9679,22436
2005,124,Canada,Brazil,19215,9118,10097
2005,840,United States of America,Brazil,280274,110797,169477
2010,516,Namibia,Brazil,534,223,311
2010,710,South Africa,Brazil,2539,1169,1370
2010,132,Cabo Verde,Brazil,275,130,145
2010,288,Ghana,Brazil,11,6,5
2010,324,Guinea,Brazil,97,70,27
2010,478,Mauritania,Brazil,159,101,58
2010,686,Senegal,Brazil,609,301,308
2010,818,Egypt,Brazil,123,49,74
2010,434,Libya,Brazil,227,139,88
2010,196,Cyprus,Brazil,63,23,40
2010,376,Israel,Brazil,8661,3770,4891
2010,400,Jordan,Brazil,238,135,103
2010,792,Turkey,Brazil,339,122,217
2010,50,Bangladesh,Brazil,14083,7605,6478
2010,156,China,Brazil,64552,40254,24298
2010,408,Dem. People's Republic of Korea,Brazil,2525,1262,1263
2010,392,Japan,Brazil,230552,103693,126859
2010,608,Philippines,Brazil,160,79,81
2010,626,Timor-Leste,Brazil,197,71,126
2010,44,Bahamas,Brazil,112,54,58
2010,136,Cayman Islands,Brazil,66,31,35
2010,214,Dominican Republic,Brazil,611,303,308
2010,312,Guadeloupe,Brazil,61,28,33
2010,474,Martinique,Brazil,74,28,46
2010,630,Puerto Rico,Brazil,97,45,52
2010,662,Saint Lucia,Brazil,9,6,3
2010,188,Costa Rica,Brazil,536,264,272
2010,222,El Salvador,Brazil,232,109,123
2010,320,Guatemala,Brazil,209,122,87
2010,340,Honduras,Brazil,169,69,100
2010,484,Mexico,Brazil,4532,1989,2543
2010,558,Nicaragua,Brazil,114,52,62
2010,591,Panama,Brazil,1704,803,901
2010,32,Argentina,Brazil,42283,17837,24446
2010,68,Bolivia (Plurinational State of),Brazil,22066,11504,10562
2010,152,Chile,Brazil,10065,4869,5196
2010,170,Colombia,Brazil,2181,975,1206
2010,218,Ecuador,Brazil,1825,840,985
2010,254,French Guiana,Brazil,16137,8200,7937
2010,328,Guyana,Brazil,1821,1111,710
2010,600,Paraguay,Brazil,75523,39560,35963
2010,604,Peru,Brazil,6193,3369,2824
2010,740,Suriname,Brazil,4626,2523,2103
2010,858,Uruguay,Brazil,11978,4812,7166
2010,862,Venezuela (Bolivarian Republic of),Brazil,5689,2811,2878
2010,36,Australia,Brazil,16550,7890,8660
2010,554,New Zealand,Brazil,2728,1322,1406
2010,112,Belarus,Brazil,89,24,65
2010,100,Bulgaria,Brazil,87,38,49
2010,203,Czechia,Brazil,301,172,129
2010,348,Hungary,Brazil,508,276,232
2010,616,Poland,Brazil,270,153,117
2010,642,Romania,Brazil,8,6,2
2010,643,Russian Federation,Brazil,425,232,193
2010,703,Slovakia,Brazil,84,31,53
2010,208,Denmark,Brazil,2963,1011,1952
2010,233,Estonia,Brazil,62,28,34
2010,234,Faroe Islands,Brazil,18,9,9
2010,246,Finland,Brazil,1175,445,730
2010,352,Iceland,Brazil,105,26,79
2010,372,Ireland,Brazil,10075,5904,4171
2010,428,Latvia,Brazil,37,27,10
2010,440,Lithuania,Brazil,70,29,41
2010,578,Norway,Brazil,3605,1142,2463
2010,752,Sweden,Brazil,6005,2164,3841
2010,826,United Kingdom,Brazil,32699,14574,18125
2010,191,Croatia,Brazil,192,67,125
2010,300,Greece,Brazil,2356,751,1605
2010,380,Italy,Brazil,110536,40412,70124
2010,470,Malta,Brazil,79,37,42
2010,620,Portugal,Brazil,118415,51344,67071
2010,674,San Marino,Brazil,24,3,21
2010,688,Serbia,Brazil,87,32,55
2010,705,Slovenia,Brazil,79,21,58
2010,724,Spain,Brazil,132649,51311,81338
2010,40,Austria,Brazil,4434,1528,2906
2010,56,Belgium,Brazil,9227,3704,5523
2010,250,France,Brazil,53906,20446,33460
2010,276,Germany,Brazil,51692,17809,33883
2010,438,Liechtenstein,Brazil,143,41,102
2010,442,Luxembourg,Brazil,195,81,114
2010,528,Netherlands,Brazil,13429,4853,8576
2010,756,Switzerland,Brazil,32302,9374,22928
2010,124,Canada,Brazil,22920,10809,12111
2010,840,United States of America,Brazil,352957,136594,216363
2015,516,Namibia,Brazil,522,219,303
2015,710,South Africa,Brazil,4579,1983,2596
2015,132,Cabo Verde,Brazil,286,135,151
2015,288,Ghana,Brazil,13,7,6
2015,324,Guinea,Brazil,14,10,4
2015,478,Mauritania,Brazil,159,102,57
2015,686,Senegal,Brazil,650,322,328
2015,818,Egypt,Brazil,91,44,47
2015,434,Libya,Brazil,255,155,100
2015,196,Cyprus,Brazil,60,22,38
2015,376,Israel,Brazil,8932,3863,5069
2015,400,Jordan,Brazil,102,48,54
2015,792,Turkey,Brazil,344,119,225
2015,50,Bangladesh,Brazil,14919,8057,6862
2015,156,China,Brazil,74289,47603,26686
2015,408,Dem. People's Republic of Korea,Brazil,2780,1397,1383
2015,392,Japan,Brazil,173437,86902,86535
2015,608,Philippines,Brazil,162,79,83
2015,626,Timor-Leste,Brazil,66,38,28
2015,44,Bahamas,Brazil,121,58,63
2015,136,Cayman Islands,Brazil,71,34,37
2015,214,Dominican Republic,Brazil,644,319,325
2015,312,Guadeloupe,Brazil,63,28,35
2015,474,Martinique,Brazil,76,28,48
2015,630,Puerto Rico,Brazil,95,45,50
2015,662,Saint Lucia,Brazil,8,6,2
2015,188,Costa Rica,Brazil,544,267,277
2015,222,El Salvador,Brazil,242,114,128
2015,320,Guatemala,Brazil,240,141,99
2015,340,Honduras,Brazil,237,97,140
2015,484,Mexico,Brazil,6444,2996,3448
2015,558,Nicaragua,Brazil,122,56,66
2015,591,Panama,Brazil,2002,941,1061
2015,32,Argentina,Brazil,48792,20566,28226
2015,68,Bolivia (Plurinational State of),Brazil,25688,13391,12297
2015,152,Chile,Brazil,15247,7206,8041
2015,170,Colombia,Brazil,2441,1104,1337
2015,218,Ecuador,Brazil,2654,1212,1442
2015,254,French Guiana,Brazil,19481,9784,9697
2015,328,Guyana,Brazil,2135,1303,832
2015,600,Paraguay,Brazil,73715,38569,35146
2015,604,Peru,Brazil,8817,5147,3670
2015,740,Suriname,Brazil,5023,2743,2280
2015,858,Uruguay,Brazil,12369,4965,7404
2015,862,Venezuela (Bolivarian Republic of),Brazil,6026,2936,3090
2015,36,Australia,Brazil,26790,12803,13987
2015,554,New Zealand,Brazil,3728,1803,1925
2015,112,Belarus,Brazil,94,26,68
2015,100,Bulgaria,Brazil,137,56,81
2015,203,Czechia,Brazil,462,280,182
2015,348,Hungary,Brazil,1733,1053,680
2015,616,Poland,Brazil,260,150,110
2015,642,Romania,Brazil,29,9,20
2015,643,Russian Federation,Brazil,433,235,198
2015,703,Slovakia,Brazil,114,47,67
2015,208,Denmark,Brazil,3470,1197,2273
2015,233,Estonia,Brazil,93,54,39
2015,234,Faroe Islands,Brazil,11,4,7
2015,246,Finland,Brazil,1578,597,981
2015,352,Iceland,Brazil,139,36,103
2015,372,Ireland,Brazil,10292,5979,4313
2015,428,Latvia,Brazil,21,15,6
2015,440,Lithuania,Brazil,61,21,40
2015,578,Norway,Brazil,5209,1691,3518
2015,752,Sweden,Brazil,7341,2709,4632
2015,826,United Kingdom,Brazil,41817,17951,23866
2015,191,Croatia,Brazil,193,67,126
2015,300,Greece,Brazil,2211,641,1570
2015,380,Italy,Brazil,99965,34079,65886
2015,470,Malta,Brazil,133,67,66
2015,620,Portugal,Brazil,134245,54298,79947
2015,674,San Marino,Brazil,29,2,27
2015,688,Serbia,Brazil,85,32,53
2015,705,Slovenia,Brazil,114,37,77
2015,724,Spain,Brazil,99187,35030,64157
2015,40,Austria,Brazil,5186,1805,3381
2015,56,Belgium,Brazil,12618,4939,7679
2015,250,France,Brazil,59715,21628,38087
2015,276,Germany,Brazil,53860,18472,35388
2015,438,Liechtenstein,Brazil,169,52,117
2015,442,Luxembourg,Brazil,297,126,171
2015,528,Netherlands,Brazil,16089,5775,10314
2015,756,Switzerland,Brazil,37517,10771,26746
2015,124,Canada,Brazil,29135,13147,15988
2015,840,United States of America,Brazil,361374,138165,223209
2019,516,Namibia,Brazil,552,232,320
2019,710,South Africa,Brazil,5131,2225,2906
2019,132,Cabo Verde,Brazil,300,142,158
2019,288,Ghana,Brazil,14,8,6
2019,324,Guinea,Brazil,13,10,3
2019,478,Mauritania,Brazil,165,106,59
2019,686,Senegal,Brazil,671,332,339
2019,818,Egypt,Brazil,129,55,74
2019,434,Libya,Brazil,270,164,106
2019,196,Cyprus,Brazil,59,22,37
2019,376,Israel,Brazil,8686,3757,4929
2019,400,Jordan,Brazil,109,51,58
2019,792,Turkey,Brazil,465,164,301
2019,50,Bangladesh,Brazil,15115,4609,10506
2019,156,China,Brazil,78301,50174,28127
2019,408,Dem. People's Republic of Korea,Brazil,2833,1424,1409
2019,392,Japan,Brazil,189735,95069,94666
2019,608,Philippines,Brazil,167,82,85
2019,626,Timor-Leste,Brazil,65,38,27
2019,44,Bahamas,Brazil,128,62,66
2019,136,Cayman Islands,Brazil,78,38,40
2019,214,Dominican Republic,Brazil,665,330,335
2019,312,Guadeloupe,Brazil,63,28,35
2019,474,Martinique,Brazil,75,28,47
2019,630,Puerto Rico,Brazil,90,43,47
2019,662,Saint Lucia,Brazil,7,6,1
2019,188,Costa Rica,Brazil,552,273,279
2019,222,El Salvador,Brazil,245,116,129
2019,320,Guatemala,Brazil,246,145,101
2019,340,Honduras,Brazil,240,98,142
2019,484,Mexico,Brazil,6643,3089,3554
2019,558,Nicaragua,Brazil,127,58,69
2019,591,Panama,Brazil,2132,1004,1128
2019,32,Argentina,Brazil,49647,20879,28768
2019,68,Bolivia (Plurinational State of),Brazil,28045,14620,13425
2019,152,Chile,Brazil,20370,9029,11341
2019,170,Colombia,Brazil,2496,1129,1367
2019,218,Ecuador,Brazil,2612,1192,1420
2019,254,French Guiana,Brazil,21549,10823,10726
2019,328,Guyana,Brazil,2178,1330,848
2019,600,Paraguay,Brazil,75626,39570,36056
2019,604,Peru,Brazil,10510,6314,4196
2019,740,Suriname,Brazil,5375,2939,2436
2019,858,Uruguay,Brazil,12790,5157,7633
2019,862,Venezuela (Bolivarian Republic of),Brazil,5902,2862,3040
2019,36,Australia,Brazil,42552,20532,22020
2019,554,New Zealand,Brazil,3831,1853,1978
2019,112,Belarus,Brazil,92,25,67
2019,100,Bulgaria,Brazil,184,80,104
2019,203,Czechia,Brazil,720,437,283
2019,348,Hungary,Brazil,778,420,358
2019,616,Poland,Brazil,275,163,112
2019,642,Romania,Brazil,308,123,185
2019,643,Russian Federation,Brazil,432,235,197
2019,703,Slovakia,Brazil,143,64,79
2019,208,Denmark,Brazil,4503,1559,2944
2019,233,Estonia,Brazil,131,78,53
2019,234,Faroe Islands,Brazil,22,8,14
2019,246,Finland,Brazil,2054,808,1246
2019,352,Iceland,Brazil,197,66,131
2019,372,Ireland,Brazil,11299,6579,4720
2019,428,Latvia,Brazil,28,20,8
2019,440,Lithuania,Brazil,51,22,29
2019,578,Norway,Brazil,5945,1820,4125
2019,752,Sweden,Brazil,9740,3788,5952
2019,826,United Kingdom,Brazil,47487,20454,27033
2019,191,Croatia,Brazil,178,62,116
2019,300,Greece,Brazil,2159,684,1475
2019,380,Italy,Brazil,115970,41971,73999
2019,470,Malta,Brazil,214,109,105
2019,620,Portugal,Brazil,136526,55395,81131
2019,674,San Marino,Brazil,30,1,29
2019,688,Serbia,Brazil,86,33,53
2019,705,Slovenia,Brazil,145,52,93
2019,724,Spain,Brazil,109552,38844,70708
2019,40,Austria,Brazil,6122,2200,3922
2019,56,Belgium,Brazil,14634,5857,8777
2019,250,France,Brazil,63208,22801,40407
2019,276,Germany,Brazil,59082,20791,38291
2019,438,Liechtenstein,Brazil,194,58,136
2019,442,Luxembourg,Brazil,3344,1259,2085
2019,528,Netherlands,Brazil,19369,7172,12197
2019,756,Switzerland,Brazil,41601,12365,29236
2019,124,Canada,Brazil,31221,14089,17132
2019,840,United States of America,Brazil,459876,175289,284587
1990,710,South Africa,British Virgin Islands,23,12,11
1990,792,Turkey,British Virgin Islands,18,9,9
1990,28,Antigua and Barbuda,British Virgin Islands,66,32,34
1990,44,Bahamas,British Virgin Islands,5,3,2
1990,212,Dominica,British Virgin Islands,31,15,16
1990,214,Dominican Republic,British Virgin Islands,12,9,3
1990,308,Grenada,British Virgin Islands,8,4,4
1990,659,Saint Kitts and Nevis,British Virgin Islands,106,49,57
1990,662,Saint Lucia,British Virgin Islands,2,1,1
1990,850,United States Virgin Islands,British Virgin Islands,2665,1122,1543
1990,36,Australia,British Virgin Islands,6,3,3
1990,100,Bulgaria,British Virgin Islands,21,14,7
1990,826,United Kingdom,British Virgin Islands,47,26,21
1990,300,Greece,British Virgin Islands,12,6,6
1990,124,Canada,British Virgin Islands,72,35,37
1995,710,South Africa,British Virgin Islands,14,8,6
1995,792,Turkey,British Virgin Islands,43,20,23
1995,28,Antigua and Barbuda,British Virgin Islands,73,35,38
1995,44,Bahamas,British Virgin Islands,8,4,4
1995,535,"Bonaire, Sint Eustatius and Saba",British Virgin Islands,874,389,485
1995,212,Dominica,British Virgin Islands,41,20,21
1995,214,Dominican Republic,British Virgin Islands,14,10,4
1995,308,Grenada,British Virgin Islands,10,5,5
1995,659,Saint Kitts and Nevis,British Virgin Islands,140,66,74
1995,662,Saint Lucia,British Virgin Islands,2,2,0
1995,850,United States Virgin Islands,British Virgin Islands,2693,1134,1559
1995,36,Australia,British Virgin Islands,3,2,1
1995,100,Bulgaria,British Virgin Islands,34,23,11
1995,372,Ireland,British Virgin Islands,1,1,0
1995,826,United Kingdom,British Virgin Islands,188,82,106
1995,300,Greece,British Virgin Islands,10,4,6
1995,124,Canada,British Virgin Islands,94,46,48
2000,710,South Africa,British Virgin Islands,10,8,2
2000,792,Turkey,British Virgin Islands,70,32,38
2000,28,Antigua and Barbuda,British Virgin Islands,80,39,41
2000,44,Bahamas,British Virgin Islands,12,6,6
2000,535,"Bonaire, Sint Eustatius and Saba",British Virgin Islands,1748,778,970
2000,212,Dominica,British Virgin Islands,49,24,25
2000,214,Dominican Republic,British Virgin Islands,15,11,4
2000,308,Grenada,British Virgin Islands,13,7,6
2000,659,Saint Kitts and Nevis,British Virgin Islands,193,95,98
2000,662,Saint Lucia,British Virgin Islands,4,3,1
2000,850,United States Virgin Islands,British Virgin Islands,2727,1148,1579
2000,100,Bulgaria,British Virgin Islands,46,31,15
2000,372,Ireland,British Virgin Islands,2,1,1
2000,752,Sweden,British Virgin Islands,1,0,1
2000,826,United Kingdom,British Virgin Islands,334,139,195
2000,300,Greece,British Virgin Islands,8,1,7
2000,124,Canada,British Virgin Islands,119,58,61
2005,710,South Africa,British Virgin Islands,12,9,3
2005,792,Turkey,British Virgin Islands,72,32,40
2005,28,Antigua and Barbuda,British Virgin Islands,86,42,44
2005,44,Bahamas,British Virgin Islands,8,3,5
2005,535,"Bonaire, Sint Eustatius and Saba",British Virgin Islands,1862,828,1034
2005,212,Dominica,British Virgin Islands,60,30,30
2005,214,Dominican Republic,British Virgin Islands,43,24,19
2005,308,Grenada,British Virgin Islands,13,7,6
2005,659,Saint Kitts and Nevis,British Virgin Islands,219,109,110
2005,662,Saint Lucia,British Virgin Islands,6,5,1
2005,534,Sint Maarten (Dutch part),British Virgin Islands,434,198,236
2005,850,United States Virgin Islands,British Virgin Islands,2594,1100,1494
2005,100,Bulgaria,British Virgin Islands,66,45,21
2005,372,Ireland,British Virgin Islands,2,1,1
2005,826,United Kingdom,British Virgin Islands,285,121,164
2005,300,Greece,British Virgin Islands,5,1,4
2005,124,Canada,British Virgin Islands,105,52,53
2010,710,South Africa,British Virgin Islands,18,14,4
2010,466,Mali,British Virgin Islands,410,173,237
2010,792,Turkey,British Virgin Islands,74,32,42
2010,28,Antigua and Barbuda,British Virgin Islands,92,45,47
2010,44,Bahamas,British Virgin Islands,3,0,3
2010,535,"Bonaire, Sint Eustatius and Saba",British Virgin Islands,56,33,23
2010,531,Curaçao,British Virgin Islands,92,15,77
2010,212,Dominica,British Virgin Islands,73,36,37
2010,214,Dominican Republic,British Virgin Islands,71,37,34
2010,308,Grenada,British Virgin Islands,14,7,7
2010,659,Saint Kitts and Nevis,British Virgin Islands,237,119,118
2010,662,Saint Lucia,British Virgin Islands,9,7,2
2010,534,Sint Maarten (Dutch part),British Virgin Islands,868,396,472
2010,850,United States Virgin Islands,British Virgin Islands,2463,1053,1410
2010,100,Bulgaria,British Virgin Islands,83,57,26
2010,372,Ireland,British Virgin Islands,1,0,1
2010,752,Sweden,British Virgin Islands,1,0,1
2010,826,United Kingdom,British Virgin Islands,300,131,169
2010,300,Greece,British Virgin Islands,1,1,0
2010,124,Canada,British Virgin Islands,95,48,47
2015,710,South Africa,British Virgin Islands,31,25,6
2015,466,Mali,British Virgin Islands,508,215,293
2015,792,Turkey,British Virgin Islands,75,32,43
2015,28,Antigua and Barbuda,British Virgin Islands,98,48,50
2015,44,Bahamas,British Virgin Islands,3,0,3
2015,535,"Bonaire, Sint Eustatius and Saba",British Virgin Islands,63,37,26
2015,531,Curaçao,British Virgin Islands,99,16,83
2015,212,Dominica,British Virgin Islands,85,42,43
2015,214,Dominican Republic,British Virgin Islands,74,39,35
2015,308,Grenada,British Virgin Islands,14,7,7
2015,659,Saint Kitts and Nevis,British Virgin Islands,243,123,120
2015,662,Saint Lucia,British Virgin Islands,8,7,1
2015,534,Sint Maarten (Dutch part),British Virgin Islands,904,412,492
2015,850,United States Virgin Islands,British Virgin Islands,2464,1053,1411
2015,100,Bulgaria,British Virgin Islands,67,43,24
2015,372,Ireland,British Virgin Islands,1,0,1
2015,752,Sweden,British Virgin Islands,3,2,1
2015,826,United Kingdom,British Virgin Islands,383,161,222
2015,124,Canada,British Virgin Islands,84,40,44
2019,710,South Africa,British Virgin Islands,34,28,6
2019,466,Mali,British Virgin Islands,565,239,326
2019,792,Turkey,British Virgin Islands,101,44,57
2019,28,Antigua and Barbuda,British Virgin Islands,101,50,51
2019,44,Bahamas,British Virgin Islands,3,0,3
2019,535,"Bonaire, Sint Eustatius and Saba",British Virgin Islands,75,45,30
2019,531,Curaçao,British Virgin Islands,107,17,90
2019,212,Dominica,British Virgin Islands,86,43,43
2019,214,Dominican Republic,British Virgin Islands,76,40,36
2019,308,Grenada,British Virgin Islands,14,7,7
2019,659,Saint Kitts and Nevis,British Virgin Islands,247,125,122
2019,662,Saint Lucia,British Virgin Islands,7,7,0
2019,534,Sint Maarten (Dutch part),British Virgin Islands,935,426,509
2019,850,United States Virgin Islands,British Virgin Islands,2465,1054,1411
2019,100,Bulgaria,British Virgin Islands,74,47,27
2019,372,Ireland,British Virgin Islands,1,0,1
2019,752,Sweden,British Virgin Islands,2,1,1
2019,826,United Kingdom,British Virgin Islands,434,183,251
2019,124,Canada,British Virgin Islands,90,43,47
1990,710,South Africa,Brunei Darussalam,23,9,14
1990,818,Egypt,Brunei Darussalam,65,26,39
1990,196,Cyprus,Brunei Darussalam,1,0,1
1990,400,Jordan,Brunei Darussalam,11,5,6
1990,762,Tajikistan,Brunei Darussalam,38,18,20
1990,356,India,Brunei Darussalam,16220,10518,5702
1990,458,Malaysia,Brunei Darussalam,3234,1628,1606
1990,608,Philippines,Brunei Darussalam,106,58,48
1990,32,Argentina,Brunei Darussalam,2,2,0
1990,36,Australia,Brunei Darussalam,1620,849,771
1990,208,Denmark,Brunei Darussalam,4,2,2
1990,372,Ireland,Brunei Darussalam,3,1,2
1990,578,Norway,Brunei Darussalam,20,12,8
1990,826,United Kingdom,Brunei Darussalam,388,234,154
1990,724,Spain,Brunei Darussalam,1,1,0
1990,40,Austria,Brunei Darussalam,3,3,0
1990,250,France,Brunei Darussalam,33,11,22
1990,528,Netherlands,Brunei Darussalam,273,146,127
1990,756,Switzerland,Brunei Darussalam,32,15,17
1990,124,Canada,Brunei Darussalam,4246,2067,2179
1995,710,South Africa,Brunei Darussalam,14,6,8
1995,818,Egypt,Brunei Darussalam,55,21,34
1995,196,Cyprus,Brunei Darussalam,2,0,2
1995,400,Jordan,Brunei Darussalam,21,4,17
1995,762,Tajikistan,Brunei Darussalam,31,16,15
1995,356,India,Brunei Darussalam,23639,15249,8390
1995,458,Malaysia,Brunei Darussalam,2956,1603,1353
1995,608,Philippines,Brunei Darussalam,142,77,65
1995,32,Argentina,Brunei Darussalam,2,2,0
1995,36,Australia,Brunei Darussalam,1911,986,925
1995,208,Denmark,Brunei Darussalam,4,2,2
1995,372,Ireland,Brunei Darussalam,9,5,4
1995,578,Norway,Brunei Darussalam,20,14,6
1995,826,United Kingdom,Brunei Darussalam,1527,752,775
1995,380,Italy,Brunei Darussalam,3,0,3
1995,724,Spain,Brunei Darussalam,3,2,1
1995,40,Austria,Brunei Darussalam,4,4,0
1995,250,France,Brunei Darussalam,34,11,23
1995,528,Netherlands,Brunei Darussalam,402,210,192
1995,756,Switzerland,Brunei Darussalam,31,15,16
1995,124,Canada,Brunei Darussalam,4242,2056,2186
2000,710,South Africa,Brunei Darussalam,10,4,6
2000,818,Egypt,Brunei Darussalam,50,18,32
2000,196,Cyprus,Brunei Darussalam,2,0,2
2000,400,Jordan,Brunei Darussalam,30,2,28
2000,762,Tajikistan,Brunei Darussalam,27,14,13
2000,356,India,Brunei Darussalam,31057,19979,11078
2000,458,Malaysia,Brunei Darussalam,3425,1986,1439
2000,608,Philippines,Brunei Darussalam,805,379,426
2000,32,Argentina,Brunei Darussalam,2,2,0
2000,36,Australia,Brunei Darussalam,2100,1069,1031
2000,208,Denmark,Brunei Darussalam,4,2,2
2000,372,Ireland,Brunei Darussalam,19,10,9
2000,578,Norway,Brunei Darussalam,21,14,7
2000,826,United Kingdom,Brunei Darussalam,2692,1279,1413
2000,380,Italy,Brunei Darussalam,5,0,5
2000,724,Spain,Brunei Darussalam,39,25,14
2000,40,Austria,Brunei Darussalam,4,4,0
2000,250,France,Brunei Darussalam,35,11,24
2000,528,Netherlands,Brunei Darussalam,545,280,265
2000,756,Switzerland,Brunei Darussalam,32,15,17
2000,124,Canada,Brunei Darussalam,4338,2093,2245
2005,710,South Africa,Brunei Darussalam,12,5,7
2005,818,Egypt,Brunei Darussalam,60,24,36
2005,196,Cyprus,Brunei Darussalam,3,0,3
2005,400,Jordan,Brunei Darussalam,44,9,35
2005,762,Tajikistan,Brunei Darussalam,25,12,13
2005,356,India,Brunei Darussalam,28695,18436,10259
2005,458,Malaysia,Brunei Darussalam,4589,2754,1835
2005,608,Philippines,Brunei Darussalam,651,312,339
2005,32,Argentina,Brunei Darussalam,2,2,0
2005,76,Brazil,Brunei Darussalam,70,5,65
2005,36,Australia,Brunei Darussalam,2570,1262,1308
2005,100,Bulgaria,Brunei Darussalam,1,1,0
2005,208,Denmark,Brunei Darussalam,4,1,3
2005,372,Ireland,Brunei Darussalam,19,10,9
2005,578,Norway,Brunei Darussalam,22,14,8
2005,752,Sweden,Brunei Darussalam,3,0,3
2005,826,United Kingdom,Brunei Darussalam,3744,1733,2011
2005,380,Italy,Brunei Darussalam,19,8,11
2005,724,Spain,Brunei Darussalam,19,12,7
2005,40,Austria,Brunei Darussalam,5,5,0
2005,250,France,Brunei Darussalam,89,47,42
2005,528,Netherlands,Brunei Darussalam,581,296,285
2005,756,Switzerland,Brunei Darussalam,39,18,21
2005,124,Canada,Brunei Darussalam,4018,2018,2000
2010,710,South Africa,Brunei Darussalam,18,8,10
2010,818,Egypt,Brunei Darussalam,65,25,40
2010,196,Cyprus,Brunei Darussalam,4,0,4
2010,400,Jordan,Brunei Darussalam,57,14,43
2010,762,Tajikistan,Brunei Darussalam,24,12,12
2010,356,India,Brunei Darussalam,26333,16893,9440
2010,458,Malaysia,Brunei Darussalam,5460,3362,2098
2010,608,Philippines,Brunei Darussalam,80,37,43
2010,32,Argentina,Brunei Darussalam,1,1,0
2010,76,Brazil,Brunei Darussalam,141,10,131
2010,36,Australia,Brunei Darussalam,3040,1504,1536
2010,100,Bulgaria,Brunei Darussalam,1,1,0
2010,208,Denmark,Brunei Darussalam,3,1,2
2010,372,Ireland,Brunei Darussalam,16,7,9
2010,578,Norway,Brunei Darussalam,29,17,12
2010,752,Sweden,Brunei Darussalam,4,2,2
2010,826,United Kingdom,Brunei Darussalam,3944,1869,2075
2010,380,Italy,Brunei Darussalam,29,13,16
2010,724,Spain,Brunei Darussalam,23,10,13
2010,40,Austria,Brunei Darussalam,5,5,0
2010,250,France,Brunei Darussalam,45,13,32
2010,528,Netherlands,Brunei Darussalam,561,292,269
2010,756,Switzerland,Brunei Darussalam,43,17,26
2010,124,Canada,Brunei Darussalam,3945,2073,1872
2015,710,South Africa,Brunei Darussalam,31,14,17
2015,818,Egypt,Brunei Darussalam,48,23,25
2015,196,Cyprus,Brunei Darussalam,3,0,3
2015,400,Jordan,Brunei Darussalam,24,1,23
2015,762,Tajikistan,Brunei Darussalam,23,12,11
2015,356,India,Brunei Darussalam,25370,16265,9105
2015,458,Malaysia,Brunei Darussalam,6657,4137,2520
2015,608,Philippines,Brunei Darussalam,82,38,44
2015,32,Argentina,Brunei Darussalam,1,1,0
2015,76,Brazil,Brunei Darussalam,170,12,158
2015,36,Australia,Brunei Darussalam,2890,1406,1484
2015,100,Bulgaria,Brunei Darussalam,1,1,0
2015,208,Denmark,Brunei Darussalam,7,5,2
2015,246,Finland,Brunei Darussalam,2,2,0
2015,372,Ireland,Brunei Darussalam,16,7,9
2015,578,Norway,Brunei Darussalam,34,20,14
2015,752,Sweden,Brunei Darussalam,11,7,4
2015,826,United Kingdom,Brunei Darussalam,5043,2311,2732
2015,380,Italy,Brunei Darussalam,33,15,18
2015,724,Spain,Brunei Darussalam,22,11,11
2015,40,Austria,Brunei Darussalam,6,6,0
2015,250,France,Brunei Darussalam,50,14,36
2015,528,Netherlands,Brunei Darussalam,615,324,291
2015,756,Switzerland,Brunei Darussalam,67,30,37
2015,124,Canada,Brunei Darussalam,4457,2330,2127
2019,710,South Africa,Brunei Darussalam,34,16,18
2019,818,Egypt,Brunei Darussalam,68,29,39
2019,196,Cyprus,Brunei Darussalam,2,0,2
2019,400,Jordan,Brunei Darussalam,25,1,24
2019,762,Tajikistan,Brunei Darussalam,22,12,10
2019,356,India,Brunei Darussalam,24952,15998,8954
2019,458,Malaysia,Brunei Darussalam,6960,4345,2615
2019,608,Philippines,Brunei Darussalam,84,39,45
2019,32,Argentina,Brunei Darussalam,1,1,0
2019,76,Brazil,Brunei Darussalam,191,14,177
2019,36,Australia,Brunei Darussalam,3237,1559,1678
2019,100,Bulgaria,Brunei Darussalam,1,1,0
2019,208,Denmark,Brunei Darussalam,8,5,3
2019,246,Finland,Brunei Darussalam,4,3,1
2019,372,Ireland,Brunei Darussalam,17,8,9
2019,578,Norway,Brunei Darussalam,34,19,15
2019,752,Sweden,Brunei Darussalam,8,2,6
2019,826,United Kingdom,Brunei Darussalam,5726,2632,3094
2019,380,Italy,Brunei Darussalam,36,14,22
2019,724,Spain,Brunei Darussalam,22,11,11
2019,40,Austria,Brunei Darussalam,7,7,0
2019,250,France,Brunei Darussalam,52,14,38
2019,528,Netherlands,Brunei Darussalam,655,351,304
2019,756,Switzerland,Brunei Darussalam,72,34,38
2019,124,Canada,Brunei Darussalam,4776,2497,2279
1990,516,Namibia,Bulgaria,45,10,35
1990,710,South Africa,Bulgaria,3836,1580,2256
1990,818,Egypt,Bulgaria,71,35,36
1990,196,Cyprus,Bulgaria,1531,501,1030
1990,376,Israel,Bulgaria,19353,8873,10480
1990,400,Jordan,Bulgaria,91,46,45
1990,792,Turkey,Bulgaria,462767,224879,237888
1990,496,Mongolia,Bulgaria,2,1,1
1990,192,Cuba,Bulgaria,296,123,173
1990,214,Dominican Republic,Bulgaria,357,205,152
1990,188,Costa Rica,Bulgaria,39,17,22
1990,484,Mexico,Bulgaria,69,46,23
1990,558,Nicaragua,Bulgaria,88,28,60
1990,591,Panama,Bulgaria,25,17,8
1990,32,Argentina,Bulgaria,975,573,402
1990,68,Bolivia (Plurinational State of),Bulgaria,16,5,11
1990,76,Brazil,Bulgaria,409,190,219
1990,152,Chile,Bulgaria,65,50,15
1990,170,Colombia,Bulgaria,68,37,31
1990,218,Ecuador,Bulgaria,65,30,35
1990,604,Peru,Bulgaria,41,25,16
1990,862,Venezuela (Bolivarian Republic of),Bulgaria,126,80,46
1990,36,Australia,Bulgaria,1755,1087,668
1990,112,Belarus,Bulgaria,30,19,11
1990,203,Czechia,Bulgaria,1154,743,411
1990,348,Hungary,Bulgaria,1962,872,1090
1990,616,Poland,Bulgaria,2414,1427,987
1990,498,Republic of Moldova,Bulgaria,462,266,196
1990,642,Romania,Bulgaria,24353,11092,13261
1990,643,Russian Federation,Bulgaria,10760,5280,5480
1990,703,Slovakia,Bulgaria,362,197,165
1990,804,Ukraine,Bulgaria,2094,1372,722
1990,208,Denmark,Bulgaria,224,99,125
1990,246,Finland,Bulgaria,274,160,114
1990,352,Iceland,Bulgaria,18,8,10
1990,372,Ireland,Bulgaria,178,84,94
1990,428,Latvia,Bulgaria,390,187,203
1990,440,Lithuania,Bulgaria,33,27,6
1990,578,Norway,Bulgaria,369,234,135
1990,752,Sweden,Bulgaria,2756,1335,1421
1990,826,United Kingdom,Bulgaria,1670,903,767
1990,300,Greece,Bulgaria,7509,5661,1848
1990,380,Italy,Bulgaria,446,155,291
1990,470,Malta,Bulgaria,77,36,41
1990,807,North Macedonia,Bulgaria,1075,448,627
1990,620,Portugal,Bulgaria,183,122,61
1990,688,Serbia,Bulgaria,139,43,96
1990,705,Slovenia,Bulgaria,65,34,31
1990,724,Spain,Bulgaria,1084,557,527
1990,40,Austria,Bulgaria,8666,3788,4878
1990,56,Belgium,Bulgaria,996,385,611
1990,250,France,Bulgaria,9404,4203,5201
1990,276,Germany,Bulgaria,27077,15209,11868
1990,438,Liechtenstein,Bulgaria,18,18,0
1990,442,Luxembourg,Bulgaria,42,17,25
1990,528,Netherlands,Bulgaria,827,331,496
1990,756,Switzerland,Bulgaria,2439,904,1535
1990,124,Canada,Bulgaria,2874,1400,1474
1990,840,United States of America,Bulgaria,8579,4383,4196
1995,516,Namibia,Bulgaria,43,10,33
1995,710,South Africa,Bulgaria,2393,1100,1293
1995,818,Egypt,Bulgaria,58,26,32
1995,196,Cyprus,Bulgaria,2165,650,1515
1995,376,Israel,Bulgaria,19887,8951,10936
1995,400,Jordan,Bulgaria,77,36,41
1995,792,Turkey,Bulgaria,454518,218995,235523
1995,496,Mongolia,Bulgaria,1,1,0
1995,192,Cuba,Bulgaria,225,88,137
1995,214,Dominican Republic,Bulgaria,397,224,173
1995,188,Costa Rica,Bulgaria,37,17,20
1995,484,Mexico,Bulgaria,191,94,97
1995,558,Nicaragua,Bulgaria,70,22,48
1995,591,Panama,Bulgaria,44,30,14
1995,32,Argentina,Bulgaria,796,422,374
1995,68,Bolivia (Plurinational State of),Bulgaria,16,5,11
1995,76,Brazil,Bulgaria,346,171,175
1995,152,Chile,Bulgaria,78,47,31
1995,170,Colombia,Bulgaria,69,36,33
1995,218,Ecuador,Bulgaria,73,33,40
1995,604,Peru,Bulgaria,42,25,17
1995,862,Venezuela (Bolivarian Republic of),Bulgaria,124,79,45
1995,36,Australia,Bulgaria,2465,1423,1042
1995,112,Belarus,Bulgaria,47,26,21
1995,203,Czechia,Bulgaria,1731,1131,600
1995,348,Hungary,Bulgaria,1696,757,939
1995,616,Poland,Bulgaria,2064,1208,856
1995,498,Republic of Moldova,Bulgaria,312,176,136
1995,642,Romania,Bulgaria,21944,9713,12231
1995,643,Russian Federation,Bulgaria,9934,5531,4403
1995,703,Slovakia,Bulgaria,790,489,301
1995,804,Ukraine,Bulgaria,2026,1348,678
1995,208,Denmark,Bulgaria,445,189,256
1995,234,Faroe Islands,Bulgaria,1,1,0
1995,246,Finland,Bulgaria,348,205,143
1995,352,Iceland,Bulgaria,46,21,25
1995,372,Ireland,Bulgaria,494,224,270
1995,428,Latvia,Bulgaria,220,109,111
1995,440,Lithuania,Bulgaria,37,31,6
1995,578,Norway,Bulgaria,566,335,231
1995,752,Sweden,Bulgaria,3271,1572,1699
1995,826,United Kingdom,Bulgaria,3395,1604,1791
1995,191,Croatia,Bulgaria,138,51,87
1995,300,Greece,Bulgaria,22834,10335,12499
1995,380,Italy,Bulgaria,5423,1957,3466
1995,470,Malta,Bulgaria,91,43,48
1995,807,North Macedonia,Bulgaria,1006,419,587
1995,620,Portugal,Bulgaria,395,262,133
1995,688,Serbia,Bulgaria,884,256,628
1995,705,Slovenia,Bulgaria,75,39,36
1995,724,Spain,Bulgaria,1959,1029,930
1995,40,Austria,Bulgaria,9777,4363,5414
1995,56,Belgium,Bulgaria,1069,420,649
1995,250,France,Bulgaria,9708,4248,5460
1995,276,Germany,Bulgaria,30146,16397,13749
1995,438,Liechtenstein,Bulgaria,21,21,0
1995,442,Luxembourg,Bulgaria,68,24,44
1995,528,Netherlands,Bulgaria,1217,469,748
1995,756,Switzerland,Bulgaria,3067,1161,1906
1995,124,Canada,Bulgaria,6089,2944,3145
1995,304,Greenland,Bulgaria,2,0,2
1995,840,United States of America,Bulgaria,22126,11447,10679
2000,516,Namibia,Bulgaria,41,9,32
2000,710,South Africa,Bulgaria,1653,891,762
2000,818,Egypt,Bulgaria,50,20,30
2000,196,Cyprus,Bulgaria,2799,799,2000
2000,268,Georgia,Bulgaria,225,101,124
2000,376,Israel,Bulgaria,19308,8645,10663
2000,400,Jordan,Bulgaria,62,26,36
2000,792,Turkey,Bulgaria,447912,213480,234432
2000,496,Mongolia,Bulgaria,2,1,1
2000,192,Cuba,Bulgaria,153,53,100
2000,214,Dominican Republic,Bulgaria,436,242,194
2000,188,Costa Rica,Bulgaria,54,24,30
2000,484,Mexico,Bulgaria,322,147,175
2000,558,Nicaragua,Bulgaria,61,21,40
2000,591,Panama,Bulgaria,66,44,22
2000,32,Argentina,Bulgaria,618,273,345
2000,68,Bolivia (Plurinational State of),Bulgaria,16,6,10
2000,76,Brazil,Bulgaria,283,152,131
2000,152,Chile,Bulgaria,91,54,37
2000,170,Colombia,Bulgaria,70,36,34
2000,218,Ecuador,Bulgaria,81,37,44
2000,604,Peru,Bulgaria,50,27,23
2000,862,Venezuela (Bolivarian Republic of),Bulgaria,122,77,45
2000,36,Australia,Bulgaria,3020,1672,1348
2000,112,Belarus,Bulgaria,63,33,30
2000,203,Czechia,Bulgaria,2308,1519,789
2000,348,Hungary,Bulgaria,1429,641,788
2000,616,Poland,Bulgaria,1766,1022,744
2000,498,Republic of Moldova,Bulgaria,211,116,95
2000,642,Romania,Bulgaria,19404,8276,11128
2000,643,Russian Federation,Bulgaria,8749,5584,3165
2000,703,Slovakia,Bulgaria,1437,916,521
2000,804,Ukraine,Bulgaria,1983,1339,644
2000,208,Denmark,Bulgaria,666,280,386
2000,234,Faroe Islands,Bulgaria,3,2,1
2000,246,Finland,Bulgaria,421,249,172
2000,352,Iceland,Bulgaria,74,34,40
2000,372,Ireland,Bulgaria,1081,507,574
2000,428,Latvia,Bulgaria,50,31,19
2000,440,Lithuania,Bulgaria,28,24,4
2000,578,Norway,Bulgaria,787,397,390
2000,752,Sweden,Bulgaria,3508,1674,1834
2000,826,United Kingdom,Bulgaria,5178,2327,2851
2000,191,Croatia,Bulgaria,262,98,164
2000,300,Greece,Bulgaria,38534,14953,23581
2000,380,Italy,Bulgaria,10400,3760,6640
2000,470,Malta,Bulgaria,230,110,120
2000,807,North Macedonia,Bulgaria,938,391,547
2000,620,Portugal,Bulgaria,624,413,211
2000,688,Serbia,Bulgaria,1203,331,872
2000,705,Slovenia,Bulgaria,183,135,48
2000,724,Spain,Bulgaria,3678,1968,1710
2000,40,Austria,Bulgaria,10888,4939,5949
2000,56,Belgium,Bulgaria,1111,444,667
2000,250,France,Bulgaria,10012,4294,5718
2000,276,Germany,Bulgaria,33214,17584,15630
2000,438,Liechtenstein,Bulgaria,24,24,0
2000,442,Luxembourg,Bulgaria,96,32,64
2000,528,Netherlands,Bulgaria,1650,622,1028
2000,756,Switzerland,Bulgaria,3708,1428,2280
2000,124,Canada,Bulgaria,9449,4558,4891
2000,304,Greenland,Bulgaria,6,5,1
2000,840,United States of America,Bulgaria,35981,18693,17288
2005,516,Namibia,Bulgaria,32,7,25
2005,710,South Africa,Bulgaria,2174,1126,1048
2005,818,Egypt,Bulgaria,60,26,34
2005,196,Cyprus,Bulgaria,4097,1151,2946
2005,268,Georgia,Bulgaria,213,96,117
2005,376,Israel,Bulgaria,17611,7855,9756
2005,400,Jordan,Bulgaria,88,43,45
2005,792,Turkey,Bulgaria,461574,214529,247045
2005,496,Mongolia,Bulgaria,7,6,1
2005,44,Bahamas,Bulgaria,10,7,3
2005,192,Cuba,Bulgaria,102,36,66
2005,214,Dominican Republic,Bulgaria,254,142,112
2005,188,Costa Rica,Bulgaria,35,15,20
2005,484,Mexico,Bulgaria,268,120,148
2005,558,Nicaragua,Bulgaria,54,19,35
2005,591,Panama,Bulgaria,62,40,22
2005,32,Argentina,Bulgaria,456,205,251
2005,68,Bolivia (Plurinational State of),Bulgaria,19,9,10
2005,76,Brazil,Bulgaria,261,136,125
2005,152,Chile,Bulgaria,136,82,54
2005,170,Colombia,Bulgaria,69,35,34
2005,218,Ecuador,Bulgaria,95,44,51
2005,604,Peru,Bulgaria,59,35,24
2005,862,Venezuela (Bolivarian Republic of),Bulgaria,127,80,47
2005,36,Australia,Bulgaria,3440,1754,1686
2005,112,Belarus,Bulgaria,61,32,29
2005,203,Czechia,Bulgaria,4421,2818,1603
2005,348,Hungary,Bulgaria,1766,810,956
2005,616,Poland,Bulgaria,1752,1007,745
2005,498,Republic of Moldova,Bulgaria,146,79,67
2005,642,Romania,Bulgaria,18833,8227,10606
2005,643,Russian Federation,Bulgaria,7315,4790,2525
2005,703,Slovakia,Bulgaria,1612,1037,575
2005,804,Ukraine,Bulgaria,1811,1224,587
2005,208,Denmark,Bulgaria,1760,866,894
2005,234,Faroe Islands,Bulgaria,10,6,4
2005,246,Finland,Bulgaria,793,443,350
2005,352,Iceland,Bulgaria,106,49,57
2005,372,Ireland,Bulgaria,1642,821,821
2005,428,Latvia,Bulgaria,297,251,46
2005,440,Lithuania,Bulgaria,59,47,12
2005,578,Norway,Bulgaria,1092,470,622
2005,752,Sweden,Bulgaria,3962,1838,2124
2005,826,United Kingdom,Bulgaria,24672,11943,12729
2005,191,Croatia,Bulgaria,283,98,185
2005,300,Greece,Bulgaria,56513,21121,35392
2005,380,Italy,Bulgaria,34041,12110,21931
2005,470,Malta,Bulgaria,361,174,187
2005,807,North Macedonia,Bulgaria,964,402,562
2005,620,Portugal,Bulgaria,2831,1517,1314
2005,688,Serbia,Bulgaria,1187,317,870
2005,705,Slovenia,Bulgaria,130,68,62
2005,724,Spain,Bulgaria,86226,48125,38101
2005,40,Austria,Bulgaria,12170,5361,6809
2005,56,Belgium,Bulgaria,4522,2158,2364
2005,250,France,Bulgaria,13222,5494,7728
2005,276,Germany,Bulgaria,61639,30539,31100
2005,438,Liechtenstein,Bulgaria,16,13,3
2005,442,Luxembourg,Bulgaria,334,112,222
2005,528,Netherlands,Bulgaria,3111,1041,2070
2005,756,Switzerland,Bulgaria,4345,1546,2799
2005,124,Canada,Bulgaria,12985,6363,6622
2005,304,Greenland,Bulgaria,8,8,0
2005,840,United States of America,Bulgaria,48219,25179,23040
2010,516,Namibia,Bulgaria,30,6,24
2010,710,South Africa,Bulgaria,3405,1758,1647
2010,818,Egypt,Bulgaria,65,27,38
2010,196,Cyprus,Bulgaria,6709,1945,4764
2010,268,Georgia,Bulgaria,215,97,118
2010,376,Israel,Bulgaria,16128,7140,8988
2010,400,Jordan,Bulgaria,113,59,54
2010,792,Turkey,Bulgaria,475652,215315,260337
2010,496,Mongolia,Bulgaria,13,10,3
2010,44,Bahamas,Bulgaria,19,14,5
2010,192,Cuba,Bulgaria,56,20,36
2010,214,Dominican Republic,Bulgaria,70,41,29
2010,188,Costa Rica,Bulgaria,70,31,39
2010,484,Mexico,Bulgaria,246,107,139
2010,558,Nicaragua,Bulgaria,57,20,37
2010,591,Panama,Bulgaria,62,38,24
2010,32,Argentina,Bulgaria,294,138,156
2010,68,Bolivia (Plurinational State of),Bulgaria,21,11,10
2010,76,Brazil,Bulgaria,236,119,117
2010,152,Chile,Bulgaria,182,110,72
2010,170,Colombia,Bulgaria,79,40,39
2010,218,Ecuador,Bulgaria,134,61,73
2010,604,Peru,Bulgaria,65,39,26
2010,862,Venezuela (Bolivarian Republic of),Bulgaria,135,86,49
2010,36,Australia,Bulgaria,3600,1698,1902
2010,112,Belarus,Bulgaria,58,31,27
2010,203,Czechia,Bulgaria,6113,3916,2197
2010,348,Hungary,Bulgaria,2102,978,1124
2010,616,Poland,Bulgaria,1794,1018,776
2010,498,Republic of Moldova,Bulgaria,122,67,55
2010,642,Romania,Bulgaria,20319,9012,11307
2010,643,Russian Federation,Bulgaria,5731,3899,1832
2010,703,Slovakia,Bulgaria,1808,1172,636
2010,804,Ukraine,Bulgaria,1727,1168,559
2010,208,Denmark,Bulgaria,2802,1427,1375
2010,233,Estonia,Bulgaria,78,50,28
2010,234,Faroe Islands,Bulgaria,12,9,3
2010,246,Finland,Bulgaria,1298,654,644
2010,352,Iceland,Bulgaria,137,64,73
2010,372,Ireland,Bulgaria,1932,895,1037
2010,428,Latvia,Bulgaria,538,465,73
2010,440,Lithuania,Bulgaria,83,64,19
2010,578,Norway,Bulgaria,2055,1059,996
2010,752,Sweden,Bulgaria,6652,3447,3205
2010,826,United Kingdom,Bulgaria,25990,12856,13134
2010,191,Croatia,Bulgaria,303,98,205
2010,300,Greece,Bulgaria,77506,28412,49094
2010,380,Italy,Bulgaria,58493,20634,37859
2010,470,Malta,Bulgaria,739,356,383
2010,499,Montenegro,Bulgaria,70,57,13
2010,807,North Macedonia,Bulgaria,990,413,577
2010,620,Portugal,Bulgaria,4568,2372,2196
2010,688,Serbia,Bulgaria,1161,309,852
2010,705,Slovenia,Bulgaria,475,287,188
2010,724,Spain,Bulgaria,145061,77873,67188
2010,40,Austria,Bulgaria,13452,5784,7668
2010,56,Belgium,Bulgaria,14364,7044,7320
2010,250,France,Bulgaria,16552,6887,9665
2010,276,Germany,Bulgaria,85217,41598,43619
2010,438,Liechtenstein,Bulgaria,10,3,7
2010,442,Luxembourg,Bulgaria,576,192,384
2010,528,Netherlands,Bulgaria,13412,6391,7021
2010,756,Switzerland,Bulgaria,4899,1552,3347
2010,124,Canada,Bulgaria,17555,8696,8859
2010,304,Greenland,Bulgaria,16,13,3
2010,840,United States of America,Bulgaria,62258,32100,30158
2015,516,Namibia,Bulgaria,29,6,23
2015,710,South Africa,Bulgaria,6141,3019,3122
2015,324,Guinea,Bulgaria,3,2,1
2015,818,Egypt,Bulgaria,48,24,24
2015,196,Cyprus,Bulgaria,6445,1899,4546
2015,268,Georgia,Bulgaria,225,102,123
2015,376,Israel,Bulgaria,16633,7318,9315
2015,400,Jordan,Bulgaria,48,20,28
2015,792,Turkey,Bulgaria,482851,172597,310254
2015,496,Mongolia,Bulgaria,16,12,4
2015,44,Bahamas,Bulgaria,21,16,5
2015,192,Cuba,Bulgaria,44,15,29
2015,214,Dominican Republic,Bulgaria,73,43,30
2015,188,Costa Rica,Bulgaria,71,32,39
2015,484,Mexico,Bulgaria,261,113,148
2015,558,Nicaragua,Bulgaria,61,22,39
2015,591,Panama,Bulgaria,73,45,28
2015,32,Argentina,Bulgaria,295,138,157
2015,68,Bolivia (Plurinational State of),Bulgaria,24,12,12
2015,76,Brazil,Bulgaria,284,143,141
2015,152,Chile,Bulgaria,275,164,111
2015,170,Colombia,Bulgaria,88,45,43
2015,218,Ecuador,Bulgaria,194,88,106
2015,604,Peru,Bulgaria,69,43,26
2015,862,Venezuela (Bolivarian Republic of),Bulgaria,142,89,53
2015,36,Australia,Bulgaria,3930,1844,2086
2015,112,Belarus,Bulgaria,61,31,30
2015,203,Czechia,Bulgaria,9276,5821,3455
2015,348,Hungary,Bulgaria,1383,639,744
2015,616,Poland,Bulgaria,1729,995,734
2015,498,Republic of Moldova,Bulgaria,116,64,52
2015,642,Romania,Bulgaria,10465,4030,6435
2015,643,Russian Federation,Bulgaria,5841,3964,1877
2015,703,Slovakia,Bulgaria,2193,1490,703
2015,804,Ukraine,Bulgaria,1732,1172,560
2015,208,Denmark,Bulgaria,5839,3317,2522
2015,233,Estonia,Bulgaria,268,213,55
2015,234,Faroe Islands,Bulgaria,13,10,3
2015,246,Finland,Bulgaria,2407,1239,1168
2015,352,Iceland,Bulgaria,241,122,119
2015,372,Ireland,Bulgaria,1974,902,1072
2015,428,Latvia,Bulgaria,157,102,55
2015,440,Lithuania,Bulgaria,74,54,20
2015,578,Norway,Bulgaria,5759,3193,2566
2015,752,Sweden,Bulgaria,8757,4488,4269
2015,826,United Kingdom,Bulgaria,33237,15943,17294
2015,191,Croatia,Bulgaria,305,98,207
2015,300,Greece,Bulgaria,72744,24701,48043
2015,380,Italy,Bulgaria,57232,19620,37612
2015,470,Malta,Bulgaria,1253,647,606
2015,499,Montenegro,Bulgaria,78,64,14
2015,807,North Macedonia,Bulgaria,1072,446,626
2015,620,Portugal,Bulgaria,5179,2562,2617
2015,688,Serbia,Bulgaria,1134,299,835
2015,705,Slovenia,Bulgaria,1179,722,457
2015,724,Spain,Bulgaria,126875,64972,61903
2015,40,Austria,Bulgaria,15733,6814,8919
2015,56,Belgium,Bulgaria,28749,14340,14409
2015,250,France,Bulgaria,26431,11924,14507
2015,276,Germany,Bulgaria,88792,43236,45556
2015,438,Liechtenstein,Bulgaria,14,3,11
2015,442,Luxembourg,Bulgaria,878,302,576
2015,528,Netherlands,Bulgaria,18714,8708,10006
2015,756,Switzerland,Bulgaria,7408,2435,4973
2015,124,Canada,Bulgaria,18515,9074,9441
2015,304,Greenland,Bulgaria,17,12,5
2015,840,United States of America,Bulgaria,73631,37783,35848
2019,516,Namibia,Bulgaria,30,6,24
2019,710,South Africa,Bulgaria,6882,3387,3495
2019,324,Guinea,Bulgaria,2,2,0
2019,818,Egypt,Bulgaria,68,30,38
2019,196,Cyprus,Bulgaria,6441,1944,4497
2019,268,Georgia,Bulgaria,231,105,126
2019,376,Israel,Bulgaria,16175,7117,9058
2019,400,Jordan,Bulgaria,51,21,30
2019,792,Turkey,Bulgaria,652900,237551,415349
2019,496,Mongolia,Bulgaria,16,12,4
2019,44,Bahamas,Bulgaria,22,17,5
2019,192,Cuba,Bulgaria,40,14,26
2019,214,Dominican Republic,Bulgaria,75,44,31
2019,188,Costa Rica,Bulgaria,72,33,39
2019,484,Mexico,Bulgaria,269,117,152
2019,558,Nicaragua,Bulgaria,63,23,40
2019,591,Panama,Bulgaria,76,48,28
2019,32,Argentina,Bulgaria,300,140,160
2019,68,Bolivia (Plurinational State of),Bulgaria,26,13,13
2019,76,Brazil,Bulgaria,319,161,158
2019,152,Chile,Bulgaria,367,211,156
2019,170,Colombia,Bulgaria,90,47,43
2019,218,Ecuador,Bulgaria,190,86,104
2019,604,Peru,Bulgaria,81,52,29
2019,862,Venezuela (Bolivarian Republic of),Bulgaria,139,87,52
2019,36,Australia,Bulgaria,4284,1978,2306
2019,112,Belarus,Bulgaria,60,31,29
2019,203,Czechia,Bulgaria,11204,7032,4172
2019,348,Hungary,Bulgaria,1396,644,752
2019,616,Poland,Bulgaria,1831,1084,747
2019,498,Republic of Moldova,Bulgaria,114,63,51
2019,642,Romania,Bulgaria,11674,4826,6848
2019,643,Russian Federation,Bulgaria,5839,3963,1876
2019,703,Slovakia,Bulgaria,2476,1700,776
2019,804,Ukraine,Bulgaria,1749,1184,565
2019,208,Denmark,Bulgaria,9993,5733,4260
2019,233,Estonia,Bulgaria,302,249,53
2019,234,Faroe Islands,Bulgaria,24,16,8
2019,246,Finland,Bulgaria,2956,1539,1417
2019,352,Iceland,Bulgaria,393,214,179
2019,372,Ireland,Bulgaria,2167,994,1173
2019,428,Latvia,Bulgaria,103,88,15
2019,440,Lithuania,Bulgaria,90,66,24
2019,578,Norway,Bulgaria,7368,4080,3288
2019,752,Sweden,Bulgaria,10188,5175,5013
2019,826,United Kingdom,Bulgaria,37744,18155,19589
2019,191,Croatia,Bulgaria,281,90,191
2019,300,Greece,Bulgaria,71043,25902,45141
2019,380,Italy,Bulgaria,62358,21778,40580
2019,470,Malta,Bulgaria,2021,1050,971
2019,499,Montenegro,Bulgaria,78,65,13
2019,807,North Macedonia,Bulgaria,1075,447,628
2019,620,Portugal,Bulgaria,5267,2612,2655
2019,688,Serbia,Bulgaria,1152,305,847
2019,705,Slovenia,Bulgaria,1157,687,470
2019,724,Spain,Bulgaria,121435,60615,60820
2019,40,Austria,Bulgaria,18572,8225,10347
2019,56,Belgium,Bulgaria,34769,17363,17406
2019,250,France,Bulgaria,27977,12587,15390
2019,276,Germany,Bulgaria,262462,138559,123903
2019,438,Liechtenstein,Bulgaria,16,4,12
2019,442,Luxembourg,Bulgaria,1666,629,1037
2019,528,Netherlands,Bulgaria,25446,12235,13211
2019,756,Switzerland,Bulgaria,8906,3161,5745
2019,124,Canada,Bulgaria,19840,9723,10117
2019,304,Greenland,Bulgaria,16,12,4
2019,840,United States of America,Bulgaria,79514,40385,39129
1990,266,Gabon,Burkina Faso,2161,1299,862
1990,516,Namibia,Burkina Faso,105,50,55
1990,204,Benin,Burkina Faso,3507,2066,1441
1990,384,Côte d'Ivoire,Burkina Faso,927756,522444,405312
1990,288,Ghana,Burkina Faso,41668,22731,18937
1990,324,Guinea,Burkina Faso,479,301,178
1990,430,Liberia,Burkina Faso,388,237,151
1990,466,Mali,Burkina Faso,23024,11605,11419
1990,562,Niger,Burkina Faso,9596,5463,4133
1990,694,Sierra Leone,Burkina Faso,35,22,13
1990,768,Togo,Burkina Faso,6133,3374,2759
1990,818,Egypt,Burkina Faso,67,64,3
1990,32,Argentina,Burkina Faso,26,4,22
1990,152,Chile,Burkina Faso,1,0,1
1990,36,Australia,Burkina Faso,30,18,12
1990,100,Bulgaria,Burkina Faso,3,2,1
1990,203,Czechia,Burkina Faso,1,0,1
1990,643,Russian Federation,Burkina Faso,525,258,267
1990,208,Denmark,Burkina Faso,2,1,1
1990,372,Ireland,Burkina Faso,2,1,1
1990,578,Norway,Burkina Faso,19,16,3
1990,752,Sweden,Burkina Faso,26,17,9
1990,826,United Kingdom,Burkina Faso,12,9,3
1990,300,Greece,Burkina Faso,5,3,2
1990,380,Italy,Burkina Faso,381,133,248
1990,724,Spain,Burkina Faso,96,60,36
1990,40,Austria,Burkina Faso,67,37,30
1990,56,Belgium,Burkina Faso,488,299,189
1990,250,France,Burkina Faso,3831,2103,1728
1990,276,Germany,Burkina Faso,563,475,88
1990,528,Netherlands,Burkina Faso,91,60,31
1990,756,Switzerland,Burkina Faso,206,124,82
1990,124,Canada,Burkina Faso,38,19,19
1995,266,Gabon,Burkina Faso,2891,1738,1153
1995,516,Namibia,Burkina Faso,100,48,52
1995,204,Benin,Burkina Faso,4830,2870,1960
1995,384,Côte d'Ivoire,Burkina Faso,1114233,623756,490477
1995,288,Ghana,Burkina Faso,41526,24463,17063
1995,324,Guinea,Burkina Faso,552,370,182
1995,430,Liberia,Burkina Faso,379,228,151
1995,466,Mali,Burkina Faso,20221,10232,9989
1995,562,Niger,Burkina Faso,13956,7806,6150
1995,694,Sierra Leone,Burkina Faso,34,21,13
1995,768,Togo,Burkina Faso,6908,3801,3107
1995,818,Egypt,Burkina Faso,55,50,5
1995,32,Argentina,Burkina Faso,25,4,21
1995,152,Chile,Burkina Faso,1,1,0
1995,36,Australia,Burkina Faso,15,9,6
1995,100,Bulgaria,Burkina Faso,5,3,2
1995,203,Czechia,Burkina Faso,2,1,1
1995,643,Russian Federation,Burkina Faso,568,270,298
1995,208,Denmark,Burkina Faso,12,8,4
1995,246,Finland,Burkina Faso,1,0,1
1995,372,Ireland,Burkina Faso,5,3,2
1995,578,Norway,Burkina Faso,10,7,3
1995,752,Sweden,Burkina Faso,31,20,11
1995,826,United Kingdom,Burkina Faso,52,32,20
1995,300,Greece,Burkina Faso,6,4,2
1995,380,Italy,Burkina Faso,2624,1516,1108
1995,724,Spain,Burkina Faso,182,112,70
1995,40,Austria,Burkina Faso,76,43,33
1995,56,Belgium,Burkina Faso,487,298,189
1995,250,France,Burkina Faso,3955,2141,1814
1995,276,Germany,Burkina Faso,1296,1154,142
1995,528,Netherlands,Burkina Faso,133,86,47
1995,756,Switzerland,Burkina Faso,317,190,127
1995,124,Canada,Burkina Faso,178,86,92
2000,266,Gabon,Burkina Faso,3616,2183,1433
2000,516,Namibia,Burkina Faso,94,44,50
2000,204,Benin,Burkina Faso,6154,3675,2479
2000,384,Côte d'Ivoire,Burkina Faso,1161053,649666,511387
2000,288,Ghana,Burkina Faso,46451,25613,20838
2000,324,Guinea,Burkina Faso,598,397,201
2000,430,Liberia,Burkina Faso,373,220,153
2000,466,Mali,Burkina Faso,20155,10242,9913
2000,562,Niger,Burkina Faso,18432,10213,8219
2000,694,Sierra Leone,Burkina Faso,33,20,13
2000,768,Togo,Burkina Faso,8781,5232,3549
2000,818,Egypt,Burkina Faso,48,41,7
2000,32,Argentina,Burkina Faso,24,4,20
2000,152,Chile,Burkina Faso,1,0,1
2000,36,Australia,Burkina Faso,10,5,5
2000,100,Bulgaria,Burkina Faso,6,4,2
2000,203,Czechia,Burkina Faso,3,2,1
2000,643,Russian Federation,Burkina Faso,592,272,320
2000,208,Denmark,Burkina Faso,21,14,7
2000,246,Finland,Burkina Faso,1,0,1
2000,372,Ireland,Burkina Faso,11,8,3
2000,578,Norway,Burkina Faso,11,8,3
2000,752,Sweden,Burkina Faso,34,22,12
2000,826,United Kingdom,Burkina Faso,94,55,39
2000,300,Greece,Burkina Faso,7,4,3
2000,380,Italy,Burkina Faso,4866,2898,1968
2000,705,Slovenia,Burkina Faso,1,1,0
2000,724,Spain,Burkina Faso,347,214,133
2000,40,Austria,Burkina Faso,84,48,36
2000,56,Belgium,Burkina Faso,472,290,182
2000,250,France,Burkina Faso,4079,2179,1900
2000,276,Germany,Burkina Faso,2029,1833,196
2000,528,Netherlands,Burkina Faso,181,114,67
2000,756,Switzerland,Burkina Faso,431,257,174
2000,124,Canada,Burkina Faso,322,155,167
2005,266,Gabon,Burkina Faso,3943,2396,1547
2005,516,Namibia,Burkina Faso,74,35,39
2005,204,Benin,Burkina Faso,8487,4849,3638
2005,384,Côte d'Ivoire,Burkina Faso,1215490,680127,535363
2005,288,Ghana,Burkina Faso,65321,37777,27544
2005,324,Guinea,Burkina Faso,650,418,232
2005,430,Liberia,Burkina Faso,223,168,55
2005,466,Mali,Burkina Faso,22190,11207,10983
2005,562,Niger,Burkina Faso,18763,10388,8375
2005,694,Sierra Leone,Burkina Faso,12,8,4
2005,768,Togo,Burkina Faso,11391,6134,5257
2005,818,Egypt,Burkina Faso,57,49,8
2005,32,Argentina,Burkina Faso,18,3,15
2005,76,Brazil,Burkina Faso,12,5,7
2005,152,Chile,Burkina Faso,1,0,1
2005,36,Australia,Burkina Faso,20,10,10
2005,100,Bulgaria,Burkina Faso,9,6,3
2005,203,Czechia,Burkina Faso,8,5,3
2005,643,Russian Federation,Burkina Faso,519,234,285
2005,208,Denmark,Burkina Faso,39,21,18
2005,246,Finland,Burkina Faso,4,3,1
2005,352,Iceland,Burkina Faso,1,1,0
2005,372,Ireland,Burkina Faso,11,8,3
2005,578,Norway,Burkina Faso,15,12,3
2005,752,Sweden,Burkina Faso,49,28,21
2005,826,United Kingdom,Burkina Faso,147,82,65
2005,300,Greece,Burkina Faso,44,39,5
2005,380,Italy,Burkina Faso,8261,5535,2726
2005,724,Spain,Burkina Faso,537,436,101
2005,40,Austria,Burkina Faso,94,53,41
2005,56,Belgium,Burkina Faso,666,397,269
2005,250,France,Burkina Faso,6972,3566,3406
2005,276,Germany,Burkina Faso,1608,1314,294
2005,528,Netherlands,Burkina Faso,284,181,103
2005,756,Switzerland,Burkina Faso,485,275,210
2005,124,Canada,Burkina Faso,793,428,365
2010,266,Gabon,Burkina Faso,4567,2809,1758
2010,516,Namibia,Burkina Faso,71,34,37
2010,204,Benin,Burkina Faso,10751,6002,4749
2010,384,Côte d'Ivoire,Burkina Faso,1269928,710363,559565
2010,288,Ghana,Burkina Faso,47703,25429,22274
2010,324,Guinea,Burkina Faso,698,448,250
2010,430,Liberia,Burkina Faso,221,163,58
2010,466,Mali,Burkina Faso,43533,23533,20000
2010,562,Niger,Burkina Faso,19065,10543,8522
2010,694,Sierra Leone,Burkina Faso,11,7,4
2010,768,Togo,Burkina Faso,12075,6572,5503
2010,818,Egypt,Burkina Faso,62,53,9
2010,32,Argentina,Burkina Faso,11,2,9
2010,76,Brazil,Burkina Faso,25,11,14
2010,152,Chile,Burkina Faso,2,1,1
2010,36,Australia,Burkina Faso,40,20,20
2010,100,Bulgaria,Burkina Faso,11,7,4
2010,203,Czechia,Burkina Faso,12,7,5
2010,643,Russian Federation,Burkina Faso,436,191,245
2010,208,Denmark,Burkina Faso,55,28,27
2010,246,Finland,Burkina Faso,6,5,1
2010,352,Iceland,Burkina Faso,1,1,0
2010,372,Ireland,Burkina Faso,9,6,3
2010,578,Norway,Burkina Faso,23,19,4
2010,752,Sweden,Burkina Faso,72,38,34
2010,826,United Kingdom,Burkina Faso,154,87,67
2010,300,Greece,Burkina Faso,84,77,7
2010,380,Italy,Burkina Faso,11105,7756,3349
2010,705,Slovenia,Burkina Faso,4,4,0
2010,724,Spain,Burkina Faso,1111,834,277
2010,40,Austria,Burkina Faso,104,58,46
2010,56,Belgium,Burkina Faso,868,450,418
2010,250,France,Burkina Faso,8208,4299,3909
2010,276,Germany,Burkina Faso,1250,878,372
2010,528,Netherlands,Burkina Faso,336,210,126
2010,756,Switzerland,Burkina Faso,570,314,256
2010,124,Canada,Burkina Faso,1010,561,449
2015,266,Gabon,Burkina Faso,6386,4271,2115
2015,516,Namibia,Burkina Faso,69,33,36
2015,204,Benin,Burkina Faso,12004,6775,5229
2015,384,Côte d'Ivoire,Burkina Faso,1324366,740814,583552
2015,288,Ghana,Burkina Faso,58704,31286,27418
2015,324,Guinea,Burkina Faso,588,518,70
2015,430,Liberia,Burkina Faso,253,186,67
2015,466,Mali,Burkina Faso,53939,29161,24778
2015,562,Niger,Burkina Faso,19323,10681,8642
2015,694,Sierra Leone,Burkina Faso,11,7,4
2015,768,Togo,Burkina Faso,13641,7443,6198
2015,818,Egypt,Burkina Faso,45,40,5
2015,32,Argentina,Burkina Faso,11,2,9
2015,76,Brazil,Burkina Faso,30,13,17
2015,152,Chile,Burkina Faso,3,2,1
2015,36,Australia,Burkina Faso,60,34,26
2015,100,Bulgaria,Burkina Faso,12,8,4
2015,203,Czechia,Burkina Faso,17,11,6
2015,643,Russian Federation,Burkina Faso,445,195,250
2015,208,Denmark,Burkina Faso,105,60,45
2015,246,Finland,Burkina Faso,18,16,2
2015,352,Iceland,Burkina Faso,1,1,0
2015,372,Ireland,Burkina Faso,9,6,3
2015,578,Norway,Burkina Faso,31,25,6
2015,752,Sweden,Burkina Faso,79,44,35
2015,826,United Kingdom,Burkina Faso,196,108,88
2015,300,Greece,Burkina Faso,24,12,12
2015,380,Italy,Burkina Faso,11714,8146,3568
2015,705,Slovenia,Burkina Faso,4,4,0
2015,724,Spain,Burkina Faso,1147,825,322
2015,40,Austria,Burkina Faso,121,67,54
2015,56,Belgium,Burkina Faso,1348,694,654
2015,250,France,Burkina Faso,9092,4643,4449
2015,276,Germany,Burkina Faso,1302,913,389
2015,528,Netherlands,Burkina Faso,375,229,146
2015,756,Switzerland,Burkina Faso,653,345,308
2015,124,Canada,Burkina Faso,1967,978,989
2019,266,Gabon,Burkina Faso,6938,4639,2299
2019,516,Namibia,Burkina Faso,73,35,38
2019,204,Benin,Burkina Faso,12784,7225,5559
2019,384,Côte d'Ivoire,Burkina Faso,1367916,765175,602741
2019,288,Ghana,Burkina Faso,66069,35278,30791
2019,324,Guinea,Burkina Faso,561,495,66
2019,430,Liberia,Burkina Faso,210,155,55
2019,466,Mali,Burkina Faso,60060,32472,27588
2019,562,Niger,Burkina Faso,20894,11550,9344
2019,694,Sierra Leone,Burkina Faso,10,6,4
2019,768,Togo,Burkina Faso,13727,7529,6198
2019,818,Egypt,Burkina Faso,64,57,7
2019,32,Argentina,Burkina Faso,11,2,9
2019,76,Brazil,Burkina Faso,33,14,19
2019,152,Chile,Burkina Faso,4,3,1
2019,36,Australia,Burkina Faso,63,33,30
2019,100,Bulgaria,Burkina Faso,13,9,4
2019,203,Czechia,Burkina Faso,17,11,6
2019,643,Russian Federation,Burkina Faso,444,195,249
2019,208,Denmark,Burkina Faso,130,74,56
2019,246,Finland,Burkina Faso,29,22,7
2019,352,Iceland,Burkina Faso,1,1,0
2019,372,Ireland,Burkina Faso,9,6,3
2019,578,Norway,Burkina Faso,33,25,8
2019,752,Sweden,Burkina Faso,88,51,37
2019,826,United Kingdom,Burkina Faso,222,123,99
2019,300,Greece,Burkina Faso,34,17,17
2019,380,Italy,Burkina Faso,12871,9045,3826
2019,705,Slovenia,Burkina Faso,6,6,0
2019,724,Spain,Burkina Faso,1188,847,341
2019,40,Austria,Burkina Faso,142,80,62
2019,56,Belgium,Burkina Faso,1568,778,790
2019,250,France,Burkina Faso,9623,4903,4720
2019,276,Germany,Burkina Faso,1998,1492,506
2019,528,Netherlands,Burkina Faso,419,269,150
2019,756,Switzerland,Burkina Faso,731,395,336
2019,124,Canada,Burkina Faso,2107,1048,1059
1990,232,Eritrea,Burundi,618,306,312
1990,231,Ethiopia,Burundi,19,10,9
1990,404,Kenya,Burundi,99,55,44
1990,454,Malawi,Burundi,705,258,447
1990,508,Mozambique,Burundi,615,334,281
1990,646,Rwanda,Burundi,26393,14038,12355
1990,800,Uganda,Burundi,48841,30689,18152
1990,834,United Republic of Tanzania,Burundi,232210,114292,117918
1990,180,Democratic Republic of the Congo,Burundi,20203,9725,10478
1990,266,Gabon,Burundi,52,31,21
1990,748,Eswatini,Burundi,7,4,3
1990,516,Namibia,Burundi,575,348,227
1990,710,South Africa,Burundi,2092,1361,731
1990,818,Egypt,Burundi,47,42,5
1990,196,Cyprus,Burundi,1,1,0
1990,214,Dominican Republic,Burundi,3,0,3
1990,152,Chile,Burundi,18,8,10
1990,36,Australia,Burundi,15,9,6
1990,100,Bulgaria,Burundi,4,2,2
1990,643,Russian Federation,Burundi,171,84,87
1990,208,Denmark,Burundi,23,10,13
1990,246,Finland,Burundi,3,3,0
1990,372,Ireland,Burundi,9,5,4
1990,428,Latvia,Burundi,1,1,0
1990,752,Sweden,Burundi,65,35,30
1990,826,United Kingdom,Burundi,281,166,115
1990,300,Greece,Burundi,44,24,20
1990,380,Italy,Burundi,101,35,66
1990,724,Spain,Burundi,5,3,2
1990,40,Austria,Burundi,53,31,22
1990,56,Belgium,Burundi,1251,701,550
1990,250,France,Burundi,1344,613,731
1990,276,Germany,Burundi,233,173,60
1990,528,Netherlands,Burundi,222,122,100
1990,756,Switzerland,Burundi,306,143,163
1990,124,Canada,Burundi,489,238,251
1995,232,Eritrea,Burundi,1141,589,552
1995,231,Ethiopia,Burundi,25,15,10
1995,404,Kenya,Burundi,147,79,68
1995,454,Malawi,Burundi,5896,3208,2688
1995,508,Mozambique,Burundi,846,461,385
1995,646,Rwanda,Burundi,37445,20846,16599
1995,800,Uganda,Burundi,46279,28498,17781
1995,834,United Republic of Tanzania,Burundi,310644,154898,155746
1995,894,Zambia,Burundi,271,133,138
1995,180,Democratic Republic of the Congo,Burundi,128458,63743,64715
1995,266,Gabon,Burundi,69,40,29
1995,748,Eswatini,Burundi,132,73,59
1995,516,Namibia,Burundi,549,334,215
1995,710,South Africa,Burundi,1305,886,419
1995,818,Egypt,Burundi,36,32,4
1995,196,Cyprus,Burundi,2,2,0
1995,214,Dominican Republic,Burundi,4,0,4
1995,68,Bolivia (Plurinational State of),Burundi,1,0,1
1995,152,Chile,Burundi,9,9,0
1995,36,Australia,Burundi,7,4,3
1995,100,Bulgaria,Burundi,7,4,3
1995,643,Russian Federation,Burundi,164,88,76
1995,208,Denmark,Burundi,132,59,73
1995,246,Finland,Burundi,4,3,1
1995,372,Ireland,Burundi,25,12,13
1995,428,Latvia,Burundi,1,1,0
1995,578,Norway,Burundi,3,3,0
1995,752,Sweden,Burundi,77,41,36
1995,826,United Kingdom,Burundi,1107,525,582
1995,300,Greece,Burundi,90,43,47
1995,380,Italy,Burundi,327,110,217
1995,724,Spain,Burundi,8,5,3
1995,40,Austria,Burundi,60,35,25
1995,56,Belgium,Burundi,1506,799,707
1995,250,France,Burundi,1388,621,767
1995,276,Germany,Burundi,331,220,111
1995,528,Netherlands,Burundi,326,175,151
1995,756,Switzerland,Burundi,356,168,188
1995,124,Canada,Burundi,1389,671,718
2000,232,Eritrea,Burundi,1663,871,792
2000,231,Ethiopia,Burundi,35,22,13
2000,404,Kenya,Burundi,198,99,99
2000,454,Malawi,Burundi,5677,3082,2595
2000,508,Mozambique,Burundi,985,522,463
2000,646,Rwanda,Burundi,56107,30140,25967
2000,800,Uganda,Burundi,14278,8431,5847
2000,834,United Republic of Tanzania,Burundi,628609,319969,308640
2000,894,Zambia,Burundi,1796,882,914
2000,180,Democratic Republic of the Congo,Burundi,36692,17996,18696
2000,266,Gabon,Burundi,87,52,35
2000,748,Eswatini,Burundi,255,127,128
2000,516,Namibia,Burundi,511,311,200
2000,710,South Africa,Burundi,1543,1019,524
2000,818,Egypt,Burundi,27,24,3
2000,196,Cyprus,Burundi,2,2,0
2000,214,Dominican Republic,Burundi,4,0,4
2000,68,Bolivia (Plurinational State of),Burundi,1,0,1
2000,152,Chile,Burundi,1,1,0
2000,36,Australia,Burundi,30,15,15
2000,100,Bulgaria,Burundi,9,5,4
2000,643,Russian Federation,Burundi,153,89,64
2000,208,Denmark,Burundi,241,109,132
2000,246,Finland,Burundi,5,3,2
2000,372,Ireland,Burundi,56,29,27
2000,428,Latvia,Burundi,1,1,0
2000,578,Norway,Burundi,58,31,27
2000,752,Sweden,Burundi,83,44,39
2000,826,United Kingdom,Burundi,1953,892,1061
2000,300,Greece,Burundi,137,62,75
2000,380,Italy,Burundi,553,185,368
2000,724,Spain,Burundi,103,65,38
2000,40,Austria,Burundi,67,40,27
2000,56,Belgium,Burundi,1719,881,838
2000,250,France,Burundi,1431,628,803
2000,276,Germany,Burundi,429,267,162
2000,528,Netherlands,Burundi,444,235,209
2000,756,Switzerland,Burundi,408,194,214
2000,124,Canada,Burundi,2323,1121,1202
2005,232,Eritrea,Burundi,1347,709,638
2005,231,Ethiopia,Burundi,29,16,13
2005,404,Kenya,Burundi,2045,1054,991
2005,454,Malawi,Burundi,5410,2929,2481
2005,508,Mozambique,Burundi,1333,648,685
2005,646,Rwanda,Burundi,68762,36674,32088
2005,800,Uganda,Burundi,15440,8879,6561
2005,834,United Republic of Tanzania,Burundi,461225,304249,156976
2005,894,Zambia,Burundi,3825,1941,1884
2005,180,Democratic Republic of the Congo,Burundi,35964,17639,18325
2005,266,Gabon,Burundi,95,57,38
2005,748,Eswatini,Burundi,337,160,177
2005,516,Namibia,Burundi,404,245,159
2005,710,South Africa,Burundi,3622,1642,1980
2005,818,Egypt,Burundi,32,29,3
2005,196,Cyprus,Burundi,3,3,0
2005,214,Dominican Republic,Burundi,4,0,4
2005,68,Bolivia (Plurinational State of),Burundi,1,0,1
2005,76,Brazil,Burundi,10,10,0
2005,152,Chile,Burundi,1,1,0
2005,36,Australia,Burundi,430,232,198
2005,100,Bulgaria,Burundi,12,6,6
2005,203,Czechia,Burundi,2,2,0
2005,643,Russian Federation,Burundi,141,99,42
2005,208,Denmark,Burundi,385,166,219
2005,246,Finland,Burundi,24,14,10
2005,372,Ireland,Burundi,56,31,25
2005,578,Norway,Burundi,444,223,221
2005,752,Sweden,Burundi,1271,616,655
2005,826,United Kingdom,Burundi,2999,1327,1672
2005,300,Greece,Burundi,137,68,69
2005,380,Italy,Burundi,780,312,468
2005,724,Spain,Burundi,50,31,19
2005,40,Austria,Burundi,75,44,31
2005,56,Belgium,Burundi,4254,2044,2210
2005,250,France,Burundi,1493,676,817
2005,276,Germany,Burundi,504,290,214
2005,528,Netherlands,Burundi,1711,971,740
2005,756,Switzerland,Burundi,447,200,247
2005,124,Canada,Burundi,4374,2147,2227
2010,232,Eritrea,Burundi,1029,546,483
2010,231,Ethiopia,Burundi,132,66,66
2010,404,Kenya,Burundi,4256,2106,2150
2010,454,Malawi,Burundi,5314,2873,2441
2010,508,Mozambique,Burundi,1544,750,794
2010,646,Rwanda,Burundi,64931,34923,30008
2010,800,Uganda,Burundi,20352,11362,8990
2010,834,United Republic of Tanzania,Burundi,111256,56985,54271
2010,894,Zambia,Burundi,3243,1682,1561
2010,180,Democratic Republic of the Congo,Burundi,37686,16301,21385
2010,266,Gabon,Burundi,109,67,42
2010,748,Eswatini,Burundi,360,167,193
2010,516,Namibia,Burundi,389,237,152
2010,710,South Africa,Burundi,5673,2561,3112
2010,818,Egypt,Burundi,35,32,3
2010,196,Cyprus,Burundi,4,4,0
2010,214,Dominican Republic,Burundi,3,0,3
2010,76,Brazil,Burundi,21,21,0
2010,152,Chile,Burundi,2,2,0
2010,36,Australia,Burundi,1860,942,918
2010,100,Bulgaria,Burundi,15,7,8
2010,203,Czechia,Burundi,2,2,0
2010,643,Russian Federation,Burundi,128,107,21
2010,208,Denmark,Burundi,519,220,299
2010,246,Finland,Burundi,50,28,22
2010,372,Ireland,Burundi,47,24,23
2010,578,Norway,Burundi,897,420,477
2010,752,Sweden,Burundi,2599,1228,1371
2010,826,United Kingdom,Burundi,3159,1434,1725
2010,300,Greece,Burundi,141,76,65
2010,380,Italy,Burundi,985,430,555
2010,705,Slovenia,Burundi,3,3,0
2010,724,Spain,Burundi,101,51,50
2010,40,Austria,Burundi,83,49,34
2010,56,Belgium,Burundi,5830,2594,3236
2010,250,France,Burundi,1752,747,1005
2010,276,Germany,Burundi,566,310,256
2010,528,Netherlands,Burundi,2746,1400,1346
2010,756,Switzerland,Burundi,540,225,315
2010,124,Canada,Burundi,6225,3079,3146
2015,232,Eritrea,Burundi,1046,560,486
2015,231,Ethiopia,Burundi,180,90,90
2015,404,Kenya,Burundi,8312,4156,4156
2015,454,Malawi,Burundi,8250,4436,3814
2015,508,Mozambique,Burundi,1621,784,837
2015,646,Rwanda,Burundi,134501,68378,66123
2015,800,Uganda,Burundi,44379,23154,21225
2015,834,United Republic of Tanzania,Burundi,175325,87663,87662
2015,894,Zambia,Burundi,4856,2519,2337
2015,180,Democratic Republic of the Congo,Burundi,39062,16304,22758
2015,266,Gabon,Burundi,153,102,51
2015,748,Eswatini,Burundi,402,197,205
2015,516,Namibia,Burundi,380,232,148
2015,710,South Africa,Burundi,10232,4333,5899
2015,324,Guinea,Burundi,39,26,13
2015,818,Egypt,Burundi,25,24,1
2015,196,Cyprus,Burundi,3,3,0
2015,214,Dominican Republic,Burundi,3,0,3
2015,76,Brazil,Burundi,25,25,0
2015,152,Chile,Burundi,3,3,0
2015,36,Australia,Burundi,2390,1228,1162
2015,100,Bulgaria,Burundi,16,8,8
2015,203,Czechia,Burundi,5,3,2
2015,643,Russian Federation,Burundi,131,110,21
2015,208,Denmark,Burundi,576,251,325
2015,246,Finland,Burundi,65,34,31
2015,372,Ireland,Burundi,48,24,24
2015,428,Latvia,Burundi,1,1,0
2015,578,Norway,Burundi,1025,481,544
2015,752,Sweden,Burundi,2935,1382,1553
2015,826,United Kingdom,Burundi,4039,1768,2271
2015,300,Greece,Burundi,132,69,63
2015,380,Italy,Burundi,1009,432,577
2015,705,Slovenia,Burundi,3,3,0
2015,724,Spain,Burundi,107,49,58
2015,40,Austria,Burundi,97,58,39
2015,56,Belgium,Burundi,6824,3028,3796
2015,250,France,Burundi,1941,798,1143
2015,276,Germany,Burundi,590,323,267
2015,528,Netherlands,Burundi,2334,1137,1197
2015,756,Switzerland,Burundi,570,230,340
2015,124,Canada,Burundi,8418,4143,4275
2019,232,Eritrea,Burundi,1056,566,490
2019,231,Ethiopia,Burundi,194,97,97
2019,404,Kenya,Burundi,7706,3856,3850
2019,454,Malawi,Burundi,8849,4728,4121
2019,508,Mozambique,Burundi,3121,1509,1612
2019,646,Rwanda,Burundi,137669,68553,69116
2019,800,Uganda,Burundi,54494,27655,26839
2019,834,United Republic of Tanzania,Burundi,295436,147174,148262
2019,894,Zambia,Burundi,6258,3247,3011
2019,180,Democratic Republic of the Congo,Burundi,59826,26168,33658
2019,266,Gabon,Burundi,165,111,54
2019,748,Eswatini,Burundi,462,225,237
2019,516,Namibia,Burundi,402,246,156
2019,710,South Africa,Burundi,11468,4863,6605
2019,324,Guinea,Burundi,37,25,12
2019,818,Egypt,Burundi,35,34,1
2019,196,Cyprus,Burundi,2,2,0
2019,214,Dominican Republic,Burundi,3,0,3
2019,76,Brazil,Burundi,28,28,0
2019,152,Chile,Burundi,4,4,0
2019,36,Australia,Burundi,2740,1396,1344
2019,100,Bulgaria,Burundi,19,10,9
2019,203,Czechia,Burundi,7,5,2
2019,643,Russian Federation,Burundi,130,110,20
2019,208,Denmark,Burundi,564,245,319
2019,246,Finland,Burundi,86,44,42
2019,372,Ireland,Burundi,52,26,26
2019,578,Norway,Burundi,1170,550,620
2019,752,Sweden,Burundi,3349,1570,1779
2019,826,United Kingdom,Burundi,4586,2014,2572
2019,300,Greece,Burundi,128,69,59
2019,380,Italy,Burundi,1134,496,638
2019,705,Slovenia,Burundi,4,3,1
2019,724,Spain,Burundi,110,49,61
2019,40,Austria,Burundi,114,69,45
2019,56,Belgium,Burundi,7942,3538,4404
2019,250,France,Burundi,2054,842,1212
2019,276,Germany,Burundi,647,362,285
2019,528,Netherlands,Burundi,2294,1119,1175
2019,756,Switzerland,Burundi,667,285,382
2019,124,Canada,Burundi,9020,4439,4581
1990,508,Mozambique,Cabo Verde,2500,1410,1090
1990,24,Angola,Cabo Verde,3569,1920,1649
1990,678,Sao Tome and Principe,Cabo Verde,4250,2255,1995
1990,384,Côte d'Ivoire,Cabo Verde,274,153,121
1990,324,Guinea,Cabo Verde,98,51,47
1990,624,Guinea-Bissau,Cabo Verde,355,130,225
1990,694,Sierra Leone,Cabo Verde,5,3,2
1990,768,Togo,Cabo Verde,19,11,8
1990,608,Philippines,Cabo Verde,12,7,5
1990,214,Dominican Republic,Cabo Verde,3,0,3
1990,32,Argentina,Cabo Verde,51,19,32
1990,152,Chile,Cabo Verde,5,2,3
1990,36,Australia,Cabo Verde,20,14,6
1990,100,Bulgaria,Cabo Verde,2,2,0
1990,203,Czechia,Cabo Verde,3,2,1
1990,643,Russian Federation,Cabo Verde,52,26,26
1990,208,Denmark,Cabo Verde,5,4,1
1990,246,Finland,Cabo Verde,2,2,0
1990,352,Iceland,Cabo Verde,19,9,10
1990,372,Ireland,Cabo Verde,1,1,0
1990,428,Latvia,Cabo Verde,1,1,0
1990,578,Norway,Cabo Verde,163,91,72
1990,752,Sweden,Cabo Verde,231,107,124
1990,826,United Kingdom,Cabo Verde,45,27,18
1990,300,Greece,Cabo Verde,32,18,14
1990,380,Italy,Cabo Verde,6799,480,6319
1990,620,Portugal,Cabo Verde,30179,15865,14314
1990,724,Spain,Cabo Verde,1274,498,776
1990,40,Austria,Cabo Verde,22,9,13
1990,56,Belgium,Cabo Verde,459,165,294
1990,250,France,Cabo Verde,16358,7646,8712
1990,442,Luxembourg,Cabo Verde,1148,570,578
1990,528,Netherlands,Cabo Verde,7912,4053,3859
1990,756,Switzerland,Cabo Verde,1084,547,537
1990,124,Canada,Cabo Verde,48,24,24
1990,840,United States of America,Cabo Verde,14368,6561,7807
1995,508,Mozambique,Cabo Verde,3439,1946,1493
1995,24,Angola,Cabo Verde,4147,2151,1996
1995,678,Sao Tome and Principe,Cabo Verde,3343,1650,1693
1995,384,Côte d'Ivoire,Cabo Verde,306,169,137
1995,324,Guinea,Cabo Verde,112,64,48
1995,624,Guinea-Bissau,Cabo Verde,466,183,283
1995,694,Sierra Leone,Cabo Verde,4,2,2
1995,768,Togo,Cabo Verde,21,12,9
1995,608,Philippines,Cabo Verde,16,10,6
1995,214,Dominican Republic,Cabo Verde,4,0,4
1995,32,Argentina,Cabo Verde,50,19,31
1995,68,Bolivia (Plurinational State of),Cabo Verde,1,0,1
1995,152,Chile,Cabo Verde,3,1,2
1995,36,Australia,Cabo Verde,10,7,3
1995,100,Bulgaria,Cabo Verde,3,2,1
1995,203,Czechia,Cabo Verde,5,3,2
1995,643,Russian Federation,Cabo Verde,50,27,23
1995,208,Denmark,Cabo Verde,12,7,5
1995,246,Finland,Cabo Verde,3,2,1
1995,352,Iceland,Cabo Verde,28,13,15
1995,372,Ireland,Cabo Verde,2,2,0
1995,428,Latvia,Cabo Verde,1,1,0
1995,578,Norway,Cabo Verde,167,93,74
1995,752,Sweden,Cabo Verde,274,125,149
1995,826,United Kingdom,Cabo Verde,180,85,95
1995,300,Greece,Cabo Verde,33,18,15
1995,380,Italy,Cabo Verde,5918,739,5179
1995,620,Portugal,Cabo Verde,36695,18895,17800
1995,724,Spain,Cabo Verde,1528,614,914
1995,40,Austria,Cabo Verde,25,10,15
1995,56,Belgium,Cabo Verde,459,165,294
1995,250,France,Cabo Verde,16887,7742,9145
1995,442,Luxembourg,Cabo Verde,1278,600,678
1995,528,Netherlands,Cabo Verde,9257,4654,4603
1995,756,Switzerland,Cabo Verde,1287,678,609
1995,124,Canada,Cabo Verde,183,89,94
1995,840,United States of America,Cabo Verde,20760,9600,11160
2000,508,Mozambique,Cabo Verde,4001,2207,1794
2000,24,Angola,Cabo Verde,4724,2381,2343
2000,678,Sao Tome and Principe,Cabo Verde,2488,1212,1276
2000,384,Côte d'Ivoire,Cabo Verde,318,176,142
2000,324,Guinea,Cabo Verde,78,45,33
2000,624,Guinea-Bissau,Cabo Verde,576,235,341
2000,694,Sierra Leone,Cabo Verde,3,1,2
2000,768,Togo,Cabo Verde,23,13,10
2000,608,Philippines,Cabo Verde,11,11,0
2000,214,Dominican Republic,Cabo Verde,4,0,4
2000,32,Argentina,Cabo Verde,49,19,30
2000,68,Bolivia (Plurinational State of),Cabo Verde,2,0,2
2000,152,Chile,Cabo Verde,1,0,1
2000,36,Australia,Cabo Verde,30,15,15
2000,100,Bulgaria,Cabo Verde,4,3,1
2000,203,Czechia,Cabo Verde,7,4,3
2000,643,Russian Federation,Cabo Verde,47,27,20
2000,208,Denmark,Cabo Verde,18,9,9
2000,246,Finland,Cabo Verde,4,2,2
2000,352,Iceland,Cabo Verde,37,18,19
2000,372,Ireland,Cabo Verde,5,4,1
2000,428,Latvia,Cabo Verde,1,1,0
2000,578,Norway,Cabo Verde,234,136,98
2000,752,Sweden,Cabo Verde,294,133,161
2000,826,United Kingdom,Cabo Verde,319,144,175
2000,300,Greece,Cabo Verde,34,18,16
2000,380,Italy,Cabo Verde,5037,999,4038
2000,620,Portugal,Cabo Verde,44701,22760,21941
2000,724,Spain,Cabo Verde,2441,1019,1422
2000,40,Austria,Cabo Verde,28,12,16
2000,56,Belgium,Cabo Verde,445,158,287
2000,250,France,Cabo Verde,17416,7838,9578
2000,442,Luxembourg,Cabo Verde,1422,637,785
2000,528,Netherlands,Cabo Verde,10923,5403,5520
2000,756,Switzerland,Cabo Verde,1496,814,682
2000,124,Canada,Cabo Verde,322,155,167
2000,840,United States of America,Cabo Verde,27281,12719,14562
2005,508,Mozambique,Cabo Verde,5412,2760,2652
2005,24,Angola,Cabo Verde,6109,3000,3109
2005,678,Sao Tome and Principe,Cabo Verde,1956,945,1011
2005,384,Côte d'Ivoire,Cabo Verde,332,184,148
2005,324,Guinea,Cabo Verde,54,34,20
2005,624,Guinea-Bissau,Cabo Verde,549,221,328
2005,694,Sierra Leone,Cabo Verde,1,0,1
2005,768,Togo,Cabo Verde,25,14,11
2005,608,Philippines,Cabo Verde,8,8,0
2005,214,Dominican Republic,Cabo Verde,4,0,4
2005,32,Argentina,Cabo Verde,37,15,22
2005,68,Bolivia (Plurinational State of),Cabo Verde,56,19,37
2005,76,Brazil,Cabo Verde,592,263,329
2005,152,Chile,Cabo Verde,1,0,1
2005,36,Australia,Cabo Verde,30,15,15
2005,100,Bulgaria,Cabo Verde,6,4,2
2005,203,Czechia,Cabo Verde,9,5,4
2005,643,Russian Federation,Cabo Verde,46,27,19
2005,208,Denmark,Cabo Verde,22,10,12
2005,246,Finland,Cabo Verde,6,4,2
2005,352,Iceland,Cabo Verde,40,19,21
2005,372,Ireland,Cabo Verde,5,4,1
2005,428,Latvia,Cabo Verde,1,1,0
2005,578,Norway,Cabo Verde,253,143,110
2005,752,Sweden,Cabo Verde,328,152,176
2005,826,United Kingdom,Cabo Verde,700,302,398
2005,300,Greece,Cabo Verde,24,12,12
2005,380,Italy,Cabo Verde,5598,1257,4341
2005,620,Portugal,Cabo Verde,53008,26065,26943
2005,724,Spain,Cabo Verde,3243,1352,1891
2005,40,Austria,Cabo Verde,32,13,19
2005,56,Belgium,Cabo Verde,542,198,344
2005,250,France,Cabo Verde,18180,8282,9898
2005,442,Luxembourg,Cabo Verde,1234,594,640
2005,528,Netherlands,Cabo Verde,11532,5571,5961
2005,756,Switzerland,Cabo Verde,1638,854,784
2005,124,Canada,Cabo Verde,246,123,123
2005,840,United States of America,Cabo Verde,30020,14085,15935
2010,508,Mozambique,Cabo Verde,6267,3196,3071
2010,24,Angola,Cabo Verde,7493,3619,3874
2010,678,Sao Tome and Principe,Cabo Verde,1538,740,798
2010,384,Côte d'Ivoire,Cabo Verde,346,192,154
2010,324,Guinea,Cabo Verde,37,23,14
2010,624,Guinea-Bissau,Cabo Verde,521,206,315
2010,694,Sierra Leone,Cabo Verde,6,2,4
2010,768,Togo,Cabo Verde,36,20,16
2010,608,Philippines,Cabo Verde,128,128,0
2010,214,Dominican Republic,Cabo Verde,3,0,3
2010,32,Argentina,Cabo Verde,24,10,14
2010,68,Bolivia (Plurinational State of),Cabo Verde,110,39,71
2010,76,Brazil,Cabo Verde,1184,526,658
2010,152,Chile,Cabo Verde,2,1,1
2010,36,Australia,Cabo Verde,30,15,15
2010,100,Bulgaria,Cabo Verde,7,5,2
2010,203,Czechia,Cabo Verde,11,7,4
2010,643,Russian Federation,Cabo Verde,45,26,19
2010,208,Denmark,Cabo Verde,24,11,13
2010,246,Finland,Cabo Verde,10,8,2
2010,352,Iceland,Cabo Verde,41,19,22
2010,372,Ireland,Cabo Verde,4,3,1
2010,428,Latvia,Cabo Verde,1,1,0
2010,578,Norway,Cabo Verde,383,209,174
2010,752,Sweden,Cabo Verde,351,161,190
2010,826,United Kingdom,Cabo Verde,737,327,410
2010,300,Greece,Cabo Verde,14,6,8
2010,380,Italy,Cabo Verde,6260,1460,4800
2010,620,Portugal,Cabo Verde,52513,25102,27411
2010,724,Spain,Cabo Verde,4499,1923,2576
2010,40,Austria,Cabo Verde,35,14,21
2010,56,Belgium,Cabo Verde,582,257,325
2010,250,France,Cabo Verde,20933,9164,11769
2010,442,Luxembourg,Cabo Verde,1060,557,503
2010,528,Netherlands,Cabo Verde,11738,5542,6196
2010,756,Switzerland,Cabo Verde,1977,976,1001
2010,124,Canada,Cabo Verde,175,93,82
2010,840,United States of America,Cabo Verde,33752,15589,18163
2015,508,Mozambique,Cabo Verde,6580,3356,3224
2015,24,Angola,Cabo Verde,8877,4238,4639
2015,678,Sao Tome and Principe,Cabo Verde,1363,655,708
2015,384,Côte d'Ivoire,Cabo Verde,360,200,160
2015,324,Guinea,Cabo Verde,34,21,13
2015,624,Guinea-Bissau,Cabo Verde,552,215,337
2015,694,Sierra Leone,Cabo Verde,43,27,16
2015,768,Togo,Cabo Verde,40,22,18
2015,608,Philippines,Cabo Verde,131,131,0
2015,214,Dominican Republic,Cabo Verde,3,0,3
2015,32,Argentina,Cabo Verde,24,10,14
2015,68,Bolivia (Plurinational State of),Cabo Verde,128,45,83
2015,76,Brazil,Cabo Verde,1426,634,792
2015,152,Chile,Cabo Verde,3,2,1
2015,36,Australia,Cabo Verde,40,23,17
2015,100,Bulgaria,Cabo Verde,6,4,2
2015,203,Czechia,Cabo Verde,11,8,3
2015,643,Russian Federation,Cabo Verde,45,26,19
2015,208,Denmark,Cabo Verde,29,13,16
2015,246,Finland,Cabo Verde,13,10,3
2015,352,Iceland,Cabo Verde,33,15,18
2015,372,Ireland,Cabo Verde,4,3,1
2015,578,Norway,Cabo Verde,409,226,183
2015,752,Sweden,Cabo Verde,379,184,195
2015,826,United Kingdom,Cabo Verde,942,403,539
2015,300,Greece,Cabo Verde,13,6,7
2015,380,Italy,Cabo Verde,6076,1475,4601
2015,620,Portugal,Cabo Verde,59532,26858,32674
2015,724,Spain,Cabo Verde,4445,1826,2619
2015,40,Austria,Cabo Verde,41,17,24
2015,56,Belgium,Cabo Verde,735,334,401
2015,250,France,Cabo Verde,23189,9792,13397
2015,442,Luxembourg,Cabo Verde,1617,862,755
2015,528,Netherlands,Cabo Verde,11997,5624,6373
2015,756,Switzerland,Cabo Verde,2544,1233,1311
2015,124,Canada,Cabo Verde,163,84,79
2015,840,United States of America,Cabo Verde,40495,18593,21902
2019,508,Mozambique,Cabo Verde,6843,3491,3352
2019,24,Angola,Cabo Verde,9400,4758,4642
2019,678,Sao Tome and Principe,Cabo Verde,1237,593,644
2019,384,Côte d'Ivoire,Cabo Verde,371,206,165
2019,324,Guinea,Cabo Verde,32,20,12
2019,624,Guinea-Bissau,Cabo Verde,606,237,369
2019,694,Sierra Leone,Cabo Verde,91,64,27
2019,768,Togo,Cabo Verde,40,22,18
2019,608,Philippines,Cabo Verde,135,135,0
2019,214,Dominican Republic,Cabo Verde,3,0,3
2019,32,Argentina,Cabo Verde,24,10,14
2019,68,Bolivia (Plurinational State of),Cabo Verde,139,49,90
2019,76,Brazil,Cabo Verde,1605,714,891
2019,152,Chile,Cabo Verde,4,3,1
2019,36,Australia,Cabo Verde,42,22,20
2019,100,Bulgaria,Cabo Verde,6,4,2
2019,203,Czechia,Cabo Verde,13,8,5
2019,643,Russian Federation,Cabo Verde,44,26,18
2019,208,Denmark,Cabo Verde,37,17,20
2019,246,Finland,Cabo Verde,17,13,4
2019,352,Iceland,Cabo Verde,46,22,24
2019,372,Ireland,Cabo Verde,4,3,1
2019,578,Norway,Cabo Verde,436,241,195
2019,752,Sweden,Cabo Verde,427,218,209
2019,826,United Kingdom,Cabo Verde,1069,459,610
2019,300,Greece,Cabo Verde,12,6,6
2019,380,Italy,Cabo Verde,6447,1623,4824
2019,620,Portugal,Cabo Verde,60543,27385,33158
2019,724,Spain,Cabo Verde,4605,1827,2778
2019,40,Austria,Cabo Verde,48,21,27
2019,56,Belgium,Cabo Verde,879,401,478
2019,250,France,Cabo Verde,24545,10332,14213
2019,442,Luxembourg,Cabo Verde,7354,3494,3860
2019,528,Netherlands,Cabo Verde,12601,5889,6712
2019,756,Switzerland,Cabo Verde,2764,1347,1417
2019,124,Canada,Cabo Verde,174,90,84
2019,840,United States of America,Cabo Verde,43729,19824,23905
1990,50,Bangladesh,Cambodia,12924,6979,5945
1990,392,Japan,Cambodia,1171,597,574
1990,410,Republic of Korea,Cambodia,3,3,0
1990,418,Lao People's Democratic Republic,Cambodia,1398,697,701
1990,458,Malaysia,Cambodia,747,457,290
1990,608,Philippines,Cambodia,7528,3840,3688
1990,764,Thailand,Cambodia,73756,36220,37536
1990,704,Viet Nam,Cambodia,21150,11456,9694
1990,214,Dominican Republic,Cambodia,118,63,55
1990,188,Costa Rica,Cambodia,2,0,2
1990,32,Argentina,Cambodia,46,30,16
1990,152,Chile,Cambodia,2,1,1
1990,36,Australia,Cambodia,20651,10474,10177
1990,554,New Zealand,Cambodia,4114,2030,2084
1990,540,New Caledonia,Cambodia,482,231,251
1990,100,Bulgaria,Cambodia,6,2,4
1990,203,Czechia,Cambodia,4,2,2
1990,348,Hungary,Cambodia,65,37,28
1990,616,Poland,Cambodia,31,20,11
1990,643,Russian Federation,Cambodia,227,111,116
1990,208,Denmark,Cambodia,50,27,23
1990,246,Finland,Cambodia,62,31,31
1990,352,Iceland,Cambodia,1,0,1
1990,372,Ireland,Cambodia,2,0,2
1990,578,Norway,Cambodia,107,56,51
1990,752,Sweden,Cambodia,254,118,136
1990,826,United Kingdom,Cambodia,97,55,42
1990,300,Greece,Cambodia,8,5,3
1990,380,Italy,Cambodia,41,14,27
1990,724,Spain,Cambodia,5,3,2
1990,40,Austria,Cambodia,528,235,293
1990,56,Belgium,Cambodia,986,403,583
1990,250,France,Cambodia,69234,35486,33748
1990,276,Germany,Cambodia,1666,960,706
1990,528,Netherlands,Cambodia,261,128,133
1990,756,Switzerland,Cambodia,1637,818,819
1990,124,Canada,Cambodia,17233,8389,8844
1990,840,United States of America,Cambodia,118833,54772,64061
1995,50,Bangladesh,Cambodia,13190,7123,6067
1995,392,Japan,Cambodia,1461,702,759
1995,410,Republic of Korea,Cambodia,20,16,4
1995,418,Lao People's Democratic Republic,Cambodia,1362,675,687
1995,458,Malaysia,Cambodia,1770,1032,738
1995,608,Philippines,Cambodia,10130,5068,5062
1995,764,Thailand,Cambodia,102948,50552,52396
1995,704,Viet Nam,Cambodia,34400,18916,15484
1995,214,Dominican Republic,Cambodia,131,68,63
1995,188,Costa Rica,Cambodia,2,0,2
1995,32,Argentina,Cambodia,45,29,16
1995,152,Chile,Cambodia,3,1,2
1995,36,Australia,Cambodia,23310,11574,11736
1995,554,New Zealand,Cambodia,3575,1687,1888
1995,540,New Caledonia,Cambodia,558,263,295
1995,100,Bulgaria,Cambodia,8,2,6
1995,203,Czechia,Cambodia,6,3,3
1995,348,Hungary,Cambodia,58,33,25
1995,616,Poland,Cambodia,26,17,9
1995,643,Russian Federation,Cambodia,190,116,74
1995,208,Denmark,Cambodia,90,44,46
1995,246,Finland,Cambodia,73,34,39
1995,352,Iceland,Cambodia,2,1,1
1995,372,Ireland,Cambodia,5,1,4
1995,578,Norway,Cambodia,155,80,75
1995,752,Sweden,Cambodia,302,139,163
1995,826,United Kingdom,Cambodia,385,172,213
1995,300,Greece,Cambodia,9,4,5
1995,380,Italy,Cambodia,167,60,107
1995,724,Spain,Cambodia,8,5,3
1995,40,Austria,Cambodia,596,270,326
1995,56,Belgium,Cambodia,980,397,583
1995,250,France,Cambodia,71472,36047,35425
1995,276,Germany,Cambodia,1266,722,544
1995,528,Netherlands,Cambodia,384,184,200
1995,756,Switzerland,Cambodia,1716,861,855
1995,124,Canada,Cambodia,17797,8622,9175
1995,840,United States of America,Cambodia,129616,60359,69257
2000,50,Bangladesh,Cambodia,13455,7266,6189
2000,392,Japan,Cambodia,1761,814,947
2000,410,Republic of Korea,Cambodia,44,34,10
2000,418,Lao People's Democratic Republic,Cambodia,1197,597,600
2000,458,Malaysia,Cambodia,3413,1963,1450
2000,608,Philippines,Cambodia,186,97,89
2000,764,Thailand,Cambodia,153382,74040,79342
2000,704,Viet Nam,Cambodia,15945,9223,6722
2000,214,Dominican Republic,Cambodia,144,74,70
2000,188,Costa Rica,Cambodia,2,0,2
2000,32,Argentina,Cambodia,44,29,15
2000,152,Chile,Cambodia,4,1,3
2000,36,Australia,Cambodia,24970,12073,12897
2000,554,New Zealand,Cambodia,4643,2258,2385
2000,540,New Caledonia,Cambodia,635,295,340
2000,100,Bulgaria,Cambodia,9,2,7
2000,203,Czechia,Cambodia,8,4,4
2000,348,Hungary,Cambodia,51,29,22
2000,616,Poland,Cambodia,23,15,8
2000,643,Russian Federation,Cambodia,148,118,30
2000,208,Denmark,Cambodia,129,60,69
2000,246,Finland,Cambodia,83,37,46
2000,352,Iceland,Cambodia,2,1,1
2000,372,Ireland,Cambodia,12,3,9
2000,578,Norway,Cambodia,173,86,87
2000,752,Sweden,Cambodia,324,148,176
2000,826,United Kingdom,Cambodia,680,290,390
2000,300,Greece,Cambodia,10,3,7
2000,380,Italy,Cambodia,292,106,186
2000,724,Spain,Cambodia,103,60,43
2000,40,Austria,Cambodia,663,305,358
2000,56,Belgium,Cambodia,950,385,565
2000,250,France,Cambodia,73710,36608,37102
2000,276,Germany,Cambodia,865,483,382
2000,528,Netherlands,Cambodia,522,246,276
2000,756,Switzerland,Cambodia,1803,911,892
2000,124,Canada,Cambodia,18784,9062,9722
2000,840,United States of America,Cambodia,140456,66069,74387
2005,50,Bangladesh,Cambodia,16015,8649,7366
2005,392,Japan,Cambodia,2531,1153,1378
2005,410,Republic of Korea,Cambodia,4552,2438,2114
2005,418,Lao People's Democratic Republic,Cambodia,1119,573,546
2005,458,Malaysia,Cambodia,8592,5150,3442
2005,608,Philippines,Cambodia,150,80,70
2005,764,Thailand,Cambodia,369213,171788,197425
2005,704,Viet Nam,Cambodia,2357,1417,940
2005,214,Dominican Republic,Cambodia,130,67,63
2005,188,Costa Rica,Cambodia,1,0,1
2005,32,Argentina,Cambodia,32,21,11
2005,76,Brazil,Cambodia,13,7,6
2005,152,Chile,Cambodia,6,2,4
2005,36,Australia,Cambodia,27610,13041,14569
2005,554,New Zealand,Cambodia,5600,2719,2881
2005,540,New Caledonia,Cambodia,676,316,360
2005,100,Bulgaria,Cambodia,11,2,9
2005,203,Czechia,Cambodia,15,9,6
2005,348,Hungary,Cambodia,63,36,27
2005,616,Poland,Cambodia,24,17,7
2005,643,Russian Federation,Cambodia,131,107,24
2005,208,Denmark,Cambodia,162,71,91
2005,246,Finland,Cambodia,158,68,90
2005,352,Iceland,Cambodia,3,1,2
2005,372,Ireland,Cambodia,13,4,9
2005,578,Norway,Cambodia,224,112,112
2005,752,Sweden,Cambodia,383,160,223
2005,826,United Kingdom,Cambodia,884,358,526
2005,300,Greece,Cambodia,16,6,10
2005,380,Italy,Cambodia,807,445,362
2005,724,Spain,Cambodia,50,29,21
2005,40,Austria,Cambodia,741,331,410
2005,56,Belgium,Cambodia,1281,469,812
2005,250,France,Cambodia,58654,28513,30141
2005,276,Germany,Cambodia,1583,772,811
2005,528,Netherlands,Cambodia,634,275,359
2005,756,Switzerland,Cambodia,1988,955,1033
2005,124,Canada,Cambodia,20565,9724,10841
2005,840,United States of America,Cambodia,147478,69805,77673
2010,50,Bangladesh,Cambodia,18541,10013,8528
2010,392,Japan,Cambodia,2683,1206,1477
2010,410,Republic of Korea,Cambodia,10863,5677,5186
2010,418,Lao People's Democratic Republic,Cambodia,2273,1196,1077
2010,458,Malaysia,Cambodia,12679,7748,4931
2010,608,Philippines,Cambodia,38,20,18
2010,764,Thailand,Cambodia,611508,285936,325572
2010,704,Viet Nam,Cambodia,1928,1124,804
2010,214,Dominican Republic,Cambodia,115,59,56
2010,188,Costa Rica,Cambodia,3,0,3
2010,32,Argentina,Cambodia,20,14,6
2010,76,Brazil,Cambodia,27,14,13
2010,152,Chile,Cambodia,8,3,5
2010,36,Australia,Cambodia,31720,14658,17062
2010,554,New Zealand,Cambodia,6263,3035,3228
2010,540,New Caledonia,Cambodia,718,338,380
2010,100,Bulgaria,Cambodia,13,2,11
2010,203,Czechia,Cambodia,20,12,8
2010,348,Hungary,Cambodia,74,42,32
2010,616,Poland,Cambodia,27,20,7
2010,643,Russian Federation,Cambodia,112,93,19
2010,208,Denmark,Cambodia,191,81,110
2010,233,Estonia,Cambodia,4,0,4
2010,246,Finland,Cambodia,278,108,170
2010,352,Iceland,Cambodia,1,0,1
2010,372,Ireland,Cambodia,11,2,9
2010,578,Norway,Cambodia,328,151,177
2010,752,Sweden,Cambodia,494,197,297
2010,826,United Kingdom,Cambodia,931,389,542
2010,300,Greece,Cambodia,22,9,13
2010,380,Italy,Cambodia,1299,767,532
2010,705,Slovenia,Cambodia,2,0,2
2010,724,Spain,Cambodia,82,35,47
2010,40,Austria,Cambodia,819,358,461
2010,56,Belgium,Cambodia,1384,577,807
2010,250,France,Cambodia,59482,28869,30613
2010,276,Germany,Cambodia,2180,1022,1158
2010,528,Netherlands,Cambodia,678,290,388
2010,756,Switzerland,Cambodia,2383,1073,1310
2010,124,Canada,Cambodia,23755,11080,12675
2010,840,United States of America,Cambodia,159212,74205,85007
2015,324,Guinea,Cambodia,9,5,4
2015,50,Bangladesh,Cambodia,19642,10607,9035
2015,392,Japan,Cambodia,3383,1509,1874
2015,410,Republic of Korea,Cambodia,13497,6904,6593
2015,418,Lao People's Democratic Republic,Cambodia,3428,1820,1608
2015,458,Malaysia,Cambodia,15461,9536,5925
2015,608,Philippines,Cambodia,39,20,19
2015,764,Thailand,Cambodia,661275,308027,353248
2015,704,Viet Nam,Cambodia,990,574,416
2015,214,Dominican Republic,Cambodia,121,62,59
2015,188,Costa Rica,Cambodia,3,0,3
2015,32,Argentina,Cambodia,20,14,6
2015,76,Brazil,Cambodia,33,17,16
2015,152,Chile,Cambodia,12,5,7
2015,36,Australia,Cambodia,34420,15851,18569
2015,554,New Zealand,Cambodia,6826,3301,3525
2015,540,New Caledonia,Cambodia,551,226,325
2015,100,Bulgaria,Cambodia,12,1,11
2015,203,Czechia,Cambodia,40,18,22
2015,348,Hungary,Cambodia,56,35,21
2015,616,Poland,Cambodia,26,20,6
2015,643,Russian Federation,Cambodia,114,95,19
2015,208,Denmark,Cambodia,247,102,145
2015,233,Estonia,Cambodia,9,4,5
2015,246,Finland,Cambodia,330,127,203
2015,352,Iceland,Cambodia,1,0,1
2015,372,Ireland,Cambodia,11,2,9
2015,578,Norway,Cambodia,409,164,245
2015,752,Sweden,Cambodia,611,239,372
2015,826,United Kingdom,Cambodia,1190,477,713
2015,300,Greece,Cambodia,20,8,12
2015,380,Italy,Cambodia,1319,772,547
2015,705,Slovenia,Cambodia,6,1,5
2015,724,Spain,Cambodia,95,32,63
2015,40,Austria,Cambodia,958,421,537
2015,56,Belgium,Cambodia,1444,566,878
2015,250,France,Cambodia,65893,31047,34846
2015,276,Germany,Cambodia,2271,1062,1209
2015,528,Netherlands,Cambodia,738,309,429
2015,756,Switzerland,Cambodia,2401,1032,1369
2015,124,Canada,Cambodia,23177,10694,12483
2015,840,United States of America,Cambodia,181502,84098,97404
2019,324,Guinea,Cambodia,8,5,3
2019,50,Bangladesh,Cambodia,19900,6069,13831
2019,392,Japan,Cambodia,3786,1689,2097
2019,410,Republic of Korea,Cambodia,13739,7025,6714
2019,418,Lao People's Democratic Republic,Cambodia,3634,1930,1704
2019,458,Malaysia,Cambodia,16166,10017,6149
2019,608,Philippines,Cambodia,40,21,19
2019,764,Thailand,Cambodia,689451,321091,368360
2019,704,Viet Nam,Cambodia,1035,601,434
2019,214,Dominican Republic,Cambodia,125,65,60
2019,188,Costa Rica,Cambodia,3,0,3
2019,32,Argentina,Cambodia,20,14,6
2019,76,Brazil,Cambodia,37,19,18
2019,152,Chile,Cambodia,16,7,9
2019,36,Australia,Cambodia,38278,17446,20832
2019,554,New Zealand,Cambodia,7016,3393,3623
2019,540,New Caledonia,Cambodia,580,237,343
2019,100,Bulgaria,Cambodia,14,1,13
2019,203,Czechia,Cambodia,56,30,26
2019,348,Hungary,Cambodia,70,40,30
2019,616,Poland,Cambodia,27,21,6
2019,643,Russian Federation,Cambodia,113,95,18
2019,208,Denmark,Cambodia,285,122,163
2019,233,Estonia,Cambodia,9,4,5
2019,246,Finland,Cambodia,391,144,247
2019,352,Iceland,Cambodia,1,0,1
2019,372,Ireland,Cambodia,12,3,9
2019,578,Norway,Cambodia,473,181,292
2019,752,Sweden,Cambodia,737,294,443
2019,826,United Kingdom,Cambodia,1351,544,807
2019,300,Greece,Cambodia,19,8,11
2019,380,Italy,Cambodia,1391,805,586
2019,705,Slovenia,Cambodia,6,0,6
2019,724,Spain,Cambodia,98,32,66
2019,40,Austria,Cambodia,1130,507,623
2019,56,Belgium,Cambodia,1553,598,955
2019,250,France,Cambodia,69748,32780,36968
2019,276,Germany,Cambodia,2491,1016,1475
2019,528,Netherlands,Cambodia,817,329,488
2019,756,Switzerland,Cambodia,2510,1078,1432
2019,124,Canada,Cambodia,24836,11460,13376
2019,840,United States of America,Cambodia,196003,89684,106319
1990,894,Zambia,Cameroon,10,8,2
1990,148,Chad,Cameroon,30992,16731,14261
1990,178,Congo,Cameroon,3464,2036,1428
1990,226,Equatorial Guinea,Cameroon,202,133,69
1990,266,Gabon,Cameroon,15661,7765,7896
1990,516,Namibia,Cameroon,175,144,31
1990,710,South Africa,Cameroon,2303,1488,815
1990,288,Ghana,Cameroon,61,38,23
1990,466,Mali,Cameroon,592,336,256
1990,478,Mauritania,Cameroon,350,189,161
1990,562,Niger,Cameroon,265,125,140
1990,566,Nigeria,Cameroon,10242,5746,4496
1990,686,Senegal,Cameroon,837,317,520
1990,768,Togo,Cameroon,334,207,127
1990,818,Egypt,Cameroon,135,118,17
1990,196,Cyprus,Cameroon,14,8,6
1990,214,Dominican Republic,Cameroon,3,3,0
1990,188,Costa Rica,Cameroon,8,3,5
1990,484,Mexico,Cameroon,5,3,2
1990,68,Bolivia (Plurinational State of),Cameroon,1,0,1
1990,152,Chile,Cameroon,18,10,8
1990,218,Ecuador,Cameroon,15,10,5
1990,36,Australia,Cameroon,68,46,22
1990,100,Bulgaria,Cameroon,1,1,0
1990,203,Czechia,Cameroon,1,0,1
1990,348,Hungary,Cameroon,6,6,0
1990,616,Poland,Cameroon,14,13,1
1990,643,Russian Federation,Cameroon,738,362,376
1990,208,Denmark,Cameroon,31,18,13
1990,246,Finland,Cameroon,6,2,4
1990,352,Iceland,Cameroon,1,1,0
1990,372,Ireland,Cameroon,67,29,38
1990,428,Latvia,Cameroon,1,1,0
1990,578,Norway,Cameroon,121,71,50
1990,752,Sweden,Cameroon,84,57,27
1990,826,United Kingdom,Cameroon,451,278,173
1990,300,Greece,Cameroon,188,104,84
1990,380,Italy,Cameroon,254,88,166
1990,620,Portugal,Cameroon,16,9,7
1990,724,Spain,Cameroon,428,228,200
1990,40,Austria,Cameroon,360,227,133
1990,56,Belgium,Cameroon,2109,1110,999
1990,250,France,Cameroon,36846,17351,19495
1990,276,Germany,Cameroon,2178,1650,528
1990,442,Luxembourg,Cameroon,58,21,37
1990,528,Netherlands,Cameroon,431,227,204
1990,756,Switzerland,Cameroon,2245,886,1359
1990,124,Canada,Cameroon,302,147,155
1990,840,United States of America,Cameroon,3161,1717,1444
1995,894,Zambia,Cameroon,13,11,2
1995,148,Chad,Cameroon,33673,18156,15517
1995,178,Congo,Cameroon,4003,2275,1728
1995,226,Equatorial Guinea,Cameroon,268,176,92
1995,266,Gabon,Cameroon,20944,10376,10568
1995,516,Namibia,Cameroon,167,138,29
1995,710,South Africa,Cameroon,1436,969,467
1995,288,Ghana,Cameroon,61,40,21
1995,466,Mali,Cameroon,618,351,267
1995,478,Mauritania,Cameroon,373,217,156
1995,562,Niger,Cameroon,329,149,180
1995,566,Nigeria,Cameroon,10384,5789,4595
1995,686,Senegal,Cameroon,875,328,547
1995,768,Togo,Cameroon,376,233,143
1995,818,Egypt,Cameroon,109,93,16
1995,196,Cyprus,Cameroon,20,11,9
1995,214,Dominican Republic,Cameroon,4,4,0
1995,188,Costa Rica,Cameroon,6,2,4
1995,484,Mexico,Cameroon,5,3,2
1995,68,Bolivia (Plurinational State of),Cameroon,2,1,1
1995,152,Chile,Cameroon,12,7,5
1995,218,Ecuador,Cameroon,17,11,6
1995,36,Australia,Cameroon,55,34,21
1995,100,Bulgaria,Cameroon,3,3,0
1995,203,Czechia,Cameroon,2,1,1
1995,348,Hungary,Cameroon,71,52,19
1995,616,Poland,Cameroon,11,11,0
1995,643,Russian Federation,Cameroon,624,379,245
1995,208,Denmark,Cameroon,84,52,32
1995,246,Finland,Cameroon,15,9,6
1995,352,Iceland,Cameroon,2,2,0
1995,372,Ireland,Cameroon,185,76,109
1995,428,Latvia,Cameroon,1,1,0
1995,578,Norway,Cameroon,149,82,67
1995,752,Sweden,Cameroon,100,67,33
1995,826,United Kingdom,Cameroon,1773,903,870
1995,300,Greece,Cameroon,308,162,146
1995,380,Italy,Cameroon,1861,921,940
1995,620,Portugal,Cameroon,35,20,15
1995,724,Spain,Cameroon,685,387,298
1995,40,Austria,Cameroon,407,259,148
1995,56,Belgium,Cameroon,2173,1149,1024
1995,250,France,Cameroon,38038,17574,20464
1995,276,Germany,Cameroon,5590,3818,1772
1995,442,Luxembourg,Cameroon,55,21,34
1995,528,Netherlands,Cameroon,634,327,307
1995,756,Switzerland,Cameroon,3555,1465,2090
1995,124,Canada,Cameroon,1275,615,660
1995,840,United States of America,Cameroon,7562,4152,3410
2000,894,Zambia,Cameroon,18,15,3
2000,148,Chad,Cameroon,36353,19581,16772
2000,178,Congo,Cameroon,5614,3118,2496
2000,226,Equatorial Guinea,Cameroon,333,218,115
2000,266,Gabon,Cameroon,26199,13073,13126
2000,516,Namibia,Cameroon,156,128,28
2000,710,South Africa,Cameroon,992,718,274
2000,288,Ghana,Cameroon,68,43,25
2000,466,Mali,Cameroon,567,323,244
2000,478,Mauritania,Cameroon,385,241,144
2000,562,Niger,Cameroon,397,175,222
2000,566,Nigeria,Cameroon,10943,6061,4882
2000,686,Senegal,Cameroon,792,275,517
2000,768,Togo,Cameroon,423,262,161
2000,818,Egypt,Cameroon,92,76,16
2000,196,Cyprus,Cameroon,26,14,12
2000,214,Dominican Republic,Cameroon,4,4,0
2000,188,Costa Rica,Cameroon,7,3,4
2000,484,Mexico,Cameroon,6,3,3
2000,68,Bolivia (Plurinational State of),Cameroon,2,1,1
2000,152,Chile,Cameroon,6,3,3
2000,218,Ecuador,Cameroon,19,13,6
2000,36,Australia,Cameroon,70,35,35
2000,100,Bulgaria,Cameroon,4,4,0
2000,203,Czechia,Cameroon,3,2,1
2000,348,Hungary,Cameroon,136,98,38
2000,616,Poland,Cameroon,10,9,1
2000,643,Russian Federation,Cameroon,488,382,106
2000,208,Denmark,Cameroon,137,87,50
2000,246,Finland,Cameroon,24,16,8
2000,352,Iceland,Cameroon,2,2,0
2000,372,Ireland,Cameroon,405,173,232
2000,428,Latvia,Cameroon,1,1,0
2000,578,Norway,Cameroon,197,113,84
2000,752,Sweden,Cameroon,108,72,36
2000,826,United Kingdom,Cameroon,3125,1541,1584
2000,300,Greece,Cameroon,434,221,213
2000,380,Italy,Cameroon,3468,1755,1713
2000,620,Portugal,Cameroon,57,32,25
2000,705,Slovenia,Cameroon,3,2,1
2000,724,Spain,Cameroon,1239,721,518
2000,40,Austria,Cameroon,453,290,163
2000,56,Belgium,Cameroon,2174,1158,1016
2000,250,France,Cameroon,39229,17796,21433
2000,276,Germany,Cameroon,9001,5985,3016
2000,442,Luxembourg,Cameroon,53,20,33
2000,528,Netherlands,Cameroon,859,435,424
2000,756,Switzerland,Cameroon,4879,2056,2823
2000,124,Canada,Cameroon,2278,1098,1180
2000,840,United States of America,Cameroon,12063,6650,5413
2005,894,Zambia,Cameroon,66,55,11
2005,148,Chad,Cameroon,25156,11412,13744
2005,178,Congo,Cameroon,3570,2357,1213
2005,226,Equatorial Guinea,Cameroon,486,322,164
2005,266,Gabon,Cameroon,28568,14398,14170
2005,516,Namibia,Cameroon,123,101,22
2005,710,South Africa,Cameroon,1365,949,416
2005,288,Ghana,Cameroon,96,63,33
2005,466,Mali,Cameroon,2313,1286,1027
2005,478,Mauritania,Cameroon,388,249,139
2005,562,Niger,Cameroon,404,178,226
2005,566,Nigeria,Cameroon,21738,12658,9080
2005,686,Senegal,Cameroon,852,316,536
2005,768,Togo,Cameroon,476,295,181
2005,818,Egypt,Cameroon,110,92,18
2005,196,Cyprus,Cameroon,38,20,18
2005,214,Dominican Republic,Cameroon,13,7,6
2005,188,Costa Rica,Cameroon,5,2,3
2005,484,Mexico,Cameroon,21,16,5
2005,68,Bolivia (Plurinational State of),Cameroon,6,5,1
2005,76,Brazil,Cameroon,69,40,29
2005,152,Chile,Cameroon,9,5,4
2005,218,Ecuador,Cameroon,22,15,7
2005,36,Australia,Cameroon,130,81,49
2005,100,Bulgaria,Cameroon,6,6,0
2005,203,Czechia,Cameroon,44,35,9
2005,348,Hungary,Cameroon,169,123,46
2005,616,Poland,Cameroon,23,20,3
2005,643,Russian Federation,Cameroon,412,326,86
2005,208,Denmark,Cameroon,348,215,133
2005,246,Finland,Cameroon,286,187,99
2005,352,Iceland,Cameroon,3,3,0
2005,372,Ireland,Cameroon,405,187,218
2005,428,Latvia,Cameroon,1,1,0
2005,578,Norway,Cameroon,368,216,152
2005,752,Sweden,Cameroon,598,440,158
2005,826,United Kingdom,Cameroon,6210,3035,3175
2005,300,Greece,Cameroon,453,234,219
2005,380,Italy,Cameroon,7462,3832,3630
2005,620,Portugal,Cameroon,66,42,24
2005,705,Slovenia,Cameroon,1,1,0
2005,724,Spain,Cameroon,3321,2070,1251
2005,40,Austria,Cameroon,506,319,187
2005,56,Belgium,Cameroon,4545,2289,2256
2005,250,France,Cameroon,63768,27110,36658
2005,276,Germany,Cameroon,12888,7738,5150
2005,442,Luxembourg,Cameroon,45,19,26
2005,528,Netherlands,Cameroon,1776,960,816
2005,756,Switzerland,Cameroon,5473,2133,3340
2005,124,Canada,Cameroon,5392,2807,2585
2005,840,United States of America,Cameroon,20699,11462,9237
2010,894,Zambia,Cameroon,243,129,114
2010,148,Chad,Cameroon,29790,13345,16445
2010,178,Congo,Cameroon,8502,5202,3300
2010,226,Equatorial Guinea,Cameroon,638,425,213
2010,266,Gabon,Cameroon,33089,16991,16098
2010,516,Namibia,Cameroon,118,97,21
2010,710,South Africa,Cameroon,2137,1484,653
2010,288,Ghana,Cameroon,95,63,32
2010,466,Mali,Cameroon,1458,745,713
2010,478,Mauritania,Cameroon,391,254,137
2010,562,Niger,Cameroon,411,180,231
2010,566,Nigeria,Cameroon,22173,12911,9262
2010,686,Senegal,Cameroon,953,379,574
2010,768,Togo,Cameroon,619,396,223
2010,818,Egypt,Cameroon,119,99,20
2010,788,Tunisia,Cameroon,555,286,269
2010,196,Cyprus,Cameroon,62,33,29
2010,214,Dominican Republic,Cameroon,22,11,11
2010,188,Costa Rica,Cameroon,9,4,5
2010,484,Mexico,Cameroon,39,31,8
2010,68,Bolivia (Plurinational State of),Cameroon,10,9,1
2010,76,Brazil,Cameroon,138,80,58
2010,152,Chile,Cameroon,12,7,5
2010,218,Ecuador,Cameroon,31,22,9
2010,36,Australia,Cameroon,270,168,102
2010,100,Bulgaria,Cameroon,8,8,0
2010,203,Czechia,Cameroon,81,65,16
2010,348,Hungary,Cameroon,201,147,54
2010,616,Poland,Cameroon,48,37,11
2010,642,Romania,Cameroon,2,2,0
2010,643,Russian Federation,Cameroon,328,262,66
2010,208,Denmark,Cameroon,548,337,211
2010,233,Estonia,Cameroon,2,2,0
2010,246,Finland,Cameroon,616,404,212
2010,352,Iceland,Cameroon,4,4,0
2010,372,Ireland,Cameroon,339,143,196
2010,428,Latvia,Cameroon,2,2,0
2010,578,Norway,Cameroon,549,312,237
2010,752,Sweden,Cameroon,1366,920,446
2010,826,United Kingdom,Cameroon,6541,3265,3276
2010,300,Greece,Cameroon,491,259,232
2010,380,Italy,Cameroon,11165,5791,5374
2010,620,Portugal,Cameroon,65,45,20
2010,705,Slovenia,Cameroon,7,7,0
2010,724,Spain,Cameroon,5860,3716,2144
2010,40,Austria,Cameroon,559,349,210
2010,56,Belgium,Cameroon,9681,4659,5022
2010,250,France,Cameroon,76324,29265,47059
2010,276,Germany,Cameroon,16097,9220,6877
2010,442,Luxembourg,Cameroon,39,18,21
2010,528,Netherlands,Cameroon,1895,938,957
2010,756,Switzerland,Cameroon,6446,2302,4144
2010,124,Canada,Cameroon,8105,4307,3798
2010,840,United States of America,Cameroon,30195,16536,13659
2015,894,Zambia,Cameroon,214,114,100
2015,148,Chad,Cameroon,30938,14015,16923
2015,178,Congo,Cameroon,11300,6727,4573
2015,226,Equatorial Guinea,Cameroon,798,535,263
2015,266,Gabon,Cameroon,46269,26905,19364
2015,516,Namibia,Cameroon,115,95,20
2015,710,South Africa,Cameroon,3854,2617,1237
2015,288,Ghana,Cameroon,116,77,39
2015,324,Guinea,Cameroon,196,142,54
2015,466,Mali,Cameroon,1806,923,883
2015,478,Mauritania,Cameroon,392,256,136
2015,562,Niger,Cameroon,417,183,234
2015,566,Nigeria,Cameroon,26893,14755,12138
2015,686,Senegal,Cameroon,1014,403,611
2015,768,Togo,Cameroon,697,446,251
2015,818,Egypt,Cameroon,88,76,12
2015,788,Tunisia,Cameroon,715,369,346
2015,196,Cyprus,Cameroon,59,32,27
2015,214,Dominican Republic,Cameroon,23,12,11
2015,188,Costa Rica,Cameroon,9,4,5
2015,484,Mexico,Cameroon,41,33,8
2015,68,Bolivia (Plurinational State of),Cameroon,12,11,1
2015,76,Brazil,Cameroon,166,96,70
2015,152,Chile,Cameroon,18,11,7
2015,218,Ecuador,Cameroon,45,32,13
2015,36,Australia,Cameroon,450,268,182
2015,100,Bulgaria,Cameroon,14,12,2
2015,203,Czechia,Cameroon,99,83,16
2015,348,Hungary,Cameroon,266,205,61
2015,616,Poland,Cameroon,36,31,5
2015,642,Romania,Cameroon,36,25,11
2015,643,Russian Federation,Cameroon,334,266,68
2015,208,Denmark,Cameroon,741,464,277
2015,233,Estonia,Cameroon,16,13,3
2015,246,Finland,Cameroon,980,599,381
2015,352,Iceland,Cameroon,7,5,2
2015,372,Ireland,Cameroon,346,143,203
2015,428,Latvia,Cameroon,1,1,0
2015,578,Norway,Cameroon,684,370,314
2015,752,Sweden,Cameroon,1360,810,550
2015,826,United Kingdom,Cameroon,8364,4051,4313
2015,300,Greece,Cameroon,460,233,227
2015,380,Italy,Cameroon,11327,5749,5578
2015,620,Portugal,Cameroon,73,48,25
2015,705,Slovenia,Cameroon,17,16,1
2015,724,Spain,Cameroon,5178,3127,2051
2015,40,Austria,Cameroon,654,410,244
2015,56,Belgium,Cameroon,16056,7683,8373
2015,250,France,Cameroon,84550,30982,53568
2015,276,Germany,Cameroon,16772,9590,7182
2015,442,Luxembourg,Cameroon,59,28,31
2015,528,Netherlands,Cameroon,1923,927,996
2015,756,Switzerland,Cameroon,7356,2609,4747
2015,124,Canada,Cameroon,18456,9229,9227
2015,840,United States of America,Cameroon,49251,26858,22393
2019,894,Zambia,Cameroon,275,147,128
2019,148,Chad,Cameroon,33936,15359,18577
2019,178,Congo,Cameroon,11647,6931,4716
2019,226,Equatorial Guinea,Cameroon,877,588,289
2019,266,Gabon,Cameroon,50273,29215,21058
2019,516,Namibia,Cameroon,121,100,21
2019,710,South Africa,Cameroon,4319,2935,1384
2019,288,Ghana,Cameroon,130,87,43
2019,324,Guinea,Cameroon,187,136,51
2019,466,Mali,Cameroon,2010,1027,983
2019,478,Mauritania,Cameroon,407,266,141
2019,562,Niger,Cameroon,450,197,253
2019,566,Nigeria,Cameroon,28177,15460,12717
2019,686,Senegal,Cameroon,1052,419,633
2019,768,Togo,Cameroon,701,450,251
2019,818,Egypt,Cameroon,125,106,19
2019,788,Tunisia,Cameroon,726,375,351
2019,196,Cyprus,Cameroon,58,32,26
2019,214,Dominican Republic,Cameroon,23,12,11
2019,188,Costa Rica,Cameroon,9,4,5
2019,484,Mexico,Cameroon,42,34,8
2019,68,Bolivia (Plurinational State of),Cameroon,13,12,1
2019,76,Brazil,Cameroon,186,108,78
2019,152,Chile,Cameroon,24,15,9
2019,218,Ecuador,Cameroon,44,32,12
2019,36,Australia,Cameroon,539,325,214
2019,100,Bulgaria,Cameroon,21,17,4
2019,203,Czechia,Cameroon,107,91,16
2019,348,Hungary,Cameroon,329,243,86
2019,616,Poland,Cameroon,38,33,5
2019,642,Romania,Cameroon,126,85,41
2019,643,Russian Federation,Cameroon,333,266,67
2019,208,Denmark,Cameroon,868,498,370
2019,233,Estonia,Cameroon,38,29,9
2019,246,Finland,Cameroon,1279,765,514
2019,352,Iceland,Cameroon,10,7,3
2019,372,Ireland,Cameroon,379,157,222
2019,428,Latvia,Cameroon,1,1,0
2019,578,Norway,Cameroon,800,431,369
2019,752,Sweden,Cameroon,1670,926,744
2019,826,United Kingdom,Cameroon,9498,4613,4885
2019,300,Greece,Cameroon,441,216,225
2019,380,Italy,Cameroon,13510,6999,6511
2019,620,Portugal,Cameroon,74,49,25
2019,705,Slovenia,Cameroon,15,13,2
2019,724,Spain,Cameroon,5365,3190,2175
2019,40,Austria,Cameroon,772,489,283
2019,56,Belgium,Cameroon,19201,9144,10057
2019,250,France,Cameroon,89496,32665,56831
2019,276,Germany,Cameroon,18398,10729,7669
2019,442,Luxembourg,Cameroon,1037,478,559
2019,528,Netherlands,Cameroon,1994,954,1040
2019,756,Switzerland,Cameroon,7989,2869,5120
2019,124,Canada,Cameroon,19777,9890,9887
2019,840,United States of America,Cameroon,53185,28743,24442
1990,480,Mauritius,Canada,36,13,23
1990,800,Uganda,Canada,98,69,29
1990,834,United Republic of Tanzania,Canada,184,109,75
1990,894,Zambia,Canada,227,107,120
1990,140,Central African Republic,Canada,19,9,10
1990,266,Gabon,Canada,90,49,41
1990,72,Botswana,Canada,112,57,55
1990,748,Eswatini,Canada,4,3,1
1990,516,Namibia,Canada,279,123,156
1990,710,South Africa,Canada,2877,1191,1686
1990,288,Ghana,Canada,147,61,86
1990,324,Guinea,Canada,297,158,139
1990,624,Guinea-Bissau,Canada,37,15,22
1990,430,Liberia,Canada,247,130,117
1990,478,Mauritania,Canada,46,26,20
1990,694,Sierra Leone,Canada,38,16,22
1990,768,Togo,Canada,18,12,6
1990,818,Egypt,Canada,331,198,133
1990,434,Libya,Canada,946,570,376
1990,196,Cyprus,Canada,374,185,189
1990,376,Israel,Canada,4777,2207,2570
1990,400,Jordan,Canada,241,123,118
1990,792,Turkey,Canada,345,176,169
1990,762,Tajikistan,Canada,77,35,42
1990,64,Bhutan,Canada,17,8,9
1990,356,India,Canada,6474,3011,3463
1990,462,Maldives,Canada,12,7,5
1990,144,Sri Lanka,Canada,2,1,1
1990,156,China,Canada,3756,2219,1537
1990,344,"China, Hong Kong SAR",Canada,8414,4674,3740
1990,408,Dem. People's Republic of Korea,Canada,149,82,67
1990,392,Japan,Canada,4910,2501,2409
1990,496,Mongolia,Canada,26,14,12
1990,410,Republic of Korea,Canada,513,278,235
1990,116,Cambodia,Canada,20,10,10
1990,360,Indonesia,Canada,286,151,135
1990,608,Philippines,Canada,628,326,302
1990,702,Singapore,Canada,717,396,321
1990,764,Thailand,Canada,917,566,351
1990,704,Viet Nam,Canada,26,14,12
1990,660,Anguilla,Canada,28,8,20
1990,28,Antigua and Barbuda,Canada,218,105,113
1990,44,Bahamas,Canada,730,286,444
1990,52,Barbados,Canada,668,280,388
1990,92,British Virgin Islands,Canada,120,51,69
1990,535,"Bonaire, Sint Eustatius and Saba",Canada,52,31,21
1990,136,Cayman Islands,Canada,422,217,205
1990,192,Cuba,Canada,135,77,58
1990,212,Dominica,Canada,67,34,33
1990,214,Dominican Republic,Canada,3562,1794,1768
1990,308,Grenada,Canada,85,42,43
1990,312,Guadeloupe,Canada,197,95,102
1990,332,Haiti,Canada,628,307,321
1990,388,Jamaica,Canada,1140,553,587
1990,500,Montserrat,Canada,56,27,29
1990,630,Puerto Rico,Canada,231,109,122
1990,662,Saint Lucia,Canada,107,51,56
1990,670,Saint Vincent and the Grenadines,Canada,143,70,73
1990,780,Trinidad and Tobago,Canada,963,460,503
1990,796,Turks and Caicos Islands,Canada,162,84,78
1990,84,Belize,Canada,542,269,273
1990,188,Costa Rica,Canada,810,463,347
1990,222,El Salvador,Canada,508,243,265
1990,320,Guatemala,Canada,272,66,206
1990,340,Honduras,Canada,264,150,114
1990,484,Mexico,Canada,3100,1428,1672
1990,558,Nicaragua,Canada,185,95,90
1990,591,Panama,Canada,140,73,67
1990,32,Argentina,Canada,796,360,436
1990,68,Bolivia (Plurinational State of),Canada,1765,872,893
1990,76,Brazil,Canada,970,612,358
1990,152,Chile,Canada,1051,555,496
1990,170,Colombia,Canada,682,348,334
1990,218,Ecuador,Canada,806,394,412
1990,328,Guyana,Canada,92,47,45
1990,600,Paraguay,Canada,1418,689,729
1990,604,Peru,Canada,762,388,374
1990,858,Uruguay,Canada,427,180,247
1990,862,Venezuela (Bolivarian Republic of),Canada,981,517,464
1990,36,Australia,Canada,27452,13475,13977
1990,554,New Zealand,Canada,6566,3114,3452
1990,598,Papua New Guinea,Canada,358,212,146
1990,258,French Polynesia,Canada,114,79,35
1990,882,Samoa,Canada,16,8,8
1990,112,Belarus,Canada,85,44,41
1990,100,Bulgaria,Canada,17,11,6
1990,203,Czechia,Canada,121,68,53
1990,348,Hungary,Canada,226,100,126
1990,616,Poland,Canada,2207,1174,1033
1990,642,Romania,Canada,28,15,13
1990,643,Russian Federation,Canada,394,193,201
1990,703,Slovakia,Canada,40,18,22
1990,208,Denmark,Canada,2175,1043,1132
1990,233,Estonia,Canada,29,16,13
1990,234,Faroe Islands,Canada,3,2,1
1990,246,Finland,Canada,960,449,511
1990,352,Iceland,Canada,145,65,80
1990,372,Ireland,Canada,371,182,189
1990,833,Isle of Man,Canada,104,46,58
1990,428,Latvia,Canada,42,23,19
1990,440,Lithuania,Canada,66,34,32
1990,578,Norway,Canada,2126,970,1156
1990,752,Sweden,Canada,1791,935,856
1990,826,United Kingdom,Canada,63555,29013,34542
1990,8,Albania,Canada,1151,908,243
1990,191,Croatia,Canada,473,170,303
1990,300,Greece,Canada,14677,7381,7296
1990,380,Italy,Canada,10188,3421,6767
1990,470,Malta,Canada,1385,671,714
1990,620,Portugal,Canada,4262,2048,2214
1990,688,Serbia,Canada,1,1,0
1990,705,Slovenia,Canada,274,125,149
1990,724,Spain,Canada,2236,1023,1213
1990,40,Austria,Canada,1402,681,721
1990,56,Belgium,Canada,2638,1340,1298
1990,250,France,Canada,16520,7738,8782
1990,276,Germany,Canada,9241,4699,4542
1990,442,Luxembourg,Canada,229,109,120
1990,528,Netherlands,Canada,6485,3220,3265
1990,756,Switzerland,Canada,6669,2983,3686
1990,60,Bermuda,Canada,2295,984,1311
1990,304,Greenland,Canada,12,4,8
1990,666,Saint Pierre and Miquelon,Canada,205,51,154
1990,840,United States of America,Canada,744830,245893,498937
1995,480,Mauritius,Canada,27,12,15
1995,800,Uganda,Canada,92,64,28
1995,834,United Republic of Tanzania,Canada,234,139,95
1995,894,Zambia,Canada,188,89,99
1995,140,Central African Republic,Canada,157,79,78
1995,266,Gabon,Canada,121,67,54
1995,72,Botswana,Canada,104,52,52
1995,748,Eswatini,Canada,4,3,1
1995,516,Namibia,Canada,266,118,148
1995,710,South Africa,Canada,2292,1092,1200
1995,288,Ghana,Canada,147,69,78
1995,324,Guinea,Canada,342,200,142
1995,624,Guinea-Bissau,Canada,48,20,28
1995,430,Liberia,Canada,241,125,116
1995,478,Mauritania,Canada,49,30,19
1995,694,Sierra Leone,Canada,37,15,22
1995,768,Togo,Canada,20,14,6
1995,818,Egypt,Canada,382,212,170
1995,434,Libya,Canada,1509,908,601
1995,196,Cyprus,Canada,529,251,278
1995,376,Israel,Canada,5666,2600,3066
1995,400,Jordan,Canada,319,166,153
1995,792,Turkey,Canada,835,409,426
1995,762,Tajikistan,Canada,62,32,30
1995,64,Bhutan,Canada,20,10,10
1995,356,India,Canada,4242,2005,2237
1995,462,Maldives,Canada,46,21,25
1995,144,Sri Lanka,Canada,31,25,6
1995,156,China,Canada,4985,2937,2048
1995,344,"China, Hong Kong SAR",Canada,11844,6591,5253
1995,408,Dem. People's Republic of Korea,Canada,179,98,81
1995,392,Japan,Canada,7325,3516,3809
1995,496,Mongolia,Canada,28,17,11
1995,410,Republic of Korea,Canada,1818,1056,762
1995,116,Cambodia,Canada,53,26,27
1995,360,Indonesia,Canada,189,102,87
1995,608,Philippines,Canada,845,431,414
1995,702,Singapore,Canada,816,448,368
1995,764,Thailand,Canada,826,522,304
1995,704,Viet Nam,Canada,77,45,32
1995,660,Anguilla,Canada,36,10,26
1995,28,Antigua and Barbuda,Canada,287,138,149
1995,44,Bahamas,Canada,1040,481,559
1995,52,Barbados,Canada,729,313,416
1995,92,British Virgin Islands,Canada,142,59,83
1995,535,"Bonaire, Sint Eustatius and Saba",Canada,108,64,44
1995,136,Cayman Islands,Canada,806,417,389
1995,192,Cuba,Canada,102,56,46
1995,212,Dominica,Canada,88,44,44
1995,214,Dominican Republic,Canada,3957,1945,2012
1995,308,Grenada,Canada,145,89,56
1995,312,Guadeloupe,Canada,263,124,139
1995,332,Haiti,Canada,596,292,304
1995,388,Jamaica,Canada,1277,644,633
1995,500,Montserrat,Canada,44,21,23
1995,630,Puerto Rico,Canada,244,116,128
1995,662,Saint Lucia,Canada,143,68,75
1995,670,Saint Vincent and the Grenadines,Canada,148,73,75
1995,780,Trinidad and Tobago,Canada,874,417,457
1995,796,Turks and Caicos Islands,Canada,284,148,136
1995,84,Belize,Canada,515,254,261
1995,188,Costa Rica,Canada,754,435,319
1995,222,El Salvador,Canada,379,184,195
1995,320,Guatemala,Canada,262,98,164
1995,340,Honduras,Canada,262,145,117
1995,484,Mexico,Canada,5063,2473,2590
1995,558,Nicaragua,Canada,147,75,72
1995,591,Panama,Canada,280,149,131
1995,32,Argentina,Canada,953,452,501
1995,68,Bolivia (Plurinational State of),Canada,1728,860,868
1995,76,Brazil,Canada,1113,671,442
1995,152,Chile,Canada,1430,761,669
1995,170,Colombia,Canada,731,380,351
1995,218,Ecuador,Canada,889,432,457
1995,328,Guyana,Canada,147,76,71
1995,600,Paraguay,Canada,1999,1179,820
1995,604,Peru,Canada,764,384,380
1995,858,Uruguay,Canada,389,147,242
1995,862,Venezuela (Bolivarian Republic of),Canada,977,522,455
1995,36,Australia,Canada,27916,13639,14277
1995,554,New Zealand,Canada,7238,3365,3873
1995,598,Papua New Guinea,Canada,366,231,135
1995,258,French Polynesia,Canada,125,86,39
1995,882,Samoa,Canada,15,8,7
1995,112,Belarus,Canada,123,52,71
1995,100,Bulgaria,Canada,64,37,27
1995,203,Czechia,Canada,181,104,77
1995,348,Hungary,Canada,824,413,411
1995,616,Poland,Canada,1887,990,897
1995,642,Romania,Canada,82,45,37
1995,643,Russian Federation,Canada,396,202,194
1995,703,Slovakia,Canada,144,71,73
1995,208,Denmark,Canada,2519,1238,1281
1995,233,Estonia,Canada,45,24,21
1995,234,Faroe Islands,Canada,6,4,2
1995,246,Finland,Canada,977,485,492
1995,352,Iceland,Canada,170,78,92
1995,372,Ireland,Canada,1313,623,690
1995,833,Isle of Man,Canada,119,53,66
1995,428,Latvia,Canada,64,35,29
1995,440,Lithuania,Canada,74,38,36
1995,578,Norway,Canada,2121,963,1158
1995,752,Sweden,Canada,2126,1102,1024
1995,826,United Kingdom,Canada,66277,29978,36299
1995,8,Albania,Canada,1244,982,262
1995,191,Croatia,Canada,468,189,279
1995,300,Greece,Canada,13411,6464,6947
1995,380,Italy,Canada,8234,2869,5365
1995,470,Malta,Canada,1622,798,824
1995,620,Portugal,Canada,5657,2692,2965
1995,688,Serbia,Canada,19,11,8
1995,705,Slovenia,Canada,246,113,133
1995,724,Spain,Canada,2642,1224,1418
1995,40,Austria,Canada,1582,782,800
1995,56,Belgium,Canada,3302,1639,1663
1995,250,France,Canada,17054,7835,9219
1995,276,Germany,Canada,10444,5113,5331
1995,442,Luxembourg,Canada,217,103,114
1995,528,Netherlands,Canada,7185,3500,3685
1995,756,Switzerland,Canada,7502,3563,3939
1995,60,Bermuda,Canada,2437,1148,1289
1995,304,Greenland,Canada,10,4,6
1995,666,Saint Pierre and Miquelon,Canada,215,65,150
1995,840,United States of America,Canada,793278,263738,529540
2000,480,Mauritius,Canada,34,15,19
2000,800,Uganda,Canada,243,139,104
2000,834,United Republic of Tanzania,Canada,247,142,105
2000,894,Zambia,Canada,157,75,82
2000,140,Central African Republic,Canada,281,142,139
2000,266,Gabon,Canada,151,83,68
2000,72,Botswana,Canada,106,52,54
2000,748,Eswatini,Canada,12,6,6
2000,516,Namibia,Canada,248,110,138
2000,710,South Africa,Canada,2392,1270,1122
2000,288,Ghana,Canada,164,69,95
2000,324,Guinea,Canada,239,140,99
2000,624,Guinea-Bissau,Canada,58,25,33
2000,430,Liberia,Canada,238,120,118
2000,478,Mauritania,Canada,50,33,17
2000,694,Sierra Leone,Canada,36,14,22
2000,768,Togo,Canada,23,17,6
2000,818,Egypt,Canada,464,243,221
2000,434,Libya,Canada,2098,1276,822
2000,196,Cyprus,Canada,684,317,367
2000,376,Israel,Canada,6238,2881,3357
2000,400,Jordan,Canada,396,210,186
2000,792,Turkey,Canada,1329,642,687
2000,762,Tajikistan,Canada,54,29,25
2000,64,Bhutan,Canada,23,11,12
2000,356,India,Canada,2009,999,1010
2000,462,Maldives,Canada,78,39,39
2000,144,Sri Lanka,Canada,61,43,18
2000,156,China,Canada,6215,3656,2559
2000,344,"China, Hong Kong SAR",Canada,15273,8508,6765
2000,408,Dem. People's Republic of Korea,Canada,209,114,95
2000,392,Japan,Canada,10089,4661,5428
2000,496,Mongolia,Canada,32,20,12
2000,410,Republic of Korea,Canada,3703,2219,1484
2000,116,Cambodia,Canada,85,42,43
2000,360,Indonesia,Canada,92,53,39
2000,608,Philippines,Canada,1872,1054,818
2000,702,Singapore,Canada,996,538,458
2000,764,Thailand,Canada,907,579,328
2000,704,Viet Nam,Canada,201,126,75
2000,660,Anguilla,Canada,44,12,32
2000,28,Antigua and Barbuda,Canada,356,172,184
2000,44,Bahamas,Canada,1351,677,674
2000,52,Barbados,Canada,791,346,445
2000,92,British Virgin Islands,Canada,163,66,97
2000,535,"Bonaire, Sint Eustatius and Saba",Canada,164,97,67
2000,136,Cayman Islands,Canada,1393,722,671
2000,192,Cuba,Canada,69,35,34
2000,212,Dominica,Canada,105,53,52
2000,214,Dominican Republic,Canada,4351,2096,2255
2000,308,Grenada,Canada,205,136,69
2000,312,Guadeloupe,Canada,329,153,176
2000,332,Haiti,Canada,566,278,288
2000,388,Jamaica,Canada,1414,735,679
2000,500,Montserrat,Canada,33,16,17
2000,630,Puerto Rico,Canada,259,124,135
2000,662,Saint Lucia,Canada,197,95,102
2000,670,Saint Vincent and the Grenadines,Canada,154,77,77
2000,780,Trinidad and Tobago,Canada,947,457,490
2000,796,Turks and Caicos Islands,Canada,406,211,195
2000,84,Belize,Canada,487,239,248
2000,188,Costa Rica,Canada,1074,611,463
2000,222,El Salvador,Canada,249,125,124
2000,320,Guatemala,Canada,251,129,122
2000,340,Honduras,Canada,259,140,119
2000,484,Mexico,Canada,7245,3640,3605
2000,558,Nicaragua,Canada,180,92,88
2000,591,Panama,Canada,438,232,206
2000,32,Argentina,Canada,1110,545,565
2000,68,Bolivia (Plurinational State of),Canada,1672,838,834
2000,76,Brazil,Canada,1256,730,526
2000,152,Chile,Canada,1809,958,851
2000,170,Colombia,Canada,780,413,367
2000,218,Ecuador,Canada,971,470,501
2000,328,Guyana,Canada,202,105,97
2000,600,Paraguay,Canada,2575,1661,914
2000,604,Peru,Canada,893,451,442
2000,858,Uruguay,Canada,355,117,238
2000,862,Venezuela (Bolivarian Republic of),Canada,964,520,444
2000,36,Australia,Canada,30240,14645,15595
2000,554,New Zealand,Canada,7563,3676,3887
2000,598,Papua New Guinea,Canada,274,190,84
2000,258,French Polynesia,Canada,134,91,43
2000,882,Samoa,Canada,14,7,7
2000,112,Belarus,Canada,160,60,100
2000,100,Bulgaria,Canada,111,63,48
2000,203,Czechia,Canada,241,140,101
2000,348,Hungary,Canada,1422,726,696
2000,616,Poland,Canada,1614,835,779
2000,642,Romania,Canada,138,76,62
2000,643,Russian Federation,Canada,385,205,180
2000,703,Slovakia,Canada,288,142,146
2000,208,Denmark,Canada,2862,1432,1430
2000,233,Estonia,Canada,60,32,28
2000,234,Faroe Islands,Canada,5,4,1
2000,246,Finland,Canada,993,521,472
2000,352,Iceland,Canada,195,91,104
2000,372,Ireland,Canada,2976,1460,1516
2000,833,Isle of Man,Canada,133,59,74
2000,428,Latvia,Canada,87,47,40
2000,440,Lithuania,Canada,57,29,28
2000,578,Norway,Canada,2242,1010,1232
2000,752,Sweden,Canada,2280,1174,1106
2000,826,United Kingdom,Canada,70115,31355,38760
2000,8,Albania,Canada,1337,1057,280
2000,191,Croatia,Canada,413,191,222
2000,300,Greece,Canada,12366,5528,6838
2000,380,Italy,Canada,6280,2318,3962
2000,470,Malta,Canada,1603,773,830
2000,620,Portugal,Canada,7283,3458,3825
2000,688,Serbia,Canada,259,139,120
2000,705,Slovenia,Canada,345,158,187
2000,724,Spain,Canada,4185,1989,2196
2000,40,Austria,Canada,1761,882,879
2000,56,Belgium,Canada,3871,1897,1974
2000,250,France,Canada,17588,7933,9655
2000,276,Germany,Canada,11647,5527,6120
2000,442,Luxembourg,Canada,208,98,110
2000,528,Netherlands,Canada,8136,3893,4243
2000,756,Switzerland,Canada,8364,4169,4195
2000,60,Bermuda,Canada,2579,1313,1266
2000,304,Greenland,Canada,11,8,3
2000,666,Saint Pierre and Miquelon,Canada,208,69,139
2000,840,United States of America,Canada,841612,282210,559402
2005,480,Mauritius,Canada,32,16,16
2005,800,Uganda,Canada,235,133,102
2005,834,United Republic of Tanzania,Canada,275,165,110
2005,894,Zambia,Canada,177,85,92
2005,120,Cameroon,Canada,179,91,88
2005,140,Central African Republic,Canada,215,109,106
2005,266,Gabon,Canada,164,90,74
2005,72,Botswana,Canada,210,102,108
2005,748,Eswatini,Canada,15,7,8
2005,516,Namibia,Canada,196,87,109
2005,710,South Africa,Canada,3147,1604,1543
2005,288,Ghana,Canada,231,105,126
2005,324,Guinea,Canada,167,110,57
2005,624,Guinea-Bissau,Canada,56,24,32
2005,430,Liberia,Canada,107,69,38
2005,478,Mauritania,Canada,50,34,16
2005,694,Sierra Leone,Canada,21,7,14
2005,768,Togo,Canada,26,20,6
2005,818,Egypt,Canada,552,305,247
2005,434,Libya,Canada,2311,1567,744
2005,196,Cyprus,Canada,1002,461,541
2005,376,Israel,Canada,7019,3277,3742
2005,400,Jordan,Canada,572,336,236
2005,792,Turkey,Canada,1369,646,723
2005,762,Tajikistan,Canada,51,27,24
2005,64,Bhutan,Canada,29,14,15
2005,356,India,Canada,1856,920,936
2005,462,Maldives,Canada,66,36,30
2005,144,Sri Lanka,Canada,122,63,59
2005,156,China,Canada,6856,4330,2526
2005,344,"China, Hong Kong SAR",Canada,14797,8188,6609
2005,408,Dem. People's Republic of Korea,Canada,255,141,114
2005,392,Japan,Canada,9427,4294,5133
2005,496,Mongolia,Canada,74,56,18
2005,410,Republic of Korea,Canada,7358,5628,1730
2005,116,Cambodia,Canada,66,33,33
2005,360,Indonesia,Canada,983,531,452
2005,608,Philippines,Canada,1515,864,651
2005,702,Singapore,Canada,2339,1223,1116
2005,764,Thailand,Canada,773,487,286
2005,704,Viet Nam,Canada,544,347,197
2005,660,Anguilla,Canada,50,14,36
2005,28,Antigua and Barbuda,Canada,382,184,198
2005,44,Bahamas,Canada,1399,735,664
2005,52,Barbados,Canada,721,316,405
2005,92,British Virgin Islands,Canada,187,76,111
2005,535,"Bonaire, Sint Eustatius and Saba",Canada,174,103,71
2005,136,Cayman Islands,Canada,1304,648,656
2005,192,Cuba,Canada,46,24,22
2005,212,Dominica,Canada,129,65,64
2005,214,Dominican Republic,Canada,2761,1376,1385
2005,308,Grenada,Canada,215,143,72
2005,312,Guadeloupe,Canada,404,186,218
2005,332,Haiti,Canada,537,264,273
2005,388,Jamaica,Canada,1378,720,658
2005,500,Montserrat,Canada,34,17,17
2005,630,Puerto Rico,Canada,202,96,106
2005,662,Saint Lucia,Canada,247,119,128
2005,670,Saint Vincent and the Grenadines,Canada,158,81,77
2005,534,Sint Maarten (Dutch part),Canada,18,9,9
2005,780,Trinidad and Tobago,Canada,1016,489,527
2005,796,Turks and Caicos Islands,Canada,427,215,212
2005,84,Belize,Canada,596,291,305
2005,188,Costa Rica,Canada,704,397,307
2005,222,El Salvador,Canada,242,125,117
2005,320,Guatemala,Canada,298,176,122
2005,340,Honduras,Canada,254,139,115
2005,484,Mexico,Canada,8248,4200,4048
2005,558,Nicaragua,Canada,219,112,107
2005,591,Panama,Canada,966,550,416
2005,32,Argentina,Canada,819,408,411
2005,68,Bolivia (Plurinational State of),Canada,1430,699,731
2005,76,Brazil,Canada,1425,900,525
2005,152,Chile,Canada,2715,1459,1256
2005,170,Colombia,Canada,782,420,362
2005,218,Ecuador,Canada,1146,567,579
2005,328,Guyana,Canada,272,142,130
2005,600,Paraguay,Canada,2453,1583,870
2005,604,Peru,Canada,1049,533,516
2005,858,Uruguay,Canada,328,109,219
2005,862,Venezuela (Bolivarian Republic of),Canada,1016,542,474
2005,36,Australia,Canada,36250,17429,18821
2005,554,New Zealand,Canada,8601,4175,4426
2005,598,Papua New Guinea,Canada,274,193,81
2005,258,French Polynesia,Canada,140,96,44
2005,882,Samoa,Canada,12,6,6
2005,112,Belarus,Canada,154,58,96
2005,100,Bulgaria,Canada,175,100,75
2005,203,Czechia,Canada,409,238,171
2005,348,Hungary,Canada,1756,912,844
2005,616,Poland,Canada,2301,1218,1083
2005,642,Romania,Canada,100,56,44
2005,643,Russian Federation,Canada,470,260,210
2005,703,Slovakia,Canada,324,162,162
2005,208,Denmark,Canada,3206,1588,1618
2005,233,Estonia,Canada,87,51,36
2005,234,Faroe Islands,Canada,8,4,4
2005,246,Finland,Canada,1257,675,582
2005,352,Iceland,Canada,216,107,109
2005,372,Ireland,Canada,4461,2143,2318
2005,833,Isle of Man,Canada,167,70,97
2005,428,Latvia,Canada,119,68,51
2005,440,Lithuania,Canada,49,27,22
2005,578,Norway,Canada,2352,1079,1273
2005,752,Sweden,Canada,2551,1314,1237
2005,826,United Kingdom,Canada,70642,30926,39716
2005,8,Albania,Canada,1128,910,218
2005,191,Croatia,Canada,706,334,372
2005,300,Greece,Canada,12627,5573,7054
2005,380,Italy,Canada,15908,6952,8956
2005,470,Malta,Canada,1519,723,796
2005,620,Portugal,Canada,7470,3550,3920
2005,688,Serbia,Canada,641,340,301
2005,705,Slovenia,Canada,379,182,197
2005,724,Spain,Canada,4961,2298,2663
2005,40,Austria,Canada,1969,962,1007
2005,56,Belgium,Canada,4374,2007,2367
2005,250,France,Canada,22661,10409,12252
2005,276,Germany,Canada,14007,6876,7131
2005,442,Luxembourg,Canada,180,91,89
2005,528,Netherlands,Canada,8841,4140,4701
2005,756,Switzerland,Canada,9354,4420,4934
2005,60,Bermuda,Canada,2426,1273,1153
2005,304,Greenland,Canada,23,16,7
2005,666,Saint Pierre and Miquelon,Canada,212,80,132
2005,840,United States of America,Canada,842344,285549,556795
2010,480,Mauritius,Canada,32,17,15
2010,800,Uganda,Canada,237,134,103
2010,834,United Republic of Tanzania,Canada,282,169,113
2010,894,Zambia,Canada,200,94,106
2010,120,Cameroon,Canada,143,76,67
2010,140,Central African Republic,Canada,213,108,105
2010,266,Gabon,Canada,190,106,84
2010,72,Botswana,Canada,160,50,110
2010,748,Eswatini,Canada,19,9,10
2010,516,Namibia,Canada,188,84,104
2010,710,South Africa,Canada,4929,2504,2425
2010,288,Ghana,Canada,230,109,121
2010,324,Guinea,Canada,116,76,40
2010,624,Guinea-Bissau,Canada,54,23,31
2010,430,Liberia,Canada,49,22,27
2010,478,Mauritania,Canada,50,35,15
2010,694,Sierra Leone,Canada,19,10,9
2010,768,Togo,Canada,42,27,15
2010,818,Egypt,Canada,596,319,277
2010,434,Libya,Canada,2528,1723,805
2010,196,Cyprus,Canada,1640,766,874
2010,376,Israel,Canada,7885,3706,4179
2010,400,Jordan,Canada,735,449,286
2010,792,Turkey,Canada,1410,649,761
2010,762,Tajikistan,Canada,50,27,23
2010,64,Bhutan,Canada,35,17,18
2010,356,India,Canada,1703,842,861
2010,462,Maldives,Canada,80,59,21
2010,144,Sri Lanka,Canada,247,130,117
2010,156,China,Canada,7498,5005,2493
2010,344,"China, Hong Kong SAR",Canada,14357,7888,6469
2010,408,Dem. People's Republic of Korea,Canada,301,169,132
2010,392,Japan,Canada,9995,4495,5500
2010,496,Mongolia,Canada,125,99,26
2010,410,Republic of Korea,Canada,13922,11156,2766
2010,116,Cambodia,Canada,47,24,23
2010,360,Indonesia,Canada,1938,994,944
2010,608,Philippines,Canada,5480,3027,2453
2010,702,Singapore,Canada,3814,1976,1838
2010,764,Thailand,Canada,695,435,260
2010,704,Viet Nam,Canada,1205,743,462
2010,660,Anguilla,Canada,54,15,39
2010,28,Antigua and Barbuda,Canada,408,197,211
2010,44,Bahamas,Canada,1446,793,653
2010,52,Barbados,Canada,656,289,367
2010,92,British Virgin Islands,Canada,210,95,115
2010,535,"Bonaire, Sint Eustatius and Saba",Canada,77,53,24
2010,136,Cayman Islands,Canada,1332,632,700
2010,192,Cuba,Canada,25,13,12
2010,531,Curaçao,Canada,83,54,29
2010,212,Dominica,Canada,158,81,77
2010,214,Dominican Republic,Canada,1152,647,505
2010,308,Grenada,Canada,225,150,75
2010,312,Guadeloupe,Canada,478,218,260
2010,332,Haiti,Canada,563,277,286
2010,388,Jamaica,Canada,1342,706,636
2010,500,Montserrat,Canada,35,17,18
2010,630,Puerto Rico,Canada,121,56,65
2010,662,Saint Lucia,Canada,269,125,144
2010,670,Saint Vincent and the Grenadines,Canada,166,88,78
2010,534,Sint Maarten (Dutch part),Canada,37,18,19
2010,780,Trinidad and Tobago,Canada,1716,875,841
2010,796,Turks and Caicos Islands,Canada,448,238,210
2010,84,Belize,Canada,685,335,350
2010,188,Costa Rica,Canada,1387,784,603
2010,222,El Salvador,Canada,235,126,109
2010,320,Guatemala,Canada,345,224,121
2010,340,Honduras,Canada,249,138,111
2010,484,Mexico,Canada,10208,5254,4954
2010,558,Nicaragua,Canada,234,121,113
2010,591,Panama,Canada,1540,900,640
2010,32,Argentina,Canada,528,272,256
2010,68,Bolivia (Plurinational State of),Canada,1185,559,626
2010,76,Brazil,Canada,1573,1056,517
2010,152,Chile,Canada,3621,1959,1662
2010,170,Colombia,Canada,919,505,414
2010,218,Ecuador,Canada,1610,777,833
2010,328,Guyana,Canada,341,179,162
2010,600,Paraguay,Canada,2337,1507,830
2010,604,Peru,Canada,2063,1376,687
2010,858,Uruguay,Canada,304,100,204
2010,862,Venezuela (Bolivarian Republic of),Canada,1083,573,510
2010,36,Australia,Canada,44530,21032,23498
2010,554,New Zealand,Canada,9350,4531,4819
2010,598,Papua New Guinea,Canada,232,166,66
2010,258,French Polynesia,Canada,135,94,41
2010,882,Samoa,Canada,11,5,6
2010,112,Belarus,Canada,148,56,92
2010,100,Bulgaria,Canada,232,134,98
2010,203,Czechia,Canada,539,322,217
2010,348,Hungary,Canada,2090,1098,992
2010,616,Poland,Canada,3061,1631,1430
2010,642,Romania,Canada,78,45,33
2010,643,Russian Federation,Canada,547,310,237
2010,703,Slovakia,Canada,363,184,179
2010,208,Denmark,Canada,3486,1713,1773
2010,233,Estonia,Canada,114,71,43
2010,234,Faroe Islands,Canada,14,7,7
2010,246,Finland,Canada,1878,952,926
2010,352,Iceland,Canada,235,121,114
2010,372,Ireland,Canada,5211,2178,3033
2010,833,Isle of Man,Canada,198,79,119
2010,428,Latvia,Canada,148,85,63
2010,440,Lithuania,Canada,36,20,16
2010,578,Norway,Canada,2800,1317,1483
2010,752,Sweden,Canada,3100,1563,1537
2010,826,United Kingdom,Canada,74418,33438,40980
2010,8,Albania,Canada,920,742,178
2010,191,Croatia,Canada,998,476,522
2010,300,Greece,Canada,13408,5848,7560
2010,380,Italy,Canada,25581,11479,14102
2010,470,Malta,Canada,1493,753,740
2010,499,Montenegro,Canada,66,9,57
2010,620,Portugal,Canada,6417,3060,3357
2010,688,Serbia,Canada,627,332,295
2010,705,Slovenia,Canada,392,188,204
2010,724,Spain,Canada,5698,2628,3070
2010,40,Austria,Canada,2177,1043,1134
2010,56,Belgium,Canada,4795,2161,2634
2010,250,France,Canada,24169,10604,13565
2010,276,Germany,Canada,15934,7984,7950
2010,442,Luxembourg,Canada,155,84,71
2010,528,Netherlands,Canada,9180,4304,4876
2010,756,Switzerland,Canada,11051,4894,6157
2010,60,Bermuda,Canada,2272,1232,1040
2010,304,Greenland,Canada,10,6,4
2010,666,Saint Pierre and Miquelon,Canada,187,71,116
2010,840,United States of America,Canada,868967,286673,582294
2015,480,Mauritius,Canada,36,20,16
2015,800,Uganda,Canada,239,134,105
2015,834,United Republic of Tanzania,Canada,294,178,116
2015,894,Zambia,Canada,176,83,93
2015,120,Cameroon,Canada,182,85,97
2015,140,Central African Republic,Canada,186,94,92
2015,266,Gabon,Canada,266,165,101
2015,72,Botswana,Canada,174,54,120
2015,748,Eswatini,Canada,19,7,12
2015,516,Namibia,Canada,184,83,101
2015,710,South Africa,Canada,8890,4294,4596
2015,288,Ghana,Canada,283,135,148
2015,324,Guinea,Canada,46,30,16
2015,624,Guinea-Bissau,Canada,57,24,33
2015,430,Liberia,Canada,56,25,31
2015,478,Mauritania,Canada,50,36,14
2015,694,Sierra Leone,Canada,19,12,7
2015,768,Togo,Canada,48,31,17
2015,818,Egypt,Canada,441,263,178
2015,434,Libya,Canada,2850,1930,920
2015,196,Cyprus,Canada,1575,741,834
2015,376,Israel,Canada,8132,3801,4331
2015,400,Jordan,Canada,316,166,150
2015,792,Turkey,Canada,1431,642,789
2015,762,Tajikistan,Canada,49,27,22
2015,64,Bhutan,Canada,37,18,19
2015,356,India,Canada,1640,811,829
2015,462,Maldives,Canada,94,82,12
2015,144,Sri Lanka,Canada,251,130,121
2015,156,China,Canada,8629,5891,2738
2015,344,"China, Hong Kong SAR",Canada,14660,7796,6864
2015,408,Dem. People's Republic of Korea,Canada,331,187,144
2015,392,Japan,Canada,9538,4254,5284
2015,496,Mongolia,Canada,154,113,41
2015,410,Republic of Korea,Canada,17298,13782,3516
2015,116,Cambodia,Canada,42,22,20
2015,360,Indonesia,Canada,2144,1122,1022
2015,608,Philippines,Canada,5565,3077,2488
2015,702,Singapore,Canada,4700,2433,2267
2015,764,Thailand,Canada,751,469,282
2015,704,Viet Nam,Canada,1454,891,563
2015,660,Anguilla,Canada,57,16,41
2015,28,Antigua and Barbuda,Canada,434,209,225
2015,44,Bahamas,Canada,1567,854,713
2015,52,Barbados,Canada,689,304,385
2015,92,British Virgin Islands,Canada,235,107,128
2015,535,"Bonaire, Sint Eustatius and Saba",Canada,87,60,27
2015,136,Cayman Islands,Canada,1450,687,763
2015,192,Cuba,Canada,20,11,9
2015,531,Curaçao,Canada,90,59,31
2015,212,Dominica,Canada,184,94,90
2015,214,Dominican Republic,Canada,1215,682,533
2015,308,Grenada,Canada,227,152,75
2015,312,Guadeloupe,Canada,496,224,272
2015,332,Haiti,Canada,591,291,300
2015,388,Jamaica,Canada,1313,691,622
2015,500,Montserrat,Canada,36,18,18
2015,630,Puerto Rico,Canada,119,56,63
2015,662,Saint Lucia,Canada,257,119,138
2015,670,Saint Vincent and the Grenadines,Canada,172,94,78
2015,534,Sint Maarten (Dutch part),Canada,38,18,20
2015,780,Trinidad and Tobago,Canada,1777,920,857
2015,796,Turks and Caicos Islands,Canada,462,246,216
2015,84,Belize,Canada,807,392,415
2015,188,Costa Rica,Canada,1408,792,616
2015,222,El Salvador,Canada,245,131,114
2015,320,Guatemala,Canada,397,260,137
2015,340,Honduras,Canada,349,194,155
2015,484,Mexico,Canada,9616,4700,4916
2015,558,Nicaragua,Canada,252,131,121
2015,591,Panama,Canada,1808,1053,755
2015,32,Argentina,Canada,530,273,257
2015,68,Bolivia (Plurinational State of),Canada,1380,651,729
2015,76,Brazil,Canada,1894,1271,623
2015,152,Chile,Canada,5485,2913,2572
2015,170,Colombia,Canada,1028,569,459
2015,218,Ecuador,Canada,2341,1121,1220
2015,328,Guyana,Canada,400,210,190
2015,600,Paraguay,Canada,2281,1470,811
2015,604,Peru,Canada,3062,2083,979
2015,858,Uruguay,Canada,313,103,210
2015,862,Venezuela (Bolivarian Republic of),Canada,1136,593,543
2015,36,Australia,Canada,52590,24794,27796
2015,554,New Zealand,Canada,9950,4812,5138
2015,598,Papua New Guinea,Canada,235,170,65
2015,258,French Polynesia,Canada,128,90,38
2015,882,Samoa,Canada,9,4,5
2015,112,Belarus,Canada,155,58,97
2015,100,Bulgaria,Canada,552,296,256
2015,203,Czechia,Canada,766,453,313
2015,348,Hungary,Canada,2382,1276,1106
2015,616,Poland,Canada,2951,1599,1352
2015,642,Romania,Canada,118,58,60
2015,643,Russian Federation,Canada,558,316,242
2015,703,Slovakia,Canada,480,264,216
2015,208,Denmark,Canada,3958,1948,2010
2015,233,Estonia,Canada,122,82,40
2015,234,Faroe Islands,Canada,13,6,7
2015,246,Finland,Canada,1914,988,926
2015,352,Iceland,Canada,277,130,147
2015,372,Ireland,Canada,5323,2186,3137
2015,833,Isle of Man,Canada,157,76,81
2015,428,Latvia,Canada,120,65,55
2015,440,Lithuania,Canada,29,13,16
2015,578,Norway,Canada,3061,1469,1592
2015,752,Sweden,Canada,3596,1789,1807
2015,826,United Kingdom,Canada,95169,41208,53961
2015,8,Albania,Canada,906,731,175
2015,191,Croatia,Canada,1004,477,527
2015,300,Greece,Canada,12584,5186,7398
2015,380,Italy,Canada,24648,11022,13626
2015,470,Malta,Canada,2440,1285,1155
2015,499,Montenegro,Canada,69,10,59
2015,620,Portugal,Canada,7275,3275,4000
2015,688,Serbia,Canada,612,323,289
2015,705,Slovenia,Canada,389,203,186
2015,724,Spain,Canada,6922,3200,3722
2015,40,Austria,Canada,2547,1228,1319
2015,56,Belgium,Canada,4917,2212,2705
2015,250,France,Canada,26773,11332,15441
2015,276,Germany,Canada,16602,8299,8303
2015,442,Luxembourg,Canada,236,130,106
2015,528,Netherlands,Canada,9776,4585,5191
2015,756,Switzerland,Canada,11908,5186,6722
2015,60,Bermuda,Canada,2302,1250,1052
2015,304,Greenland,Canada,14,10,4
2015,666,Saint Pierre and Miquelon,Canada,181,69,112
2015,840,United States of America,Canada,830628,269786,560842
2019,480,Mauritius,Canada,36,20,16
2019,800,Uganda,Canada,237,133,104
2019,834,United Republic of Tanzania,Canada,263,159,104
2019,894,Zambia,Canada,226,107,119
2019,120,Cameroon,Canada,181,85,96
2019,140,Central African Republic,Canada,206,104,102
2019,266,Gabon,Canada,289,180,109
2019,72,Botswana,Canada,186,58,128
2019,748,Eswatini,Canada,18,6,12
2019,516,Namibia,Canada,194,88,106
2019,710,South Africa,Canada,9964,4818,5146
2019,288,Ghana,Canada,318,152,166
2019,324,Guinea,Canada,43,28,15
2019,624,Guinea-Bissau,Canada,62,26,36
2019,430,Liberia,Canada,46,21,25
2019,478,Mauritania,Canada,51,37,14
2019,694,Sierra Leone,Canada,18,12,6
2019,768,Togo,Canada,48,31,17
2019,818,Egypt,Canada,628,345,283
2019,434,Libya,Canada,3023,2047,976
2019,196,Cyprus,Canada,1574,749,825
2019,376,Israel,Canada,7908,3697,4211
2019,400,Jordan,Canada,339,178,161
2019,792,Turkey,Canada,1934,878,1056
2019,762,Tajikistan,Canada,48,27,21
2019,64,Bhutan,Canada,38,19,19
2019,356,India,Canada,1613,798,815
2019,462,Maldives,Canada,101,89,12
2019,144,Sri Lanka,Canada,252,131,121
2019,156,China,Canada,9095,6210,2885
2019,344,"China, Hong Kong SAR",Canada,18993,9833,9160
2019,408,Dem. People's Republic of Korea,Canada,337,191,146
2019,392,Japan,Canada,10522,4693,5829
2019,496,Mongolia,Canada,163,120,43
2019,410,Republic of Korea,Canada,17609,14029,3580
2019,116,Cambodia,Canada,44,23,21
2019,360,Indonesia,Canada,2239,1172,1067
2019,608,Philippines,Canada,5740,3174,2566
2019,702,Singapore,Canada,3983,2060,1923
2019,764,Thailand,Canada,782,488,294
2019,704,Viet Nam,Canada,1520,932,588
2019,660,Anguilla,Canada,59,17,42
2019,28,Antigua and Barbuda,Canada,451,218,233
2019,44,Bahamas,Canada,1663,907,756
2019,52,Barbados,Canada,695,307,388
2019,92,British Virgin Islands,Canada,255,116,139
2019,535,"Bonaire, Sint Eustatius and Saba",Canada,103,71,32
2019,136,Cayman Islands,Canada,1605,761,844
2019,192,Cuba,Canada,18,10,8
2019,531,Curaçao,Canada,97,64,33
2019,212,Dominica,Canada,187,96,91
2019,214,Dominican Republic,Canada,1255,705,550
2019,308,Grenada,Canada,229,154,75
2019,312,Guadeloupe,Canada,503,227,276
2019,332,Haiti,Canada,614,303,311
2019,388,Jamaica,Canada,1330,700,630
2019,500,Montserrat,Canada,36,18,18
2019,630,Puerto Rico,Canada,113,53,60
2019,662,Saint Lucia,Canada,248,115,133
2019,670,Saint Vincent and the Grenadines,Canada,173,95,78
2019,534,Sint Maarten (Dutch part),Canada,39,19,20
2019,780,Trinidad and Tobago,Canada,1912,1032,880
2019,796,Turks and Caicos Islands,Canada,498,266,232
2019,84,Belize,Canada,885,430,455
2019,188,Costa Rica,Canada,1428,807,621
2019,222,El Salvador,Canada,248,133,115
2019,320,Guatemala,Canada,407,267,140
2019,340,Honduras,Canada,354,197,157
2019,484,Mexico,Canada,9914,4846,5068
2019,558,Nicaragua,Canada,263,137,126
2019,591,Panama,Canada,1923,1120,803
2019,32,Argentina,Canada,539,278,261
2019,68,Bolivia (Plurinational State of),Canada,1506,711,795
2019,76,Brazil,Canada,2133,1432,701
2019,152,Chile,Canada,7328,3701,3627
2019,170,Colombia,Canada,1051,582,469
2019,218,Ecuador,Canada,2304,1103,1201
2019,328,Guyana,Canada,408,215,193
2019,600,Paraguay,Canada,2340,1508,832
2019,604,Peru,Canada,3649,2531,1118
2019,858,Uruguay,Canada,323,107,216
2019,862,Venezuela (Bolivarian Republic of),Canada,1112,578,534
2019,36,Australia,Canada,57798,26852,30946
2019,554,New Zealand,Canada,10227,4946,5281
2019,598,Papua New Guinea,Canada,237,172,65
2019,258,French Polynesia,Canada,132,93,39
2019,882,Samoa,Canada,8,4,4
2019,112,Belarus,Canada,153,58,95
2019,100,Bulgaria,Canada,717,387,330
2019,203,Czechia,Canada,915,547,368
2019,348,Hungary,Canada,2616,1389,1227
2019,616,Poland,Canada,3125,1749,1376
2019,642,Romania,Canada,492,279,213
2019,643,Russian Federation,Canada,557,316,241
2019,703,Slovakia,Canada,538,302,236
2019,208,Denmark,Canada,4191,2061,2130
2019,233,Estonia,Canada,132,90,42
2019,234,Faroe Islands,Canada,14,6,8
2019,246,Finland,Canada,2106,1107,999
2019,352,Iceland,Canada,344,171,173
2019,372,Ireland,Canada,5843,2410,3433
2019,833,Isle of Man,Canada,159,77,82
2019,428,Latvia,Canada,140,83,57
2019,440,Lithuania,Canada,14,5,9
2019,578,Norway,Canada,3395,1607,1788
2019,752,Sweden,Canada,4271,2094,2177
2019,826,United Kingdom,Canada,108074,46951,61123
2019,8,Albania,Canada,856,691,165
2019,191,Croatia,Canada,927,439,488
2019,300,Greece,Canada,12289,5338,6951
2019,380,Italy,Canada,25716,11625,14091
2019,470,Malta,Canada,3937,2086,1851
2019,499,Montenegro,Canada,69,11,58
2019,620,Portugal,Canada,7398,3339,4059
2019,688,Serbia,Canada,621,328,293
2019,705,Slovenia,Canada,376,202,174
2019,724,Spain,Canada,7172,3224,3948
2019,40,Austria,Canada,3006,1476,1530
2019,56,Belgium,Canada,5172,2382,2790
2019,250,France,Canada,28339,11958,16381
2019,276,Germany,Canada,18211,9315,8896
2019,442,Luxembourg,Canada,822,422,400
2019,528,Netherlands,Canada,10955,5126,5829
2019,756,Switzerland,Canada,12393,5452,6941
2019,60,Bermuda,Canada,2327,1264,1063
2019,304,Greenland,Canada,13,10,3
2019,666,Saint Pierre and Miquelon,Canada,181,69,112
2019,840,United States of America,Canada,825040,266916,558124
1990,44,Bahamas,Cayman Islands,9,3,6
1990,662,Saint Lucia,Cayman Islands,2,1,1
1990,188,Costa Rica,Cayman Islands,8,6,2
1990,340,Honduras,Cayman Islands,68,36,32
1990,152,Chile,Cayman Islands,17,5,12
1990,36,Australia,Cayman Islands,3,0,3
1990,372,Ireland,Cayman Islands,5,2,3
1990,826,United Kingdom,Cayman Islands,150,85,65
1990,300,Greece,Cayman Islands,15,7,8
1990,124,Canada,Cayman Islands,96,47,49
1995,44,Bahamas,Cayman Islands,9,4,5
1995,662,Saint Lucia,Cayman Islands,2,2,0
1995,188,Costa Rica,Cayman Islands,6,5,1
1995,340,Honduras,Cayman Islands,68,35,33
1995,152,Chile,Cayman Islands,9,1,8
1995,36,Australia,Cayman Islands,1,0,1
1995,100,Bulgaria,Cayman Islands,1,1,0
1995,372,Ireland,Cayman Islands,13,5,8
1995,826,United Kingdom,Cayman Islands,591,262,329
1995,300,Greece,Cayman Islands,12,5,7
1995,124,Canada,Cayman Islands,91,44,47
2000,44,Bahamas,Cayman Islands,9,6,3
2000,662,Saint Lucia,Cayman Islands,4,3,1
2000,188,Costa Rica,Cayman Islands,6,5,1
2000,340,Honduras,Cayman Islands,67,34,33
2000,152,Chile,Cayman Islands,1,0,1
2000,36,Australia,Cayman Islands,20,10,10
2000,100,Bulgaria,Cayman Islands,1,1,0
2000,372,Ireland,Cayman Islands,29,13,16
2000,826,United Kingdom,Cayman Islands,1043,442,601
2000,300,Greece,Cayman Islands,10,3,7
2000,124,Canada,Cayman Islands,89,42,47
2005,44,Bahamas,Cayman Islands,15,9,6
2005,662,Saint Lucia,Cayman Islands,7,6,1
2005,188,Costa Rica,Cayman Islands,4,3,1
2005,340,Honduras,Cayman Islands,66,34,32
2005,152,Chile,Cayman Islands,1,0,1
2005,36,Australia,Cayman Islands,40,20,20
2005,100,Bulgaria,Cayman Islands,2,1,1
2005,372,Ireland,Cayman Islands,29,14,15
2005,826,United Kingdom,Cayman Islands,892,387,505
2005,300,Greece,Cayman Islands,5,1,4
2005,124,Canada,Cayman Islands,230,115,115
2010,44,Bahamas,Cayman Islands,21,12,9
2010,662,Saint Lucia,Cayman Islands,11,9,2
2010,188,Costa Rica,Cayman Islands,8,7,1
2010,340,Honduras,Cayman Islands,64,33,31
2010,152,Chile,Cayman Islands,2,1,1
2010,36,Australia,Cayman Islands,80,40,40
2010,100,Bulgaria,Cayman Islands,2,1,1
2010,372,Ireland,Cayman Islands,24,10,14
2010,826,United Kingdom,Cayman Islands,939,418,521
2010,124,Canada,Cayman Islands,240,122,118
2015,44,Bahamas,Cayman Islands,23,13,10
2015,662,Saint Lucia,Cayman Islands,10,9,1
2015,188,Costa Rica,Cayman Islands,8,7,1
2015,340,Honduras,Cayman Islands,90,47,43
2015,152,Chile,Cayman Islands,3,2,1
2015,36,Australia,Cayman Islands,130,67,63
2015,100,Bulgaria,Cayman Islands,3,2,1
2015,372,Ireland,Cayman Islands,25,11,14
2015,826,United Kingdom,Cayman Islands,1200,514,686
2015,124,Canada,Cayman Islands,268,144,124
2019,44,Bahamas,Cayman Islands,24,14,10
2019,662,Saint Lucia,Cayman Islands,9,9,0
2019,188,Costa Rica,Cayman Islands,8,7,1
2019,340,Honduras,Cayman Islands,91,48,43
2019,152,Chile,Cayman Islands,4,3,1
2019,36,Australia,Cayman Islands,158,67,91
2019,100,Bulgaria,Cayman Islands,4,2,2
2019,372,Ireland,Cayman Islands,27,12,15
2019,826,United Kingdom,Cayman Islands,1362,585,777
2019,124,Canada,Cayman Islands,287,155,132
1990,148,Chad,Central African Republic,8067,4355,3712
1990,178,Congo,Central African Republic,10616,5635,4981
1990,710,South Africa,Central African Republic,118,85,33
1990,466,Mali,Central African Republic,283,146,137
1990,768,Togo,Central African Republic,179,98,81
1990,818,Egypt,Central African Republic,51,35,16
1990,729,Sudan,Central African Republic,17911,9208,8703
1990,196,Cyprus,Central African Republic,4,2,2
1990,214,Dominican Republic,Central African Republic,6,0,6
1990,188,Costa Rica,Central African Republic,5,4,1
1990,152,Chile,Central African Republic,8,5,3
1990,36,Australia,Central African Republic,6,6,0
1990,203,Czechia,Central African Republic,1,1,0
1990,348,Hungary,Central African Republic,4,4,0
1990,643,Russian Federation,Central African Republic,131,64,67
1990,208,Denmark,Central African Republic,1,1,0
1990,372,Ireland,Central African Republic,1,0,1
1990,428,Latvia,Central African Republic,1,0,1
1990,752,Sweden,Central African Republic,8,4,4
1990,826,United Kingdom,Central African Republic,42,22,20
1990,300,Greece,Central African Republic,42,24,18
1990,380,Italy,Central African Republic,6,2,4
1990,705,Slovenia,Central African Republic,12,6,6
1990,724,Spain,Central African Republic,13,7,6
1990,40,Austria,Central African Republic,16,10,6
1990,56,Belgium,Central African Republic,190,95,95
1990,250,France,Central African Republic,8492,4317,4175
1990,528,Netherlands,Central African Republic,14,9,5
1990,756,Switzerland,Central African Republic,120,56,64
1990,124,Canada,Central African Republic,14,6,8
1995,148,Chad,Central African Republic,8765,4726,4039
1995,178,Congo,Central African Republic,11844,5710,6134
1995,710,South Africa,Central African Republic,73,55,18
1995,466,Mali,Central African Republic,295,152,143
1995,686,Senegal,Central African Republic,3,2,1
1995,768,Togo,Central African Republic,201,110,91
1995,818,Egypt,Central African Republic,45,29,16
1995,729,Sudan,Central African Republic,18271,9412,8859
1995,196,Cyprus,Central African Republic,6,3,3
1995,214,Dominican Republic,Central African Republic,7,0,7
1995,188,Costa Rica,Central African Republic,4,3,1
1995,152,Chile,Central African Republic,5,3,2
1995,36,Australia,Central African Republic,3,3,0
1995,203,Czechia,Central African Republic,1,0,1
1995,348,Hungary,Central African Republic,5,4,1
1995,643,Russian Federation,Central African Republic,132,67,65
1995,208,Denmark,Central African Republic,2,1,1
1995,246,Finland,Central African Republic,1,1,0
1995,372,Ireland,Central African Republic,4,1,3
1995,428,Latvia,Central African Republic,1,0,1
1995,752,Sweden,Central African Republic,10,5,5
1995,826,United Kingdom,Central African Republic,169,64,105
1995,300,Greece,Central African Republic,66,31,35
1995,380,Italy,Central African Republic,35,19,16
1995,705,Slovenia,Central African Republic,25,14,11
1995,724,Spain,Central African Republic,20,11,9
1995,40,Austria,Central African Republic,18,11,7
1995,56,Belgium,Central African Republic,187,92,95
1995,250,France,Central African Republic,8767,4384,4383
1995,528,Netherlands,Central African Republic,20,12,8
1995,756,Switzerland,Central African Republic,133,69,64
1995,124,Canada,Central African Republic,92,44,48
2000,148,Chad,Central African Republic,9463,5097,4366
2000,178,Congo,Central African Republic,16245,7300,8945
2000,710,South Africa,Central African Republic,50,40,10
2000,466,Mali,Central African Republic,271,140,131
2000,686,Senegal,Central African Republic,3,2,1
2000,768,Togo,Central African Republic,226,124,102
2000,818,Egypt,Central African Republic,43,25,18
2000,729,Sudan,Central African Republic,18639,9621,9018
2000,196,Cyprus,Central African Republic,7,3,4
2000,214,Dominican Republic,Central African Republic,7,0,7
2000,188,Costa Rica,Central African Republic,4,3,1
2000,152,Chile,Central African Republic,2,1,1
2000,36,Australia,Central African Republic,10,5,5
2000,203,Czechia,Central African Republic,1,0,1
2000,348,Hungary,Central African Republic,6,4,2
2000,643,Russian Federation,Central African Republic,129,68,61
2000,208,Denmark,Central African Republic,2,1,1
2000,246,Finland,Central African Republic,2,2,0
2000,372,Ireland,Central African Republic,9,3,6
2000,428,Latvia,Central African Republic,2,1,1
2000,752,Sweden,Central African Republic,11,5,6
2000,826,United Kingdom,Central African Republic,299,106,193
2000,300,Greece,Central African Republic,91,37,54
2000,380,Italy,Central African Republic,63,36,27
2000,724,Spain,Central African Republic,241,137,104
2000,40,Austria,Central African Republic,20,13,7
2000,56,Belgium,Central African Republic,182,90,92
2000,250,France,Central African Republic,9041,4451,4590
2000,528,Netherlands,Central African Republic,29,15,14
2000,756,Switzerland,Central African Republic,147,81,66
2000,124,Canada,Central African Republic,173,83,90
2005,120,Cameroon,Central African Republic,14607,6558,8049
2005,148,Chad,Central African Republic,63510,28812,34698
2005,178,Congo,Central African Republic,14620,6570,8050
2005,710,South Africa,Central African Republic,65,51,14
2005,466,Mali,Central African Republic,1105,556,549
2005,686,Senegal,Central African Republic,13,6,7
2005,768,Togo,Central African Republic,254,139,115
2005,818,Egypt,Central African Republic,51,31,20
2005,729,Sudan,Central African Republic,20771,10697,10074
2005,196,Cyprus,Central African Republic,10,4,6
2005,214,Dominican Republic,Central African Republic,68,41,27
2005,188,Costa Rica,Central African Republic,3,2,1
2005,68,Bolivia (Plurinational State of),Central African Republic,28,22,6
2005,76,Brazil,Central African Republic,5,0,5
2005,152,Chile,Central African Republic,3,2,1
2005,36,Australia,Central African Republic,10,5,5
2005,203,Czechia,Central African Republic,1,0,1
2005,348,Hungary,Central African Republic,7,5,2
2005,643,Russian Federation,Central African Republic,110,63,47
2005,208,Denmark,Central African Republic,6,2,4
2005,246,Finland,Central African Republic,2,1,1
2005,372,Ireland,Central African Republic,9,3,6
2005,428,Latvia,Central African Republic,1,1,0
2005,752,Sweden,Central African Republic,55,25,30
2005,826,United Kingdom,Central African Republic,217,78,139
2005,300,Greece,Central African Republic,247,120,127
2005,380,Italy,Central African Republic,151,86,65
2005,724,Spain,Central African Republic,116,65,51
2005,40,Austria,Central African Republic,23,15,8
2005,56,Belgium,Central African Republic,271,140,131
2005,250,France,Central African Republic,14600,7190,7410
2005,528,Netherlands,Central African Republic,43,23,20
2005,756,Switzerland,Central African Republic,158,83,75
2005,124,Canada,Central African Republic,256,113,143
2010,728,South Sudan,Central African Republic,5166,2857,2309
2010,120,Cameroon,Central African Republic,105626,53342,52284
2010,148,Chad,Central African Republic,75211,33693,41518
2010,178,Congo,Central African Republic,24601,12771,11830
2010,710,South Africa,Central African Republic,101,80,21
2010,466,Mali,Central African Republic,767,400,367
2010,686,Senegal,Central African Republic,19,10,9
2010,768,Togo,Central African Republic,333,190,143
2010,818,Egypt,Central African Republic,55,33,22
2010,729,Sudan,Central African Republic,16064,8197,7867
2010,196,Cyprus,Central African Republic,16,7,9
2010,214,Dominican Republic,Central African Republic,128,81,47
2010,188,Costa Rica,Central African Republic,5,4,1
2010,68,Bolivia (Plurinational State of),Central African Republic,56,44,12
2010,76,Brazil,Central African Republic,11,3,8
2010,152,Chile,Central African Republic,4,3,1
2010,36,Australia,Central African Republic,20,10,10
2010,203,Czechia,Central African Republic,1,0,1
2010,348,Hungary,Central African Republic,7,6,1
2010,643,Russian Federation,Central African Republic,90,57,33
2010,208,Denmark,Central African Republic,9,4,5
2010,233,Estonia,Central African Republic,1,1,0
2010,246,Finland,Central African Republic,2,1,1
2010,372,Ireland,Central African Republic,8,3,5
2010,428,Latvia,Central African Republic,1,1,0
2010,752,Sweden,Central African Republic,80,38,42
2010,826,United Kingdom,Central African Republic,228,85,143
2010,300,Greece,Central African Republic,418,210,208
2010,380,Italy,Central African Republic,241,143,98
2010,705,Slovenia,Central African Republic,3,1,2
2010,724,Spain,Central African Republic,142,78,64
2010,40,Austria,Central African Republic,25,16,9
2010,56,Belgium,Central African Republic,300,157,143
2010,250,France,Central African Republic,15699,7550,8149
2010,528,Netherlands,Central African Republic,57,27,30
2010,756,Switzerland,Central African Republic,195,97,98
2010,124,Canada,Central African Republic,235,100,135
2015,728,South Sudan,Central African Republic,4574,2650,1924
2015,120,Cameroon,Central African Republic,265926,134293,131633
2015,148,Chad,Central African Republic,88259,41460,46799
2015,178,Congo,Central African Republic,32696,16302,16394
2015,180,Democratic Republic of the Congo,Central African Republic,257929,135260,122669
2015,710,South Africa,Central African Republic,181,143,38
2015,324,Guinea,Central African Republic,18,14,4
2015,466,Mali,Central African Republic,950,496,454
2015,686,Senegal,Central African Republic,668,344,324
2015,768,Togo,Central African Republic,375,214,161
2015,818,Egypt,Central African Republic,40,26,14
2015,729,Sudan,Central African Republic,13489,6908,6581
2015,196,Cyprus,Central African Republic,15,7,8
2015,214,Dominican Republic,Central African Republic,135,86,49
2015,188,Costa Rica,Central African Republic,5,4,1
2015,68,Bolivia (Plurinational State of),Central African Republic,65,51,14
2015,76,Brazil,Central African Republic,13,3,10
2015,152,Chile,Central African Republic,6,5,1
2015,36,Australia,Central African Republic,30,18,12
2015,348,Hungary,Central African Republic,6,5,1
2015,643,Russian Federation,Central African Republic,91,57,34
2015,208,Denmark,Central African Republic,10,3,7
2015,246,Finland,Central African Republic,3,2,1
2015,372,Ireland,Central African Republic,8,3,5
2015,752,Sweden,Central African Republic,108,57,51
2015,826,United Kingdom,Central African Republic,291,103,188
2015,300,Greece,Central African Republic,392,189,203
2015,380,Italy,Central African Republic,223,126,97
2015,705,Slovenia,Central African Republic,34,19,15
2015,724,Spain,Central African Republic,162,97,65
2015,40,Austria,Central African Republic,29,19,10
2015,56,Belgium,Central African Republic,411,228,183
2015,250,France,Central African Republic,17391,8115,9276
2015,528,Netherlands,Central African Republic,56,28,28
2015,756,Switzerland,Central African Republic,211,105,106
2015,124,Canada,Central African Republic,1048,536,512
2019,728,South Sudan,Central African Republic,4690,2717,1973
2019,120,Cameroon,Central African Republic,264537,133592,130945
2019,148,Chad,Central African Republic,96813,45440,51373
2019,178,Congo,Central African Republic,33701,16794,16907
2019,180,Democratic Republic of the Congo,Central African Republic,326984,166898,160086
2019,710,South Africa,Central African Republic,202,160,42
2019,324,Guinea,Central African Republic,17,14,3
2019,466,Mali,Central African Republic,1057,552,505
2019,686,Senegal,Central African Republic,730,376,354
2019,768,Togo,Central African Republic,377,216,161
2019,818,Egypt,Central African Republic,57,35,22
2019,729,Sudan,Central African Republic,16634,8393,8241
2019,196,Cyprus,Central African Republic,14,7,7
2019,214,Dominican Republic,Central African Republic,139,89,50
2019,188,Costa Rica,Central African Republic,5,4,1
2019,68,Bolivia (Plurinational State of),Central African Republic,70,55,15
2019,76,Brazil,Central African Republic,14,3,11
2019,152,Chile,Central African Republic,8,7,1
2019,36,Australia,Central African Republic,42,22,20
2019,348,Hungary,Central African Republic,12,9,3
2019,643,Russian Federation,Central African Republic,90,57,33
2019,208,Denmark,Central African Republic,29,13,16
2019,246,Finland,Central African Republic,8,6,2
2019,372,Ireland,Central African Republic,8,3,5
2019,752,Sweden,Central African Republic,125,68,57
2019,826,United Kingdom,Central African Republic,330,118,212
2019,300,Greece,Central African Republic,382,192,190
2019,380,Italy,Central African Republic,293,184,109
2019,705,Slovenia,Central African Republic,2,1,1
2019,724,Spain,Central African Republic,167,99,68
2019,40,Austria,Central African Republic,34,23,11
2019,56,Belgium,Central African Republic,485,267,218
2019,250,France,Central African Republic,18408,8567,9841
2019,528,Netherlands,Central African Republic,67,36,31
2019,756,Switzerland,Central African Republic,235,118,117
2019,124,Canada,Central African Republic,1123,575,548
1990,24,Angola,Chad,12,6,6
1990,120,Cameroon,Chad,95527,47150,48377
1990,140,Central African Republic,Chad,10010,5457,4553
1990,178,Congo,Chad,3239,2103,1136
1990,266,Gabon,Chad,1398,841,557
1990,204,Benin,Chad,143,77,66
1990,288,Ghana,Chad,8,6,2
1990,478,Mauritania,Chad,47,24,23
1990,562,Niger,Chad,1443,832,611
1990,566,Nigeria,Chad,11111,6234,4877
1990,768,Togo,Chad,342,225,117
1990,818,Egypt,Chad,305,198,107
1990,434,Libya,Chad,871,569,302
1990,729,Sudan,Chad,196164,97702,98462
1990,48,Bahrain,Chad,140,100,40
1990,400,Jordan,Chad,4,4,0
1990,414,Kuwait,Chad,870,527,343
1990,634,Qatar,Chad,10484,3150,7334
1990,784,United Arab Emirates,Chad,1063,757,306
1990,214,Dominican Republic,Chad,3,3,0
1990,68,Bolivia (Plurinational State of),Chad,6,5,1
1990,152,Chile,Chad,4,2,2
1990,36,Australia,Chad,15,9,6
1990,100,Bulgaria,Chad,1,1,0
1990,203,Czechia,Chad,2,2,0
1990,348,Hungary,Chad,2,2,0
1990,643,Russian Federation,Chad,161,79,82
1990,703,Slovakia,Chad,8,5,3
1990,208,Denmark,Chad,1,1,0
1990,246,Finland,Chad,1,1,0
1990,372,Ireland,Chad,2,1,1
1990,578,Norway,Chad,7,7,0
1990,752,Sweden,Chad,22,18,4
1990,826,United Kingdom,Chad,25,21,4
1990,300,Greece,Chad,18,9,9
1990,380,Italy,Chad,17,6,11
1990,724,Spain,Chad,7,5,2
1990,40,Austria,Chad,7,4,3
1990,56,Belgium,Chad,202,116,86
1990,250,France,Chad,2554,1460,1094
1990,276,Germany,Chad,265,235,30
1990,528,Netherlands,Chad,28,17,11
1990,756,Switzerland,Chad,157,80,77
1990,124,Canada,Chad,106,52,54
1995,24,Angola,Chad,14,6,8
1995,120,Cameroon,Chad,88874,43740,45134
1995,140,Central African Republic,Chad,13169,7299,5870
1995,178,Congo,Chad,3743,2368,1375
1995,266,Gabon,Chad,1870,1124,746
1995,204,Benin,Chad,198,107,91
1995,288,Ghana,Chad,8,6,2
1995,478,Mauritania,Chad,50,28,22
1995,562,Niger,Chad,1077,612,465
1995,566,Nigeria,Chad,11265,6280,4985
1995,694,Sierra Leone,Chad,3,2,1
1995,768,Togo,Chad,385,254,131
1995,818,Egypt,Chad,264,169,95
1995,434,Libya,Chad,744,494,250
1995,729,Sudan,Chad,85807,42738,43069
1995,48,Bahrain,Chad,154,109,45
1995,400,Jordan,Chad,18,14,4
1995,414,Kuwait,Chad,697,445,252
1995,634,Qatar,Chad,9228,3761,5467
1995,784,United Arab Emirates,Chad,1361,975,386
1995,214,Dominican Republic,Chad,4,4,0
1995,68,Bolivia (Plurinational State of),Chad,4,3,1
1995,152,Chile,Chad,10,3,7
1995,36,Australia,Chad,12,9,3
1995,100,Bulgaria,Chad,2,2,0
1995,203,Czechia,Chad,3,3,0
1995,348,Hungary,Chad,2,1,1
1995,643,Russian Federation,Chad,139,83,56
1995,703,Slovakia,Chad,43,17,26
1995,208,Denmark,Chad,2,2,0
1995,246,Finland,Chad,2,2,0
1995,372,Ireland,Chad,5,3,2
1995,578,Norway,Chad,9,9,0
1995,752,Sweden,Chad,26,21,5
1995,826,United Kingdom,Chad,101,76,25
1995,300,Greece,Chad,21,13,8
1995,380,Italy,Chad,71,31,40
1995,724,Spain,Chad,11,8,3
1995,40,Austria,Chad,8,5,3
1995,56,Belgium,Chad,202,116,86
1995,250,France,Chad,2637,1488,1149
1995,276,Germany,Chad,281,246,35
1995,528,Netherlands,Chad,40,23,17
1995,756,Switzerland,Chad,186,98,88
1995,124,Canada,Chad,356,172,184
2000,24,Angola,Chad,16,7,9
2000,120,Cameroon,Chad,82221,40330,41891
2000,140,Central African Republic,Chad,15183,8502,6681
2000,178,Congo,Chad,5249,3263,1986
2000,266,Gabon,Chad,2339,1411,928
2000,204,Benin,Chad,253,137,116
2000,288,Ghana,Chad,9,7,2
2000,478,Mauritania,Chad,51,31,20
2000,562,Niger,Chad,720,397,323
2000,566,Nigeria,Chad,11871,6575,5296
2000,694,Sierra Leone,Chad,1,1,0
2000,768,Togo,Chad,433,286,147
2000,818,Egypt,Chad,244,153,91
2000,434,Libya,Chad,631,434,197
2000,729,Sudan,Chad,72615,37367,35248
2000,48,Bahrain,Chad,169,118,51
2000,400,Jordan,Chad,32,24,8
2000,414,Kuwait,Chad,795,538,257
2000,634,Qatar,Chad,6597,3840,2757
2000,784,United Arab Emirates,Chad,1739,1245,494
2000,214,Dominican Republic,Chad,4,4,0
2000,68,Bolivia (Plurinational State of),Chad,1,1,0
2000,152,Chile,Chad,17,5,12
2000,36,Australia,Chad,40,20,20
2000,100,Bulgaria,Chad,3,3,0
2000,203,Czechia,Chad,4,4,0
2000,348,Hungary,Chad,1,0,1
2000,643,Russian Federation,Chad,112,84,28
2000,703,Slovakia,Chad,91,33,58
2000,208,Denmark,Chad,2,2,0
2000,246,Finland,Chad,3,3,0
2000,372,Ireland,Chad,12,8,4
2000,578,Norway,Chad,7,7,0
2000,752,Sweden,Chad,28,22,6
2000,826,United Kingdom,Chad,180,133,47
2000,300,Greece,Chad,24,17,7
2000,380,Italy,Chad,124,56,68
2000,724,Spain,Chad,141,98,43
2000,40,Austria,Chad,9,6,3
2000,56,Belgium,Chad,196,112,84
2000,250,France,Chad,2719,1516,1203
2000,276,Germany,Chad,297,257,40
2000,528,Netherlands,Chad,56,31,25
2000,756,Switzerland,Chad,216,115,101
2000,124,Canada,Chad,614,296,318
2005,24,Angola,Chad,21,9,12
2005,120,Cameroon,Chad,70899,37548,33351
2005,140,Central African Republic,Chad,11609,6507,5102
2005,178,Congo,Chad,3338,2373,965
2005,266,Gabon,Chad,2552,1551,1001
2005,204,Benin,Chad,514,302,212
2005,288,Ghana,Chad,13,10,3
2005,478,Mauritania,Chad,51,32,19
2005,562,Niger,Chad,733,404,329
2005,566,Nigeria,Chad,23582,13732,9850
2005,694,Sierra Leone,Chad,1,1,0
2005,768,Togo,Chad,487,322,165
2005,818,Egypt,Chad,290,188,102
2005,434,Libya,Chad,696,519,177
2005,729,Sudan,Chad,80942,41675,39267
2005,48,Bahrain,Chad,256,175,81
2005,400,Jordan,Chad,46,37,9
2005,414,Kuwait,Chad,858,567,291
2005,634,Qatar,Chad,2582,1311,1271
2005,784,United Arab Emirates,Chad,2094,1448,646
2005,214,Dominican Republic,Chad,4,4,0
2005,68,Bolivia (Plurinational State of),Chad,1,1,0
2005,152,Chile,Chad,25,8,17
2005,36,Australia,Chad,40,20,20
2005,100,Bulgaria,Chad,4,3,1
2005,203,Czechia,Chad,6,5,1
2005,348,Hungary,Chad,1,0,1
2005,643,Russian Federation,Chad,131,104,27
2005,703,Slovakia,Chad,103,38,65
2005,208,Denmark,Chad,9,7,2
2005,246,Finland,Chad,5,4,1
2005,372,Ireland,Chad,12,8,4
2005,578,Norway,Chad,16,13,3
2005,752,Sweden,Chad,39,30,9
2005,826,United Kingdom,Chad,245,157,88
2005,300,Greece,Chad,22,13,9
2005,380,Italy,Chad,344,244,100
2005,705,Slovenia,Chad,1,1,0
2005,724,Spain,Chad,68,47,21
2005,40,Austria,Chad,10,6,4
2005,56,Belgium,Chad,305,189,116
2005,250,France,Chad,6219,3309,2910
2005,276,Germany,Chad,275,218,57
2005,528,Netherlands,Chad,103,70,33
2005,756,Switzerland,Chad,235,120,115
2005,124,Canada,Chad,668,372,296
2010,728,South Sudan,Chad,5327,3064,2263
2010,24,Angola,Chad,26,11,15
2010,120,Cameroon,Chad,49629,26284,23345
2010,140,Central African Republic,Chad,11488,6443,5045
2010,178,Congo,Chad,7949,5323,2626
2010,266,Gabon,Chad,2955,1818,1137
2010,204,Benin,Chad,780,472,308
2010,288,Ghana,Chad,13,10,3
2010,466,Mali,Chad,486,238,248
2010,478,Mauritania,Chad,51,33,18
2010,562,Niger,Chad,745,410,335
2010,566,Nigeria,Chad,24054,14006,10048
2010,694,Sierra Leone,Chad,1,1,0
2010,768,Togo,Chad,633,428,205
2010,818,Egypt,Chad,313,199,114
2010,434,Libya,Chad,763,571,192
2010,729,Sudan,Chad,80202,42462,37740
2010,48,Bahrain,Chad,401,272,129
2010,400,Jordan,Chad,59,48,11
2010,414,Kuwait,Chad,1136,740,396
2010,634,Qatar,Chad,663,532,131
2010,784,United Arab Emirates,Chad,4493,3152,1341
2010,214,Dominican Republic,Chad,3,3,0
2010,152,Chile,Chad,34,11,23
2010,36,Australia,Chad,60,30,30
2010,100,Bulgaria,Chad,5,4,1
2010,203,Czechia,Chad,7,6,1
2010,348,Hungary,Chad,1,0,1
2010,643,Russian Federation,Chad,149,123,26
2010,703,Slovakia,Chad,116,44,72
2010,208,Denmark,Chad,14,11,3
2010,246,Finland,Chad,9,8,1
2010,372,Ireland,Chad,10,7,3
2010,578,Norway,Chad,23,19,4
2010,752,Sweden,Chad,54,39,15
2010,826,United Kingdom,Chad,258,168,90
2010,300,Greece,Chad,19,8,11
2010,380,Italy,Chad,533,395,138
2010,724,Spain,Chad,95,65,30
2010,40,Austria,Chad,11,7,4
2010,56,Belgium,Chad,362,204,158
2010,250,France,Chad,6966,3815,3151
2010,276,Germany,Chad,256,185,71
2010,528,Netherlands,Chad,100,65,35
2010,756,Switzerland,Chad,286,137,149
2010,124,Canada,Chad,750,464,286
2015,728,South Sudan,Chad,5184,3122,2062
2015,24,Angola,Chad,31,13,18
2015,120,Cameroon,Chad,34740,18399,16341
2015,140,Central African Republic,Chad,10029,5594,4435
2015,178,Congo,Chad,10565,6926,3639
2015,266,Gabon,Chad,4132,2764,1368
2015,204,Benin,Chad,969,607,362
2015,288,Ghana,Chad,15,12,3
2015,324,Guinea,Chad,389,275,114
2015,466,Mali,Chad,602,295,307
2015,478,Mauritania,Chad,51,34,17
2015,562,Niger,Chad,756,416,340
2015,566,Nigeria,Chad,29175,16007,13168
2015,768,Togo,Chad,713,483,230
2015,818,Egypt,Chad,232,159,73
2015,434,Libya,Chad,860,641,219
2015,729,Sudan,Chad,74514,37631,36883
2015,48,Bahrain,Chad,430,290,140
2015,400,Jordan,Chad,25,20,5
2015,414,Kuwait,Chad,1305,788,517
2015,634,Qatar,Chad,512,418,94
2015,784,United Arab Emirates,Chad,4909,3386,1523
2015,214,Dominican Republic,Chad,3,3,0
2015,152,Chile,Chad,51,16,35
2015,36,Australia,Chad,70,40,30
2015,100,Bulgaria,Chad,5,4,1
2015,203,Czechia,Chad,6,5,1
2015,348,Hungary,Chad,1,1,0
2015,643,Russian Federation,Chad,152,126,26
2015,703,Slovakia,Chad,139,60,79
2015,208,Denmark,Chad,16,13,3
2015,246,Finland,Chad,8,6,2
2015,372,Ireland,Chad,10,7,3
2015,578,Norway,Chad,24,19,5
2015,752,Sweden,Chad,71,49,22
2015,826,United Kingdom,Chad,329,211,118
2015,300,Greece,Chad,17,7,10
2015,380,Italy,Chad,527,401,126
2015,705,Slovenia,Chad,1,1,0
2015,724,Spain,Chad,122,90,32
2015,40,Austria,Chad,12,8,4
2015,56,Belgium,Chad,496,278,218
2015,250,France,Chad,7716,4129,3587
2015,276,Germany,Chad,267,193,74
2015,528,Netherlands,Chad,85,55,30
2015,756,Switzerland,Chad,301,137,164
2015,124,Canada,Chad,1585,835,750
2019,728,South Sudan,Chad,5315,3200,2115
2019,24,Angola,Chad,1928,1157,771
2019,120,Cameroon,Chad,24318,12880,11438
2019,140,Central African Republic,Chad,11141,6221,4920
2019,178,Congo,Chad,10889,7136,3753
2019,266,Gabon,Chad,4489,3002,1487
2019,204,Benin,Chad,1032,648,384
2019,288,Ghana,Chad,16,13,3
2019,324,Guinea,Chad,371,263,108
2019,466,Mali,Chad,670,329,341
2019,478,Mauritania,Chad,52,35,17
2019,562,Niger,Chad,817,450,367
2019,566,Nigeria,Chad,30568,16771,13797
2019,768,Togo,Chad,717,487,230
2019,818,Egypt,Chad,330,214,116
2019,434,Libya,Chad,912,680,232
2019,729,Sudan,Chad,91890,45700,46190
2019,48,Bahrain,Chad,452,305,147
2019,400,Jordan,Chad,26,21,5
2019,414,Kuwait,Chad,1381,834,547
2019,634,Qatar,Chad,522,420,102
2019,784,United Arab Emirates,Chad,5272,3636,1636
2019,214,Dominican Republic,Chad,3,3,0
2019,152,Chile,Chad,68,19,49
2019,36,Australia,Chad,63,33,30
2019,100,Bulgaria,Chad,6,5,1
2019,203,Czechia,Chad,6,5,1
2019,348,Hungary,Chad,3,3,0
2019,643,Russian Federation,Chad,151,126,25
2019,703,Slovakia,Chad,138,61,77
2019,208,Denmark,Chad,22,11,11
2019,246,Finland,Chad,10,8,2
2019,372,Ireland,Chad,10,7,3
2019,578,Norway,Chad,34,25,9
2019,752,Sweden,Chad,126,83,43
2019,826,United Kingdom,Chad,373,240,133
2019,300,Greece,Chad,16,7,9
2019,380,Italy,Chad,551,409,142
2019,705,Slovenia,Chad,1,1,0
2019,724,Spain,Chad,126,93,33
2019,40,Austria,Chad,14,10,4
2019,56,Belgium,Chad,535,293,242
2019,250,France,Chad,8167,4362,3805
2019,276,Germany,Chad,758,589,169
2019,528,Netherlands,Chad,101,63,38
2019,756,Switzerland,Chad,318,148,170
2019,124,Canada,Chad,1698,895,803
1990,136,Cayman Islands,Channel Islands,4,3,1
1990,188,Costa Rica,Channel Islands,97,32,65
1990,833,Isle of Man,Channel Islands,182,105,77
1990,826,United Kingdom,Channel Islands,18441,8613,9828
1990,300,Greece,Channel Islands,2,2,0
1995,136,Cayman Islands,Channel Islands,8,4,4
1995,188,Costa Rica,Channel Islands,73,25,48
1995,833,Isle of Man,Channel Islands,195,114,81
1995,826,United Kingdom,Channel Islands,15347,7333,8014
1995,300,Greece,Channel Islands,3,1,2
2000,136,Cayman Islands,Channel Islands,15,7,8
2000,188,Costa Rica,Channel Islands,85,28,57
2000,833,Isle of Man,Channel Islands,208,124,84
2000,826,United Kingdom,Channel Islands,12513,6157,6356
2000,300,Greece,Channel Islands,4,0,4
2005,136,Cayman Islands,Channel Islands,14,7,7
2005,188,Costa Rica,Channel Islands,56,18,38
2005,833,Isle of Man,Channel Islands,232,133,99
2005,826,United Kingdom,Channel Islands,14541,7024,7517
2005,300,Greece,Channel Islands,3,0,3
2010,136,Cayman Islands,Channel Islands,15,7,8
2010,188,Costa Rica,Channel Islands,110,35,75
2010,833,Isle of Man,Channel Islands,253,140,113
2010,826,United Kingdom,Channel Islands,15318,7562,7756
2010,300,Greece,Channel Islands,2,0,2
2015,136,Cayman Islands,Channel Islands,15,8,7
2015,188,Costa Rica,Channel Islands,111,35,76
2015,833,Isle of Man,Channel Islands,170,97,73
2015,826,United Kingdom,Channel Islands,19589,9377,10212
2015,300,Greece,Channel Islands,1,0,1
2019,136,Cayman Islands,Channel Islands,16,8,8
2019,188,Costa Rica,Channel Islands,112,36,76
2019,833,Isle of Man,Channel Islands,172,98,74
2019,826,United Kingdom,Channel Islands,22245,10678,11567
1990,516,Namibia,Chile,48,34,14
1990,710,South Africa,Chile,650,408,242
1990,818,Egypt,Chile,21,8,13
1990,196,Cyprus,Chile,12,5,7
1990,376,Israel,Chile,2613,1228,1385
1990,792,Turkey,Chile,10,4,6
1990,608,Philippines,Chile,9,3,6
1990,44,Bahamas,Chile,9,5,4
1990,192,Cuba,Chile,393,214,179
1990,214,Dominican Republic,Chile,1891,1237,654
1990,332,Haiti,Chile,333,214,119
1990,630,Puerto Rico,Chile,924,438,486
1990,188,Costa Rica,Chile,1490,757,733
1990,222,El Salvador,Chile,380,172,208
1990,320,Guatemala,Chile,271,92,179
1990,340,Honduras,Chile,273,143,130
1990,484,Mexico,Chile,2783,1340,1443
1990,558,Nicaragua,Chile,144,94,50
1990,591,Panama,Chile,998,504,494
1990,32,Argentina,Chile,223528,117266,106262
1990,68,Bolivia (Plurinational State of),Chile,4807,2398,2409
1990,76,Brazil,Chile,22243,12936,9307
1990,170,Colombia,Chile,1859,874,985
1990,218,Ecuador,Chile,5302,2850,2452
1990,238,Falkland Islands (Malvinas),Chile,43,25,18
1990,600,Paraguay,Chile,2460,1366,1094
1990,604,Peru,Chile,4479,2090,2389
1990,858,Uruguay,Chile,1161,559,602
1990,862,Venezuela (Bolivarian Republic of),Chile,22198,11600,10598
1990,36,Australia,Chile,29145,14340,14805
1990,554,New Zealand,Chile,826,399,427
1990,100,Bulgaria,Chile,3,2,1
1990,203,Czechia,Chile,7,4,3
1990,348,Hungary,Chile,112,70,42
1990,616,Poland,Chile,33,21,12
1990,643,Russian Federation,Chile,638,313,325
1990,703,Slovakia,Chile,2,1,1
1990,208,Denmark,Chile,1070,538,532
1990,246,Finland,Chile,166,85,81
1990,352,Iceland,Chile,15,9,6
1990,372,Ireland,Chile,27,11,16
1990,428,Latvia,Chile,1,1,0
1990,578,Norway,Chile,5496,3117,2379
1990,752,Sweden,Chile,21091,10690,10401
1990,826,United Kingdom,Chile,717,415,302
1990,20,Andorra,Chile,68,36,32
1990,191,Croatia,Chile,122,43,79
1990,300,Greece,Chile,783,461,322
1990,380,Italy,Chile,8674,2913,5761
1990,620,Portugal,Chile,55,27,28
1990,705,Slovenia,Chile,7,4,3
1990,724,Spain,Chile,11887,5295,6592
1990,40,Austria,Chile,693,325,368
1990,56,Belgium,Chile,4908,2638,2270
1990,250,France,Chile,13207,6501,6706
1990,276,Germany,Chile,6888,3508,3380
1990,442,Luxembourg,Chile,56,29,27
1990,528,Netherlands,Chile,2655,1343,1312
1990,756,Switzerland,Chile,4716,2348,2368
1990,124,Canada,Chile,21945,10684,11261
1990,840,United States of America,Chile,55681,23396,32285
1995,516,Namibia,Chile,45,32,13
1995,710,South Africa,Chile,405,246,159
1995,818,Egypt,Chile,20,9,11
1995,196,Cyprus,Chile,17,6,11
1995,376,Israel,Chile,2900,1342,1558
1995,792,Turkey,Chile,25,9,16
1995,608,Philippines,Chile,12,4,8
1995,44,Bahamas,Chile,8,4,4
1995,192,Cuba,Chile,298,156,142
1995,214,Dominican Republic,Chile,2101,1357,744
1995,332,Haiti,Chile,316,203,113
1995,630,Puerto Rico,Chile,879,418,461
1995,188,Costa Rica,Chile,1127,586,541
1995,222,El Salvador,Chile,294,136,158
1995,320,Guatemala,Chile,231,95,136
1995,340,Honduras,Chile,252,128,124
1995,484,Mexico,Chile,4144,1909,2235
1995,558,Nicaragua,Chile,115,75,40
1995,591,Panama,Chile,997,506,491
1995,32,Argentina,Chile,214736,108853,105883
1995,68,Bolivia (Plurinational State of),Chile,4622,2348,2274
1995,76,Brazil,Chile,19708,11601,8107
1995,170,Colombia,Chile,1810,892,918
1995,218,Ecuador,Chile,5002,2711,2291
1995,238,Falkland Islands (Malvinas),Chile,42,25,17
1995,600,Paraguay,Chile,2425,1389,1036
1995,604,Peru,Chile,4483,2063,2420
1995,858,Uruguay,Chile,1299,625,674
1995,862,Venezuela (Bolivarian Republic of),Chile,18675,9742,8933
1995,36,Australia,Chile,27782,13567,14215
1995,554,New Zealand,Chile,1019,480,539
1995,100,Bulgaria,Chile,7,4,3
1995,203,Czechia,Chile,11,7,4
1995,348,Hungary,Chile,110,63,47
1995,616,Poland,Chile,28,18,10
1995,643,Russian Federation,Chile,662,328,334
1995,703,Slovakia,Chile,8,5,3
1995,208,Denmark,Chile,1198,600,598
1995,246,Finland,Chile,175,91,84
1995,352,Iceland,Chile,34,20,14
1995,372,Ireland,Chile,75,30,45
1995,428,Latvia,Chile,1,1,0
1995,578,Norway,Chile,5249,2885,2364
1995,752,Sweden,Chile,25029,12592,12437
1995,826,United Kingdom,Chile,2817,1300,1517
1995,20,Andorra,Chile,63,33,30
1995,191,Croatia,Chile,110,38,72
1995,300,Greece,Chile,582,303,279
1995,380,Italy,Chile,6919,2375,4544
1995,620,Portugal,Chile,119,58,61
1995,705,Slovenia,Chile,14,7,7
1995,724,Spain,Chile,14194,6449,7745
1995,40,Austria,Chile,782,374,408
1995,56,Belgium,Chile,4983,2604,2379
1995,250,France,Chile,13634,6595,7039
1995,276,Germany,Chile,6584,3114,3470
1995,442,Luxembourg,Chile,53,28,25
1995,528,Netherlands,Chile,2673,1330,1343
1995,756,Switzerland,Chile,4967,2535,2432
1995,124,Canada,Chile,23182,11230,11952
1995,840,United States of America,Chile,69155,29448,39707
2000,516,Namibia,Chile,44,31,13
2000,710,South Africa,Chile,281,151,130
2000,818,Egypt,Chile,20,10,10
2000,196,Cyprus,Chile,22,8,14
2000,376,Israel,Chile,3024,1396,1628
2000,792,Turkey,Chile,41,14,27
2000,608,Philippines,Chile,108,46,62
2000,44,Bahamas,Chile,8,5,3
2000,192,Cuba,Chile,203,99,104
2000,214,Dominican Republic,Chile,2310,1476,834
2000,332,Haiti,Chile,300,193,107
2000,630,Puerto Rico,Chile,837,398,439
2000,188,Costa Rica,Chile,1327,686,641
2000,222,El Salvador,Chile,207,99,108
2000,320,Guatemala,Chile,191,98,93
2000,340,Honduras,Chile,230,113,117
2000,484,Mexico,Chile,5685,2574,3111
2000,558,Nicaragua,Chile,111,69,42
2000,591,Panama,Chile,1060,538,522
2000,32,Argentina,Chile,205945,100442,105503
2000,68,Bolivia (Plurinational State of),Chile,4388,2271,2117
2000,76,Brazil,Chile,17172,10266,6906
2000,170,Colombia,Chile,1761,910,851
2000,218,Ecuador,Chile,4702,2572,2130
2000,238,Falkland Islands (Malvinas),Chile,65,39,26
2000,600,Paraguay,Chile,2382,1401,981
2000,604,Peru,Chile,5239,2424,2815
2000,858,Uruguay,Chile,1455,699,756
2000,862,Venezuela (Bolivarian Republic of),Chile,15733,8183,7550
2000,36,Australia,Chile,26080,12595,13485
2000,554,New Zealand,Chile,735,358,377
2000,100,Bulgaria,Chile,10,6,4
2000,203,Czechia,Chile,15,10,5
2000,348,Hungary,Chile,108,56,52
2000,616,Poland,Chile,24,15,9
2000,643,Russian Federation,Chile,662,331,331
2000,703,Slovakia,Chile,17,10,7
2000,208,Denmark,Chile,1326,662,664
2000,246,Finland,Chile,183,96,87
2000,352,Iceland,Chile,52,31,21
2000,372,Ireland,Chile,164,68,96
2000,428,Latvia,Chile,2,2,0
2000,578,Norway,Chile,5444,2922,2522
2000,752,Sweden,Chile,26842,13417,13425
2000,826,United Kingdom,Chile,4966,2204,2762
2000,20,Andorra,Chile,58,30,28
2000,191,Croatia,Chile,87,30,57
2000,300,Greece,Chile,391,146,245
2000,380,Italy,Chile,5164,1837,3327
2000,620,Portugal,Chile,188,91,97
2000,705,Slovenia,Chile,16,6,10
2000,724,Spain,Chile,22607,10585,12022
2000,40,Austria,Chile,870,422,448
2000,56,Belgium,Chile,4912,2500,2412
2000,250,France,Chile,14060,6688,7372
2000,276,Germany,Chile,6279,2719,3560
2000,442,Luxembourg,Chile,51,27,24
2000,528,Netherlands,Chile,2787,1361,1426
2000,756,Switzerland,Chile,5238,2739,2499
2000,124,Canada,Chile,24970,12046,12924
2000,840,United States of America,Chile,82855,35658,47197
2005,516,Namibia,Chile,34,24,10
2005,710,South Africa,Chile,369,189,180
2005,818,Egypt,Chile,24,13,11
2005,196,Cyprus,Chile,32,12,20
2005,376,Israel,Chile,3134,1447,1687
2005,792,Turkey,Chile,42,14,28
2005,608,Philippines,Chile,87,38,49
2005,44,Bahamas,Chile,20,9,11
2005,192,Cuba,Chile,135,66,69
2005,214,Dominican Republic,Chile,1460,908,552
2005,332,Haiti,Chile,284,183,101
2005,630,Puerto Rico,Chile,1007,477,530
2005,188,Costa Rica,Chile,869,444,425
2005,222,El Salvador,Chile,214,105,109
2005,320,Guatemala,Chile,227,128,99
2005,340,Honduras,Chile,226,113,113
2005,484,Mexico,Chile,5175,2524,2651
2005,558,Nicaragua,Chile,110,64,46
2005,591,Panama,Chile,1271,660,611
2005,32,Argentina,Chile,195316,92812,102504
2005,68,Bolivia (Plurinational State of),Chile,4230,2200,2030
2005,76,Brazil,Chile,16352,9780,6572
2005,170,Colombia,Chile,1679,896,783
2005,218,Ecuador,Chile,5551,3090,2461
2005,238,Falkland Islands (Malvinas),Chile,131,76,55
2005,600,Paraguay,Chile,2269,1335,934
2005,604,Peru,Chile,6155,2869,3286
2005,858,Uruguay,Chile,1347,648,699
2005,862,Venezuela (Bolivarian Republic of),Chile,15347,8008,7339
2005,36,Australia,Chile,26870,12948,13922
2005,554,New Zealand,Chile,1316,639,677
2005,100,Bulgaria,Chile,15,9,6
2005,203,Czechia,Chile,53,33,20
2005,348,Hungary,Chile,133,70,63
2005,616,Poland,Chile,41,24,17
2005,643,Russian Federation,Chile,386,199,187
2005,703,Slovakia,Chile,20,12,8
2005,208,Denmark,Chile,1403,692,711
2005,246,Finland,Chile,284,140,144
2005,352,Iceland,Chile,68,38,30
2005,372,Ireland,Chile,165,75,90
2005,428,Latvia,Chile,3,3,0
2005,578,Norway,Chile,5893,3119,2774
2005,752,Sweden,Chile,27811,13964,13847
2005,826,United Kingdom,Chile,5667,2559,3108
2005,20,Andorra,Chile,148,78,70
2005,191,Croatia,Chile,106,39,67
2005,300,Greece,Chile,383,140,243
2005,380,Italy,Chile,8795,3562,5233
2005,620,Portugal,Chile,196,94,102
2005,705,Slovenia,Chile,17,8,9
2005,724,Spain,Chile,49390,24552,24838
2005,40,Austria,Chile,973,460,513
2005,56,Belgium,Chile,4516,2229,2287
2005,250,France,Chile,13011,6276,6735
2005,276,Germany,Chile,9900,4628,5272
2005,442,Luxembourg,Chile,44,25,19
2005,528,Netherlands,Chile,3031,1450,1581
2005,756,Switzerland,Chile,5860,2934,2926
2005,124,Canada,Chile,24756,12053,12703
2005,840,United States of America,Chile,87860,38089,49771
2010,516,Namibia,Chile,32,23,9
2010,710,South Africa,Chile,577,295,282
2010,466,Mali,Chile,1253,681,572
2010,818,Egypt,Chile,26,14,12
2010,196,Cyprus,Chile,52,20,32
2010,376,Israel,Chile,3283,1514,1769
2010,792,Turkey,Chile,43,14,29
2010,608,Philippines,Chile,92,38,54
2010,44,Bahamas,Chile,32,14,18
2010,192,Cuba,Chile,75,37,38
2010,214,Dominican Republic,Chile,600,334,266
2010,332,Haiti,Chile,298,192,106
2010,630,Puerto Rico,Chile,1052,493,559
2010,188,Costa Rica,Chile,1713,877,836
2010,222,El Salvador,Chile,220,111,109
2010,320,Guatemala,Chile,262,157,105
2010,340,Honduras,Chile,221,112,109
2010,484,Mexico,Chile,5267,2772,2495
2010,558,Nicaragua,Chile,117,69,48
2010,591,Panama,Chile,1544,823,721
2010,32,Argentina,Chile,184687,85183,99504
2010,68,Bolivia (Plurinational State of),Chile,4063,2125,1938
2010,76,Brazil,Chile,15298,9146,6152
2010,170,Colombia,Chile,1889,1050,839
2010,218,Ecuador,Chile,7797,4252,3545
2010,238,Falkland Islands (Malvinas),Chile,181,103,78
2010,600,Paraguay,Chile,2161,1270,891
2010,604,Peru,Chile,7564,3735,3829
2010,858,Uruguay,Chile,1248,595,653
2010,862,Venezuela (Bolivarian Republic of),Chile,15123,7923,7200
2010,36,Australia,Chile,28280,13696,14584
2010,554,New Zealand,Chile,1924,932,992
2010,100,Bulgaria,Chile,20,12,8
2010,203,Czechia,Chile,85,53,32
2010,348,Hungary,Chile,158,84,74
2010,616,Poland,Chile,61,35,26
2010,642,Romania,Chile,2,1,1
2010,643,Russian Federation,Chile,104,64,40
2010,703,Slovakia,Chile,22,13,9
2010,208,Denmark,Chile,1453,710,743
2010,233,Estonia,Chile,8,8,0
2010,246,Finland,Chile,444,195,249
2010,352,Iceland,Chile,82,44,38
2010,372,Ireland,Chile,139,58,81
2010,428,Latvia,Chile,5,5,0
2010,578,Norway,Chile,6336,3335,3001
2010,752,Sweden,Chile,28378,14287,14091
2010,826,United Kingdom,Chile,5969,2763,3206
2010,20,Andorra,Chile,230,121,109
2010,191,Croatia,Chile,125,49,76
2010,300,Greece,Chile,390,141,249
2010,380,Italy,Chile,12765,5412,7353
2010,620,Portugal,Chile,172,82,90
2010,705,Slovenia,Chile,28,16,12
2010,724,Spain,Chile,64296,31720,32576
2010,40,Austria,Chile,1075,497,578
2010,56,Belgium,Chile,4004,1921,2083
2010,250,France,Chile,13523,6273,7250
2010,276,Germany,Chile,12897,6238,6659
2010,442,Luxembourg,Chile,38,22,16
2010,528,Netherlands,Chile,3050,1430,1620
2010,756,Switzerland,Chile,6921,3253,3668
2010,124,Canada,Chile,25195,12409,12786
2010,840,United States of America,Chile,95695,40740,54955
2015,516,Namibia,Chile,31,23,8
2015,710,South Africa,Chile,1040,506,534
2015,324,Guinea,Chile,11,8,3
2015,466,Mali,Chile,1552,844,708
2015,818,Egypt,Chile,19,12,7
2015,196,Cyprus,Chile,49,19,30
2015,376,Israel,Chile,3386,1553,1833
2015,792,Turkey,Chile,43,13,30
2015,608,Philippines,Chile,93,39,54
2015,44,Bahamas,Chile,35,15,20
2015,192,Cuba,Chile,60,30,30
2015,214,Dominican Republic,Chile,633,353,280
2015,332,Haiti,Chile,312,201,111
2015,630,Puerto Rico,Chile,789,368,421
2015,188,Costa Rica,Chile,1739,885,854
2015,222,El Salvador,Chile,229,115,114
2015,320,Guatemala,Chile,301,182,119
2015,340,Honduras,Chile,309,157,152
2015,484,Mexico,Chile,6212,3074,3138
2015,558,Nicaragua,Chile,126,75,51
2015,591,Panama,Chile,1813,965,848
2015,32,Argentina,Chile,213119,98228,114891
2015,68,Bolivia (Plurinational State of),Chile,4730,2474,2256
2015,76,Brazil,Chile,18422,11014,7408
2015,170,Colombia,Chile,2114,1184,930
2015,218,Ecuador,Chile,11341,6148,5193
2015,238,Falkland Islands (Malvinas),Chile,198,111,87
2015,600,Paraguay,Chile,2109,1239,870
2015,604,Peru,Chile,9437,4983,4454
2015,858,Uruguay,Chile,1288,614,674
2015,862,Venezuela (Bolivarian Republic of),Chile,15263,7894,7369
2015,36,Australia,Chile,30180,14772,15408
2015,554,New Zealand,Chile,2503,1211,1292
2015,100,Bulgaria,Chile,22,14,8
2015,203,Czechia,Chile,122,75,47
2015,348,Hungary,Chile,141,74,67
2015,616,Poland,Chile,58,34,24
2015,642,Romania,Chile,25,13,12
2015,643,Russian Federation,Chile,107,66,41
2015,703,Slovakia,Chile,28,17,11
2015,208,Denmark,Chile,1677,838,839
2015,233,Estonia,Chile,13,12,1
2015,246,Finland,Chile,527,250,277
2015,352,Iceland,Chile,77,46,31
2015,372,Ireland,Chile,142,58,84
2015,428,Latvia,Chile,5,4,1
2015,578,Norway,Chile,6658,3456,3202
2015,752,Sweden,Chile,28072,14162,13910
2015,826,United Kingdom,Chile,7633,3412,4221
2015,20,Andorra,Chile,214,115,99
2015,191,Croatia,Chile,126,49,77
2015,300,Greece,Chile,366,123,243
2015,380,Italy,Chile,12138,5052,7086
2015,620,Portugal,Chile,194,88,106
2015,705,Slovenia,Chile,28,17,11
2015,724,Spain,Chile,54400,26031,28369
2015,40,Austria,Chile,1258,586,672
2015,56,Belgium,Chile,4223,2015,2208
2015,250,France,Chile,14981,6729,8252
2015,276,Germany,Chile,13438,6483,6955
2015,442,Luxembourg,Chile,57,33,24
2015,528,Netherlands,Chile,3328,1559,1769
2015,756,Switzerland,Chile,7222,3369,3853
2015,124,Canada,Chile,26541,13078,13463
2015,840,United States of America,Chile,106717,45119,61598
2019,516,Namibia,Chile,32,24,8
2019,710,South Africa,Chile,1165,568,597
2019,324,Guinea,Chile,10,8,2
2019,466,Mali,Chile,1728,940,788
2019,818,Egypt,Chile,27,16,11
2019,196,Cyprus,Chile,48,19,29
2019,376,Israel,Chile,3292,1510,1782
2019,792,Turkey,Chile,58,18,40
2019,608,Philippines,Chile,95,40,55
2019,44,Bahamas,Chile,37,16,21
2019,192,Cuba,Chile,55,28,27
2019,214,Dominican Republic,Chile,654,365,289
2019,332,Haiti,Chile,324,209,115
2019,630,Puerto Rico,Chile,4,2,2
2019,188,Costa Rica,Chile,1764,904,860
2019,222,El Salvador,Chile,232,117,115
2019,320,Guatemala,Chile,308,186,122
2019,340,Honduras,Chile,313,159,154
2019,484,Mexico,Chile,6404,3169,3235
2019,558,Nicaragua,Chile,131,78,53
2019,591,Panama,Chile,1930,1029,901
2019,32,Argentina,Chile,216855,99758,117097
2019,68,Bolivia (Plurinational State of),Chile,5164,2701,2463
2019,76,Brazil,Chile,20747,12405,8342
2019,170,Colombia,Chile,2162,1211,951
2019,218,Ecuador,Chile,11165,6051,5114
2019,238,Falkland Islands (Malvinas),Chile,239,134,105
2019,600,Paraguay,Chile,2163,1271,892
2019,604,Peru,Chile,11249,6156,5093
2019,858,Uruguay,Chile,1331,637,694
2019,862,Venezuela (Bolivarian Republic of),Chile,14950,7700,7250
2019,36,Australia,Chile,33707,16472,17235
2019,554,New Zealand,Chile,2572,1244,1328
2019,100,Bulgaria,Chile,26,16,10
2019,203,Czechia,Chile,155,96,59
2019,348,Hungary,Chile,155,82,73
2019,616,Poland,Chile,61,37,24
2019,642,Romania,Chile,57,29,28
2019,643,Russian Federation,Chile,106,66,40
2019,703,Slovakia,Chile,29,17,12
2019,208,Denmark,Chile,2000,1006,994
2019,233,Estonia,Chile,22,20,2
2019,246,Finland,Chile,620,310,310
2019,352,Iceland,Chile,83,51,32
2019,372,Ireland,Chile,155,64,91
2019,428,Latvia,Chile,5,5,0
2019,578,Norway,Chile,7207,3724,3483
2019,752,Sweden,Chile,27855,14018,13837
2019,826,United Kingdom,Chile,8668,3887,4781
2019,20,Andorra,Chile,228,124,104
2019,191,Croatia,Chile,116,45,71
2019,300,Greece,Chile,357,129,228
2019,380,Italy,Chile,12775,5407,7368
2019,620,Portugal,Chile,197,90,107
2019,705,Slovenia,Chile,34,18,16
2019,724,Spain,Chile,56704,26647,30057
2019,40,Austria,Chile,1485,706,779
2019,56,Belgium,Chile,4450,2162,2288
2019,250,France,Chile,15857,7103,8754
2019,276,Germany,Chile,14741,7413,7328
2019,442,Luxembourg,Chile,227,103,124
2019,528,Netherlands,Chile,3769,1818,1951
2019,756,Switzerland,Chile,7512,3509,4003
2019,124,Canada,Chile,28441,14014,14427
2019,840,United States of America,Chile,115243,48008,67235
1990,232,Eritrea,China,8,2,6
1990,450,Madagascar,China,1481,827,654
1990,480,Mauritius,China,346,270,76
1990,690,Seychelles,China,58,43,15
1990,800,Uganda,China,137,98,39
1990,894,Zambia,China,100,72,28
1990,178,Congo,China,283,260,23
1990,266,Gabon,China,107,76,31
1990,72,Botswana,China,874,844,30
1990,426,Lesotho,China,162,92,70
1990,516,Namibia,China,4593,3287,1306
1990,710,South Africa,China,8690,3804,4886
1990,132,Cabo Verde,China,30,14,16
1990,288,Ghana,China,121,99,22
1990,324,Guinea,China,134,102,32
1990,466,Mali,China,301,242,59
1990,478,Mauritania,China,142,19,123
1990,694,Sierra Leone,China,280,273,7
1990,768,Togo,China,247,199,48
1990,818,Egypt,China,479,394,85
1990,434,Libya,China,1366,1125,241
1990,729,Sudan,China,1678,863,815
1990,196,Cyprus,China,398,204,194
1990,268,Georgia,China,421,186,235
1990,376,Israel,China,1027,468,559
1990,400,Jordan,China,192,103,89
1990,422,Lebanon,China,88,47,41
1990,792,Turkey,China,529,289,240
1990,398,Kazakhstan,China,695,367,328
1990,417,Kyrgyzstan,China,770,325,445
1990,762,Tajikistan,China,74,33,41
1990,50,Bangladesh,China,140163,75689,64474
1990,64,Bhutan,China,422,225,197
1990,356,India,China,18165,10785,7380
1990,524,Nepal,China,21906,9448,12458
1990,586,Pakistan,China,490,283,207
1990,144,Sri Lanka,China,37,30,7
1990,344,"China, Hong Kong SAR",China,1659157,920641,738516
1990,446,"China, Macao SAR",China,172346,80292,92054
1990,408,Dem. People's Republic of Korea,China,19668,10741,8927
1990,392,Japan,China,150383,74831,75552
1990,496,Mongolia,China,1649,944,705
1990,410,Republic of Korea,China,19827,10564,9263
1990,96,Brunei Darussalam,China,1509,809,700
1990,116,Cambodia,China,707,412,295
1990,360,Indonesia,China,258310,121854,136456
1990,418,Lao People's Democratic Republic,China,4125,2251,1874
1990,458,Malaysia,China,91377,45422,45955
1990,104,Myanmar,China,72413,38077,34336
1990,608,Philippines,China,53792,28456,25336
1990,702,Singapore,China,150447,70486,79961
1990,764,Thailand,China,58,39,19
1990,626,Timor-Leste,China,928,588,340
1990,704,Viet Nam,China,612,323,289
1990,28,Antigua and Barbuda,China,57,27,30
1990,533,Aruba,China,247,154,93
1990,44,Bahamas,China,67,43,24
1990,535,"Bonaire, Sint Eustatius and Saba",China,23,13,10
1990,192,Cuba,China,658,507,151
1990,212,Dominica,China,14,9,5
1990,214,Dominican Republic,China,3613,2061,1552
1990,332,Haiti,China,348,201,147
1990,474,Martinique,China,68,33,35
1990,630,Puerto Rico,China,339,161,178
1990,662,Saint Lucia,China,21,10,11
1990,780,Trinidad and Tobago,China,469,242,227
1990,84,Belize,China,551,340,211
1990,188,Costa Rica,China,252,159,93
1990,222,El Salvador,China,260,168,92
1990,320,Guatemala,China,307,133,174
1990,340,Honduras,China,394,255,139
1990,484,Mexico,China,1240,784,456
1990,558,Nicaragua,China,55,44,11
1990,591,Panama,China,10235,5942,4293
1990,32,Argentina,China,4268,2149,2119
1990,68,Bolivia (Plurinational State of),China,805,504,301
1990,76,Brazil,China,8532,4565,3967
1990,152,Chile,China,1124,653,471
1990,170,Colombia,China,1233,709,524
1990,218,Ecuador,China,654,390,264
1990,254,French Guiana,China,961,514,447
1990,328,Guyana,China,263,154,109
1990,600,Paraguay,China,1953,1089,864
1990,604,Peru,China,2548,1405,1143
1990,740,Suriname,China,2055,1109,946
1990,862,Venezuela (Bolivarian Republic of),China,6458,3768,2690
1990,36,Australia,China,97526,51145,46381
1990,554,New Zealand,China,9059,4531,4528
1990,242,Fiji,China,848,452,396
1990,540,New Caledonia,China,77,41,36
1990,598,Papua New Guinea,China,135,50,85
1990,90,Solomon Islands,China,241,133,108
1990,316,Guam,China,1719,1249,470
1990,584,Marshall Islands,China,40,35,5
1990,520,Nauru,China,504,295,209
1990,580,Northern Mariana Islands,China,2598,638,1960
1990,585,Palau,China,320,229,91
1990,16,American Samoa,China,100,71,29
1990,258,French Polynesia,China,546,274,272
1990,882,Samoa,China,93,73,20
1990,776,Tonga,China,91,55,36
1990,100,Bulgaria,China,362,211,151
1990,203,Czechia,China,303,182,121
1990,348,Hungary,China,941,419,522
1990,616,Poland,China,922,443,479
1990,642,Romania,China,605,346,259
1990,643,Russian Federation,China,67405,33076,34329
1990,703,Slovakia,China,49,26,23
1990,804,Ukraine,China,7924,4888,3036
1990,208,Denmark,China,1301,637,664
1990,233,Estonia,China,59,28,31
1990,234,Faroe Islands,China,1,1,0
1990,246,Finland,China,428,253,175
1990,352,Iceland,China,58,26,32
1990,372,Ireland,China,563,277,286
1990,428,Latvia,China,24,10,14
1990,440,Lithuania,China,157,92,65
1990,578,Norway,China,1862,1069,793
1990,752,Sweden,China,6920,2853,4067
1990,826,United Kingdom,China,23384,10926,12458
1990,300,Greece,China,329,234,95
1990,380,Italy,China,32172,14849,17323
1990,470,Malta,China,148,63,85
1990,620,Portugal,China,673,349,324
1990,688,Serbia,China,216,123,93
1990,705,Slovenia,China,61,31,30
1990,724,Spain,China,8432,4470,3962
1990,40,Austria,China,9703,4371,5332
1990,56,Belgium,China,4851,2747,2104
1990,250,France,China,41681,19645,22036
1990,276,Germany,China,19834,14297,5537
1990,438,Liechtenstein,China,28,14,14
1990,442,Luxembourg,China,1017,497,520
1990,528,Netherlands,China,20779,10382,10397
1990,756,Switzerland,China,8082,3515,4567
1990,60,Bermuda,China,85,56,29
1990,124,Canada,China,168079,81825,86254
1990,840,United States of America,China,773939,378564,395375
1995,232,Eritrea,China,53,45,8
1995,450,Madagascar,China,1312,738,574
1995,480,Mauritius,China,3273,628,2645
1995,690,Seychelles,China,80,66,14
1995,800,Uganda,China,129,91,38
1995,894,Zambia,China,128,93,35
1995,178,Congo,China,327,299,28
1995,266,Gabon,China,143,102,41
1995,72,Botswana,China,1055,1018,37
1995,426,Lesotho,China,140,80,60
1995,516,Namibia,China,4392,3151,1241
1995,710,South Africa,China,8051,4170,3881
1995,132,Cabo Verde,China,41,20,21
1995,288,Ghana,China,121,101,20
1995,324,Guinea,China,154,122,32
1995,466,Mali,China,190,145,45
1995,478,Mauritania,China,151,32,119
1995,694,Sierra Leone,China,273,266,7
1995,768,Togo,China,278,224,54
1995,818,Egypt,China,501,370,131
1995,434,Libya,China,1800,1293,507
1995,729,Sudan,China,1711,882,829
1995,196,Cyprus,China,563,277,286
1995,268,Georgia,China,337,159,178
1995,376,Israel,China,1002,449,553
1995,400,Jordan,China,5718,646,5072
1995,422,Lebanon,China,2596,77,2519
1995,792,Turkey,China,1020,511,509
1995,398,Kazakhstan,China,1142,611,531
1995,417,Kyrgyzstan,China,612,278,334
1995,762,Tajikistan,China,60,35,25
1995,50,Bangladesh,China,131427,70971,60456
1995,64,Bhutan,China,496,264,232
1995,356,India,China,98000,50768,47232
1995,524,Nepal,China,25260,12500,12760
1995,586,Pakistan,China,410,237,173
1995,144,Sri Lanka,China,312,285,27
1995,344,"China, Hong Kong SAR",China,1772597,949254,823343
1995,446,"China, Macao SAR",China,189060,86329,102731
1995,408,Dem. People's Republic of Korea,China,19590,10522,9068
1995,392,Japan,China,222311,110050,112261
1995,496,Mongolia,China,1821,1081,740
1995,410,Republic of Korea,China,48299,24455,23844
1995,96,Brunei Darussalam,China,1718,929,789
1995,116,Cambodia,China,1853,1077,776
1995,360,Indonesia,China,170906,82982,87924
1995,418,Lao People's Democratic Republic,China,3743,2044,1699
1995,458,Malaysia,China,65974,32710,33264
1995,104,Myanmar,China,55637,29002,26635
1995,608,Philippines,China,72391,37615,34776
1995,702,Singapore,China,191075,86902,104173
1995,764,Thailand,China,116,74,42
1995,626,Timor-Leste,China,1012,637,375
1995,704,Viet Nam,China,1192,650,542
1995,28,Antigua and Barbuda,China,84,40,44
1995,533,Aruba,China,435,242,193
1995,44,Bahamas,China,80,51,29
1995,535,"Bonaire, Sint Eustatius and Saba",China,48,27,21
1995,192,Cuba,China,499,380,119
1995,212,Dominica,China,19,13,6
1995,214,Dominican Republic,China,4013,2247,1766
1995,332,Haiti,China,330,191,139
1995,474,Martinique,China,103,55,48
1995,630,Puerto Rico,China,826,393,433
1995,662,Saint Lucia,China,27,13,14
1995,780,Trinidad and Tobago,China,425,219,206
1995,84,Belize,China,823,473,350
1995,188,Costa Rica,China,190,121,69
1995,222,El Salvador,China,224,143,81
1995,320,Guatemala,China,361,173,188
1995,340,Honduras,China,419,266,153
1995,484,Mexico,China,1911,1049,862
1995,558,Nicaragua,China,44,35,9
1995,591,Panama,China,10439,5863,4576
1995,32,Argentina,China,5850,3107,2743
1995,68,Bolivia (Plurinational State of),China,675,424,251
1995,76,Brazil,China,9429,5115,4314
1995,152,Chile,China,1691,927,764
1995,170,Colombia,China,1392,790,602
1995,218,Ecuador,China,934,557,377
1995,254,French Guiana,China,1201,614,587
1995,328,Guyana,China,422,249,173
1995,600,Paraguay,China,1419,794,625
1995,604,Peru,China,2551,1393,1158
1995,740,Suriname,China,2538,1374,1164
1995,862,Venezuela (Bolivarian Republic of),China,8067,4573,3494
1995,36,Australia,China,108346,54255,54091
1995,554,New Zealand,China,18991,9179,9812
1995,242,Fiji,China,835,441,394
1995,540,New Caledonia,China,89,47,42
1995,598,Papua New Guinea,China,138,50,88
1995,90,Solomon Islands,China,239,132,107
1995,316,Guam,China,2215,1315,900
1995,584,Marshall Islands,China,89,61,28
1995,520,Nauru,China,466,273,193
1995,580,Northern Mariana Islands,China,7844,1928,5916
1995,585,Palau,China,543,366,177
1995,16,American Samoa,China,200,141,59
1995,258,French Polynesia,China,599,293,306
1995,882,Samoa,China,84,66,18
1995,776,Tonga,China,103,64,39
1995,100,Bulgaria,China,443,247,196
1995,203,Czechia,China,454,278,176
1995,348,Hungary,China,4242,2194,2048
1995,616,Poland,China,788,373,415
1995,642,Romania,China,1331,766,565
1995,643,Russian Federation,China,64969,34661,30308
1995,703,Slovakia,China,320,154,166
1995,804,Ukraine,China,7666,4812,2854
1995,208,Denmark,China,2441,1070,1371
1995,233,Estonia,China,92,44,48
1995,246,Finland,China,1106,560,546
1995,352,Iceland,China,118,55,63
1995,372,Ireland,China,3056,1456,1600
1995,428,Latvia,China,175,93,82
1995,440,Lithuania,China,175,103,72
1995,578,Norway,China,2878,1411,1467
1995,752,Sweden,China,8212,3349,4863
1995,826,United Kingdom,China,83030,40188,42842
1995,300,Greece,China,441,276,165
1995,380,Italy,China,53519,25410,28109
1995,470,Malta,China,173,75,98
1995,620,Portugal,China,1452,752,700
1995,688,Serbia,China,1375,767,608
1995,705,Slovenia,China,132,76,56
1995,724,Spain,China,4349,2291,2058
1995,40,Austria,China,10934,4993,5941
1995,56,Belgium,China,5889,2971,2918
1995,250,France,China,43028,19896,23132
1995,276,Germany,China,34512,20740,13772
1995,438,Liechtenstein,China,40,21,19
1995,442,Luxembourg,China,966,470,496
1995,528,Netherlands,China,26141,12795,13346
1995,756,Switzerland,China,9792,4325,5467
1995,60,Bermuda,China,128,83,45
1995,124,Canada,China,286712,138663,148049
1995,840,United States of America,China,1058487,519973,538514
2000,232,Eritrea,China,98,88,10
2000,450,Madagascar,China,1458,820,638
2000,480,Mauritius,China,8024,849,7175
2000,690,Seychelles,China,103,89,14
2000,800,Uganda,China,374,240,134
2000,894,Zambia,China,166,120,46
2000,178,Congo,China,459,419,40
2000,266,Gabon,China,179,128,51
2000,72,Botswana,China,1348,1301,47
2000,426,Lesotho,China,114,65,49
2000,516,Namibia,China,4078,2931,1147
2000,710,South Africa,China,9841,5634,4207
2000,132,Cabo Verde,China,51,26,25
2000,288,Ghana,China,135,111,24
2000,324,Guinea,China,166,131,35
2000,466,Mali,China,76,46,30
2000,478,Mauritania,China,156,46,110
2000,694,Sierra Leone,China,266,259,7
2000,768,Togo,China,313,253,60
2000,818,Egypt,China,562,375,187
2000,434,Libya,China,2264,1494,770
2000,729,Sudan,China,1746,901,845
2000,196,Cyprus,China,728,351,377
2000,268,Georgia,China,74,36,38
2000,376,Israel,China,921,411,510
2000,400,Jordan,China,11240,1232,10008
2000,422,Lebanon,China,5103,107,4996
2000,792,Turkey,China,1634,810,824
2000,398,Kazakhstan,China,1588,855,733
2000,417,Kyrgyzstan,China,438,223,215
2000,762,Tajikistan,China,52,32,20
2000,50,Bangladesh,China,122691,66254,56437
2000,64,Bhutan,China,570,304,266
2000,356,India,China,92343,47583,44760
2000,524,Nepal,China,22820,13348,9472
2000,586,Pakistan,China,363,210,153
2000,144,Sri Lanka,China,588,534,54
2000,344,"China, Hong Kong SAR",China,1886037,977867,908170
2000,446,"China, Macao SAR",China,204282,90635,113647
2000,408,Dem. People's Republic of Korea,China,19511,10302,9209
2000,392,Japan,China,335600,155039,180561
2000,496,Mongolia,China,2013,1235,778
2000,410,Republic of Korea,China,92142,47637,44505
2000,96,Brunei Darussalam,China,1926,1048,878
2000,116,Cambodia,China,2998,1742,1256
2000,360,Indonesia,China,83502,44109,39393
2000,418,Lao People's Democratic Republic,China,3005,1664,1341
2000,458,Malaysia,China,54430,26406,28024
2000,104,Myanmar,China,44999,23227,21772
2000,608,Philippines,China,88418,44141,44277
2000,702,Singapore,China,250198,109883,140315
2000,764,Thailand,China,200,124,76
2000,626,Timor-Leste,China,1104,690,414
2000,704,Viet Nam,China,2573,1481,1092
2000,28,Antigua and Barbuda,China,110,53,57
2000,533,Aruba,China,622,330,292
2000,44,Bahamas,China,93,59,34
2000,535,"Bonaire, Sint Eustatius and Saba",China,74,42,32
2000,192,Cuba,China,339,252,87
2000,212,Dominica,China,23,16,7
2000,214,Dominican Republic,China,4413,2434,1979
2000,332,Haiti,China,313,181,132
2000,474,Martinique,China,139,77,62
2000,630,Puerto Rico,China,1315,624,691
2000,662,Saint Lucia,China,38,19,19
2000,780,Trinidad and Tobago,China,461,240,221
2000,84,Belize,China,1094,605,489
2000,188,Costa Rica,China,222,140,82
2000,222,El Salvador,China,187,117,70
2000,320,Guatemala,China,415,214,201
2000,340,Honduras,China,443,277,166
2000,484,Mexico,China,2665,1363,1302
2000,558,Nicaragua,China,81,56,25
2000,591,Panama,China,11300,6124,5176
2000,32,Argentina,China,7432,4066,3366
2000,68,Bolivia (Plurinational State of),China,538,339,199
2000,76,Brazil,China,10326,5665,4661
2000,152,Chile,China,2258,1232,1026
2000,170,Colombia,China,1551,871,680
2000,218,Ecuador,China,1214,724,490
2000,254,French Guiana,China,1440,713,727
2000,328,Guyana,China,580,343,237
2000,600,Paraguay,China,882,494,388
2000,604,Peru,China,2981,1634,1347
2000,740,Suriname,China,3135,1697,1438
2000,862,Venezuela (Bolivarian Republic of),China,9988,5483,4505
2000,36,Australia,China,144690,69016,75674
2000,554,New Zealand,China,37900,18421,19479
2000,242,Fiji,China,833,440,393
2000,540,New Caledonia,China,101,52,49
2000,598,Papua New Guinea,China,103,28,75
2000,90,Solomon Islands,China,228,126,102
2000,316,Guam,China,2710,1380,1330
2000,584,Marshall Islands,China,153,107,46
2000,520,Nauru,China,428,251,177
2000,580,Northern Mariana Islands,China,13566,2973,10593
2000,585,Palau,China,1079,624,455
2000,16,American Samoa,China,299,210,89
2000,258,French Polynesia,China,641,307,334
2000,882,Samoa,China,75,59,16
2000,776,Tonga,China,115,72,43
2000,100,Bulgaria,China,524,283,241
2000,203,Czechia,China,605,374,231
2000,348,Hungary,China,7543,3969,3574
2000,616,Poland,China,674,313,361
2000,642,Romania,China,2100,1209,891
2000,643,Russian Federation,China,60177,35000,25177
2000,703,Slovakia,China,681,325,356
2000,804,Ukraine,China,7502,4795,2707
2000,208,Denmark,China,3580,1502,2078
2000,233,Estonia,China,124,59,65
2000,234,Faroe Islands,China,1,1,0
2000,246,Finland,China,1783,866,917
2000,352,Iceland,China,177,83,94
2000,372,Ireland,China,7229,3562,3667
2000,428,Latvia,China,326,175,151
2000,440,Lithuania,China,137,81,56
2000,578,Norway,China,3617,1410,2207
2000,752,Sweden,China,8150,3320,4830
2000,826,United Kingdom,China,144073,70015,74058
2000,300,Greece,China,560,320,240
2000,380,Italy,China,74865,35971,38894
2000,470,Malta,China,220,97,123
2000,620,Portugal,China,2291,1188,1103
2000,688,Serbia,China,1870,1026,844
2000,705,Slovenia,China,201,122,79
2000,724,Spain,China,2138,1152,986
2000,40,Austria,China,12165,5615,6550
2000,56,Belgium,China,6757,3121,3636
2000,250,France,China,44375,20148,24227
2000,276,Germany,China,49190,27184,22006
2000,438,Liechtenstein,China,52,27,25
2000,442,Luxembourg,China,927,450,477
2000,528,Netherlands,China,32395,15607,16788
2000,756,Switzerland,China,11538,5167,6371
2000,60,Bermuda,China,170,109,61
2000,124,Canada,China,412162,198829,213333
2000,304,Greenland,China,1,1,0
2000,840,United States of America,China,1348465,664923,683542
2005,232,Eritrea,China,115,104,11
2005,450,Madagascar,China,1609,906,703
2005,480,Mauritius,China,5151,774,4377
2005,690,Seychelles,China,279,243,36
2005,800,Uganda,China,362,231,131
2005,894,Zambia,China,408,295,113
2005,178,Congo,China,292,273,19
2005,266,Gabon,China,195,140,55
2005,72,Botswana,China,2724,2286,438
2005,426,Lesotho,China,116,66,50
2005,516,Namibia,China,3224,2312,912
2005,710,South Africa,China,12947,7169,5778
2005,132,Cabo Verde,China,37,18,19
2005,288,Ghana,China,190,158,32
2005,324,Guinea,China,116,94,22
2005,466,Mali,China,307,185,122
2005,478,Mauritania,China,157,51,106
2005,694,Sierra Leone,China,221,216,5
2005,768,Togo,China,352,285,67
2005,818,Egypt,China,669,460,209
2005,434,Libya,China,2493,1796,697
2005,729,Sudan,China,1890,976,914
2005,196,Cyprus,China,1065,510,555
2005,268,Georgia,China,70,34,36
2005,376,Israel,China,747,333,414
2005,400,Jordan,China,16235,3533,12702
2005,422,Lebanon,China,3994,242,3752
2005,792,Turkey,China,1695,822,873
2005,398,Kazakhstan,China,1811,997,814
2005,417,Kyrgyzstan,China,375,191,184
2005,762,Tajikistan,China,50,31,19
2005,50,Bangladesh,China,145405,78519,66886
2005,64,Bhutan,China,714,376,338
2005,356,India,China,77200,39684,37516
2005,524,Nepal,China,19775,10790,8985
2005,586,Pakistan,China,347,201,146
2005,144,Sri Lanka,China,1153,1011,142
2005,344,"China, Hong Kong SAR",China,2070537,991785,1078752
2005,446,"China, Macao SAR",China,236962,108158,128804
2005,408,Dem. People's Republic of Korea,China,22740,11808,10932
2005,392,Japan,China,648120,296819,351301
2005,496,Mongolia,China,4994,4057,937
2005,410,Republic of Korea,China,243217,121985,121232
2005,96,Brunei Darussalam,China,1969,1077,892
2005,116,Cambodia,China,2340,1387,953
2005,360,Indonesia,China,72094,40757,31337
2005,418,Lao People's Democratic Republic,China,2820,1596,1224
2005,458,Malaysia,China,29909,14796,15113
2005,104,Myanmar,China,38118,19832,18286
2005,608,Philippines,China,71566,36289,35277
2005,702,Singapore,China,299651,126904,172747
2005,764,Thailand,China,33311,21444,11867
2005,626,Timor-Leste,China,1172,781,391
2005,704,Viet Nam,China,2661,1604,1057
2005,28,Antigua and Barbuda,China,118,57,61
2005,533,Aruba,China,855,444,411
2005,44,Bahamas,China,126,75,51
2005,52,Barbados,China,30,17,13
2005,535,"Bonaire, Sint Eustatius and Saba",China,78,44,34
2005,192,Cuba,China,227,169,58
2005,212,Dominica,China,27,19,8
2005,214,Dominican Republic,China,2920,1617,1303
2005,332,Haiti,China,297,172,125
2005,474,Martinique,China,145,79,66
2005,630,Puerto Rico,China,1422,673,749
2005,662,Saint Lucia,China,48,24,24
2005,534,Sint Maarten (Dutch part),China,83,44,39
2005,780,Trinidad and Tobago,China,494,257,237
2005,84,Belize,China,1378,760,618
2005,188,Costa Rica,China,146,92,54
2005,222,El Salvador,China,218,135,83
2005,320,Guatemala,China,493,260,233
2005,340,Honduras,China,434,273,161
2005,484,Mexico,China,4696,2524,2172
2005,558,Nicaragua,China,121,78,43
2005,591,Panama,China,13280,7047,6233
2005,32,Argentina,China,9954,5375,4579
2005,68,Bolivia (Plurinational State of),China,754,472,282
2005,76,Brazil,China,14884,8099,6785
2005,152,Chile,China,3733,2065,1668
2005,170,Colombia,China,1588,893,695
2005,218,Ecuador,China,1433,867,566
2005,254,French Guiana,China,1236,614,622
2005,328,Guyana,China,780,465,315
2005,600,Paraguay,China,840,471,369
2005,604,Peru,China,3502,1930,1572
2005,740,Suriname,China,3836,2090,1746
2005,862,Venezuela (Bolivarian Republic of),China,11278,6394,4884
2005,36,Australia,China,227600,104773,122827
2005,554,New Zealand,China,74705,36260,38445
2005,242,Fiji,China,836,441,395
2005,540,New Caledonia,China,107,56,51
2005,598,Papua New Guinea,China,103,31,72
2005,90,Solomon Islands,China,213,119,94
2005,316,Guam,China,2422,1241,1181
2005,584,Marshall Islands,China,231,156,75
2005,520,Nauru,China,402,233,169
2005,580,Northern Mariana Islands,China,9611,1840,7771
2005,585,Palau,China,550,389,161
2005,16,American Samoa,China,450,314,136
2005,258,French Polynesia,China,671,323,348
2005,882,Samoa,China,70,55,15
2005,776,Tonga,China,134,85,49
2005,100,Bulgaria,China,689,374,315
2005,203,Czechia,China,2714,1507,1207
2005,348,Hungary,China,9317,4981,4336
2005,616,Poland,China,932,421,511
2005,642,Romania,China,2101,1228,873
2005,643,Russian Federation,China,58247,33333,24914
2005,703,Slovakia,China,764,371,393
2005,804,Ukraine,China,6854,4384,2470
2005,208,Denmark,China,7229,2815,4414
2005,233,Estonia,China,163,81,82
2005,234,Faroe Islands,China,7,1,6
2005,246,Finland,China,4573,1973,2600
2005,352,Iceland,China,335,128,207
2005,372,Ireland,China,10704,5609,5095
2005,428,Latvia,China,281,149,132
2005,440,Lithuania,China,105,46,59
2005,578,Norway,China,5995,1877,4118
2005,752,Sweden,China,13277,4733,8544
2005,826,United Kingdom,China,147321,71181,76140
2005,191,Croatia,China,222,109,113
2005,300,Greece,China,2015,1077,938
2005,380,Italy,China,137633,68705,68928
2005,470,Malta,China,259,117,142
2005,620,Portugal,China,6280,3289,2991
2005,688,Serbia,China,1845,1003,842
2005,705,Slovenia,China,323,177,146
2005,724,Spain,China,81322,42538,38784
2005,40,Austria,China,13655,6139,7516
2005,56,Belgium,China,12294,5841,6453
2005,250,France,China,70951,31501,39450
2005,276,Germany,China,67622,33379,34243
2005,438,Liechtenstein,China,58,29,29
2005,442,Luxembourg,China,804,415,389
2005,528,Netherlands,China,43937,19451,24486
2005,756,Switzerland,China,13469,5677,7792
2005,60,Bermuda,China,258,147,111
2005,124,Canada,China,508994,237598,271396
2005,304,Greenland,China,5,4,1
2005,840,United States of America,China,1607654,797231,810423
2010,232,Eritrea,China,133,120,13
2010,450,Madagascar,China,1784,1005,779
2010,480,Mauritius,China,2564,952,1612
2010,690,Seychelles,China,456,398,58
2010,800,Uganda,China,364,231,133
2010,894,Zambia,China,1007,701,306
2010,178,Congo,China,695,643,52
2010,266,Gabon,China,226,163,63
2010,72,Botswana,China,4100,3270,830
2010,426,Lesotho,China,118,67,51
2010,516,Namibia,China,3106,2229,877
2010,710,South Africa,China,20281,11196,9085
2010,132,Cabo Verde,China,22,10,12
2010,288,Ghana,China,189,158,31
2010,324,Guinea,China,81,65,16
2010,466,Mali,China,2820,1567,1253
2010,478,Mauritania,China,158,54,104
2010,694,Sierra Leone,China,207,188,19
2010,768,Togo,China,459,374,85
2010,818,Egypt,China,722,488,234
2010,434,Libya,China,2727,1973,754
2010,729,Sudan,China,1215,627,588
2010,196,Cyprus,China,1744,847,897
2010,268,Georgia,China,70,34,36
2010,376,Israel,China,582,259,323
2010,400,Jordan,China,20878,5464,15414
2010,422,Lebanon,China,2885,378,2507
2010,792,Turkey,China,1727,815,912
2010,398,Kazakhstan,China,2033,1139,894
2010,417,Kyrgyzstan,China,308,155,153
2010,762,Tajikistan,China,49,31,18
2010,50,Bangladesh,China,160252,86537,73715
2010,64,Bhutan,China,858,448,410
2010,356,India,China,100003,51286,48717
2010,524,Nepal,China,20920,6172,14748
2010,586,Pakistan,China,338,196,142
2010,144,Sri Lanka,China,2312,2035,277
2010,344,"China, Hong Kong SAR",China,2260045,1008141,1251904
2010,446,"China, Macao SAR",China,251200,116737,134463
2010,408,Dem. People's Republic of Korea,China,25969,13314,12655
2010,392,Japan,China,687156,311580,375576
2010,496,Mongolia,China,8546,7444,1102
2010,410,Republic of Korea,China,490407,237111,253296
2010,96,Brunei Darussalam,China,2012,1106,906
2010,116,Cambodia,China,1682,1031,651
2010,360,Indonesia,China,65307,36626,28681
2010,418,Lao People's Democratic Republic,China,8110,5576,2534
2010,458,Malaysia,China,9306,4895,4411
2010,104,Myanmar,China,35082,18543,16539
2010,608,Philippines,China,35398,17245,18153
2010,702,Singapore,China,365797,150765,215032
2010,764,Thailand,China,68811,44547,24264
2010,626,Timor-Leste,China,1196,851,345
2010,704,Viet Nam,China,2440,1427,1013
2010,28,Antigua and Barbuda,China,126,61,65
2010,533,Aruba,China,1071,550,521
2010,44,Bahamas,China,159,92,67
2010,52,Barbados,China,41,23,18
2010,535,"Bonaire, Sint Eustatius and Saba",China,15,10,5
2010,192,Cuba,China,126,94,32
2010,531,Curaçao,China,450,213,237
2010,212,Dominica,China,33,22,11
2010,214,Dominican Republic,China,1406,789,617
2010,332,Haiti,China,311,180,131
2010,474,Martinique,China,151,81,70
2010,630,Puerto Rico,China,1351,633,718
2010,662,Saint Lucia,China,55,27,28
2010,534,Sint Maarten (Dutch part),China,167,88,79
2010,780,Trinidad and Tobago,China,836,457,379
2010,84,Belize,China,1737,958,779
2010,188,Costa Rica,China,287,180,107
2010,222,El Salvador,China,248,153,95
2010,320,Guatemala,China,571,307,264
2010,340,Honduras,China,425,270,155
2010,484,Mexico,China,7272,3980,3292
2010,558,Nicaragua,China,129,84,45
2010,591,Panama,China,15893,8402,7491
2010,32,Argentina,China,12476,6684,5792
2010,68,Bolivia (Plurinational State of),China,968,604,364
2010,76,Brazil,China,19229,10409,8820
2010,152,Chile,China,5208,2899,2309
2010,170,Colombia,China,1901,1081,820
2010,218,Ecuador,China,2013,1198,815
2010,254,French Guiana,China,1032,515,517
2010,328,Guyana,China,980,587,393
2010,600,Paraguay,China,800,448,352
2010,604,Peru,China,6491,4069,2422
2010,740,Suriname,China,4526,2468,2058
2010,862,Venezuela (Bolivarian Republic of),China,12864,7520,5344
2010,36,Australia,China,371550,168629,202921
2010,554,New Zealand,China,84329,40859,43470
2010,242,Fiji,China,898,480,418
2010,540,New Caledonia,China,114,60,54
2010,598,Papua New Guinea,China,87,28,59
2010,90,Solomon Islands,China,211,119,92
2010,316,Guam,China,2133,1101,1032
2010,584,Marshall Islands,China,296,199,97
2010,520,Nauru,China,125,74,51
2010,580,Northern Mariana Islands,China,2894,269,2625
2010,585,Palau,China,526,364,162
2010,16,American Samoa,China,600,418,182
2010,258,French Polynesia,China,648,322,326
2010,882,Samoa,China,62,48,14
2010,776,Tonga,China,143,91,52
2010,100,Bulgaria,China,824,448,376
2010,203,Czechia,China,4558,2543,2015
2010,348,Hungary,China,11091,5993,5098
2010,616,Poland,China,1221,540,681
2010,642,Romania,China,2695,1591,1104
2010,643,Russian Federation,China,55119,30995,24124
2010,703,Slovakia,China,856,421,435
2010,804,Ukraine,China,6539,4186,2353
2010,208,Denmark,China,10686,4060,6626
2010,233,Estonia,China,201,102,99
2010,234,Faroe Islands,China,18,4,14
2010,246,Finland,China,8568,3204,5364
2010,352,Iceland,China,492,175,317
2010,372,Ireland,China,12416,6087,6329
2010,428,Latvia,China,230,118,112
2010,440,Lithuania,China,60,2,58
2010,578,Norway,China,8852,2794,6058
2010,752,Sweden,China,23998,9381,14617
2010,826,United Kingdom,China,155196,76633,78563
2010,191,Croatia,China,443,218,225
2010,300,Greece,China,3610,1910,1700
2010,380,Italy,China,194677,98669,96008
2010,470,Malta,China,292,124,168
2010,620,Portugal,China,9227,4851,4376
2010,688,Serbia,China,1804,980,824
2010,705,Slovenia,China,732,420,312
2010,724,Spain,China,154918,76977,77941
2010,40,Austria,China,15145,6664,8481
2010,56,Belgium,China,15600,6418,9182
2010,250,France,China,103338,42025,61313
2010,276,Germany,China,82817,38667,44150
2010,438,Liechtenstein,China,66,31,35
2010,442,Luxembourg,China,691,385,306
2010,528,Netherlands,China,52904,23311,29593
2010,756,Switzerland,China,15244,5893,9351
2010,60,Bermuda,China,346,185,161
2010,124,Canada,China,611990,280194,331796
2010,304,Greenland,China,7,1,6
2010,840,United States of America,China,1922950,940249,982701
2015,232,Eritrea,China,135,122,13
2015,450,Madagascar,China,1979,1112,867
2015,480,Mauritius,China,2951,1187,1764
2015,690,Seychelles,China,510,449,61
2015,800,Uganda,China,366,231,135
2015,894,Zambia,China,887,617,270
2015,178,Congo,China,924,852,72
2015,266,Gabon,China,316,240,76
2015,72,Botswana,China,4475,3569,906
2015,426,Lesotho,China,121,69,52
2015,516,Namibia,China,3039,2183,856
2015,710,South Africa,China,36583,19362,17221
2015,132,Cabo Verde,China,23,10,13
2015,288,Ghana,China,232,194,38
2015,324,Guinea,China,169,134,35
2015,466,Mali,China,3494,1942,1552
2015,478,Mauritania,China,158,55,103
2015,694,Sierra Leone,China,195,120,75
2015,768,Togo,China,517,422,95
2015,818,Egypt,China,535,384,151
2015,434,Libya,China,3074,2213,861
2015,729,Sudan,China,1111,574,537
2015,196,Cyprus,China,1675,819,856
2015,268,Georgia,China,73,36,37
2015,376,Israel,China,600,265,335
2015,400,Jordan,China,20150,5197,14953
2015,422,Lebanon,China,2429,1163,1266
2015,792,Turkey,China,1764,814,950
2015,398,Kazakhstan,China,2162,1227,935
2015,417,Kyrgyzstan,China,271,136,135
2015,762,Tajikistan,China,48,31,17
2015,50,Bangladesh,China,162772,87897,74875
2015,64,Bhutan,China,906,673,233
2015,356,India,China,110098,56464,53634
2015,524,Nepal,China,20302,5946,14356
2015,586,Pakistan,China,334,194,140
2015,144,Sri Lanka,China,2463,2162,301
2015,344,"China, Hong Kong SAR",China,2307783,979443,1328340
2015,446,"China, Macao SAR",China,280130,131738,148392
2015,408,Dem. People's Republic of Korea,China,28594,14741,13853
2015,392,Japan,China,714570,337804,376766
2015,496,Mongolia,China,10595,8841,1754
2015,410,Republic of Korea,China,609332,287290,322042
2015,96,Brunei Darussalam,China,2055,1135,920
2015,116,Cambodia,China,1518,943,575
2015,360,Indonesia,China,72302,41236,31066
2015,418,Lao People's Democratic Republic,China,13400,9555,3845
2015,458,Malaysia,China,11347,6058,5289
2015,104,Myanmar,China,33656,17929,15727
2015,608,Philippines,China,35952,17544,18408
2015,702,Singapore,China,448566,182526,266040
2015,764,Thailand,China,74411,48085,26326
2015,626,Timor-Leste,China,953,674,279
2015,704,Viet Nam,China,3005,1753,1252
2015,28,Antigua and Barbuda,China,134,65,69
2015,533,Aruba,China,1127,579,548
2015,44,Bahamas,China,172,99,73
2015,52,Barbados,China,43,25,18
2015,535,"Bonaire, Sint Eustatius and Saba",China,17,12,5
2015,192,Cuba,China,100,75,25
2015,531,Curaçao,China,489,232,257
2015,212,Dominica,China,38,25,13
2015,214,Dominican Republic,China,3776,2448,1328
2015,332,Haiti,China,326,189,137
2015,474,Martinique,China,156,83,73
2015,630,Puerto Rico,China,1088,508,580
2015,662,Saint Lucia,China,52,26,26
2015,534,Sint Maarten (Dutch part),China,174,91,83
2015,780,Trinidad and Tobago,China,866,480,386
2015,84,Belize,China,2048,1124,924
2015,188,Costa Rica,China,291,182,109
2015,222,El Salvador,China,259,160,99
2015,320,Guatemala,China,657,358,299
2015,340,Honduras,China,596,379,217
2015,484,Mexico,China,8980,5714,3266
2015,558,Nicaragua,China,139,91,48
2015,591,Panama,China,18665,9846,8819
2015,32,Argentina,China,14397,7709,6688
2015,68,Bolivia (Plurinational State of),China,1127,703,424
2015,76,Brazil,China,23156,12535,10621
2015,152,Chile,China,7889,4316,3573
2015,170,Colombia,China,2128,1219,909
2015,218,Ecuador,China,2928,1735,1193
2015,254,French Guiana,China,1246,614,632
2015,328,Guyana,China,1149,688,461
2015,600,Paraguay,China,780,436,344
2015,604,Peru,China,18783,14936,3847
2015,740,Suriname,China,4915,2683,2232
2015,862,Venezuela (Bolivarian Republic of),China,13865,8024,5841
2015,36,Australia,China,508870,228993,279877
2015,554,New Zealand,China,92602,44780,47822
2015,242,Fiji,China,925,499,426
2015,540,New Caledonia,China,87,42,45
2015,598,Papua New Guinea,China,88,30,58
2015,90,Solomon Islands,China,197,111,86
2015,316,Guam,China,2152,1110,1042
2015,584,Marshall Islands,China,318,211,107
2015,520,Nauru,China,198,120,78
2015,580,Northern Mariana Islands,China,2592,230,2362
2015,585,Palau,China,473,336,137
2015,16,American Samoa,China,598,416,182
2015,258,French Polynesia,China,615,306,309
2015,882,Samoa,China,50,39,11
2015,776,Tonga,China,122,78,44
2015,100,Bulgaria,China,1236,635,601
2015,203,Czechia,China,4807,2531,2276
2015,348,Hungary,China,14829,7675,7154
2015,616,Poland,China,1177,533,644
2015,642,Romania,China,3722,2170,1552
2015,643,Russian Federation,China,56171,31463,24708
2015,703,Slovakia,China,1074,576,498
2015,804,Ukraine,China,6560,4203,2357
2015,208,Denmark,China,12137,4542,7595
2015,233,Estonia,China,348,177,171
2015,234,Faroe Islands,China,30,8,22
2015,246,Finland,China,11725,4451,7274
2015,352,Iceland,China,582,183,399
2015,372,Ireland,China,12683,6138,6545
2015,428,Latvia,China,268,152,116
2015,440,Lithuania,China,53,0,53
2015,578,Norway,China,11095,3737,7358
2015,752,Sweden,China,28410,11330,17080
2015,826,United Kingdom,China,198472,95022,103450
2015,191,Croatia,China,446,219,227
2015,300,Greece,China,3388,1725,1663
2015,380,Italy,China,200372,100237,100135
2015,470,Malta,China,495,229,266
2015,620,Portugal,China,10461,5246,5215
2015,688,Serbia,China,1763,956,807
2015,705,Slovenia,China,863,469,394
2015,724,Spain,China,155713,71920,83793
2015,40,Austria,China,17713,7848,9865
2015,56,Belgium,China,19048,8034,11014
2015,250,France,China,114475,44682,69793
2015,276,Germany,China,86291,40181,46110
2015,438,Liechtenstein,China,81,34,47
2015,442,Luxembourg,China,1054,595,459
2015,528,Netherlands,China,62708,27987,34721
2015,756,Switzerland,China,22978,9234,13744
2015,60,Bermuda,China,350,188,162
2015,124,Canada,China,645278,288860,356418
2015,304,Greenland,China,10,2,8
2015,840,United States of America,China,2676697,1298394,1378303
2019,232,Eritrea,China,136,123,13
2019,450,Madagascar,China,2155,1211,944
2019,480,Mauritius,China,2978,1198,1780
2019,690,Seychelles,China,515,454,61
2019,800,Uganda,China,366,231,135
2019,894,Zambia,China,1143,796,347
2019,178,Congo,China,952,878,74
2019,266,Gabon,China,342,261,81
2019,72,Botswana,China,4792,3822,970
2019,426,Lesotho,China,127,73,54
2019,516,Namibia,China,3216,2310,906
2019,710,South Africa,China,41004,21720,19284
2019,132,Cabo Verde,China,24,11,13
2019,288,Ghana,China,261,219,42
2019,324,Guinea,China,161,128,33
2019,466,Mali,China,3890,2162,1728
2019,478,Mauritania,China,164,58,106
2019,694,Sierra Leone,China,190,62,128
2019,768,Togo,China,520,425,95
2019,818,Egypt,China,762,522,240
2019,434,Libya,China,3261,2348,913
2019,729,Sudan,China,1370,698,672
2019,196,Cyprus,China,1674,828,846
2019,268,Georgia,China,75,37,38
2019,376,Israel,China,583,258,325
2019,400,Jordan,China,21669,5589,16080
2019,422,Lebanon,China,2294,1099,1195
2019,792,Turkey,China,2385,1114,1271
2019,398,Kazakhstan,China,2259,1282,977
2019,417,Kyrgyzstan,China,265,133,132
2019,762,Tajikistan,China,47,31,16
2019,50,Bangladesh,China,164917,50290,114627
2019,64,Bhutan,China,944,702,242
2019,356,India,China,108286,55670,52616
2019,524,Nepal,China,19558,5641,13917
2019,586,Pakistan,China,310,180,130
2019,144,Sri Lanka,China,2482,2179,303
2019,344,"China, Hong Kong SAR",China,2272293,977684,1294609
2019,446,"China, Macao SAR",China,297643,139972,157671
2019,408,Dem. People's Republic of Korea,China,29145,15026,14119
2019,392,Japan,China,784763,370987,413776
2019,496,Mongolia,China,11271,9394,1877
2019,410,Republic of Korea,China,620295,292334,327961
2019,96,Brunei Darussalam,China,2213,1223,990
2019,116,Cambodia,China,1614,1003,611
2019,360,Indonesia,China,75511,43066,32445
2019,418,Lao People's Democratic Republic,China,14205,10130,4075
2019,458,Malaysia,China,11864,6375,5489
2019,104,Myanmar,China,34893,18587,16306
2019,608,Philippines,China,37083,18096,18987
2019,702,Singapore,China,380145,154403,225742
2019,764,Thailand,China,77581,50129,27452
2019,626,Timor-Leste,China,941,666,275
2019,704,Viet Nam,China,3141,1833,1308
2019,28,Antigua and Barbuda,China,139,68,71
2019,533,Aruba,China,1140,586,554
2019,44,Bahamas,China,182,105,77
2019,52,Barbados,China,43,25,18
2019,535,"Bonaire, Sint Eustatius and Saba",China,20,15,5
2019,192,Cuba,China,91,68,23
2019,531,Curaçao,China,531,252,279
2019,212,Dominica,China,38,25,13
2019,214,Dominican Republic,China,3902,2530,1372
2019,332,Haiti,China,339,197,142
2019,474,Martinique,China,155,83,72
2019,630,Puerto Rico,China,1309,609,700
2019,662,Saint Lucia,China,50,25,25
2019,534,Sint Maarten (Dutch part),China,180,95,85
2019,780,Trinidad and Tobago,China,932,536,396
2019,84,Belize,China,2247,1234,1013
2019,188,Costa Rica,China,295,186,109
2019,222,El Salvador,China,262,162,100
2019,320,Guatemala,China,674,368,306
2019,340,Honduras,China,605,385,220
2019,484,Mexico,China,9258,5891,3367
2019,558,Nicaragua,China,145,95,50
2019,591,Panama,China,19876,10486,9390
2019,32,Argentina,China,14649,7833,6816
2019,68,Bolivia (Plurinational State of),China,1230,768,462
2019,76,Brazil,China,26078,14117,11961
2019,152,Chile,China,10540,5501,5039
2019,170,Colombia,China,2176,1247,929
2019,218,Ecuador,China,2882,1707,1175
2019,254,French Guiana,China,1378,679,699
2019,328,Guyana,China,1172,702,470
2019,600,Paraguay,China,800,448,352
2019,604,Peru,China,20390,15991,4399
2019,740,Suriname,China,5260,2875,2385
2019,862,Venezuela (Bolivarian Republic of),China,13581,7834,5747
2019,36,Australia,China,641624,287749,353875
2019,554,New Zealand,China,95185,46030,49155
2019,242,Fiji,China,944,510,434
2019,540,New Caledonia,China,91,44,47
2019,598,Papua New Guinea,China,88,30,58
2019,90,Solomon Islands,China,192,108,84
2019,316,Guam,China,2258,1165,1093
2019,584,Marshall Islands,China,319,212,107
2019,520,Nauru,China,220,134,86
2019,580,Northern Mariana Islands,China,2611,231,2380
2019,585,Palau,China,485,331,154
2019,16,American Samoa,China,598,416,182
2019,258,French Polynesia,China,638,318,320
2019,882,Samoa,China,47,37,10
2019,776,Tonga,China,115,74,41
2019,100,Bulgaria,China,1447,686,761
2019,203,Czechia,China,5404,2818,2586
2019,348,Hungary,China,17389,8673,8716
2019,616,Poland,China,1246,591,655
2019,642,Romania,China,5557,3148,2409
2019,643,Russian Federation,China,56157,31455,24702
2019,703,Slovakia,China,1198,647,551
2019,804,Ukraine,China,6625,4245,2380
2019,208,Denmark,China,14880,5599,9281
2019,233,Estonia,China,399,204,195
2019,234,Faroe Islands,China,35,11,24
2019,246,Finland,China,14040,5418,8622
2019,352,Iceland,China,702,251,451
2019,372,Ireland,China,13924,6761,7163
2019,428,Latvia,China,335,187,148
2019,440,Lithuania,China,85,8,77
2019,578,Norway,China,12448,4146,8302
2019,752,Sweden,China,34476,13903,20573
2019,826,United Kingdom,China,225385,108204,117181
2019,191,Croatia,China,411,201,210
2019,300,Greece,China,3308,1746,1562
2019,380,Italy,China,228231,114170,114061
2019,470,Malta,China,798,372,426
2019,620,Portugal,China,10638,5346,5292
2019,688,Serbia,China,1791,972,819
2019,705,Slovenia,China,944,505,439
2019,724,Spain,China,164695,74020,90675
2019,40,Austria,China,20910,9465,11445
2019,56,Belgium,China,21031,8869,12162
2019,250,France,China,121172,47127,74045
2019,276,Germany,China,119093,57470,61623
2019,438,Liechtenstein,China,97,41,56
2019,442,Luxembourg,China,4053,1906,2147
2019,528,Netherlands,China,70830,31114,39716
2019,756,Switzerland,China,25313,10320,14993
2019,60,Bermuda,China,353,190,163
2019,124,Canada,China,691489,309547,381942
2019,304,Greenland,China,9,2,7
2019,840,United States of America,China,2899267,1403530,1495737
1990,480,Mauritius,"China, Hong Kong SAR",91,49,42
1990,710,South Africa,"China, Hong Kong SAR",1786,851,935
1990,400,Jordan,"China, Hong Kong SAR",1,1,0
1990,792,Turkey,"China, Hong Kong SAR",14,7,7
1990,156,China,"China, Hong Kong SAR",2458,1393,1065
1990,446,"China, Macao SAR","China, Hong Kong SAR",11736,6155,5581
1990,408,Dem. People's Republic of Korea,"China, Hong Kong SAR",97,51,46
1990,96,Brunei Darussalam,"China, Hong Kong SAR",382,188,194
1990,116,Cambodia,"China, Hong Kong SAR",54,31,23
1990,608,Philippines,"China, Hong Kong SAR",196,127,69
1990,702,Singapore,"China, Hong Kong SAR",15043,7049,7994
1990,44,Bahamas,"China, Hong Kong SAR",46,28,18
1990,535,"Bonaire, Sint Eustatius and Saba","China, Hong Kong SAR",58,37,21
1990,84,Belize,"China, Hong Kong SAR",47,25,22
1990,188,Costa Rica,"China, Hong Kong SAR",1504,808,696
1990,222,El Salvador,"China, Hong Kong SAR",13,6,7
1990,591,Panama,"China, Hong Kong SAR",187,100,87
1990,32,Argentina,"China, Hong Kong SAR",9,9,0
1990,152,Chile,"China, Hong Kong SAR",29,19,10
1990,170,Colombia,"China, Hong Kong SAR",32,23,9
1990,218,Ecuador,"China, Hong Kong SAR",33,19,14
1990,862,Venezuela (Bolivarian Republic of),"China, Hong Kong SAR",507,296,211
1990,36,Australia,"China, Hong Kong SAR",57852,28626,29226
1990,554,New Zealand,"China, Hong Kong SAR",4839,2384,2455
1990,583,Micronesia (Fed. States of),"China, Hong Kong SAR",8,3,5
1990,203,Czechia,"China, Hong Kong SAR",6,2,4
1990,643,Russian Federation,"China, Hong Kong SAR",38,19,19
1990,208,Denmark,"China, Hong Kong SAR",492,246,246
1990,372,Ireland,"China, Hong Kong SAR",86,42,44
1990,578,Norway,"China, Hong Kong SAR",728,421,307
1990,752,Sweden,"China, Hong Kong SAR",440,189,251
1990,826,United Kingdom,"China, Hong Kong SAR",72371,37581,34790
1990,300,Greece,"China, Hong Kong SAR",30,16,14
1990,620,Portugal,"China, Hong Kong SAR",27,11,16
1990,40,Austria,"China, Hong Kong SAR",154,75,79
1990,250,France,"China, Hong Kong SAR",2227,1027,1200
1990,124,Canada,"China, Hong Kong SAR",230328,112130,118198
1990,840,United States of America,"China, Hong Kong SAR",147131,71968,75163
1995,480,Mauritius,"China, Hong Kong SAR",45,27,18
1995,710,South Africa,"China, Hong Kong SAR",1075,535,540
1995,400,Jordan,"China, Hong Kong SAR",24,14,10
1995,792,Turkey,"China, Hong Kong SAR",33,16,17
1995,156,China,"China, Hong Kong SAR",2805,1717,1088
1995,446,"China, Macao SAR","China, Hong Kong SAR",12873,6645,6228
1995,408,Dem. People's Republic of Korea,"China, Hong Kong SAR",102,58,44
1995,96,Brunei Darussalam,"China, Hong Kong SAR",432,215,217
1995,116,Cambodia,"China, Hong Kong SAR",142,81,61
1995,608,Philippines,"China, Hong Kong SAR",263,169,94
1995,702,Singapore,"China, Hong Kong SAR",31708,14689,17019
1995,44,Bahamas,"China, Hong Kong SAR",35,21,14
1995,535,"Bonaire, Sint Eustatius and Saba","China, Hong Kong SAR",121,78,43
1995,84,Belize,"China, Hong Kong SAR",49,25,24
1995,188,Costa Rica,"China, Hong Kong SAR",1604,874,730
1995,222,El Salvador,"China, Hong Kong SAR",10,4,6
1995,591,Panama,"China, Hong Kong SAR",270,146,124
1995,32,Argentina,"China, Hong Kong SAR",9,9,0
1995,68,Bolivia (Plurinational State of),"China, Hong Kong SAR",8,5,3
1995,152,Chile,"China, Hong Kong SAR",40,23,17
1995,170,Colombia,"China, Hong Kong SAR",31,22,9
1995,218,Ecuador,"China, Hong Kong SAR",37,21,16
1995,862,Venezuela (Bolivarian Republic of),"China, Hong Kong SAR",500,292,208
1995,36,Australia,"China, Hong Kong SAR",68683,33861,34822
1995,554,New Zealand,"China, Hong Kong SAR",11441,5490,5951
1995,583,Micronesia (Fed. States of),"China, Hong Kong SAR",7,4,3
1995,203,Czechia,"China, Hong Kong SAR",9,3,6
1995,643,Russian Federation,"China, Hong Kong SAR",36,20,16
1995,208,Denmark,"China, Hong Kong SAR",492,246,246
1995,372,Ireland,"China, Hong Kong SAR",468,221,247
1995,578,Norway,"China, Hong Kong SAR",854,467,387
1995,752,Sweden,"China, Hong Kong SAR",523,223,300
1995,826,United Kingdom,"China, Hong Kong SAR",72931,37509,35422
1995,300,Greece,"China, Hong Kong SAR",40,21,19
1995,620,Portugal,"China, Hong Kong SAR",57,23,34
1995,40,Austria,"China, Hong Kong SAR",174,86,88
1995,250,France,"China, Hong Kong SAR",2299,1039,1260
1995,124,Canada,"China, Hong Kong SAR",231291,112067,119224
1995,840,United States of America,"China, Hong Kong SAR",177702,87787,89915
2000,480,Mauritius,"China, Hong Kong SAR",25,16,9
2000,710,South Africa,"China, Hong Kong SAR",679,353,326
2000,400,Jordan,"China, Hong Kong SAR",47,28,19
2000,792,Turkey,"China, Hong Kong SAR",54,26,28
2000,156,China,"China, Hong Kong SAR",3152,2040,1112
2000,446,"China, Macao SAR","China, Hong Kong SAR",14240,7990,6250
2000,408,Dem. People's Republic of Korea,"China, Hong Kong SAR",106,65,41
2000,96,Brunei Darussalam,"China, Hong Kong SAR",482,242,240
2000,116,Cambodia,"China, Hong Kong SAR",229,131,98
2000,608,Philippines,"China, Hong Kong SAR",268,136,132
2000,702,Singapore,"China, Hong Kong SAR",51442,23448,27994
2000,44,Bahamas,"China, Hong Kong SAR",25,16,9
2000,535,"Bonaire, Sint Eustatius and Saba","China, Hong Kong SAR",185,119,66
2000,84,Belize,"China, Hong Kong SAR",50,25,25
2000,188,Costa Rica,"China, Hong Kong SAR",2506,1348,1158
2000,222,El Salvador,"China, Hong Kong SAR",7,3,4
2000,591,Panama,"China, Hong Kong SAR",371,201,170
2000,32,Argentina,"China, Hong Kong SAR",9,9,0
2000,68,Bolivia (Plurinational State of),"China, Hong Kong SAR",15,10,5
2000,152,Chile,"China, Hong Kong SAR",51,29,22
2000,170,Colombia,"China, Hong Kong SAR",30,21,9
2000,218,Ecuador,"China, Hong Kong SAR",41,24,17
2000,862,Venezuela (Bolivarian Republic of),"China, Hong Kong SAR",490,286,204
2000,36,Australia,"China, Hong Kong SAR",75420,37233,38187
2000,554,New Zealand,"China, Hong Kong SAR",10996,5345,5651
2000,583,Micronesia (Fed. States of),"China, Hong Kong SAR",8,4,4
2000,203,Czechia,"China, Hong Kong SAR",12,4,8
2000,643,Russian Federation,"China, Hong Kong SAR",34,20,14
2000,208,Denmark,"China, Hong Kong SAR",491,245,246
2000,372,Ireland,"China, Hong Kong SAR",1108,543,565
2000,578,Norway,"China, Hong Kong SAR",884,473,411
2000,752,Sweden,"China, Hong Kong SAR",561,237,324
2000,826,United Kingdom,"China, Hong Kong SAR",74718,37977,36741
2000,300,Greece,"China, Hong Kong SAR",51,27,24
2000,620,Portugal,"China, Hong Kong SAR",91,36,55
2000,40,Austria,"China, Hong Kong SAR",194,98,96
2000,250,France,"China, Hong Kong SAR",2371,1052,1319
2000,124,Canada,"China, Hong Kong SAR",237754,114695,123059
2000,840,United States of America,"China, Hong Kong SAR",208749,103982,104767
2005,480,Mauritius,"China, Hong Kong SAR",21,14,7
2005,710,South Africa,"China, Hong Kong SAR",892,445,447
2005,400,Jordan,"China, Hong Kong SAR",68,44,24
2005,792,Turkey,"China, Hong Kong SAR",55,26,29
2005,156,China,"China, Hong Kong SAR",118990,71680,47310
2005,446,"China, Macao SAR","China, Hong Kong SAR",16517,9434,7083
2005,408,Dem. People's Republic of Korea,"China, Hong Kong SAR",128,83,45
2005,96,Brunei Darussalam,"China, Hong Kong SAR",493,249,244
2005,116,Cambodia,"China, Hong Kong SAR",179,105,74
2005,608,Philippines,"China, Hong Kong SAR",216,111,105
2005,702,Singapore,"China, Hong Kong SAR",52509,23390,29119
2005,44,Bahamas,"China, Hong Kong SAR",25,14,11
2005,535,"Bonaire, Sint Eustatius and Saba","China, Hong Kong SAR",197,127,70
2005,84,Belize,"China, Hong Kong SAR",56,29,27
2005,188,Costa Rica,"China, Hong Kong SAR",1641,873,768
2005,222,El Salvador,"China, Hong Kong SAR",8,4,4
2005,591,Panama,"China, Hong Kong SAR",297,154,143
2005,32,Argentina,"China, Hong Kong SAR",7,7,0
2005,68,Bolivia (Plurinational State of),"China, Hong Kong SAR",9,6,3
2005,152,Chile,"China, Hong Kong SAR",76,44,32
2005,170,Colombia,"China, Hong Kong SAR",29,21,8
2005,218,Ecuador,"China, Hong Kong SAR",48,28,20
2005,862,Venezuela (Bolivarian Republic of),"China, Hong Kong SAR",515,301,214
2005,36,Australia,"China, Hong Kong SAR",79850,39027,40823
2005,554,New Zealand,"China, Hong Kong SAR",7350,3568,3782
2005,583,Micronesia (Fed. States of),"China, Hong Kong SAR",15,9,6
2005,203,Czechia,"China, Hong Kong SAR",6,2,4
2005,643,Russian Federation,"China, Hong Kong SAR",46,27,19
2005,208,Denmark,"China, Hong Kong SAR",503,251,252
2005,372,Ireland,"China, Hong Kong SAR",1610,762,848
2005,578,Norway,"China, Hong Kong SAR",918,496,422
2005,752,Sweden,"China, Hong Kong SAR",589,256,333
2005,826,United Kingdom,"China, Hong Kong SAR",87213,44640,42573
2005,300,Greece,"China, Hong Kong SAR",26,14,12
2005,620,Portugal,"China, Hong Kong SAR",112,45,67
2005,40,Austria,"China, Hong Kong SAR",217,107,110
2005,250,France,"China, Hong Kong SAR",1415,628,787
2005,124,Canada,"China, Hong Kong SAR",214333,102326,112007
2005,840,United States of America,"China, Hong Kong SAR",216351,108369,107982
2010,480,Mauritius,"China, Hong Kong SAR",20,13,7
2010,710,South Africa,"China, Hong Kong SAR",1397,695,702
2010,400,Jordan,"China, Hong Kong SAR",87,58,29
2010,792,Turkey,"China, Hong Kong SAR",56,26,30
2010,156,China,"China, Hong Kong SAR",234829,141321,93508
2010,446,"China, Macao SAR","China, Hong Kong SAR",18888,11181,7707
2010,408,Dem. People's Republic of Korea,"China, Hong Kong SAR",149,100,49
2010,96,Brunei Darussalam,"China, Hong Kong SAR",504,256,248
2010,116,Cambodia,"China, Hong Kong SAR",129,78,51
2010,608,Philippines,"China, Hong Kong SAR",252,124,128
2010,702,Singapore,"China, Hong Kong SAR",56502,24597,31905
2010,44,Bahamas,"China, Hong Kong SAR",24,11,13
2010,535,"Bonaire, Sint Eustatius and Saba","China, Hong Kong SAR",15,10,5
2010,531,Curaçao,"China, Hong Kong SAR",103,67,36
2010,84,Belize,"China, Hong Kong SAR",61,32,29
2010,188,Costa Rica,"China, Hong Kong SAR",3235,1725,1510
2010,222,El Salvador,"China, Hong Kong SAR",8,4,4
2010,591,Panama,"China, Hong Kong SAR",239,118,121
2010,32,Argentina,"China, Hong Kong SAR",4,4,0
2010,68,Bolivia (Plurinational State of),"China, Hong Kong SAR",2,1,1
2010,152,Chile,"China, Hong Kong SAR",102,60,42
2010,170,Colombia,"China, Hong Kong SAR",33,24,9
2010,218,Ecuador,"China, Hong Kong SAR",67,39,28
2010,862,Venezuela (Bolivarian Republic of),"China, Hong Kong SAR",547,321,226
2010,36,Australia,"China, Hong Kong SAR",85460,41454,44006
2010,554,New Zealand,"China, Hong Kong SAR",7401,3587,3814
2010,583,Micronesia (Fed. States of),"China, Hong Kong SAR",18,13,5
2010,203,Czechia,"China, Hong Kong SAR",9,3,6
2010,643,Russian Federation,"China, Hong Kong SAR",58,34,24
2010,208,Denmark,"China, Hong Kong SAR",505,252,253
2010,233,Estonia,"China, Hong Kong SAR",1,0,1
2010,372,Ireland,"China, Hong Kong SAR",1847,748,1099
2010,578,Norway,"China, Hong Kong SAR",988,522,466
2010,752,Sweden,"China, Hong Kong SAR",593,259,334
2010,826,United Kingdom,"China, Hong Kong SAR",91875,47947,43928
2010,620,Portugal,"China, Hong Kong SAR",116,47,69
2010,40,Austria,"China, Hong Kong SAR",240,116,124
2010,250,France,"China, Hong Kong SAR",484,210,274
2010,124,Canada,"China, Hong Kong SAR",205425,97181,108244
2010,840,United States of America,"China, Hong Kong SAR",230796,114021,116775
2015,480,Mauritius,"China, Hong Kong SAR",23,16,7
2015,710,South Africa,"China, Hong Kong SAR",2519,1189,1330
2015,400,Jordan,"China, Hong Kong SAR",37,22,15
2015,792,Turkey,"China, Hong Kong SAR",56,25,31
2015,156,China,"China, Hong Kong SAR",270252,167553,102699
2015,446,"China, Macao SAR","China, Hong Kong SAR",20984,12542,8442
2015,408,Dem. People's Republic of Korea,"China, Hong Kong SAR",164,110,54
2015,96,Brunei Darussalam,"China, Hong Kong SAR",515,263,252
2015,116,Cambodia,"China, Hong Kong SAR",116,71,45
2015,608,Philippines,"China, Hong Kong SAR",256,127,129
2015,702,Singapore,"China, Hong Kong SAR",61969,26810,35159
2015,44,Bahamas,"China, Hong Kong SAR",26,12,14
2015,535,"Bonaire, Sint Eustatius and Saba","China, Hong Kong SAR",17,12,5
2015,531,Curaçao,"China, Hong Kong SAR",111,72,39
2015,84,Belize,"China, Hong Kong SAR",71,37,34
2015,188,Costa Rica,"China, Hong Kong SAR",3285,1743,1542
2015,222,El Salvador,"China, Hong Kong SAR",8,4,4
2015,591,Panama,"China, Hong Kong SAR",281,138,143
2015,32,Argentina,"China, Hong Kong SAR",4,4,0
2015,68,Bolivia (Plurinational State of),"China, Hong Kong SAR",2,1,1
2015,152,Chile,"China, Hong Kong SAR",154,90,64
2015,170,Colombia,"China, Hong Kong SAR",36,27,9
2015,218,Ecuador,"China, Hong Kong SAR",97,56,41
2015,862,Venezuela (Bolivarian Republic of),"China, Hong Kong SAR",573,332,241
2015,36,Australia,"China, Hong Kong SAR",95050,46370,48680
2015,554,New Zealand,"China, Hong Kong SAR",7334,3547,3787
2015,583,Micronesia (Fed. States of),"China, Hong Kong SAR",21,14,7
2015,203,Czechia,"China, Hong Kong SAR",13,4,9
2015,643,Russian Federation,"China, Hong Kong SAR",60,36,24
2015,208,Denmark,"China, Hong Kong SAR",548,277,271
2015,372,Ireland,"China, Hong Kong SAR",1887,750,1137
2015,578,Norway,"China, Hong Kong SAR",1238,673,565
2015,752,Sweden,"China, Hong Kong SAR",581,244,337
2015,826,United Kingdom,"China, Hong Kong SAR",117494,59651,57843
2015,620,Portugal,"China, Hong Kong SAR",132,51,81
2015,40,Austria,"China, Hong Kong SAR",281,136,145
2015,250,France,"China, Hong Kong SAR",535,223,312
2015,124,Canada,"China, Hong Kong SAR",207658,97379,110279
2015,840,United States of America,"China, Hong Kong SAR",248913,122324,126589
2019,480,Mauritius,"China, Hong Kong SAR",23,16,7
2019,710,South Africa,"China, Hong Kong SAR",2822,1334,1488
2019,400,Jordan,"China, Hong Kong SAR",39,23,16
2019,792,Turkey,"China, Hong Kong SAR",75,34,41
2019,156,China,"China, Hong Kong SAR",284848,176603,108245
2019,446,"China, Macao SAR","China, Hong Kong SAR",22295,13326,8969
2019,408,Dem. People's Republic of Korea,"China, Hong Kong SAR",167,112,55
2019,96,Brunei Darussalam,"China, Hong Kong SAR",554,283,271
2019,116,Cambodia,"China, Hong Kong SAR",123,76,47
2019,608,Philippines,"China, Hong Kong SAR",264,131,133
2019,702,Singapore,"China, Hong Kong SAR",52516,22683,29833
2019,44,Bahamas,"China, Hong Kong SAR",27,13,14
2019,535,"Bonaire, Sint Eustatius and Saba","China, Hong Kong SAR",20,15,5
2019,531,Curaçao,"China, Hong Kong SAR",120,78,42
2019,84,Belize,"China, Hong Kong SAR",77,40,37
2019,188,Costa Rica,"China, Hong Kong SAR",3333,1779,1554
2019,222,El Salvador,"China, Hong Kong SAR",8,4,4
2019,591,Panama,"China, Hong Kong SAR",298,148,150
2019,32,Argentina,"China, Hong Kong SAR",4,4,0
2019,68,Bolivia (Plurinational State of),"China, Hong Kong SAR",2,1,1
2019,152,Chile,"China, Hong Kong SAR",205,115,90
2019,170,Colombia,"China, Hong Kong SAR",36,27,9
2019,218,Ecuador,"China, Hong Kong SAR",95,55,40
2019,862,Venezuela (Bolivarian Republic of),"China, Hong Kong SAR",561,324,237
2019,36,Australia,"China, Hong Kong SAR",105165,51194,53971
2019,554,New Zealand,"China, Hong Kong SAR",7538,3646,3892
2019,583,Micronesia (Fed. States of),"China, Hong Kong SAR",21,14,7
2019,203,Czechia,"China, Hong Kong SAR",19,6,13
2019,643,Russian Federation,"China, Hong Kong SAR",59,36,23
2019,372,Ireland,"China, Hong Kong SAR",2071,827,1244
2019,578,Norway,"China, Hong Kong SAR",1389,751,638
2019,752,Sweden,"China, Hong Kong SAR",607,252,355
2019,826,United Kingdom,"China, Hong Kong SAR",133426,67906,65520
2019,620,Portugal,"China, Hong Kong SAR",134,52,82
2019,40,Austria,"China, Hong Kong SAR",331,163,168
2019,250,France,"China, Hong Kong SAR",566,235,331
2019,124,Canada,"China, Hong Kong SAR",222529,104353,118176
2019,840,United States of America,"China, Hong Kong SAR",268803,130629,138174
1990,156,China,"China, Macao SAR",12256,6857,5399
1990,344,"China, Hong Kong SAR","China, Macao SAR",57222,29574,27648
1990,702,Singapore,"China, Macao SAR",11755,5110,6645
1990,188,Costa Rica,"China, Macao SAR",2,1,1
1990,152,Chile,"China, Macao SAR",31,14,17
1990,36,Australia,"China, Macao SAR",1699,767,932
1990,208,Denmark,"China, Macao SAR",5,2,3
1990,578,Norway,"China, Macao SAR",17,13,4
1990,620,Portugal,"China, Macao SAR",842,378,464
1990,40,Austria,"China, Macao SAR",9,3,6
1990,250,France,"China, Macao SAR",111,55,56
1990,124,Canada,"China, Macao SAR",6592,3209,3383
1990,840,United States of America,"China, Macao SAR",5107,2499,2608
1995,156,China,"China, Macao SAR",12470,7076,5394
1995,344,"China, Hong Kong SAR","China, Macao SAR",58769,30151,28618
1995,702,Singapore,"China, Macao SAR",10309,4505,5804
1995,188,Costa Rica,"China, Macao SAR",1,1,0
1995,152,Chile,"China, Macao SAR",20,9,11
1995,36,Australia,"China, Macao SAR",1947,877,1070
1995,208,Denmark,"China, Macao SAR",3,1,2
1995,578,Norway,"China, Macao SAR",22,13,9
1995,620,Portugal,"China, Macao SAR",1816,813,1003
1995,40,Austria,"China, Macao SAR",10,3,7
1995,250,France,"China, Macao SAR",115,56,59
1995,124,Canada,"China, Macao SAR",6620,3208,3412
1995,840,United States of America,"China, Macao SAR",5991,2961,3030
2000,156,China,"China, Macao SAR",12685,7295,5390
2000,344,"China, Hong Kong SAR","China, Macao SAR",60316,30729,29587
2000,702,Singapore,"China, Macao SAR",9861,4233,5628
2000,188,Costa Rica,"China, Macao SAR",1,1,0
2000,152,Chile,"China, Macao SAR",9,4,5
2000,36,Australia,"China, Macao SAR",2050,927,1123
2000,578,Norway,"China, Macao SAR",28,14,14
2000,620,Portugal,"China, Macao SAR",2865,1286,1579
2000,40,Austria,"China, Macao SAR",11,4,7
2000,250,France,"China, Macao SAR",118,57,61
2000,124,Canada,"China, Macao SAR",6805,3283,3522
2000,840,United States of America,"China, Macao SAR",6888,3433,3455
2005,156,China,"China, Macao SAR",16943,9502,7441
2005,344,"China, Hong Kong SAR","China, Macao SAR",64994,30955,34039
2005,702,Singapore,"China, Macao SAR",13897,5815,8082
2005,188,Costa Rica,"China, Macao SAR",1,1,0
2005,152,Chile,"China, Macao SAR",13,6,7
2005,36,Australia,"China, Macao SAR",2100,956,1144
2005,578,Norway,"China, Macao SAR",61,40,21
2005,620,Portugal,"China, Macao SAR",2521,1132,1389
2005,40,Austria,"China, Macao SAR",13,5,8
2005,250,France,"China, Macao SAR",67,33,34
2005,124,Canada,"China, Macao SAR",5977,2860,3117
2005,840,United States of America,"China, Macao SAR",8805,4413,4392
2010,156,China,"China, Macao SAR",21201,11708,9493
2010,344,"China, Hong Kong SAR","China, Macao SAR",69830,31258,38572
2010,702,Singapore,"China, Macao SAR",18709,7712,10997
2010,188,Costa Rica,"China, Macao SAR",1,1,0
2010,152,Chile,"China, Macao SAR",18,9,9
2010,36,Australia,"China, Macao SAR",2560,1181,1379
2010,578,Norway,"China, Macao SAR",87,63,24
2010,620,Portugal,"China, Macao SAR",1760,793,967
2010,40,Austria,"China, Macao SAR",14,5,9
2010,250,France,"China, Macao SAR",16,8,8
2010,124,Canada,"China, Macao SAR",5565,2646,2919
2010,840,United States of America,"China, Macao SAR",11044,5460,5584
2015,156,China,"China, Macao SAR",24399,13973,10426
2015,344,"China, Hong Kong SAR","China, Macao SAR",71305,30378,40927
2015,702,Singapore,"China, Macao SAR",22199,9130,13069
2015,188,Costa Rica,"China, Macao SAR",1,1,0
2015,152,Chile,"China, Macao SAR",27,14,13
2015,36,Australia,"China, Macao SAR",2780,1234,1546
2015,620,Portugal,"China, Macao SAR",1995,843,1152
2015,40,Austria,"China, Macao SAR",17,7,10
2015,250,France,"China, Macao SAR",17,8,9
2015,124,Canada,"China, Macao SAR",5714,2528,3186
2015,840,United States of America,"China, Macao SAR",12568,6181,6387
2019,156,China,"China, Macao SAR",25716,14727,10989
2019,344,"China, Hong Kong SAR","China, Macao SAR",92383,37766,54617
2019,702,Singapore,"China, Macao SAR",18820,7722,11098
2019,188,Costa Rica,"China, Macao SAR",1,1,0
2019,152,Chile,"China, Macao SAR",36,18,18
2019,36,Australia,"China, Macao SAR",3237,1488,1749
2019,620,Portugal,"China, Macao SAR",2028,859,1169
2019,40,Austria,"China, Macao SAR",20,9,11
2019,250,France,"China, Macao SAR",17,8,9
2019,124,Canada,"China, Macao SAR",6123,2709,3414
2019,840,United States of America,"China, Macao SAR",13572,6602,6970
1990,710,South Africa,Colombia,118,71,47
1990,818,Egypt,Colombia,65,59,6
1990,196,Cyprus,Colombia,31,9,22
1990,376,Israel,Colombia,1155,486,669
1990,400,Jordan,Colombia,15,3,12
1990,792,Turkey,Colombia,11,4,7
1990,608,Philippines,Colombia,156,81,75
1990,533,Aruba,Colombia,1849,678,1171
1990,44,Bahamas,Colombia,28,8,20
1990,535,"Bonaire, Sint Eustatius and Saba",Colombia,787,250,537
1990,136,Cayman Islands,Colombia,72,46,26
1990,192,Cuba,Colombia,353,176,177
1990,214,Dominican Republic,Colombia,4697,2450,2247
1990,332,Haiti,Colombia,828,421,407
1990,630,Puerto Rico,Colombia,3399,1610,1789
1990,188,Costa Rica,Colombia,4372,2160,2212
1990,222,El Salvador,Colombia,386,161,225
1990,320,Guatemala,Colombia,490,152,338
1990,340,Honduras,Colombia,409,237,172
1990,484,Mexico,Colombia,4660,2272,2388
1990,558,Nicaragua,Colombia,298,143,155
1990,591,Panama,Colombia,13968,6902,7066
1990,32,Argentina,Colombia,2702,1195,1507
1990,68,Bolivia (Plurinational State of),Colombia,651,272,379
1990,76,Brazil,Colombia,2223,1097,1126
1990,152,Chile,Colombia,1554,688,866
1990,218,Ecuador,Colombia,40238,18406,21832
1990,604,Peru,Colombia,3702,1746,1956
1990,862,Venezuela (Bolivarian Republic of),Colombia,555578,259738,295840
1990,36,Australia,Colombia,2106,986,1120
1990,554,New Zealand,Colombia,235,114,121
1990,100,Bulgaria,Colombia,1,0,1
1990,203,Czechia,Colombia,18,11,7
1990,348,Hungary,Colombia,33,20,13
1990,616,Poland,Colombia,81,54,27
1990,643,Russian Federation,Colombia,336,165,171
1990,703,Slovakia,Colombia,3,2,1
1990,208,Denmark,Colombia,807,421,386
1990,234,Faroe Islands,Colombia,22,12,10
1990,246,Finland,Colombia,132,66,66
1990,352,Iceland,Colombia,21,9,12
1990,428,Latvia,Colombia,2,0,2
1990,578,Norway,Colombia,1618,906,712
1990,752,Sweden,Colombia,5749,3096,2653
1990,826,United Kingdom,Colombia,5546,2037,3509
1990,300,Greece,Colombia,442,20,422
1990,380,Italy,Colombia,9633,1467,8166
1990,620,Portugal,Colombia,107,34,73
1990,705,Slovenia,Colombia,2,1,1
1990,724,Spain,Colombia,12548,4415,8133
1990,40,Austria,Colombia,864,344,520
1990,56,Belgium,Colombia,1897,848,1049
1990,250,France,Colombia,15050,6729,8321
1990,276,Germany,Colombia,4218,1868,2350
1990,442,Luxembourg,Colombia,26,8,18
1990,528,Netherlands,Colombia,4915,2176,2739
1990,756,Switzerland,Colombia,5057,2079,2978
1990,124,Canada,Colombia,7547,3674,3873
1990,840,United States of America,Colombia,286124,125806,160318
1995,710,South Africa,Colombia,159,74,85
1995,818,Egypt,Colombia,52,44,8
1995,196,Cyprus,Colombia,44,11,33
1995,376,Israel,Colombia,1520,628,892
1995,400,Jordan,Colombia,23,8,15
1995,792,Turkey,Colombia,27,10,17
1995,608,Philippines,Colombia,209,107,102
1995,533,Aruba,Colombia,4446,1744,2702
1995,44,Bahamas,Colombia,30,13,17
1995,535,"Bonaire, Sint Eustatius and Saba",Colombia,1641,516,1125
1995,136,Cayman Islands,Colombia,136,86,50
1995,192,Cuba,Colombia,268,128,140
1995,214,Dominican Republic,Colombia,5217,2661,2556
1995,332,Haiti,Colombia,786,400,386
1995,630,Puerto Rico,Colombia,3601,1707,1894
1995,188,Costa Rica,Colombia,4147,2081,2066
1995,222,El Salvador,Colombia,375,165,210
1995,320,Guatemala,Colombia,610,245,365
1995,340,Honduras,Colombia,527,296,231
1995,484,Mexico,Colombia,5530,2576,2954
1995,558,Nicaragua,Colombia,237,113,124
1995,591,Panama,Colombia,17179,8492,8687
1995,32,Argentina,Colombia,3162,1459,1703
1995,68,Bolivia (Plurinational State of),Colombia,1002,480,522
1995,76,Brazil,Colombia,3196,1695,1501
1995,152,Chile,Colombia,2734,1231,1503
1995,218,Ecuador,Colombia,55897,26355,29542
1995,604,Peru,Colombia,3706,1724,1982
1995,862,Venezuela (Bolivarian Republic of),Colombia,588323,278046,310277
1995,36,Australia,Colombia,3146,1494,1652
1995,554,New Zealand,Colombia,290,137,153
1995,100,Bulgaria,Colombia,6,3,3
1995,203,Czechia,Colombia,27,16,11
1995,348,Hungary,Colombia,84,45,39
1995,616,Poland,Colombia,69,46,23
1995,643,Russian Federation,Colombia,297,173,124
1995,703,Slovakia,Colombia,16,12,4
1995,208,Denmark,Colombia,1424,764,660
1995,234,Faroe Islands,Colombia,39,23,16
1995,246,Finland,Colombia,242,130,112
1995,352,Iceland,Colombia,42,18,24
1995,428,Latvia,Colombia,3,0,3
1995,578,Norway,Colombia,2584,1472,1112
1995,752,Sweden,Colombia,6822,3649,3173
1995,826,United Kingdom,Colombia,8660,3398,5262
1995,300,Greece,Colombia,410,55,355
1995,380,Italy,Colombia,12313,2452,9861
1995,620,Portugal,Colombia,229,72,157
1995,705,Slovenia,Colombia,4,3,1
1995,724,Spain,Colombia,21683,7751,13932
1995,40,Austria,Colombia,975,398,577
1995,56,Belgium,Colombia,2318,929,1389
1995,250,France,Colombia,15537,6802,8735
1995,276,Germany,Colombia,6401,2202,4199
1995,442,Luxembourg,Colombia,24,8,16
1995,528,Netherlands,Colombia,6784,2921,3863
1995,756,Switzerland,Colombia,6475,2774,3701
1995,124,Canada,Colombia,12595,6092,6503
1995,840,United States of America,Colombia,403325,179708,223617
2000,710,South Africa,Colombia,249,95,154
2000,818,Egypt,Colombia,43,32,11
2000,196,Cyprus,Colombia,57,14,43
2000,376,Israel,Colombia,1800,745,1055
2000,400,Jordan,Colombia,30,12,18
2000,792,Turkey,Colombia,44,15,29
2000,608,Philippines,Colombia,56,41,15
2000,533,Aruba,Colombia,7043,2811,4232
2000,44,Bahamas,Colombia,33,19,14
2000,535,"Bonaire, Sint Eustatius and Saba",Colombia,2495,781,1714
2000,136,Cayman Islands,Colombia,235,149,86
2000,192,Cuba,Colombia,182,80,102
2000,214,Dominican Republic,Colombia,5737,2872,2865
2000,332,Haiti,Colombia,746,380,366
2000,630,Puerto Rico,Colombia,3813,1809,2004
2000,188,Costa Rica,Colombia,5995,2958,3037
2000,222,El Salvador,Colombia,363,169,194
2000,320,Guatemala,Colombia,730,339,391
2000,340,Honduras,Colombia,644,355,289
2000,484,Mexico,Colombia,6639,3007,3632
2000,558,Nicaragua,Colombia,309,161,148
2000,591,Panama,Colombia,21473,10565,10908
2000,32,Argentina,Colombia,3622,1724,1898
2000,68,Bolivia (Plurinational State of),Colombia,1342,682,660
2000,76,Brazil,Colombia,4169,2294,1875
2000,152,Chile,Colombia,3913,1750,2163
2000,218,Ecuador,Colombia,71556,34305,37251
2000,604,Peru,Colombia,4331,2002,2329
2000,862,Venezuela (Bolivarian Republic of),Colombia,617257,294429,322828
2000,36,Australia,Colombia,4000,1929,2071
2000,554,New Zealand,Colombia,209,102,107
2000,100,Bulgaria,Colombia,10,6,4
2000,203,Czechia,Colombia,36,22,14
2000,348,Hungary,Colombia,135,70,65
2000,616,Poland,Colombia,59,38,21
2000,643,Russian Federation,Colombia,249,175,74
2000,703,Slovakia,Colombia,34,25,9
2000,208,Denmark,Colombia,2040,1107,933
2000,234,Faroe Islands,Colombia,43,25,18
2000,246,Finland,Colombia,352,195,157
2000,352,Iceland,Colombia,62,27,35
2000,428,Latvia,Colombia,4,0,4
2000,578,Norway,Colombia,3230,1804,1426
2000,752,Sweden,Colombia,7317,3892,3425
2000,826,United Kingdom,Colombia,11920,4802,7118
2000,300,Greece,Colombia,385,85,300
2000,380,Italy,Colombia,14993,3437,11556
2000,620,Portugal,Colombia,362,115,247
2000,705,Slovenia,Colombia,4,2,2
2000,724,Spain,Colombia,40145,14796,25349
2000,40,Austria,Colombia,1086,452,634
2000,56,Belgium,Colombia,2671,989,1682
2000,250,France,Colombia,16023,6874,9149
2000,276,Germany,Colombia,8584,2537,6047
2000,438,Liechtenstein,Colombia,1,1,0
2000,442,Luxembourg,Colombia,23,7,16
2000,528,Netherlands,Colombia,8883,3755,5128
2000,756,Switzerland,Colombia,7917,3490,4427
2000,124,Canada,Colombia,17942,8655,9287
2000,840,United States of America,Colombia,522819,235026,287793
2005,710,South Africa,Colombia,328,116,212
2005,818,Egypt,Colombia,51,39,12
2005,196,Cyprus,Colombia,84,20,64
2005,376,Israel,Colombia,2226,922,1304
2005,400,Jordan,Colombia,44,21,23
2005,792,Turkey,Colombia,45,15,30
2005,608,Philippines,Colombia,45,34,11
2005,533,Aruba,Colombia,8243,3127,5116
2005,44,Bahamas,Colombia,106,63,43
2005,535,"Bonaire, Sint Eustatius and Saba",Colombia,2658,831,1827
2005,136,Cayman Islands,Colombia,296,157,139
2005,192,Cuba,Colombia,121,53,68
2005,214,Dominican Republic,Colombia,4593,2310,2283
2005,332,Haiti,Colombia,708,361,347
2005,630,Puerto Rico,Colombia,4482,2120,2362
2005,534,Sint Maarten (Dutch part),Colombia,100,41,59
2005,188,Costa Rica,Colombia,7703,3770,3933
2005,222,El Salvador,Colombia,458,219,239
2005,320,Guatemala,Colombia,868,438,430
2005,340,Honduras,Colombia,631,351,280
2005,484,Mexico,Colombia,9403,4102,5301
2005,558,Nicaragua,Colombia,389,211,178
2005,591,Panama,Colombia,33463,15635,17828
2005,32,Argentina,Colombia,2672,1294,1378
2005,68,Bolivia (Plurinational State of),Colombia,1946,1082,864
2005,76,Brazil,Colombia,5520,2879,2641
2005,152,Chile,Colombia,9159,4192,4967
2005,218,Ecuador,Colombia,93022,44596,48426
2005,604,Peru,Colombia,5087,2396,2691
2005,862,Venezuela (Bolivarian Republic of),Colombia,672292,318105,354187
2005,36,Australia,Colombia,5810,2718,3092
2005,554,New Zealand,Colombia,372,181,191
2005,100,Bulgaria,Colombia,16,10,6
2005,203,Czechia,Colombia,99,52,47
2005,348,Hungary,Colombia,167,88,79
2005,616,Poland,Colombia,92,49,43
2005,643,Russian Federation,Colombia,228,160,68
2005,703,Slovakia,Colombia,39,29,10
2005,208,Denmark,Colombia,2522,1337,1185
2005,234,Faroe Islands,Colombia,43,24,19
2005,246,Finland,Colombia,623,331,292
2005,352,Iceland,Colombia,110,45,65
2005,428,Latvia,Colombia,7,2,5
2005,578,Norway,Colombia,4123,2252,1871
2005,752,Sweden,Colombia,8896,4688,4208
2005,826,United Kingdom,Colombia,17569,7145,10424
2005,191,Croatia,Colombia,23,8,15
2005,300,Greece,Colombia,397,92,305
2005,380,Italy,Colombia,27259,8810,18449
2005,620,Portugal,Colombia,507,171,336
2005,705,Slovenia,Colombia,12,5,7
2005,724,Spain,Colombia,270028,115774,154254
2005,40,Austria,Colombia,1214,488,726
2005,56,Belgium,Colombia,4213,1612,2601
2005,250,France,Colombia,22163,10047,12116
2005,276,Germany,Colombia,13677,4876,8801
2005,438,Liechtenstein,Colombia,15,4,11
2005,442,Luxembourg,Colombia,19,7,12
2005,528,Netherlands,Colombia,11688,4935,6753
2005,756,Switzerland,Colombia,8955,3694,5261
2005,124,Canada,Colombia,39330,18731,20599
2005,840,United States of America,Colombia,580965,262932,318033
2010,710,South Africa,Colombia,513,181,332
2010,818,Egypt,Colombia,55,42,13
2010,196,Cyprus,Colombia,137,34,103
2010,376,Israel,Colombia,2678,1106,1572
2010,400,Jordan,Colombia,57,28,29
2010,792,Turkey,Colombia,46,15,31
2010,608,Philippines,Colombia,123,89,34
2010,533,Aruba,Colombia,9279,3580,5699
2010,44,Bahamas,Colombia,178,106,72
2010,535,"Bonaire, Sint Eustatius and Saba",Colombia,517,199,318
2010,136,Cayman Islands,Colombia,385,180,205
2010,192,Cuba,Colombia,67,29,38
2010,531,Curaçao,Colombia,4414,1513,2901
2010,214,Dominican Republic,Colombia,3416,1731,1685
2010,332,Haiti,Colombia,743,379,364
2010,630,Puerto Rico,Colombia,4589,2151,2438
2010,534,Sint Maarten (Dutch part),Colombia,200,82,118
2010,188,Costa Rica,Colombia,20945,10326,10619
2010,222,El Salvador,Colombia,553,270,283
2010,320,Guatemala,Colombia,1005,537,468
2010,340,Honduras,Colombia,618,348,270
2010,484,Mexico,Colombia,13259,5683,7576
2010,558,Nicaragua,Colombia,415,226,189
2010,591,Panama,Colombia,47046,21726,25320
2010,32,Argentina,Colombia,1722,864,858
2010,68,Bolivia (Plurinational State of),Colombia,2546,1480,1066
2010,76,Brazil,Colombia,6792,3419,3373
2010,152,Chile,Colombia,14401,6632,7769
2010,218,Ecuador,Colombia,192805,96826,95979
2010,604,Peru,Colombia,6454,3194,3260
2010,862,Venezuela (Bolivarian Republic of),Colombia,929944,447146,482798
2010,36,Australia,Colombia,12410,5913,6497
2010,554,New Zealand,Colombia,790,383,407
2010,100,Bulgaria,Colombia,22,14,8
2010,203,Czechia,Colombia,152,78,74
2010,348,Hungary,Colombia,199,106,93
2010,616,Poland,Colombia,128,61,67
2010,643,Russian Federation,Colombia,203,141,62
2010,703,Slovakia,Colombia,44,33,11
2010,208,Denmark,Colombia,2950,1541,1409
2010,233,Estonia,Colombia,13,6,7
2010,234,Faroe Islands,Colombia,36,22,14
2010,246,Finland,Colombia,1060,507,553
2010,352,Iceland,Colombia,156,62,94
2010,428,Latvia,Colombia,10,4,6
2010,578,Norway,Colombia,4823,2573,2250
2010,752,Sweden,Colombia,10531,5382,5149
2010,826,United Kingdom,Colombia,18508,7753,10755
2010,191,Croatia,Colombia,45,16,29
2010,300,Greece,Colombia,424,103,321
2010,380,Italy,Colombia,39214,13853,25361
2010,620,Portugal,Colombia,568,199,369
2010,705,Slovenia,Colombia,30,10,20
2010,724,Spain,Colombia,376161,163795,212366
2010,40,Austria,Colombia,1342,525,817
2010,56,Belgium,Colombia,4839,1996,2843
2010,250,France,Colombia,25571,10642,14929
2010,276,Germany,Colombia,17892,6860,11032
2010,438,Liechtenstein,Colombia,30,7,23
2010,442,Luxembourg,Colombia,17,7,10
2010,528,Netherlands,Colombia,12975,5426,7549
2010,756,Switzerland,Colombia,10460,3962,6498
2010,124,Canada,Colombia,60555,28789,31766
2010,840,United States of America,Colombia,658465,293048,365417
2015,710,South Africa,Colombia,924,296,628
2015,324,Guinea,Colombia,2623,1517,1106
2015,818,Egypt,Colombia,40,32,8
2015,196,Cyprus,Colombia,131,33,98
2015,376,Israel,Colombia,2762,1133,1629
2015,400,Jordan,Colombia,24,9,15
2015,792,Turkey,Colombia,46,14,32
2015,608,Philippines,Colombia,125,90,35
2015,533,Aruba,Colombia,9762,3756,6006
2015,44,Bahamas,Colombia,193,114,79
2015,535,"Bonaire, Sint Eustatius and Saba",Colombia,588,227,361
2015,136,Cayman Islands,Colombia,419,197,222
2015,192,Cuba,Colombia,53,23,30
2015,531,Curaçao,Colombia,4797,1650,3147
2015,214,Dominican Republic,Colombia,2838,1446,1392
2015,332,Haiti,Colombia,780,398,382
2015,630,Puerto Rico,Colombia,3788,1767,2021
2015,534,Sint Maarten (Dutch part),Colombia,208,85,123
2015,188,Costa Rica,Colombia,21270,10421,10849
2015,222,El Salvador,Colombia,577,282,295
2015,320,Guatemala,Colombia,1156,625,531
2015,340,Honduras,Colombia,868,491,377
2015,484,Mexico,Colombia,18736,7918,10818
2015,558,Nicaragua,Colombia,447,245,202
2015,591,Panama,Colombia,55251,25446,29805
2015,32,Argentina,Colombia,8640,4333,4307
2015,68,Bolivia (Plurinational State of),Colombia,2964,1723,1241
2015,76,Brazil,Colombia,8179,4117,4062
2015,152,Chile,Colombia,73601,33035,40566
2015,218,Ecuador,Colombia,194721,97851,96870
2015,604,Peru,Colombia,7599,3948,3651
2015,862,Venezuela (Bolivarian Republic of),Colombia,973315,469595,503720
2015,36,Australia,Colombia,19810,9284,10526
2015,554,New Zealand,Colombia,1197,579,618
2015,100,Bulgaria,Colombia,41,23,18
2015,203,Czechia,Colombia,250,134,116
2015,348,Hungary,Colombia,216,111,105
2015,616,Poland,Colombia,123,60,63
2015,643,Russian Federation,Colombia,206,142,64
2015,703,Slovakia,Colombia,56,41,15
2015,208,Denmark,Colombia,3403,1816,1587
2015,233,Estonia,Colombia,27,21,6
2015,234,Faroe Islands,Colombia,30,15,15
2015,246,Finland,Colombia,1272,620,652
2015,352,Iceland,Colombia,189,68,121
2015,428,Latvia,Colombia,6,2,4
2015,578,Norway,Colombia,5699,2982,2717
2015,752,Sweden,Colombia,11914,5987,5927
2015,826,United Kingdom,Colombia,23668,9507,14161
2015,191,Croatia,Colombia,45,16,29
2015,300,Greece,Colombia,397,83,314
2015,380,Italy,Colombia,38859,13636,25223
2015,620,Portugal,Colombia,644,205,439
2015,705,Slovenia,Colombia,41,12,29
2015,724,Spain,Colombia,347505,143907,203598
2015,40,Austria,Colombia,1570,620,950
2015,56,Belgium,Colombia,6119,2490,3629
2015,250,France,Colombia,28326,11333,16993
2015,276,Germany,Colombia,18643,7122,11521
2015,438,Liechtenstein,Colombia,41,11,30
2015,442,Luxembourg,Colombia,25,10,15
2015,528,Netherlands,Colombia,14375,5945,8430
2015,756,Switzerland,Colombia,12714,4722,7992
2015,124,Canada,Colombia,69610,31856,37754
2015,840,United States of America,Colombia,699399,308309,391090
2019,710,South Africa,Colombia,1035,333,702
2019,324,Guinea,Colombia,2503,1448,1055
2019,818,Egypt,Colombia,57,45,12
2019,196,Cyprus,Colombia,130,34,96
2019,376,Israel,Colombia,2685,1101,1584
2019,400,Jordan,Colombia,25,9,16
2019,792,Turkey,Colombia,62,20,42
2019,608,Philippines,Colombia,128,92,36
2019,533,Aruba,Colombia,9874,3799,6075
2019,44,Bahamas,Colombia,204,121,83
2019,535,"Bonaire, Sint Eustatius and Saba",Colombia,700,271,429
2019,136,Cayman Islands,Colombia,464,218,246
2019,192,Cuba,Colombia,48,21,27
2019,531,Curaçao,Colombia,4714,1544,3170
2019,214,Dominican Republic,Colombia,2932,1494,1438
2019,332,Haiti,Colombia,811,414,397
2019,630,Puerto Rico,Colombia,4361,2026,2335
2019,534,Sint Maarten (Dutch part),Colombia,215,88,127
2019,188,Costa Rica,Colombia,21583,10646,10937
2019,222,El Salvador,Colombia,584,285,299
2019,320,Guatemala,Colombia,1186,641,545
2019,340,Honduras,Colombia,881,498,383
2019,484,Mexico,Colombia,19317,8164,11153
2019,558,Nicaragua,Colombia,468,257,211
2019,591,Panama,Colombia,44952,19180,25772
2019,32,Argentina,Colombia,8791,4402,4389
2019,68,Bolivia (Plurinational State of),Colombia,3236,1882,1354
2019,76,Brazil,Colombia,9211,4637,4574
2019,152,Chile,Colombia,120626,63407,57219
2019,218,Ecuador,Colombia,191537,96188,95349
2019,604,Peru,Colombia,9057,4882,4175
2019,862,Venezuela (Bolivarian Republic of),Colombia,953386,457759,495627
2019,36,Australia,Colombia,27835,13077,14758
2019,554,New Zealand,Colombia,1230,595,635
2019,100,Bulgaria,Colombia,49,23,26
2019,203,Czechia,Colombia,297,159,138
2019,348,Hungary,Colombia,252,127,125
2019,616,Poland,Colombia,130,66,64
2019,643,Russian Federation,Colombia,205,142,63
2019,703,Slovakia,Colombia,58,42,16
2019,208,Denmark,Colombia,3767,1944,1823
2019,233,Estonia,Colombia,42,28,14
2019,234,Faroe Islands,Colombia,35,15,20
2019,246,Finland,Colombia,1495,730,765
2019,352,Iceland,Colombia,242,99,143
2019,428,Latvia,Colombia,5,2,3
2019,578,Norway,Colombia,6378,3332,3046
2019,752,Sweden,Colombia,12699,6343,6356
2019,826,United Kingdom,Colombia,26877,10837,16040
2019,191,Croatia,Colombia,41,15,26
2019,300,Greece,Colombia,387,92,295
2019,380,Italy,Colombia,40769,14553,26216
2019,620,Portugal,Colombia,654,209,445
2019,705,Slovenia,Colombia,48,11,37
2019,724,Spain,Colombia,367816,148740,219076
2019,40,Austria,Colombia,1853,751,1102
2019,56,Belgium,Colombia,6809,2795,4014
2019,250,France,Colombia,29983,11955,18028
2019,276,Germany,Colombia,20450,8187,12263
2019,438,Liechtenstein,Colombia,43,11,32
2019,442,Luxembourg,Colombia,469,208,261
2019,528,Netherlands,Colombia,15843,6611,9232
2019,756,Switzerland,Colombia,13892,5207,8685
2019,124,Canada,Colombia,74595,34138,40457
2019,840,United States of America,Colombia,798294,351060,447234
1990,232,Eritrea,Comoros,27,6,21
1990,450,Madagascar,Comoros,8179,4565,3614
1990,175,Mayotte,Comoros,10288,6124,4164
1990,638,Réunion,Comoros,441,237,204
1990,834,United Republic of Tanzania,Comoros,343,206,137
1990,710,South Africa,Comoros,194,158,36
1990,818,Egypt,Comoros,431,381,50
1990,434,Libya,Comoros,1230,1088,142
1990,152,Chile,Comoros,4,2,2
1990,643,Russian Federation,Comoros,17,8,9
1990,208,Denmark,Comoros,18,13,5
1990,246,Finland,Comoros,1,1,0
1990,752,Sweden,Comoros,7,4,3
1990,826,United Kingdom,Comoros,7,5,2
1990,380,Italy,Comoros,3,1,2
1990,250,France,Comoros,18859,9246,9613
1990,756,Switzerland,Comoros,15,8,7
1990,124,Canada,Comoros,19,9,10
1995,232,Eritrea,Comoros,60,26,34
1995,450,Madagascar,Comoros,7242,4070,3172
1995,175,Mayotte,Comoros,20154,11193,8961
1995,638,Réunion,Comoros,952,470,482
1995,834,United Republic of Tanzania,Comoros,458,276,182
1995,710,South Africa,Comoros,120,100,20
1995,818,Egypt,Comoros,527,443,84
1995,434,Libya,Comoros,2178,1843,335
1995,152,Chile,Comoros,2,1,1
1995,203,Czechia,Comoros,1,1,0
1995,643,Russian Federation,Comoros,15,9,6
1995,208,Denmark,Comoros,17,12,5
1995,246,Finland,Comoros,2,1,1
1995,752,Sweden,Comoros,9,5,4
1995,826,United Kingdom,Comoros,33,16,17
1995,380,Italy,Comoros,7,2,5
1995,250,France,Comoros,19469,9378,10091
1995,756,Switzerland,Comoros,17,10,7
1995,124,Canada,Comoros,29,14,15
2000,232,Eritrea,Comoros,93,45,48
2000,450,Madagascar,Comoros,8050,4540,3510
2000,175,Mayotte,Comoros,36203,18514,17689
2000,638,Réunion,Comoros,1509,722,787
2000,834,United Republic of Tanzania,Comoros,487,293,194
2000,710,South Africa,Comoros,83,71,12
2000,818,Egypt,Comoros,664,540,124
2000,434,Libya,Comoros,3162,2635,527
2000,152,Chile,Comoros,1,0,1
2000,203,Czechia,Comoros,1,1,0
2000,643,Russian Federation,Comoros,13,9,4
2000,208,Denmark,Comoros,16,11,5
2000,246,Finland,Comoros,2,1,1
2000,752,Sweden,Comoros,9,5,4
2000,826,United Kingdom,Comoros,60,27,33
2000,380,Italy,Comoros,11,3,8
2000,250,France,Comoros,20078,9509,10569
2000,756,Switzerland,Comoros,21,13,8
2000,124,Canada,Comoros,40,19,21
2005,232,Eritrea,Comoros,141,72,69
2005,450,Madagascar,Comoros,8910,5042,3868
2005,175,Mayotte,Comoros,49545,24487,25058
2005,638,Réunion,Comoros,1878,895,983
2005,834,United Republic of Tanzania,Comoros,551,332,219
2005,710,South Africa,Comoros,108,93,15
2005,818,Egypt,Comoros,791,652,139
2005,434,Libya,Comoros,3483,3006,477
2005,152,Chile,Comoros,1,0,1
2005,203,Czechia,Comoros,1,1,0
2005,643,Russian Federation,Comoros,50,27,23
2005,208,Denmark,Comoros,17,9,8
2005,246,Finland,Comoros,3,2,1
2005,752,Sweden,Comoros,6,3,3
2005,826,United Kingdom,Comoros,95,41,54
2005,300,Greece,Comoros,38,29,9
2005,380,Italy,Comoros,24,8,16
2005,250,France,Comoros,30384,15080,15304
2005,756,Switzerland,Comoros,23,15,8
2005,124,Canada,Comoros,109,52,57
2010,232,Eritrea,Comoros,189,98,91
2010,450,Madagascar,Comoros,9876,5605,4271
2010,175,Mayotte,Comoros,56520,26800,29720
2010,638,Réunion,Comoros,2143,1016,1127
2010,834,United Republic of Tanzania,Comoros,567,342,225
2010,710,South Africa,Comoros,169,146,23
2010,818,Egypt,Comoros,854,698,156
2010,434,Libya,Comoros,3810,3293,517
2010,152,Chile,Comoros,2,1,1
2010,203,Czechia,Comoros,1,1,0
2010,643,Russian Federation,Comoros,87,45,42
2010,208,Denmark,Comoros,17,7,10
2010,246,Finland,Comoros,3,2,1
2010,752,Sweden,Comoros,7,5,2
2010,826,United Kingdom,Comoros,100,45,55
2010,300,Greece,Comoros,78,61,17
2010,380,Italy,Comoros,39,15,24
2010,705,Slovenia,Comoros,1,1,0
2010,250,France,Comoros,34401,15886,18515
2010,756,Switzerland,Comoros,28,16,12
2010,124,Canada,Comoros,175,84,91
2015,232,Eritrea,Comoros,192,101,91
2015,450,Madagascar,Comoros,10953,6238,4715
2015,175,Mayotte,Comoros,57482,26594,30888
2015,638,Réunion,Comoros,2215,1045,1170
2015,834,United Republic of Tanzania,Comoros,596,360,236
2015,710,South Africa,Comoros,304,262,42
2015,324,Guinea,Comoros,761,475,286
2015,818,Egypt,Comoros,633,533,100
2015,434,Libya,Comoros,4295,3705,590
2015,152,Chile,Comoros,3,2,1
2015,203,Czechia,Comoros,1,1,0
2015,643,Russian Federation,Comoros,88,44,44
2015,208,Denmark,Comoros,13,4,9
2015,246,Finland,Comoros,3,2,1
2015,752,Sweden,Comoros,3,2,1
2015,826,United Kingdom,Comoros,127,55,72
2015,300,Greece,Comoros,73,57,16
2015,380,Italy,Comoros,29,11,18
2015,250,France,Comoros,38108,17033,21075
2015,756,Switzerland,Comoros,39,21,18
2015,124,Canada,Comoros,134,65,69
2019,232,Eritrea,Comoros,193,102,91
2019,450,Madagascar,Comoros,11932,6794,5138
2019,175,Mayotte,Comoros,57991,26830,31161
2019,638,Réunion,Comoros,2248,1061,1187
2019,834,United Republic of Tanzania,Comoros,534,322,212
2019,710,South Africa,Comoros,340,294,46
2019,324,Guinea,Comoros,726,454,272
2019,818,Egypt,Comoros,902,743,159
2019,434,Libya,Comoros,4557,3931,626
2019,152,Chile,Comoros,4,3,1
2019,203,Czechia,Comoros,1,1,0
2019,643,Russian Federation,Comoros,87,44,43
2019,208,Denmark,Comoros,15,5,10
2019,246,Finland,Comoros,4,3,1
2019,826,United Kingdom,Comoros,144,63,81
2019,300,Greece,Comoros,71,56,15
2019,380,Italy,Comoros,25,11,14
2019,250,France,Comoros,40337,17979,22358
2019,756,Switzerland,Comoros,44,21,23
2019,124,Canada,Comoros,143,70,73
1990,454,Malawi,Congo,735,401,334
1990,834,United Republic of Tanzania,Congo,15007,7624,7383
1990,894,Zambia,Congo,116,52,64
1990,24,Angola,Congo,410,190,220
1990,148,Chad,Congo,715,386,329
1990,180,Democratic Republic of the Congo,Congo,3647,1823,1824
1990,266,Gabon,Congo,5045,2338,2707
1990,748,Eswatini,Congo,1,1,0
1990,516,Namibia,Congo,1652,955,697
1990,710,South Africa,Congo,1302,765,537
1990,204,Benin,Congo,393,209,184
1990,466,Mali,Congo,4022,2098,1924
1990,768,Togo,Congo,123,73,50
1990,818,Egypt,Congo,26,23,3
1990,434,Libya,Congo,74,67,7
1990,504,Morocco,Congo,1286,680,606
1990,608,Philippines,Congo,121,66,55
1990,188,Costa Rica,Congo,7,5,2
1990,32,Argentina,Congo,92,48,44
1990,68,Bolivia (Plurinational State of),Congo,1,0,1
1990,152,Chile,Congo,2,1,1
1990,36,Australia,Congo,134,75,59
1990,100,Bulgaria,Congo,10,9,1
1990,203,Czechia,Congo,16,14,2
1990,348,Hungary,Congo,18,18,0
1990,616,Poland,Congo,68,54,14
1990,643,Russian Federation,Congo,492,241,251
1990,703,Slovakia,Congo,1,1,0
1990,208,Denmark,Congo,31,14,17
1990,246,Finland,Congo,12,5,7
1990,372,Ireland,Congo,163,80,83
1990,428,Latvia,Congo,1,1,0
1990,578,Norway,Congo,132,67,65
1990,752,Sweden,Congo,125,67,58
1990,826,United Kingdom,Congo,456,277,179
1990,300,Greece,Congo,35,2,33
1990,380,Italy,Congo,508,177,331
1990,620,Portugal,Congo,532,252,280
1990,724,Spain,Congo,93,62,31
1990,40,Austria,Congo,252,140,112
1990,56,Belgium,Congo,6195,4028,2167
1990,250,France,Congo,48395,25853,22542
1990,276,Germany,Congo,351,299,52
1990,528,Netherlands,Congo,295,174,121
1990,756,Switzerland,Congo,3193,1759,1434
1990,124,Canada,Congo,87,42,45
1995,454,Malawi,Congo,1567,858,709
1995,834,United Republic of Tanzania,Congo,22000,11149,10851
1995,894,Zambia,Congo,456,205,251
1995,24,Angola,Congo,477,210,267
1995,148,Chad,Congo,777,419,358
1995,180,Democratic Republic of the Congo,Congo,5912,2954,2958
1995,266,Gabon,Congo,6747,3125,3622
1995,748,Eswatini,Congo,9,5,4
1995,516,Namibia,Congo,1579,917,662
1995,710,South Africa,Congo,3712,2355,1357
1995,204,Benin,Congo,542,291,251
1995,466,Mali,Congo,4208,2194,2014
1995,768,Togo,Congo,138,82,56
1995,818,Egypt,Congo,39,29,10
1995,434,Libya,Congo,183,134,49
1995,504,Morocco,Congo,1180,616,564
1995,608,Philippines,Congo,162,87,75
1995,188,Costa Rica,Congo,5,3,2
1995,32,Argentina,Congo,90,47,43
1995,68,Bolivia (Plurinational State of),Congo,3,1,2
1995,152,Chile,Congo,7,5,2
1995,36,Australia,Congo,130,69,61
1995,100,Bulgaria,Congo,9,7,2
1995,203,Czechia,Congo,24,20,4
1995,348,Hungary,Congo,37,32,5
1995,616,Poland,Congo,58,47,11
1995,643,Russian Federation,Congo,424,253,171
1995,703,Slovakia,Congo,6,4,2
1995,208,Denmark,Congo,58,29,29
1995,246,Finland,Congo,12,5,7
1995,372,Ireland,Congo,578,274,304
1995,428,Latvia,Congo,1,1,0
1995,578,Norway,Congo,172,86,86
1995,752,Sweden,Congo,149,80,69
1995,826,United Kingdom,Congo,1793,893,900
1995,300,Greece,Congo,435,211,224
1995,380,Italy,Congo,1898,904,994
1995,620,Portugal,Congo,1148,541,607
1995,724,Spain,Congo,294,206,88
1995,40,Austria,Congo,284,160,124
1995,56,Belgium,Congo,4892,2982,1910
1995,250,France,Congo,49960,26297,23663
1995,276,Germany,Congo,844,545,299
1995,528,Netherlands,Congo,433,250,183
1995,756,Switzerland,Congo,2070,1146,924
1995,124,Canada,Congo,182,88,94
2000,454,Malawi,Congo,1509,824,685
2000,834,United Republic of Tanzania,Congo,23123,11438,11685
2000,894,Zambia,Congo,4330,2410,1920
2000,24,Angola,Congo,543,230,313
2000,148,Chad,Congo,839,452,387
2000,180,Democratic Republic of the Congo,Congo,9470,4645,4825
2000,266,Gabon,Congo,8440,3941,4499
2000,748,Eswatini,Congo,36,19,17
2000,516,Namibia,Congo,1468,855,613
2000,710,South Africa,Congo,7885,4959,2926
2000,204,Benin,Congo,691,373,318
2000,466,Mali,Congo,3856,2021,1835
2000,768,Togo,Congo,155,92,63
2000,818,Egypt,Congo,55,37,18
2000,434,Libya,Congo,297,206,91
2000,504,Morocco,Congo,1243,639,604
2000,608,Philippines,Congo,555,555,0
2000,188,Costa Rica,Congo,6,4,2
2000,32,Argentina,Congo,88,47,41
2000,68,Bolivia (Plurinational State of),Congo,5,3,2
2000,152,Chile,Congo,12,8,4
2000,36,Australia,Congo,130,71,59
2000,100,Bulgaria,Congo,8,5,3
2000,203,Czechia,Congo,32,27,5
2000,348,Hungary,Congo,55,46,9
2000,616,Poland,Congo,50,40,10
2000,643,Russian Federation,Congo,341,256,85
2000,703,Slovakia,Congo,14,9,5
2000,208,Denmark,Congo,84,44,40
2000,246,Finland,Congo,12,6,6
2000,372,Ireland,Congo,1312,645,667
2000,428,Latvia,Congo,2,2,0
2000,578,Norway,Congo,266,135,131
2000,752,Sweden,Congo,160,85,75
2000,826,United Kingdom,Congo,3162,1522,1640
2000,300,Greece,Congo,843,420,423
2000,380,Italy,Congo,3287,1630,1657
2000,620,Portugal,Congo,1812,855,957
2000,705,Slovenia,Congo,2,2,0
2000,724,Spain,Congo,623,442,181
2000,40,Austria,Congo,316,180,136
2000,56,Belgium,Congo,3445,1848,1597
2000,250,France,Congo,51524,26741,24783
2000,276,Germany,Congo,1337,791,546
2000,528,Netherlands,Congo,587,335,252
2000,756,Switzerland,Congo,955,539,416
2000,124,Canada,Congo,282,136,146
2005,454,Malawi,Congo,1438,783,655
2005,834,United Republic of Tanzania,Congo,23777,11743,12034
2005,894,Zambia,Congo,5632,1998,3634
2005,24,Angola,Congo,703,287,416
2005,120,Cameroon,Congo,2972,1475,1497
2005,148,Chad,Congo,580,262,318
2005,180,Democratic Republic of the Congo,Congo,9470,4645,4825
2005,266,Gabon,Congo,9203,4346,4857
2005,748,Eswatini,Congo,49,24,25
2005,516,Namibia,Congo,1160,673,487
2005,710,South Africa,Congo,10876,6343,4533
2005,204,Benin,Congo,1802,923,879
2005,466,Mali,Congo,15735,8003,7732
2005,768,Togo,Congo,174,104,70
2005,818,Egypt,Congo,65,45,20
2005,434,Libya,Congo,326,245,81
2005,504,Morocco,Congo,1275,646,629
2005,608,Philippines,Congo,449,449,0
2005,188,Costa Rica,Congo,4,3,1
2005,32,Argentina,Congo,65,34,31
2005,68,Bolivia (Plurinational State of),Congo,6,4,2
2005,76,Brazil,Congo,39,35,4
2005,152,Chile,Congo,18,13,5
2005,36,Australia,Congo,710,413,297
2005,100,Bulgaria,Congo,9,5,4
2005,203,Czechia,Congo,43,31,12
2005,348,Hungary,Congo,68,57,11
2005,616,Poland,Congo,78,51,27
2005,643,Russian Federation,Congo,459,344,115
2005,703,Slovakia,Congo,16,10,6
2005,208,Denmark,Congo,377,184,193
2005,246,Finland,Congo,55,29,26
2005,372,Ireland,Congo,2058,1078,980
2005,428,Latvia,Congo,1,1,0
2005,578,Norway,Congo,687,352,335
2005,752,Sweden,Congo,347,180,167
2005,826,United Kingdom,Congo,5608,2430,3178
2005,300,Greece,Congo,1144,536,608
2005,380,Italy,Congo,3336,1694,1642
2005,620,Portugal,Congo,1216,497,719
2005,724,Spain,Congo,1694,1130,564
2005,40,Austria,Congo,354,198,156
2005,56,Belgium,Congo,5255,2662,2593
2005,250,France,Congo,57496,28522,28974
2005,276,Germany,Congo,2465,1298,1167
2005,528,Netherlands,Congo,1071,624,447
2005,756,Switzerland,Congo,991,536,455
2005,124,Canada,Congo,1004,558,446
2010,454,Malawi,Congo,1413,768,645
2010,834,United Republic of Tanzania,Congo,24354,12007,12347
2010,894,Zambia,Congo,8481,4262,4219
2010,24,Angola,Congo,862,344,518
2010,120,Cameroon,Congo,2365,1227,1138
2010,148,Chad,Congo,687,307,380
2010,180,Democratic Republic of the Congo,Congo,1551,766,785
2010,266,Gabon,Congo,10660,5142,5518
2010,748,Eswatini,Congo,62,29,33
2010,516,Namibia,Congo,1117,649,468
2010,710,South Africa,Congo,17037,9910,7127
2010,204,Benin,Congo,2942,1484,1458
2010,466,Mali,Congo,8589,4484,4105
2010,768,Togo,Congo,229,140,89
2010,818,Egypt,Congo,70,48,22
2010,434,Libya,Congo,357,269,88
2010,504,Morocco,Congo,1427,720,707
2010,608,Philippines,Congo,521,521,0
2010,188,Costa Rica,Congo,8,5,3
2010,32,Argentina,Congo,42,22,20
2010,68,Bolivia (Plurinational State of),Congo,6,4,2
2010,76,Brazil,Congo,79,71,8
2010,152,Chile,Congo,24,17,7
2010,36,Australia,Congo,1030,580,450
2010,100,Bulgaria,Congo,9,4,5
2010,203,Czechia,Congo,50,32,18
2010,348,Hungary,Congo,81,68,13
2010,616,Poland,Congo,110,63,47
2010,643,Russian Federation,Congo,569,426,143
2010,703,Slovakia,Congo,18,11,7
2010,208,Denmark,Congo,658,320,338
2010,233,Estonia,Congo,4,3,1
2010,246,Finland,Congo,107,61,46
2010,372,Ireland,Congo,2466,1211,1255
2010,428,Latvia,Congo,1,1,0
2010,578,Norway,Congo,1694,875,819
2010,752,Sweden,Congo,637,313,324
2010,826,United Kingdom,Congo,5907,2628,3279
2010,300,Greece,Congo,1503,680,823
2010,380,Italy,Congo,3474,1815,1659
2010,620,Portugal,Congo,419,58,361
2010,705,Slovenia,Congo,7,5,2
2010,724,Spain,Congo,2333,1469,864
2010,40,Austria,Congo,391,216,175
2010,56,Belgium,Congo,4153,1987,2166
2010,250,France,Congo,65240,33155,32085
2010,276,Germany,Congo,3401,1731,1670
2010,528,Netherlands,Congo,1008,550,458
2010,756,Switzerland,Congo,1262,650,612
2010,124,Canada,Congo,1655,941,714
2015,454,Malawi,Congo,11395,6358,5037
2015,834,United Republic of Tanzania,Congo,25017,12399,12618
2015,894,Zambia,Congo,7471,3741,3730
2015,24,Angola,Congo,1021,401,620
2015,120,Cameroon,Congo,3020,1371,1649
2015,148,Chad,Congo,852,392,460
2015,180,Democratic Republic of the Congo,Congo,6545,1184,5361
2015,266,Gabon,Congo,14905,8267,6638
2015,748,Eswatini,Congo,72,36,36
2015,516,Namibia,Congo,1093,637,456
2015,710,South Africa,Congo,30731,17221,13510
2015,204,Benin,Congo,3783,1955,1828
2015,324,Guinea,Congo,122,79,43
2015,466,Mali,Congo,10642,5557,5085
2015,768,Togo,Congo,257,157,100
2015,818,Egypt,Congo,51,37,14
2015,434,Libya,Congo,402,302,100
2015,504,Morocco,Congo,1859,934,925
2015,608,Philippines,Congo,529,529,0
2015,188,Costa Rica,Congo,8,5,3
2015,32,Argentina,Congo,42,22,20
2015,68,Bolivia (Plurinational State of),Congo,7,5,2
2015,76,Brazil,Congo,95,85,10
2015,152,Chile,Congo,36,26,10
2015,36,Australia,Congo,1610,809,801
2015,100,Bulgaria,Congo,11,5,6
2015,203,Czechia,Congo,62,42,20
2015,348,Hungary,Congo,82,65,17
2015,616,Poland,Congo,106,62,44
2015,643,Russian Federation,Congo,580,434,146
2015,703,Slovakia,Congo,23,14,9
2015,208,Denmark,Congo,786,383,403
2015,233,Estonia,Congo,4,3,1
2015,246,Finland,Congo,146,77,69
2015,372,Ireland,Congo,2519,1221,1298
2015,578,Norway,Congo,224,110,114
2015,752,Sweden,Congo,806,405,401
2015,826,United Kingdom,Congo,7554,3237,4317
2015,300,Greece,Congo,1410,605,805
2015,380,Italy,Congo,3307,1698,1609
2015,620,Portugal,Congo,474,44,430
2015,705,Slovenia,Congo,9,6,3
2015,724,Spain,Congo,2105,1252,853
2015,40,Austria,Congo,457,254,203
2015,56,Belgium,Congo,4084,1943,2141
2015,250,France,Congo,72271,35749,36522
2015,276,Germany,Congo,3543,1799,1744
2015,528,Netherlands,Congo,996,506,490
2015,756,Switzerland,Congo,1188,609,579
2015,124,Canada,Congo,2444,1346,1098
2019,454,Malawi,Congo,11560,6450,5110
2019,834,United Republic of Tanzania,Congo,22434,11056,11378
2019,894,Zambia,Congo,9628,4833,4795
2019,24,Angola,Congo,1081,461,620
2019,120,Cameroon,Congo,3004,1365,1639
2019,148,Chad,Congo,934,430,504
2019,180,Democratic Republic of the Congo,Congo,6314,1053,5261
2019,266,Gabon,Congo,16194,8976,7218
2019,748,Eswatini,Congo,71,35,36
2019,516,Namibia,Congo,1156,674,482
2019,710,South Africa,Congo,34445,19317,15128
2019,204,Benin,Congo,4029,2086,1943
2019,324,Guinea,Congo,116,75,41
2019,466,Mali,Congo,11849,6188,5661
2019,768,Togo,Congo,258,158,100
2019,818,Egypt,Congo,72,50,22
2019,434,Libya,Congo,426,320,106
2019,504,Morocco,Congo,1982,996,986
2019,608,Philippines,Congo,545,545,0
2019,188,Costa Rica,Congo,8,5,3
2019,32,Argentina,Congo,42,22,20
2019,68,Bolivia (Plurinational State of),Congo,7,5,2
2019,76,Brazil,Congo,106,95,11
2019,152,Chile,Congo,48,34,14
2019,36,Australia,Congo,1851,864,987
2019,100,Bulgaria,Congo,18,7,11
2019,203,Czechia,Congo,67,44,23
2019,348,Hungary,Congo,78,63,15
2019,616,Poland,Congo,112,68,44
2019,643,Russian Federation,Congo,579,434,145
2019,703,Slovakia,Congo,24,14,10
2019,208,Denmark,Congo,463,214,249
2019,233,Estonia,Congo,4,4,0
2019,246,Finland,Congo,161,90,71
2019,372,Ireland,Congo,2765,1345,1420
2019,428,Latvia,Congo,1,1,0
2019,578,Norway,Congo,276,130,146
2019,752,Sweden,Congo,887,439,448
2019,826,United Kingdom,Congo,8578,3688,4890
2019,300,Greece,Congo,1377,621,756
2019,380,Italy,Congo,3293,1742,1551
2019,620,Portugal,Congo,482,46,436
2019,705,Slovenia,Congo,7,4,3
2019,724,Spain,Congo,2181,1277,904
2019,40,Austria,Congo,539,304,235
2019,56,Belgium,Congo,4154,1985,2169
2019,250,France,Congo,76499,37752,38747
2019,276,Germany,Congo,3886,1998,1888
2019,528,Netherlands,Congo,990,514,476
2019,756,Switzerland,Congo,1207,627,580
2019,124,Canada,Congo,2619,1443,1176
1990,214,Dominican Republic,Cook Islands,9,3,6
1990,152,Chile,Cook Islands,2,0,2
1990,36,Australia,Cook Islands,2295,1115,1180
1990,554,New Zealand,Cook Islands,15136,7239,7897
1990,242,Fiji,Cook Islands,30,16,14
1990,882,Samoa,Cook Islands,6,0,6
1990,208,Denmark,Cook Islands,1,0,1
1990,300,Greece,Cook Islands,5,3,2
1990,250,France,Cook Islands,4,1,3
1995,214,Dominican Republic,Cook Islands,10,3,7
1995,152,Chile,Cook Islands,2,1,1
1995,36,Australia,Cook Islands,3562,1749,1813
1995,554,New Zealand,Cook Islands,13387,6374,7013
1995,242,Fiji,Cook Islands,30,16,14
1995,882,Samoa,Cook Islands,11,3,8
1995,208,Denmark,Cook Islands,1,0,1
1995,300,Greece,Cook Islands,5,3,2
1995,250,France,Cook Islands,4,1,3
2000,214,Dominican Republic,Cook Islands,11,3,8
2000,152,Chile,Cook Islands,2,0,2
2000,36,Australia,Cook Islands,4600,2268,2332
2000,554,New Zealand,Cook Islands,14811,7199,7612
2000,242,Fiji,Cook Islands,30,16,14
2000,882,Samoa,Cook Islands,17,2,15
2000,208,Denmark,Cook Islands,1,0,1
2000,300,Greece,Cook Islands,5,2,3
2000,250,France,Cook Islands,4,1,3
2005,214,Dominican Republic,Cook Islands,10,3,7
2005,152,Chile,Cook Islands,3,1,2
2005,36,Australia,Cook Islands,5460,2706,2754
2005,554,New Zealand,Cook Islands,14055,6822,7233
2005,242,Fiji,Cook Islands,30,16,14
2005,882,Samoa,Cook Islands,16,2,14
2005,208,Denmark,Cook Islands,1,0,1
2005,300,Greece,Cook Islands,3,1,2
2005,250,France,Cook Islands,6,0,6
2010,214,Dominican Republic,Cook Islands,8,2,6
2010,152,Chile,Cook Islands,4,1,3
2010,36,Australia,Cook Islands,6630,3322,3308
2010,554,New Zealand,Cook Islands,13868,6721,7147
2010,242,Fiji,Cook Islands,32,17,15
2010,882,Samoa,Cook Islands,14,3,11
2010,250,France,Cook Islands,3,0,3
2015,214,Dominican Republic,Cook Islands,8,2,6
2015,152,Chile,Cook Islands,6,2,4
2015,36,Australia,Cook Islands,8040,4160,3880
2015,554,New Zealand,Cook Islands,13460,6509,6951
2015,242,Fiji,Cook Islands,33,18,15
2015,882,Samoa,Cook Islands,11,2,9
2015,250,France,Cook Islands,3,0,3
2019,214,Dominican Republic,Cook Islands,8,2,6
2019,152,Chile,Cook Islands,8,3,5
2019,36,Australia,Cook Islands,8590,4398,4192
2019,554,New Zealand,Cook Islands,13835,6691,7144
2019,242,Fiji,Cook Islands,33,18,15
2019,882,Samoa,Cook Islands,10,2,8
2019,250,France,Cook Islands,4,1,3
1990,196,Cyprus,Costa Rica,1,0,1
1990,792,Turkey,Costa Rica,13,8,5
1990,608,Philippines,Costa Rica,21,15,6
1990,44,Bahamas,Costa Rica,10,5,5
1990,136,Cayman Islands,Costa Rica,87,62,25
1990,214,Dominican Republic,Costa Rica,1552,628,924
1990,332,Haiti,Costa Rica,274,106,168
1990,388,Jamaica,Costa Rica,96,40,56
1990,630,Puerto Rico,Costa Rica,487,231,256
1990,222,El Salvador,Costa Rica,1558,759,799
1990,320,Guatemala,Costa Rica,758,204,554
1990,340,Honduras,Costa Rica,594,328,266
1990,484,Mexico,Costa Rica,2088,783,1305
1990,558,Nicaragua,Costa Rica,5959,2894,3065
1990,591,Panama,Costa Rica,3919,1683,2236
1990,32,Argentina,Costa Rica,462,223,239
1990,68,Bolivia (Plurinational State of),Costa Rica,102,53,49
1990,76,Brazil,Costa Rica,388,267,121
1990,152,Chile,Costa Rica,428,207,221
1990,170,Colombia,Costa Rica,691,321,370
1990,218,Ecuador,Costa Rica,313,145,168
1990,604,Peru,Costa Rica,209,101,108
1990,862,Venezuela (Bolivarian Republic of),Costa Rica,1661,715,946
1990,36,Australia,Costa Rica,236,122,114
1990,100,Bulgaria,Costa Rica,1,1,0
1990,203,Czechia,Costa Rica,3,2,1
1990,348,Hungary,Costa Rica,8,7,1
1990,616,Poland,Costa Rica,28,21,7
1990,643,Russian Federation,Costa Rica,35,17,18
1990,208,Denmark,Costa Rica,42,32,10
1990,246,Finland,Costa Rica,10,6,4
1990,352,Iceland,Costa Rica,3,2,1
1990,372,Ireland,Costa Rica,2,1,1
1990,578,Norway,Costa Rica,130,63,67
1990,752,Sweden,Costa Rica,162,77,85
1990,826,United Kingdom,Costa Rica,50,29,21
1990,300,Greece,Costa Rica,26,15,11
1990,380,Italy,Costa Rica,92,32,60
1990,724,Spain,Costa Rica,644,275,369
1990,40,Austria,Costa Rica,99,38,61
1990,56,Belgium,Costa Rica,136,66,70
1990,250,France,Costa Rica,421,192,229
1990,276,Germany,Costa Rica,516,231,285
1990,528,Netherlands,Costa Rica,207,101,106
1990,756,Switzerland,Costa Rica,412,167,245
1990,124,Canada,Costa Rica,1247,607,640
1990,840,United States of America,Costa Rica,43530,17377,26153
1995,196,Cyprus,Costa Rica,2,0,2
1995,792,Turkey,Costa Rica,31,17,14
1995,608,Philippines,Costa Rica,28,20,8
1995,44,Bahamas,Costa Rica,38,16,22
1995,136,Cayman Islands,Costa Rica,165,118,47
1995,214,Dominican Republic,Costa Rica,1724,673,1051
1995,332,Haiti,Costa Rica,260,101,159
1995,388,Jamaica,Costa Rica,101,42,59
1995,630,Puerto Rico,Costa Rica,531,252,279
1995,222,El Salvador,Costa Rica,1188,573,615
1995,320,Guatemala,Costa Rica,746,261,485
1995,340,Honduras,Costa Rica,617,331,286
1995,484,Mexico,Costa Rica,2571,1000,1571
1995,558,Nicaragua,Costa Rica,4727,2277,2450
1995,591,Panama,Costa Rica,4155,1844,2311
1995,32,Argentina,Costa Rica,359,179,180
1995,68,Bolivia (Plurinational State of),Costa Rica,122,61,61
1995,76,Brazil,Costa Rica,314,188,126
1995,152,Chile,Costa Rica,441,212,229
1995,170,Colombia,Costa Rica,757,357,400
1995,218,Ecuador,Costa Rica,351,162,189
1995,604,Peru,Costa Rica,210,100,110
1995,862,Venezuela (Bolivarian Republic of),Costa Rica,1405,592,813
1995,36,Australia,Costa Rica,307,161,146
1995,100,Bulgaria,Costa Rica,2,2,0
1995,203,Czechia,Costa Rica,4,3,1
1995,348,Hungary,Costa Rica,15,11,4
1995,616,Poland,Costa Rica,24,19,5
1995,643,Russian Federation,Costa Rica,34,18,16
1995,208,Denmark,Costa Rica,68,46,22
1995,246,Finland,Costa Rica,16,9,7
1995,352,Iceland,Costa Rica,5,3,2
1995,372,Ireland,Costa Rica,5,2,3
1995,578,Norway,Costa Rica,157,79,78
1995,752,Sweden,Costa Rica,193,92,101
1995,826,United Kingdom,Costa Rica,200,90,110
1995,300,Greece,Costa Rica,26,12,14
1995,380,Italy,Costa Rica,301,71,230
1995,724,Spain,Costa Rica,778,343,435
1995,40,Austria,Costa Rica,112,44,68
1995,56,Belgium,Costa Rica,136,66,70
1995,250,France,Costa Rica,435,194,241
1995,276,Germany,Costa Rica,639,241,398
1995,528,Netherlands,Costa Rica,304,143,161
1995,756,Switzerland,Costa Rica,505,222,283
1995,124,Canada,Costa Rica,1840,890,950
1995,840,United States of America,Costa Rica,58472,23701,34771
2000,196,Cyprus,Costa Rica,2,0,2
2000,792,Turkey,Costa Rica,51,27,24
2000,608,Philippines,Costa Rica,29,29,0
2000,44,Bahamas,Costa Rica,66,27,39
2000,136,Cayman Islands,Costa Rica,284,202,82
2000,214,Dominican Republic,Costa Rica,1896,718,1178
2000,332,Haiti,Costa Rica,246,95,151
2000,388,Jamaica,Costa Rica,106,45,61
2000,630,Puerto Rico,Costa Rica,577,274,303
2000,222,El Salvador,Costa Rica,818,387,431
2000,320,Guatemala,Costa Rica,734,319,415
2000,340,Honduras,Costa Rica,639,334,305
2000,484,Mexico,Costa Rica,3166,1270,1896
2000,558,Nicaragua,Costa Rica,6948,3453,3495
2000,591,Panama,Costa Rica,4654,2108,2546
2000,32,Argentina,Costa Rica,257,136,121
2000,68,Bolivia (Plurinational State of),Costa Rica,141,68,73
2000,76,Brazil,Costa Rica,239,109,130
2000,152,Chile,Costa Rica,455,217,238
2000,170,Colombia,Costa Rica,822,392,430
2000,218,Ecuador,Costa Rica,389,180,209
2000,604,Peru,Costa Rica,246,118,128
2000,862,Venezuela (Bolivarian Republic of),Costa Rica,1178,484,694
2000,36,Australia,Costa Rica,350,189,161
2000,100,Bulgaria,Costa Rica,3,3,0
2000,203,Czechia,Costa Rica,5,4,1
2000,348,Hungary,Costa Rica,22,15,7
2000,616,Poland,Costa Rica,21,16,5
2000,643,Russian Federation,Costa Rica,33,18,15
2000,208,Denmark,Costa Rica,93,60,33
2000,246,Finland,Costa Rica,21,11,10
2000,352,Iceland,Costa Rica,6,4,2
2000,372,Ireland,Costa Rica,12,5,7
2000,578,Norway,Costa Rica,177,88,89
2000,752,Sweden,Costa Rica,207,97,110
2000,826,United Kingdom,Costa Rica,355,153,202
2000,300,Greece,Costa Rica,27,9,18
2000,380,Italy,Costa Rica,509,109,400
2000,705,Slovenia,Costa Rica,1,0,1
2000,724,Spain,Costa Rica,1249,572,677
2000,40,Austria,Costa Rica,124,49,75
2000,56,Belgium,Costa Rica,131,63,68
2000,250,France,Costa Rica,448,196,252
2000,276,Germany,Costa Rica,762,251,511
2000,528,Netherlands,Costa Rica,413,191,222
2000,756,Switzerland,Costa Rica,600,277,323
2000,124,Canada,Costa Rica,2476,1194,1282
2000,840,United States of America,Costa Rica,73694,30197,43497
2005,196,Cyprus,Costa Rica,3,0,3
2005,792,Turkey,Costa Rica,52,27,25
2005,608,Philippines,Costa Rica,23,23,0
2005,44,Bahamas,Costa Rica,58,23,35
2005,136,Cayman Islands,Costa Rica,193,137,56
2005,214,Dominican Republic,Costa Rica,1097,438,659
2005,332,Haiti,Costa Rica,233,90,143
2005,388,Jamaica,Costa Rica,104,45,59
2005,630,Puerto Rico,Costa Rica,601,285,316
2005,222,El Salvador,Costa Rica,829,387,442
2005,320,Guatemala,Costa Rica,872,417,455
2005,340,Honduras,Costa Rica,626,331,295
2005,484,Mexico,Costa Rica,2669,1134,1535
2005,558,Nicaragua,Costa Rica,9343,4692,4651
2005,591,Panama,Costa Rica,5500,2545,2955
2005,32,Argentina,Costa Rica,190,102,88
2005,68,Bolivia (Plurinational State of),Costa Rica,133,66,67
2005,76,Brazil,Costa Rica,313,171,142
2005,152,Chile,Costa Rica,682,331,351
2005,170,Colombia,Costa Rica,832,402,430
2005,218,Ecuador,Costa Rica,459,218,241
2005,604,Peru,Costa Rica,289,139,150
2005,862,Venezuela (Bolivarian Republic of),Costa Rica,1142,482,660
2005,36,Australia,Costa Rica,380,200,180
2005,100,Bulgaria,Costa Rica,4,4,0
2005,203,Czechia,Costa Rica,17,11,6
2005,348,Hungary,Costa Rica,27,19,8
2005,616,Poland,Costa Rica,28,26,2
2005,643,Russian Federation,Costa Rica,32,18,14
2005,208,Denmark,Costa Rica,119,73,46
2005,246,Finland,Costa Rica,38,23,15
2005,352,Iceland,Costa Rica,6,4,2
2005,372,Ireland,Costa Rica,13,6,7
2005,578,Norway,Costa Rica,219,112,107
2005,752,Sweden,Costa Rica,273,129,144
2005,826,United Kingdom,Costa Rica,503,229,274
2005,300,Greece,Costa Rica,33,8,25
2005,380,Italy,Costa Rica,1009,343,666
2005,724,Spain,Costa Rica,2116,952,1164
2005,40,Austria,Costa Rica,139,53,86
2005,56,Belgium,Costa Rica,181,84,97
2005,250,France,Costa Rica,640,249,391
2005,276,Germany,Costa Rica,1182,484,698
2005,528,Netherlands,Costa Rica,560,249,311
2005,756,Switzerland,Costa Rica,691,303,388
2005,124,Canada,Costa Rica,3364,1634,1730
2005,840,United States of America,Costa Rica,80856,33396,47460
2010,196,Cyprus,Costa Rica,4,0,4
2010,792,Turkey,Costa Rica,53,27,26
2010,608,Philippines,Costa Rica,38,38,0
2010,44,Bahamas,Costa Rica,50,20,30
2010,136,Cayman Islands,Costa Rica,120,84,36
2010,214,Dominican Republic,Costa Rica,291,155,136
2010,332,Haiti,Costa Rica,244,94,150
2010,388,Jamaica,Costa Rica,101,45,56
2010,630,Puerto Rico,Costa Rica,551,259,292
2010,222,El Salvador,Costa Rica,840,388,452
2010,320,Guatemala,Costa Rica,1010,515,495
2010,340,Honduras,Costa Rica,613,328,285
2010,484,Mexico,Costa Rica,2482,1132,1350
2010,558,Nicaragua,Costa Rica,9989,5051,4938
2010,591,Panama,Costa Rica,6608,3149,3459
2010,32,Argentina,Costa Rica,123,68,55
2010,68,Bolivia (Plurinational State of),Costa Rica,125,64,61
2010,76,Brazil,Costa Rica,383,231,152
2010,152,Chile,Costa Rica,910,446,464
2010,170,Colombia,Costa Rica,986,489,497
2010,218,Ecuador,Costa Rica,645,298,347
2010,604,Peru,Costa Rica,323,155,168
2010,862,Venezuela (Bolivarian Republic of),Costa Rica,1120,485,635
2010,36,Australia,Costa Rica,440,227,213
2010,100,Bulgaria,Costa Rica,5,5,0
2010,203,Czechia,Costa Rica,28,18,10
2010,348,Hungary,Costa Rica,32,23,9
2010,616,Poland,Costa Rica,37,37,0
2010,643,Russian Federation,Costa Rica,31,17,14
2010,208,Denmark,Costa Rica,141,84,57
2010,233,Estonia,Costa Rica,2,2,0
2010,246,Finland,Costa Rica,58,33,25
2010,352,Iceland,Costa Rica,5,3,2
2010,372,Ireland,Costa Rica,11,4,7
2010,428,Latvia,Costa Rica,1,0,1
2010,578,Norway,Costa Rica,247,121,126
2010,752,Sweden,Costa Rica,362,187,175
2010,826,United Kingdom,Costa Rica,529,247,282
2010,300,Greece,Costa Rica,40,7,33
2010,380,Italy,Costa Rica,1478,543,935
2010,705,Slovenia,Costa Rica,1,0,1
2010,724,Spain,Costa Rica,3149,1466,1683
2010,40,Austria,Costa Rica,153,56,97
2010,56,Belgium,Costa Rica,232,100,132
2010,250,France,Costa Rica,706,300,406
2010,276,Germany,Costa Rica,1529,679,850
2010,528,Netherlands,Costa Rica,625,273,352
2010,756,Switzerland,Costa Rica,794,319,475
2010,124,Canada,Costa Rica,4095,2001,2094
2010,840,United States of America,Costa Rica,90687,36725,53962
2015,324,Guinea,Costa Rica,118,73,45
2015,196,Cyprus,Costa Rica,3,0,3
2015,792,Turkey,Costa Rica,53,27,26
2015,608,Philippines,Costa Rica,39,39,0
2015,44,Bahamas,Costa Rica,54,21,33
2015,136,Cayman Islands,Costa Rica,130,92,38
2015,214,Dominican Republic,Costa Rica,307,164,143
2015,332,Haiti,Costa Rica,256,99,157
2015,388,Jamaica,Costa Rica,99,44,55
2015,630,Puerto Rico,Costa Rica,685,320,365
2015,222,El Salvador,Costa Rica,876,405,471
2015,320,Guatemala,Costa Rica,1162,601,561
2015,340,Honduras,Costa Rica,861,462,399
2015,484,Mexico,Costa Rica,3174,1570,1604
2015,558,Nicaragua,Costa Rica,10772,5473,5299
2015,591,Panama,Costa Rica,7760,3688,4072
2015,32,Argentina,Costa Rica,123,68,55
2015,68,Bolivia (Plurinational State of),Costa Rica,146,75,71
2015,76,Brazil,Costa Rica,461,278,183
2015,152,Chile,Costa Rica,1378,661,717
2015,170,Colombia,Costa Rica,1103,552,551
2015,218,Ecuador,Costa Rica,938,430,508
2015,604,Peru,Costa Rica,343,170,173
2015,862,Venezuela (Bolivarian Republic of),Costa Rica,1127,480,647
2015,36,Australia,Costa Rica,500,254,246
2015,100,Bulgaria,Costa Rica,7,7,0
2015,203,Czechia,Costa Rica,54,32,22
2015,348,Hungary,Costa Rica,46,25,21
2015,616,Poland,Costa Rica,35,35,0
2015,643,Russian Federation,Costa Rica,32,17,15
2015,208,Denmark,Costa Rica,181,111,70
2015,233,Estonia,Costa Rica,3,3,0
2015,246,Finland,Costa Rica,78,52,26
2015,352,Iceland,Costa Rica,7,4,3
2015,372,Ireland,Costa Rica,11,4,7
2015,428,Latvia,Costa Rica,2,1,1
2015,578,Norway,Costa Rica,280,145,135
2015,752,Sweden,Costa Rica,423,208,215
2015,826,United Kingdom,Costa Rica,676,305,371
2015,300,Greece,Costa Rica,37,5,32
2015,380,Italy,Costa Rica,1478,563,915
2015,705,Slovenia,Costa Rica,4,2,2
2015,724,Spain,Costa Rica,3339,1499,1840
2015,40,Austria,Costa Rica,179,66,113
2015,56,Belgium,Costa Rica,284,129,155
2015,250,France,Costa Rica,782,321,461
2015,276,Germany,Costa Rica,1594,707,887
2015,528,Netherlands,Costa Rica,738,332,406
2015,756,Switzerland,Costa Rica,937,390,547
2015,124,Canada,Costa Rica,3925,1773,2152
2015,840,United States of America,Costa Rica,91939,36953,54986
2019,324,Guinea,Costa Rica,112,70,42
2019,196,Cyprus,Costa Rica,2,0,2
2019,792,Turkey,Costa Rica,71,37,34
2019,608,Philippines,Costa Rica,40,40,0
2019,44,Bahamas,Costa Rica,57,22,35
2019,136,Cayman Islands,Costa Rica,144,103,41
2019,214,Dominican Republic,Costa Rica,317,170,147
2019,332,Haiti,Costa Rica,266,103,163
2019,388,Jamaica,Costa Rica,100,45,55
2019,630,Puerto Rico,Costa Rica,998,465,533
2019,222,El Salvador,Costa Rica,887,410,477
2019,320,Guatemala,Costa Rica,1192,617,575
2019,340,Honduras,Costa Rica,874,469,405
2019,484,Mexico,Costa Rica,3272,1619,1653
2019,558,Nicaragua,Costa Rica,11283,5733,5550
2019,591,Panama,Costa Rica,8260,3926,4334
2019,32,Argentina,Costa Rica,125,69,56
2019,68,Bolivia (Plurinational State of),Costa Rica,159,82,77
2019,76,Brazil,Costa Rica,519,313,206
2019,152,Chile,Costa Rica,1841,830,1011
2019,170,Colombia,Costa Rica,1128,565,563
2019,218,Ecuador,Costa Rica,923,423,500
2019,604,Peru,Costa Rica,408,211,197
2019,862,Venezuela (Bolivarian Republic of),Costa Rica,1103,467,636
2019,36,Australia,Costa Rica,571,294,277
2019,100,Bulgaria,Costa Rica,8,8,0
2019,203,Czechia,Costa Rica,86,50,36
2019,348,Hungary,Costa Rica,47,22,25
2019,616,Poland,Costa Rica,37,37,0
2019,643,Russian Federation,Costa Rica,31,17,14
2019,208,Denmark,Costa Rica,199,111,88
2019,233,Estonia,Costa Rica,4,4,0
2019,246,Finland,Costa Rica,94,63,31
2019,352,Iceland,Costa Rica,19,12,7
2019,372,Ireland,Costa Rica,12,5,7
2019,578,Norway,Costa Rica,314,156,158
2019,752,Sweden,Costa Rica,472,229,243
2019,826,United Kingdom,Costa Rica,767,347,420
2019,300,Greece,Costa Rica,36,6,30
2019,380,Italy,Costa Rica,1619,630,989
2019,705,Slovenia,Costa Rica,3,2,1
2019,724,Spain,Costa Rica,3459,1507,1952
2019,40,Austria,Costa Rica,211,80,131
2019,56,Belgium,Costa Rica,330,146,184
2019,250,France,Costa Rica,827,338,489
2019,276,Germany,Costa Rica,1748,857,891
2019,528,Netherlands,Costa Rica,884,405,479
2019,756,Switzerland,Costa Rica,1065,472,593
2019,124,Canada,Costa Rica,4206,1900,2306
2019,840,United States of America,Costa Rica,99285,39268,60017
1990,800,Uganda,Côte d'Ivoire,68,34,34
1990,24,Angola,Côte d'Ivoire,5,3,2
1990,266,Gabon,Côte d'Ivoire,1049,669,380
1990,516,Namibia,Côte d'Ivoire,45,31,14
1990,710,South Africa,Côte d'Ivoire,1115,706,409
1990,204,Benin,Côte d'Ivoire,2836,1477,1359
1990,854,Burkina Faso,Côte d'Ivoire,243776,122630,121146
1990,132,Cabo Verde,Côte d'Ivoire,9,4,5
1990,288,Ghana,Côte d'Ivoire,4902,2436,2466
1990,324,Guinea,Côte d'Ivoire,2472,1291,1181
1990,430,Liberia,Côte d'Ivoire,2182,1299,883
1990,466,Mali,Côte d'Ivoire,48556,25254,23302
1990,478,Mauritania,Côte d'Ivoire,175,70,105
1990,562,Niger,Côte d'Ivoire,4425,2364,2061
1990,686,Senegal,Côte d'Ivoire,2322,1221,1101
1990,694,Sierra Leone,Côte d'Ivoire,74,45,29
1990,768,Togo,Côte d'Ivoire,1590,799,791
1990,818,Egypt,Côte d'Ivoire,208,150,58
1990,434,Libya,Côte d'Ivoire,594,429,165
1990,788,Tunisia,Côte d'Ivoire,550,274,276
1990,188,Costa Rica,Côte d'Ivoire,2,1,1
1990,484,Mexico,Côte d'Ivoire,139,70,69
1990,32,Argentina,Côte d'Ivoire,1,1,0
1990,68,Bolivia (Plurinational State of),Côte d'Ivoire,4,0,4
1990,152,Chile,Côte d'Ivoire,12,8,4
1990,36,Australia,Côte d'Ivoire,34,20,14
1990,100,Bulgaria,Côte d'Ivoire,1,1,0
1990,203,Czechia,Côte d'Ivoire,3,2,1
1990,643,Russian Federation,Côte d'Ivoire,113,55,58
1990,208,Denmark,Côte d'Ivoire,70,52,18
1990,246,Finland,Côte d'Ivoire,14,13,1
1990,372,Ireland,Côte d'Ivoire,26,14,12
1990,428,Latvia,Côte d'Ivoire,1,1,0
1990,578,Norway,Côte d'Ivoire,71,53,18
1990,752,Sweden,Côte d'Ivoire,247,168,79
1990,826,United Kingdom,Côte d'Ivoire,388,252,136
1990,300,Greece,Côte d'Ivoire,117,64,53
1990,380,Italy,Côte d'Ivoire,1324,460,864
1990,620,Portugal,Côte d'Ivoire,27,21,6
1990,724,Spain,Côte d'Ivoire,152,95,57
1990,40,Austria,Côte d'Ivoire,118,83,35
1990,56,Belgium,Côte d'Ivoire,642,417,225
1990,250,France,Côte d'Ivoire,40942,19709,21233
1990,276,Germany,Côte d'Ivoire,737,603,134
1990,528,Netherlands,Côte d'Ivoire,177,111,66
1990,756,Switzerland,Côte d'Ivoire,975,457,518
1990,124,Canada,Côte d'Ivoire,1670,813,857
1990,840,United States of America,Côte d'Ivoire,1388,907,481
1995,800,Uganda,Côte d'Ivoire,64,31,33
1995,24,Angola,Côte d'Ivoire,6,3,3
1995,266,Gabon,Côte d'Ivoire,1403,894,509
1995,516,Namibia,Côte d'Ivoire,43,30,13
1995,710,South Africa,Côte d'Ivoire,695,461,234
1995,204,Benin,Côte d'Ivoire,3906,2057,1849
1995,854,Burkina Faso,Côte d'Ivoire,303170,152766,150404
1995,132,Cabo Verde,Côte d'Ivoire,12,5,7
1995,288,Ghana,Côte d'Ivoire,4885,2663,2222
1995,324,Guinea,Côte d'Ivoire,2850,1637,1213
1995,430,Liberia,Côte d'Ivoire,2132,1215,917
1995,466,Mali,Côte d'Ivoire,59377,30893,28484
1995,478,Mauritania,Côte d'Ivoire,186,85,101
1995,562,Niger,Côte d'Ivoire,2774,1435,1339
1995,686,Senegal,Côte d'Ivoire,2428,1270,1158
1995,694,Sierra Leone,Côte d'Ivoire,72,43,29
1995,768,Togo,Côte d'Ivoire,1791,900,891
1995,818,Egypt,Côte d'Ivoire,181,127,54
1995,434,Libya,Côte d'Ivoire,511,363,148
1995,788,Tunisia,Côte d'Ivoire,546,274,272
1995,188,Costa Rica,Côte d'Ivoire,2,1,1
1995,484,Mexico,Côte d'Ivoire,70,36,34
1995,32,Argentina,Côte d'Ivoire,1,1,0
1995,68,Bolivia (Plurinational State of),Côte d'Ivoire,3,0,3
1995,152,Chile,Côte d'Ivoire,10,6,4
1995,36,Australia,Côte d'Ivoire,43,26,17
1995,100,Bulgaria,Côte d'Ivoire,2,2,0
1995,203,Czechia,Côte d'Ivoire,5,4,1
1995,348,Hungary,Côte d'Ivoire,8,6,2
1995,643,Russian Federation,Côte d'Ivoire,100,58,42
1995,208,Denmark,Côte d'Ivoire,191,134,57
1995,246,Finland,Côte d'Ivoire,28,24,4
1995,352,Iceland,Côte d'Ivoire,1,0,1
1995,372,Ireland,Côte d'Ivoire,71,36,35
1995,428,Latvia,Côte d'Ivoire,1,1,0
1995,578,Norway,Côte d'Ivoire,92,71,21
1995,752,Sweden,Côte d'Ivoire,293,198,95
1995,826,United Kingdom,Côte d'Ivoire,1529,844,685
1995,300,Greece,Côte d'Ivoire,116,64,52
1995,380,Italy,Côte d'Ivoire,6833,3290,3543
1995,620,Portugal,Côte d'Ivoire,57,43,14
1995,724,Spain,Côte d'Ivoire,241,155,86
1995,40,Austria,Côte d'Ivoire,133,94,39
1995,56,Belgium,Côte d'Ivoire,874,510,364
1995,250,France,Côte d'Ivoire,42266,19978,22288
1995,276,Germany,Côte d'Ivoire,1745,1294,451
1995,528,Netherlands,Côte d'Ivoire,260,161,99
1995,756,Switzerland,Côte d'Ivoire,1487,729,758
1995,124,Canada,Côte d'Ivoire,1677,813,864
1995,840,United States of America,Côte d'Ivoire,4337,2855,1482
2000,800,Uganda,Côte d'Ivoire,58,3,55
2000,24,Angola,Côte d'Ivoire,7,4,3
2000,266,Gabon,Côte d'Ivoire,1755,1123,632
2000,516,Namibia,Côte d'Ivoire,41,28,13
2000,710,South Africa,Côte d'Ivoire,481,345,136
2000,204,Benin,Côte d'Ivoire,4977,2638,2339
2000,854,Burkina Faso,Côte d'Ivoire,383695,191021,192674
2000,132,Cabo Verde,Côte d'Ivoire,15,7,8
2000,288,Ghana,Côte d'Ivoire,5465,2751,2714
2000,324,Guinea,Côte d'Ivoire,3087,1746,1341
2000,430,Liberia,Côte d'Ivoire,2093,1132,961
2000,466,Mali,Côte d'Ivoire,54884,28484,26400
2000,478,Mauritania,Côte d'Ivoire,192,99,93
2000,562,Niger,Côte d'Ivoire,1147,518,629
2000,686,Senegal,Côte d'Ivoire,2195,1099,1096
2000,694,Sierra Leone,Côte d'Ivoire,70,41,29
2000,768,Togo,Côte d'Ivoire,2017,1014,1003
2000,818,Egypt,Côte d'Ivoire,168,114,54
2000,434,Libya,Côte d'Ivoire,438,307,131
2000,788,Tunisia,Côte d'Ivoire,632,321,311
2000,764,Thailand,Côte d'Ivoire,2,1,1
2000,188,Costa Rica,Côte d'Ivoire,2,1,1
2000,484,Mexico,Côte d'Ivoire,6,5,1
2000,32,Argentina,Côte d'Ivoire,1,1,0
2000,68,Bolivia (Plurinational State of),Côte d'Ivoire,1,0,1
2000,152,Chile,Côte d'Ivoire,9,5,4
2000,36,Australia,Côte d'Ivoire,60,30,30
2000,100,Bulgaria,Côte d'Ivoire,3,3,0
2000,203,Czechia,Côte d'Ivoire,7,6,1
2000,348,Hungary,Côte d'Ivoire,16,12,4
2000,643,Russian Federation,Côte d'Ivoire,85,59,26
2000,208,Denmark,Côte d'Ivoire,311,215,96
2000,246,Finland,Côte d'Ivoire,41,35,6
2000,352,Iceland,Côte d'Ivoire,1,0,1
2000,372,Ireland,Côte d'Ivoire,154,79,75
2000,428,Latvia,Côte d'Ivoire,2,2,0
2000,578,Norway,Côte d'Ivoire,122,85,37
2000,752,Sweden,Côte d'Ivoire,315,212,103
2000,826,United Kingdom,Côte d'Ivoire,2697,1449,1248
2000,300,Greece,Côte d'Ivoire,116,64,52
2000,380,Italy,Côte d'Ivoire,12341,6120,6221
2000,620,Portugal,Côte d'Ivoire,91,68,23
2000,705,Slovenia,Côte d'Ivoire,1,1,0
2000,724,Spain,Côte d'Ivoire,436,285,151
2000,40,Austria,Côte d'Ivoire,148,105,43
2000,56,Belgium,Côte d'Ivoire,1080,592,488
2000,250,France,Côte d'Ivoire,43589,20246,23343
2000,276,Germany,Côte d'Ivoire,2753,1986,767
2000,528,Netherlands,Côte d'Ivoire,353,216,137
2000,756,Switzerland,Côte d'Ivoire,2005,1005,1000
2000,124,Canada,Côte d'Ivoire,1723,831,892
2000,840,United States of America,Côte d'Ivoire,7355,4852,2503
2005,800,Uganda,Côte d'Ivoire,56,2,54
2005,24,Angola,Côte d'Ivoire,20,11,9
2005,266,Gabon,Côte d'Ivoire,1914,1232,682
2005,516,Namibia,Côte d'Ivoire,32,22,10
2005,710,South Africa,Côte d'Ivoire,639,448,191
2005,204,Benin,Côte d'Ivoire,14618,6798,7820
2005,854,Burkina Faso,Côte d'Ivoire,458125,224696,233429
2005,132,Cabo Verde,Côte d'Ivoire,11,5,6
2005,288,Ghana,Côte d'Ivoire,25762,12077,13685
2005,324,Guinea,Côte d'Ivoire,7307,3417,3890
2005,430,Liberia,Côte d'Ivoire,7592,3493,4099
2005,466,Mali,Côte d'Ivoire,48527,25106,23421
2005,478,Mauritania,Côte d'Ivoire,290,160,130
2005,562,Niger,Côte d'Ivoire,1167,527,640
2005,686,Senegal,Côte d'Ivoire,2362,1225,1137
2005,694,Sierra Leone,Côte d'Ivoire,376,190,186
2005,768,Togo,Côte d'Ivoire,2377,1188,1189
2005,818,Egypt,Côte d'Ivoire,200,140,60
2005,434,Libya,Côte d'Ivoire,483,365,118
2005,788,Tunisia,Côte d'Ivoire,607,312,295
2005,764,Thailand,Côte d'Ivoire,8,5,3
2005,188,Costa Rica,Côte d'Ivoire,1,0,1
2005,484,Mexico,Côte d'Ivoire,14,11,3
2005,32,Argentina,Côte d'Ivoire,1,1,0
2005,68,Bolivia (Plurinational State of),Côte d'Ivoire,2,0,2
2005,76,Brazil,Côte d'Ivoire,164,120,44
2005,152,Chile,Côte d'Ivoire,13,8,5
2005,36,Australia,Côte d'Ivoire,200,110,90
2005,100,Bulgaria,Côte d'Ivoire,4,3,1
2005,203,Czechia,Côte d'Ivoire,42,38,4
2005,348,Hungary,Côte d'Ivoire,20,15,5
2005,643,Russian Federation,Côte d'Ivoire,97,71,26
2005,208,Denmark,Côte d'Ivoire,365,221,144
2005,246,Finland,Côte d'Ivoire,76,59,17
2005,352,Iceland,Côte d'Ivoire,2,1,1
2005,372,Ireland,Côte d'Ivoire,155,84,71
2005,428,Latvia,Côte d'Ivoire,2,2,0
2005,578,Norway,Côte d'Ivoire,185,119,66
2005,752,Sweden,Côte d'Ivoire,442,270,172
2005,826,United Kingdom,Côte d'Ivoire,4946,2426,2520
2005,300,Greece,Côte d'Ivoire,117,76,41
2005,380,Italy,Côte d'Ivoire,18946,10547,8399
2005,620,Portugal,Côte d'Ivoire,111,84,27
2005,724,Spain,Côte d'Ivoire,1403,1004,399
2005,40,Austria,Côte d'Ivoire,166,117,49
2005,56,Belgium,Côte d'Ivoire,2325,1311,1014
2005,250,France,Côte d'Ivoire,75481,35351,40130
2005,276,Germany,Côte d'Ivoire,3038,1994,1044
2005,528,Netherlands,Côte d'Ivoire,765,482,283
2005,756,Switzerland,Côte d'Ivoire,2265,1079,1186
2005,124,Canada,Côte d'Ivoire,3845,2068,1777
2005,840,United States of America,Côte d'Ivoire,14130,7079,7051
2010,800,Uganda,Côte d'Ivoire,56,2,54
2010,24,Angola,Côte d'Ivoire,33,18,15
2010,266,Gabon,Côte d'Ivoire,2216,1441,775
2010,516,Namibia,Côte d'Ivoire,30,21,9
2010,710,South Africa,Côte d'Ivoire,1000,701,299
2010,204,Benin,Côte d'Ivoire,24530,11032,13498
2010,854,Burkina Faso,Côte d'Ivoire,517165,252411,264754
2010,132,Cabo Verde,Côte d'Ivoire,7,4,3
2010,288,Ghana,Côte d'Ivoire,52511,27992,24519
2010,324,Guinea,Côte d'Ivoire,12219,5715,6504
2010,430,Liberia,Côte d'Ivoire,26335,14080,12255
2010,466,Mali,Côte d'Ivoire,136445,66440,70005
2010,478,Mauritania,Côte d'Ivoire,533,304,229
2010,562,Niger,Côte d'Ivoire,1186,534,652
2010,686,Senegal,Côte d'Ivoire,2642,1425,1217
2010,694,Sierra Leone,Côte d'Ivoire,271,152,119
2010,768,Togo,Côte d'Ivoire,3007,1593,1414
2010,818,Egypt,Côte d'Ivoire,216,149,67
2010,434,Libya,Côte d'Ivoire,529,401,128
2010,788,Tunisia,Côte d'Ivoire,504,261,243
2010,764,Thailand,Côte d'Ivoire,15,8,7
2010,188,Costa Rica,Côte d'Ivoire,3,2,1
2010,484,Mexico,Côte d'Ivoire,25,18,7
2010,32,Argentina,Côte d'Ivoire,1,1,0
2010,68,Bolivia (Plurinational State of),Côte d'Ivoire,3,1,2
2010,76,Brazil,Côte d'Ivoire,329,241,88
2010,152,Chile,Côte d'Ivoire,18,11,7
2010,36,Australia,Côte d'Ivoire,480,241,239
2010,100,Bulgaria,Côte d'Ivoire,5,4,1
2010,203,Czechia,Côte d'Ivoire,73,67,6
2010,348,Hungary,Côte d'Ivoire,24,18,6
2010,643,Russian Federation,Côte d'Ivoire,108,81,27
2010,208,Denmark,Côte d'Ivoire,411,223,188
2010,233,Estonia,Côte d'Ivoire,1,1,0
2010,246,Finland,Côte d'Ivoire,135,98,37
2010,352,Iceland,Côte d'Ivoire,3,2,1
2010,372,Ireland,Côte d'Ivoire,130,66,64
2010,428,Latvia,Côte d'Ivoire,2,2,0
2010,578,Norway,Côte d'Ivoire,285,175,110
2010,752,Sweden,Côte d'Ivoire,709,404,305
2010,826,United Kingdom,Côte d'Ivoire,5210,2610,2600
2010,300,Greece,Côte d'Ivoire,122,92,30
2010,380,Italy,Côte d'Ivoire,24594,14329,10265
2010,620,Portugal,Côte d'Ivoire,114,86,28
2010,705,Slovenia,Côte d'Ivoire,1,1,0
2010,724,Spain,Côte d'Ivoire,3187,2403,784
2010,40,Austria,Côte d'Ivoire,183,128,55
2010,56,Belgium,Côte d'Ivoire,3858,2055,1803
2010,250,France,Côte d'Ivoire,84455,38212,46243
2010,276,Germany,Côte d'Ivoire,3265,1998,1267
2010,528,Netherlands,Côte d'Ivoire,1093,629,464
2010,756,Switzerland,Côte d'Ivoire,2649,1180,1469
2010,124,Canada,Côte d'Ivoire,5570,3087,2483
2010,840,United States of America,Côte d'Ivoire,21516,10631,10885
2015,800,Uganda,Côte d'Ivoire,56,2,54
2015,24,Angola,Côte d'Ivoire,46,25,21
2015,266,Gabon,Côte d'Ivoire,3099,2167,932
2015,516,Namibia,Côte d'Ivoire,29,21,8
2015,710,South Africa,Côte d'Ivoire,1803,1237,566
2015,204,Benin,Côte d'Ivoire,31920,14707,17213
2015,854,Burkina Faso,Côte d'Ivoire,540779,263936,276843
2015,132,Cabo Verde,Côte d'Ivoire,7,4,3
2015,288,Ghana,Côte d'Ivoire,64621,34439,30182
2015,324,Guinea,Côte d'Ivoire,7968,4702,3266
2015,430,Liberia,Côte d'Ivoire,38041,20339,17702
2015,466,Mali,Côte d'Ivoire,169062,82330,86732
2015,478,Mauritania,Côte d'Ivoire,462,264,198
2015,562,Niger,Côte d'Ivoire,1419,666,753
2015,686,Senegal,Côte d'Ivoire,2850,1535,1315
2015,694,Sierra Leone,Côte d'Ivoire,154,94,60
2015,768,Togo,Côte d'Ivoire,5746,2850,2896
2015,818,Egypt,Côte d'Ivoire,556,278,278
2015,434,Libya,Côte d'Ivoire,596,450,146
2015,788,Tunisia,Côte d'Ivoire,646,335,311
2015,764,Thailand,Côte d'Ivoire,16,9,7
2015,188,Costa Rica,Côte d'Ivoire,3,2,1
2015,484,Mexico,Côte d'Ivoire,26,19,7
2015,32,Argentina,Côte d'Ivoire,1,1,0
2015,68,Bolivia (Plurinational State of),Côte d'Ivoire,3,1,2
2015,76,Brazil,Côte d'Ivoire,396,290,106
2015,152,Chile,Côte d'Ivoire,27,17,10
2015,36,Australia,Côte d'Ivoire,600,313,287
2015,100,Bulgaria,Côte d'Ivoire,13,8,5
2015,203,Czechia,Côte d'Ivoire,87,77,10
2015,348,Hungary,Côte d'Ivoire,37,28,9
2015,643,Russian Federation,Côte d'Ivoire,110,83,27
2015,208,Denmark,Côte d'Ivoire,465,247,218
2015,233,Estonia,Côte d'Ivoire,5,5,0
2015,246,Finland,Côte d'Ivoire,156,114,42
2015,352,Iceland,Côte d'Ivoire,1,0,1
2015,372,Ireland,Côte d'Ivoire,133,67,66
2015,428,Latvia,Côte d'Ivoire,3,2,1
2015,578,Norway,Côte d'Ivoire,339,191,148
2015,752,Sweden,Côte d'Ivoire,981,523,458
2015,826,United Kingdom,Côte d'Ivoire,6662,3239,3423
2015,300,Greece,Côte d'Ivoire,80,40,40
2015,380,Italy,Côte d'Ivoire,25176,14643,10533
2015,620,Portugal,Côte d'Ivoire,130,96,34
2015,705,Slovenia,Côte d'Ivoire,2,1,1
2015,724,Spain,Côte d'Ivoire,2958,2067,891
2015,40,Austria,Côte d'Ivoire,213,148,65
2015,56,Belgium,Côte d'Ivoire,5642,2889,2753
2015,250,France,Côte d'Ivoire,93558,40921,52637
2015,276,Germany,Côte d'Ivoire,3402,2079,1323
2015,528,Netherlands,Côte d'Ivoire,1268,716,552
2015,756,Switzerland,Côte d'Ivoire,3195,1421,1774
2015,124,Canada,Côte d'Ivoire,11255,5737,5518
2015,840,United States of America,Côte d'Ivoire,28813,14163,14650
2019,800,Uganda,Côte d'Ivoire,56,2,54
2019,24,Angola,Côte d'Ivoire,12896,7738,5158
2019,266,Gabon,Côte d'Ivoire,3367,2353,1014
2019,516,Namibia,Côte d'Ivoire,30,22,8
2019,710,South Africa,Côte d'Ivoire,2020,1388,632
2019,204,Benin,Côte d'Ivoire,33996,15694,18302
2019,854,Burkina Faso,Côte d'Ivoire,557732,272214,285518
2019,132,Cabo Verde,Côte d'Ivoire,7,4,3
2019,288,Ghana,Côte d'Ivoire,72728,38832,33896
2019,324,Guinea,Côte d'Ivoire,7605,4488,3117
2019,430,Liberia,Côte d'Ivoire,20090,10742,9348
2019,466,Mali,Côte d'Ivoire,188250,91679,96571
2019,478,Mauritania,Côte d'Ivoire,479,274,205
2019,562,Niger,Côte d'Ivoire,1534,720,814
2019,686,Senegal,Côte d'Ivoire,2933,1580,1353
2019,694,Sierra Leone,Côte d'Ivoire,125,79,46
2019,768,Togo,Côte d'Ivoire,5782,2886,2896
2019,818,Egypt,Côte d'Ivoire,792,349,443
2019,434,Libya,Côte d'Ivoire,632,478,154
2019,788,Tunisia,Côte d'Ivoire,656,341,315
2019,764,Thailand,Côte d'Ivoire,16,9,7
2019,188,Costa Rica,Côte d'Ivoire,3,2,1
2019,484,Mexico,Côte d'Ivoire,26,19,7
2019,32,Argentina,Côte d'Ivoire,1,1,0
2019,68,Bolivia (Plurinational State of),Côte d'Ivoire,3,1,2
2019,76,Brazil,Côte d'Ivoire,445,326,119
2019,152,Chile,Côte d'Ivoire,36,22,14
2019,36,Australia,Côte d'Ivoire,677,349,328
2019,100,Bulgaria,Côte d'Ivoire,16,10,6
2019,203,Czechia,Côte d'Ivoire,98,84,14
2019,348,Hungary,Côte d'Ivoire,52,42,10
2019,643,Russian Federation,Côte d'Ivoire,109,83,26
2019,208,Denmark,Côte d'Ivoire,498,249,249
2019,233,Estonia,Côte d'Ivoire,4,4,0
2019,246,Finland,Côte d'Ivoire,185,129,56
2019,352,Iceland,Côte d'Ivoire,5,2,3
2019,372,Ireland,Côte d'Ivoire,146,74,72
2019,428,Latvia,Côte d'Ivoire,2,2,0
2019,578,Norway,Côte d'Ivoire,374,205,169
2019,752,Sweden,Côte d'Ivoire,1148,620,528
2019,826,United Kingdom,Côte d'Ivoire,7565,3688,3877
2019,300,Greece,Côte d'Ivoire,121,60,61
2019,380,Italy,Côte d'Ivoire,30267,18928,11339
2019,620,Portugal,Côte d'Ivoire,132,98,34
2019,705,Slovenia,Côte d'Ivoire,3,2,1
2019,724,Spain,Côte d'Ivoire,3064,2119,945
2019,40,Austria,Côte d'Ivoire,251,176,75
2019,56,Belgium,Côte d'Ivoire,6384,3240,3144
2019,250,France,Côte d'Ivoire,99031,43188,55843
2019,276,Germany,Côte d'Ivoire,3731,2483,1248
2019,528,Netherlands,Côte d'Ivoire,1239,663,576
2019,756,Switzerland,Côte d'Ivoire,3530,1576,1954
2019,124,Canada,Côte d'Ivoire,12061,6148,5913
2019,840,United States of America,Côte d'Ivoire,31114,15124,15990
1990,710,South Africa,Croatia,479,254,225
1990,818,Egypt,Croatia,124,108,16
1990,196,Cyprus,Croatia,21,9,12
1990,400,Jordan,Croatia,19,3,16
1990,792,Turkey,Croatia,53,25,28
1990,188,Costa Rica,Croatia,21,12,9
1990,484,Mexico,Croatia,64,34,30
1990,591,Panama,Croatia,36,32,4
1990,32,Argentina,Croatia,2171,1024,1147
1990,152,Chile,Croatia,211,124,87
1990,170,Colombia,Croatia,52,29,23
1990,218,Ecuador,Croatia,27,17,10
1990,604,Peru,Croatia,56,45,11
1990,862,Venezuela (Bolivarian Republic of),Croatia,363,209,154
1990,36,Australia,Croatia,48565,25531,23034
1990,554,New Zealand,Croatia,673,365,308
1990,100,Bulgaria,Croatia,15,8,7
1990,203,Czechia,Croatia,417,247,170
1990,348,Hungary,Croatia,365,162,203
1990,616,Poland,Croatia,1142,536,606
1990,642,Romania,Croatia,324,158,166
1990,643,Russian Federation,Croatia,365,179,186
1990,703,Slovakia,Croatia,95,61,34
1990,208,Denmark,Croatia,504,263,241
1990,234,Faroe Islands,Croatia,1,1,0
1990,352,Iceland,Croatia,6,3,3
1990,372,Ireland,Croatia,97,51,46
1990,428,Latvia,Croatia,4,3,1
1990,578,Norway,Croatia,7,4,3
1990,752,Sweden,Croatia,4108,2137,1971
1990,826,United Kingdom,Croatia,1897,1241,656
1990,70,Bosnia and Herzegovina,Croatia,21218,10343,10875
1990,300,Greece,Croatia,466,257,209
1990,380,Italy,Croatia,6648,2311,4337
1990,470,Malta,Croatia,18,10,8
1990,807,North Macedonia,Croatia,1437,599,838
1990,620,Portugal,Croatia,27,17,10
1990,688,Serbia,Croatia,35548,17021,18527
1990,705,Slovenia,Croatia,48018,24538,23480
1990,724,Spain,Croatia,218,113,105
1990,40,Austria,Croatia,43774,20473,23301
1990,56,Belgium,Croatia,48,23,25
1990,250,France,Croatia,10463,5599,4864
1990,276,Germany,Croatia,150313,78035,72278
1990,438,Liechtenstein,Croatia,111,54,57
1990,442,Luxembourg,Croatia,400,206,194
1990,528,Netherlands,Croatia,38,21,17
1990,756,Switzerland,Croatia,21387,10325,11062
1990,124,Canada,Croatia,466,227,239
1990,840,United States of America,Croatia,22927,11215,11712
1995,710,South Africa,Croatia,391,213,178
1995,818,Egypt,Croatia,96,80,16
1995,196,Cyprus,Croatia,30,12,18
1995,400,Jordan,Croatia,25,5,20
1995,792,Turkey,Croatia,129,57,72
1995,188,Costa Rica,Croatia,16,9,7
1995,484,Mexico,Croatia,71,36,35
1995,591,Panama,Croatia,39,36,3
1995,32,Argentina,Croatia,2119,1011,1108
1995,68,Bolivia (Plurinational State of),Croatia,28,18,10
1995,152,Chile,Croatia,292,171,121
1995,170,Colombia,Croatia,51,28,23
1995,218,Ecuador,Croatia,31,20,11
1995,604,Peru,Croatia,57,45,12
1995,862,Venezuela (Bolivarian Republic of),Croatia,358,206,152
1995,36,Australia,Croatia,55036,28846,26190
1995,554,New Zealand,Croatia,897,472,425
1995,100,Bulgaria,Croatia,29,15,14
1995,203,Czechia,Croatia,626,378,248
1995,348,Hungary,Croatia,980,444,536
1995,616,Poland,Croatia,976,451,525
1995,642,Romania,Croatia,927,467,460
1995,643,Russian Federation,Croatia,313,188,125
1995,703,Slovakia,Croatia,273,171,102
1995,208,Denmark,Croatia,542,283,259
1995,234,Faroe Islands,Croatia,1,1,0
1995,246,Finland,Croatia,52,27,25
1995,352,Iceland,Croatia,9,5,4
1995,372,Ireland,Croatia,269,136,133
1995,428,Latvia,Croatia,6,5,1
1995,578,Norway,Croatia,102,52,50
1995,752,Sweden,Croatia,4875,2519,2356
1995,826,United Kingdom,Croatia,4290,2061,2229
1995,70,Bosnia and Herzegovina,Croatia,27272,13257,14015
1995,300,Greece,Croatia,407,189,218
1995,380,Italy,Croatia,17882,7396,10486
1995,470,Malta,Croatia,22,12,10
1995,807,North Macedonia,Croatia,1335,551,784
1995,620,Portugal,Croatia,58,37,21
1995,688,Serbia,Croatia,255683,124788,130895
1995,705,Slovenia,Croatia,47721,23817,23904
1995,724,Spain,Croatia,348,184,164
1995,40,Austria,Croatia,49385,23527,25858
1995,56,Belgium,Croatia,72,35,37
1995,250,France,Croatia,10802,5696,5106
1995,276,Germany,Croatia,179958,90667,89291
1995,438,Liechtenstein,Croatia,135,62,73
1995,442,Luxembourg,Croatia,380,195,185
1995,528,Netherlands,Croatia,81,42,39
1995,756,Switzerland,Croatia,18107,8863,9244
1995,124,Canada,Croatia,19628,9469,10159
1995,840,United States of America,Croatia,32344,15891,16453
2000,710,South Africa,Croatia,428,232,196
2000,818,Egypt,Croatia,76,58,18
2000,196,Cyprus,Croatia,38,15,23
2000,400,Jordan,Croatia,31,8,23
2000,792,Turkey,Croatia,207,90,117
2000,188,Costa Rica,Croatia,18,10,8
2000,484,Mexico,Croatia,82,40,42
2000,591,Panama,Croatia,46,42,4
2000,32,Argentina,Croatia,2067,999,1068
2000,68,Bolivia (Plurinational State of),Croatia,55,35,20
2000,152,Chile,Croatia,374,217,157
2000,170,Colombia,Croatia,49,27,22
2000,218,Ecuador,Croatia,34,22,12
2000,604,Peru,Croatia,67,52,15
2000,862,Venezuela (Bolivarian Republic of),Croatia,351,202,149
2000,36,Australia,Croatia,58210,30557,27653
2000,554,New Zealand,Croatia,2218,1079,1139
2000,100,Bulgaria,Croatia,42,22,20
2000,203,Czechia,Croatia,835,509,326
2000,348,Hungary,Croatia,1595,727,868
2000,616,Poland,Croatia,835,379,456
2000,642,Romania,Croatia,1543,781,762
2000,643,Russian Federation,Croatia,250,189,61
2000,703,Slovakia,Croatia,527,328,199
2000,208,Denmark,Croatia,579,302,277
2000,246,Finland,Croatia,104,54,50
2000,352,Iceland,Croatia,11,6,5
2000,372,Ireland,Croatia,589,306,283
2000,428,Latvia,Croatia,8,7,1
2000,578,Norway,Croatia,1425,785,640
2000,752,Sweden,Croatia,5229,2685,2544
2000,826,United Kingdom,Croatia,6757,2911,3846
2000,70,Bosnia and Herzegovina,Croatia,33326,16171,17155
2000,300,Greece,Croatia,355,120,235
2000,380,Italy,Croatia,29115,12480,16635
2000,470,Malta,Croatia,54,29,25
2000,807,North Macedonia,Croatia,1253,522,731
2000,620,Portugal,Croatia,92,58,34
2000,688,Serbia,Croatia,325449,149363,176086
2000,705,Slovenia,Croatia,59921,30046,29875
2000,724,Spain,Croatia,630,339,291
2000,40,Austria,Croatia,54995,26581,28414
2000,56,Belgium,Croatia,93,45,48
2000,250,France,Croatia,11140,5793,5347
2000,276,Germany,Croatia,209603,103300,106303
2000,438,Liechtenstein,Croatia,157,68,89
2000,442,Luxembourg,Croatia,365,187,178
2000,528,Netherlands,Croatia,129,65,64
2000,756,Switzerland,Croatia,14894,7461,7433
2000,124,Canada,Croatia,39257,18938,20319
2000,840,United States of America,Croatia,41946,20685,21261
2005,710,South Africa,Croatia,553,288,265
2005,818,Egypt,Croatia,90,70,20
2005,196,Cyprus,Croatia,56,22,34
2005,400,Jordan,Croatia,45,16,29
2005,792,Turkey,Croatia,213,90,123
2005,188,Costa Rica,Croatia,12,7,5
2005,484,Mexico,Croatia,63,31,32
2005,591,Panama,Croatia,64,53,11
2005,32,Argentina,Croatia,1525,750,775
2005,68,Bolivia (Plurinational State of),Croatia,44,27,17
2005,76,Brazil,Croatia,283,109,174
2005,152,Chile,Croatia,561,330,231
2005,170,Colombia,Croatia,47,27,20
2005,218,Ecuador,Croatia,40,27,13
2005,604,Peru,Croatia,79,61,18
2005,862,Venezuela (Bolivarian Republic of),Croatia,368,212,156
2005,36,Australia,Croatia,69500,35958,33542
2005,554,New Zealand,Croatia,1979,961,1018
2005,100,Bulgaria,Croatia,62,33,29
2005,203,Czechia,Croatia,1163,766,397
2005,348,Hungary,Croatia,1970,917,1053
2005,616,Poland,Croatia,812,412,400
2005,642,Romania,Croatia,1128,577,551
2005,643,Russian Federation,Croatia,284,211,73
2005,703,Slovakia,Croatia,592,372,220
2005,208,Denmark,Croatia,665,339,326
2005,234,Faroe Islands,Croatia,25,14,11
2005,246,Finland,Croatia,139,71,68
2005,352,Iceland,Croatia,81,43,38
2005,372,Ireland,Croatia,591,324,267
2005,428,Latvia,Croatia,7,6,1
2005,578,Norway,Croatia,2564,1385,1179
2005,752,Sweden,Croatia,5937,2992,2945
2005,826,United Kingdom,Croatia,7108,2952,4156
2005,70,Bosnia and Herzegovina,Croatia,17930,8673,9257
2005,300,Greece,Croatia,397,127,270
2005,380,Italy,Croatia,26910,11519,15391
2005,470,Malta,Croatia,87,47,40
2005,807,North Macedonia,Croatia,1288,537,751
2005,620,Portugal,Croatia,89,49,40
2005,688,Serbia,Croatia,296465,134900,161565
2005,705,Slovenia,Croatia,56322,28048,28274
2005,724,Spain,Croatia,1532,814,718
2005,40,Austria,Croatia,44600,21313,23287
2005,56,Belgium,Croatia,92,42,50
2005,250,France,Croatia,9031,4547,4484
2005,276,Germany,Croatia,188110,90586,97524
2005,438,Liechtenstein,Croatia,143,67,76
2005,442,Luxembourg,Croatia,316,171,145
2005,528,Netherlands,Croatia,180,88,92
2005,756,Switzerland,Croatia,16547,7857,8690
2005,124,Canada,Croatia,38142,18479,19663
2005,840,United States of America,Croatia,43372,21510,21862
2010,710,South Africa,Croatia,865,449,416
2010,466,Mali,Croatia,799,508,291
2010,818,Egypt,Croatia,97,75,22
2010,196,Cyprus,Croatia,91,37,54
2010,400,Jordan,Croatia,59,23,36
2010,792,Turkey,Croatia,219,90,129
2010,188,Costa Rica,Croatia,24,13,11
2010,484,Mexico,Croatia,52,25,27
2010,591,Panama,Croatia,86,66,20
2010,32,Argentina,Croatia,983,501,482
2010,68,Bolivia (Plurinational State of),Croatia,33,20,13
2010,76,Brazil,Croatia,567,218,349
2010,152,Chile,Croatia,748,442,306
2010,170,Colombia,Croatia,53,31,22
2010,218,Ecuador,Croatia,56,37,19
2010,604,Peru,Croatia,88,69,19
2010,862,Venezuela (Bolivarian Republic of),Croatia,391,226,165
2010,36,Australia,Croatia,68490,34884,33606
2010,554,New Zealand,Croatia,1902,923,979
2010,100,Bulgaria,Croatia,80,43,37
2010,203,Czechia,Croatia,1383,968,415
2010,348,Hungary,Croatia,2345,1107,1238
2010,616,Poland,Croatia,815,454,361
2010,642,Romania,Croatia,537,366,171
2010,643,Russian Federation,Croatia,314,229,85
2010,703,Slovakia,Croatia,664,421,243
2010,208,Denmark,Croatia,737,370,367
2010,233,Estonia,Croatia,13,9,4
2010,234,Faroe Islands,Croatia,25,14,11
2010,246,Finland,Croatia,206,99,107
2010,352,Iceland,Croatia,150,79,71
2010,372,Ireland,Croatia,495,255,240
2010,428,Latvia,Croatia,6,5,1
2010,578,Norway,Croatia,2742,1426,1316
2010,752,Sweden,Croatia,6277,3110,3167
2010,826,United Kingdom,Croatia,7487,3199,4288
2010,70,Bosnia and Herzegovina,Croatia,12849,6282,6567
2010,300,Greece,Croatia,455,138,317
2010,380,Italy,Croatia,25997,11212,14785
2010,470,Malta,Croatia,59,35,24
2010,499,Montenegro,Croatia,14529,5452,9077
2010,807,North Macedonia,Croatia,1323,552,771
2010,620,Portugal,Croatia,72,31,41
2010,688,Serbia,Croatia,289781,130669,159112
2010,705,Slovenia,Croatia,55964,27421,28543
2010,724,Spain,Croatia,1691,835,856
2010,40,Austria,Croatia,34205,16046,18159
2010,56,Belgium,Croatia,109,47,62
2010,250,France,Croatia,9481,4828,4653
2010,276,Germany,Croatia,169476,79011,90465
2010,438,Liechtenstein,Croatia,130,65,65
2010,442,Luxembourg,Croatia,271,157,114
2010,528,Netherlands,Croatia,200,100,100
2010,756,Switzerland,Croatia,19678,8768,10910
2010,124,Canada,Croatia,40015,19524,20491
2010,840,United States of America,Croatia,46167,22577,23590
2015,710,South Africa,Croatia,1560,772,788
2015,324,Guinea,Croatia,19,12,7
2015,466,Mali,Croatia,990,630,360
2015,818,Egypt,Croatia,71,57,14
2015,196,Cyprus,Croatia,87,36,51
2015,400,Jordan,Croatia,25,6,19
2015,792,Turkey,Croatia,222,89,133
2015,188,Costa Rica,Croatia,24,13,11
2015,484,Mexico,Croatia,55,27,28
2015,591,Panama,Croatia,102,79,23
2015,32,Argentina,Croatia,986,502,484
2015,68,Bolivia (Plurinational State of),Croatia,38,23,15
2015,76,Brazil,Croatia,683,263,420
2015,152,Chile,Croatia,1133,660,473
2015,170,Colombia,Croatia,59,35,24
2015,218,Ecuador,Croatia,81,54,27
2015,604,Peru,Croatia,92,72,20
2015,862,Venezuela (Bolivarian Republic of),Croatia,410,234,176
2015,36,Australia,Croatia,61820,31372,30448
2015,554,New Zealand,Croatia,1795,869,926
2015,100,Bulgaria,Croatia,108,64,44
2015,203,Czechia,Croatia,1632,1123,509
2015,348,Hungary,Croatia,2054,985,1069
2015,616,Poland,Croatia,785,444,341
2015,642,Romania,Croatia,18,11,7
2015,643,Russian Federation,Croatia,321,234,87
2015,703,Slovakia,Croatia,850,573,277
2015,208,Denmark,Croatia,851,422,429
2015,233,Estonia,Croatia,28,13,15
2015,234,Faroe Islands,Croatia,22,13,9
2015,246,Finland,Croatia,274,139,135
2015,352,Iceland,Croatia,169,92,77
2015,372,Ireland,Croatia,506,258,248
2015,428,Latvia,Croatia,7,5,2
2015,578,Norway,Croatia,3427,1845,1582
2015,752,Sweden,Croatia,8452,4354,4098
2015,826,United Kingdom,Croatia,9574,3928,5646
2015,70,Bosnia and Herzegovina,Croatia,12776,6246,6530
2015,300,Greece,Croatia,427,117,310
2015,380,Italy,Croatia,23566,9907,13659
2015,470,Malta,Croatia,101,63,38
2015,499,Montenegro,Croatia,15486,5766,9720
2015,807,North Macedonia,Croatia,1433,596,837
2015,620,Portugal,Croatia,81,31,50
2015,688,Serbia,Croatia,283247,127291,155956
2015,705,Slovenia,Croatia,46995,23087,23908
2015,724,Spain,Croatia,1684,812,872
2015,40,Austria,Croatia,40006,18884,21122
2015,56,Belgium,Croatia,249,111,138
2015,250,France,Croatia,9253,4527,4726
2015,276,Germany,Croatia,176585,82103,94482
2015,438,Liechtenstein,Croatia,118,57,61
2015,442,Luxembourg,Croatia,413,242,171
2015,528,Netherlands,Croatia,267,134,133
2015,756,Switzerland,Croatia,19553,8461,11092
2015,124,Canada,Croatia,39799,19873,19926
2015,840,United States of America,Croatia,44944,21862,23082
2019,710,South Africa,Croatia,1747,865,882
2019,324,Guinea,Croatia,18,12,6
2019,466,Mali,Croatia,1102,702,400
2019,818,Egypt,Croatia,101,79,22
2019,196,Cyprus,Croatia,86,36,50
2019,400,Jordan,Croatia,26,6,20
2019,792,Turkey,Croatia,300,122,178
2019,188,Costa Rica,Croatia,24,13,11
2019,484,Mexico,Croatia,56,28,28
2019,591,Panama,Croatia,107,84,23
2019,32,Argentina,Croatia,1003,510,493
2019,68,Bolivia (Plurinational State of),Croatia,41,25,16
2019,76,Brazil,Croatia,769,296,473
2019,152,Chile,Croatia,1513,846,667
2019,170,Colombia,Croatia,60,36,24
2019,218,Ecuador,Croatia,79,53,26
2019,604,Peru,Croatia,109,87,22
2019,862,Venezuela (Bolivarian Republic of),Croatia,401,228,173
2019,36,Australia,Croatia,62527,31374,31153
2019,554,New Zealand,Croatia,1845,894,951
2019,100,Bulgaria,Croatia,137,87,50
2019,203,Czechia,Croatia,1708,1172,536
2019,348,Hungary,Croatia,2091,1017,1074
2019,616,Poland,Croatia,831,484,347
2019,642,Romania,Croatia,180,131,49
2019,643,Russian Federation,Croatia,320,234,86
2019,703,Slovakia,Croatia,1089,759,330
2019,208,Denmark,Croatia,2069,1125,944
2019,233,Estonia,Croatia,43,22,21
2019,234,Faroe Islands,Croatia,27,15,12
2019,246,Finland,Croatia,352,185,167
2019,352,Iceland,Croatia,287,170,117
2019,372,Ireland,Croatia,555,284,271
2019,428,Latvia,Croatia,7,7,0
2019,578,Norway,Croatia,4507,2421,2086
2019,752,Sweden,Croatia,12406,6720,5686
2019,826,United Kingdom,Croatia,10872,4477,6395
2019,70,Bosnia and Herzegovina,Croatia,11842,5778,6064
2019,300,Greece,Croatia,417,126,291
2019,380,Italy,Croatia,24438,10297,14141
2019,470,Malta,Croatia,162,102,60
2019,499,Montenegro,Croatia,15517,5821,9696
2019,807,North Macedonia,Croatia,1437,598,839
2019,620,Portugal,Croatia,82,32,50
2019,688,Serbia,Croatia,287762,129450,158312
2019,705,Slovenia,Croatia,45612,22311,23301
2019,724,Spain,Croatia,1744,819,925
2019,40,Austria,Croatia,47226,22721,24505
2019,56,Belgium,Croatia,412,184,228
2019,250,France,Croatia,9794,4781,5013
2019,276,Germany,Croatia,321527,165855,155672
2019,438,Liechtenstein,Croatia,118,58,60
2019,442,Luxembourg,Croatia,800,381,419
2019,528,Netherlands,Croatia,570,283,287
2019,756,Switzerland,Croatia,20130,8700,11430
2019,124,Canada,Croatia,42649,21297,21352
2019,840,United States of America,Croatia,48534,23340,25194
1990,690,Seychelles,Cuba,20,9,11
1990,800,Uganda,Cuba,144,115,29
1990,178,Congo,Cuba,164,49,115
1990,516,Namibia,Cuba,1005,404,601
1990,710,South Africa,Cuba,317,251,66
1990,132,Cabo Verde,Cuba,69,33,36
1990,324,Guinea,Cuba,61,29,32
1990,196,Cyprus,Cuba,9,5,4
1990,792,Turkey,Cuba,10,6,4
1990,626,Timor-Leste,Cuba,85,41,44
1990,28,Antigua and Barbuda,Cuba,12,6,6
1990,44,Bahamas,Cuba,48,17,31
1990,535,"Bonaire, Sint Eustatius and Saba",Cuba,621,214,407
1990,136,Cayman Islands,Cuba,232,126,106
1990,212,Dominica,Cuba,5,0,5
1990,214,Dominican Republic,Cuba,6824,3900,2924
1990,332,Haiti,Cuba,1203,673,530
1990,388,Jamaica,Cuba,1746,835,911
1990,630,Puerto Rico,Cuba,19579,9510,10069
1990,662,Saint Lucia,Cuba,10,4,6
1990,780,Trinidad and Tobago,Cuba,40,22,18
1990,188,Costa Rica,Cuba,4504,2348,2156
1990,222,El Salvador,Cuba,84,44,40
1990,320,Guatemala,Cuba,275,101,174
1990,340,Honduras,Cuba,464,322,142
1990,484,Mexico,Cuba,2660,1138,1522
1990,558,Nicaragua,Cuba,896,534,362
1990,591,Panama,Cuba,3267,1787,1480
1990,32,Argentina,Cuba,1427,628,799
1990,68,Bolivia (Plurinational State of),Cuba,105,55,50
1990,76,Brazil,Cuba,442,191,251
1990,152,Chile,Cuba,518,247,271
1990,170,Colombia,Cuba,1296,756,540
1990,218,Ecuador,Cuba,998,551,447
1990,604,Peru,Cuba,563,336,227
1990,862,Venezuela (Bolivarian Republic of),Cuba,11559,5874,5685
1990,36,Australia,Cuba,361,197,164
1990,112,Belarus,Cuba,22,21,1
1990,100,Bulgaria,Cuba,50,36,14
1990,203,Czechia,Cuba,123,98,25
1990,348,Hungary,Cuba,252,86,166
1990,616,Poland,Cuba,261,175,86
1990,642,Romania,Cuba,1,1,0
1990,643,Russian Federation,Cuba,2689,1320,1369
1990,703,Slovakia,Cuba,23,18,5
1990,208,Denmark,Cuba,34,20,14
1990,246,Finland,Cuba,22,13,9
1990,352,Iceland,Cuba,7,4,3
1990,372,Ireland,Cuba,16,8,8
1990,428,Latvia,Cuba,21,9,12
1990,578,Norway,Cuba,44,22,22
1990,752,Sweden,Cuba,1170,693,477
1990,826,United Kingdom,Cuba,150,87,63
1990,300,Greece,Cuba,194,107,87
1990,380,Italy,Cuba,1444,502,942
1990,620,Portugal,Cuba,116,51,65
1990,688,Serbia,Cuba,3,2,1
1990,705,Slovenia,Cuba,2,1,1
1990,724,Spain,Cuba,21854,9264,12590
1990,40,Austria,Cuba,485,148,337
1990,56,Belgium,Cuba,335,114,221
1990,250,France,Cuba,2031,861,1170
1990,276,Germany,Cuba,2734,1833,901
1990,442,Luxembourg,Cuba,23,8,15
1990,528,Netherlands,Cuba,313,134,179
1990,756,Switzerland,Cuba,1035,401,634
1990,60,Bermuda,Cuba,11,5,6
1990,124,Canada,Cuba,1737,845,892
1990,840,United States of America,Cuba,736971,351002,385969
1995,690,Seychelles,Cuba,26,14,12
1995,800,Uganda,Cuba,136,108,28
1995,178,Congo,Cuba,190,51,139
1995,516,Namibia,Cuba,961,390,571
1995,710,South Africa,Cuba,416,277,139
1995,132,Cabo Verde,Cuba,92,46,46
1995,324,Guinea,Cuba,70,38,32
1995,196,Cyprus,Cuba,13,7,6
1995,792,Turkey,Cuba,24,13,11
1995,626,Timor-Leste,Cuba,92,44,48
1995,28,Antigua and Barbuda,Cuba,15,7,8
1995,44,Bahamas,Cuba,79,31,48
1995,535,"Bonaire, Sint Eustatius and Saba",Cuba,1295,443,852
1995,136,Cayman Islands,Cuba,437,239,198
1995,212,Dominica,Cuba,6,0,6
1995,214,Dominican Republic,Cuba,7580,4253,3327
1995,332,Haiti,Cuba,1142,639,503
1995,388,Jamaica,Cuba,1837,891,946
1995,630,Puerto Rico,Cuba,19293,9266,10027
1995,662,Saint Lucia,Cuba,13,6,7
1995,780,Trinidad and Tobago,Cuba,36,20,16
1995,188,Costa Rica,Cuba,3558,1900,1658
1995,222,El Salvador,Cuba,82,43,39
1995,320,Guatemala,Cuba,347,160,187
1995,340,Honduras,Cuba,460,315,145
1995,484,Mexico,Cuba,4858,2235,2623
1995,558,Nicaragua,Cuba,711,421,290
1995,591,Panama,Cuba,2396,1324,1072
1995,32,Argentina,Cuba,1873,910,963
1995,68,Bolivia (Plurinational State of),Cuba,311,166,145
1995,76,Brazil,Cuba,894,484,410
1995,152,Chile,Cuba,1751,919,832
1995,170,Colombia,Cuba,1375,817,558
1995,218,Ecuador,Cuba,1120,619,501
1995,604,Peru,Cuba,564,333,231
1995,862,Venezuela (Bolivarian Republic of),Cuba,10603,5466,5137
1995,36,Australia,Cuba,438,235,203
1995,112,Belarus,Cuba,34,32,2
1995,100,Bulgaria,Cuba,91,59,32
1995,203,Czechia,Cuba,185,148,37
1995,348,Hungary,Cuba,335,130,205
1995,616,Poland,Cuba,223,149,74
1995,642,Romania,Cuba,1,1,0
1995,643,Russian Federation,Cuba,2513,1383,1130
1995,703,Slovakia,Cuba,49,36,13
1995,208,Denmark,Cuba,102,46,56
1995,246,Finland,Cuba,74,48,26
1995,352,Iceland,Cuba,11,6,5
1995,372,Ireland,Cuba,44,20,24
1995,428,Latvia,Cuba,45,27,18
1995,578,Norway,Cuba,49,25,24
1995,752,Sweden,Cuba,1388,818,570
1995,826,United Kingdom,Cuba,592,275,317
1995,300,Greece,Cuba,199,81,118
1995,380,Italy,Cuba,6552,910,5642
1995,620,Portugal,Cuba,250,109,141
1995,688,Serbia,Cuba,22,12,10
1995,705,Slovenia,Cuba,4,2,2
1995,724,Spain,Cuba,28314,12258,16056
1995,40,Austria,Cuba,547,173,374
1995,56,Belgium,Cuba,495,167,328
1995,250,France,Cuba,2097,869,1228
1995,276,Germany,Cuba,4993,2588,2405
1995,442,Luxembourg,Cuba,21,8,13
1995,528,Netherlands,Cuba,460,191,269
1995,756,Switzerland,Cuba,1585,715,870
1995,60,Bermuda,Cuba,15,7,8
1995,124,Canada,Cuba,3462,1673,1789
1995,840,United States of America,Cuba,815617,389993,425624
2000,690,Seychelles,Cuba,33,19,14
2000,800,Uganda,Cuba,17,15,2
2000,178,Congo,Cuba,266,65,201
2000,516,Namibia,Cuba,893,365,528
2000,710,South Africa,Cuba,645,383,262
2000,132,Cabo Verde,Cuba,115,59,56
2000,324,Guinea,Cuba,75,40,35
2000,196,Cyprus,Cuba,16,8,8
2000,268,Georgia,Cuba,13,7,6
2000,792,Turkey,Cuba,40,21,19
2000,626,Timor-Leste,Cuba,101,47,54
2000,28,Antigua and Barbuda,Cuba,17,8,9
2000,44,Bahamas,Cuba,110,46,64
2000,535,"Bonaire, Sint Eustatius and Saba",Cuba,1970,672,1298
2000,136,Cayman Islands,Cuba,753,412,341
2000,212,Dominica,Cuba,7,0,7
2000,214,Dominican Republic,Cuba,8335,4606,3729
2000,332,Haiti,Cuba,1084,607,477
2000,388,Jamaica,Cuba,1928,947,981
2000,630,Puerto Rico,Cuba,19054,9042,10012
2000,662,Saint Lucia,Cuba,18,8,10
2000,780,Trinidad and Tobago,Cuba,40,22,18
2000,188,Costa Rica,Cuba,4391,2334,2057
2000,222,El Salvador,Cuba,80,43,37
2000,320,Guatemala,Cuba,418,218,200
2000,340,Honduras,Cuba,455,307,148
2000,484,Mexico,Cuba,7267,3445,3822
2000,558,Nicaragua,Cuba,754,457,297
2000,591,Panama,Cuba,1676,938,738
2000,32,Argentina,Cuba,2319,1192,1127
2000,68,Bolivia (Plurinational State of),Cuba,513,275,238
2000,76,Brazil,Cuba,1346,777,569
2000,152,Chile,Cuba,2984,1558,1426
2000,170,Colombia,Cuba,1454,879,575
2000,218,Ecuador,Cuba,1242,687,555
2000,604,Peru,Cuba,660,391,269
2000,862,Venezuela (Bolivarian Republic of),Cuba,9928,5191,4737
2000,36,Australia,Cuba,510,268,242
2000,112,Belarus,Cuba,46,43,3
2000,100,Bulgaria,Cuba,132,82,50
2000,203,Czechia,Cuba,247,198,49
2000,348,Hungary,Cuba,417,174,243
2000,616,Poland,Cuba,191,126,65
2000,642,Romania,Cuba,1,1,0
2000,643,Russian Federation,Cuba,2246,1396,850
2000,703,Slovakia,Cuba,90,64,26
2000,208,Denmark,Cuba,170,72,98
2000,246,Finland,Cuba,125,83,42
2000,352,Iceland,Cuba,14,8,6
2000,372,Ireland,Cuba,96,44,52
2000,428,Latvia,Cuba,70,45,25
2000,578,Norway,Cuba,209,81,128
2000,752,Sweden,Cuba,1489,873,616
2000,826,United Kingdom,Cuba,1044,466,578
2000,300,Greece,Cuba,208,54,154
2000,380,Italy,Cuba,11659,1318,10341
2000,620,Portugal,Cuba,396,173,223
2000,688,Serbia,Cuba,30,15,15
2000,705,Slovenia,Cuba,3,1,2
2000,724,Spain,Cuba,45738,20270,25468
2000,40,Austria,Cuba,609,198,411
2000,56,Belgium,Cuba,642,219,423
2000,250,France,Cuba,2162,876,1286
2000,276,Germany,Cuba,7251,3343,3908
2000,442,Luxembourg,Cuba,20,7,13
2000,528,Netherlands,Cuba,624,252,372
2000,756,Switzerland,Cuba,2142,1035,1107
2000,60,Bermuda,Cuba,18,8,10
2000,124,Canada,Cuba,5269,2541,2728
2000,840,United States of America,Cuba,894876,429838,465038
2005,690,Seychelles,Cuba,36,18,18
2005,800,Uganda,Cuba,16,15,1
2005,178,Congo,Cuba,169,71,98
2005,516,Namibia,Cuba,706,286,420
2005,710,South Africa,Cuba,847,487,360
2005,132,Cabo Verde,Cuba,99,49,50
2005,324,Guinea,Cuba,375,224,151
2005,196,Cyprus,Cuba,24,12,12
2005,268,Georgia,Cuba,12,7,5
2005,792,Turkey,Cuba,41,21,20
2005,626,Timor-Leste,Cuba,107,50,57
2005,28,Antigua and Barbuda,Cuba,18,8,10
2005,44,Bahamas,Cuba,240,81,159
2005,52,Barbados,Cuba,42,21,21
2005,535,"Bonaire, Sint Eustatius and Saba",Cuba,2099,716,1383
2005,136,Cayman Islands,Cuba,693,357,336
2005,212,Dominica,Cuba,8,0,8
2005,214,Dominican Republic,Cuba,6008,3322,2686
2005,332,Haiti,Cuba,1029,576,453
2005,388,Jamaica,Cuba,1879,929,950
2005,630,Puerto Rico,Cuba,17039,8077,8962
2005,662,Saint Lucia,Cuba,54,23,31
2005,534,Sint Maarten (Dutch part),Cuba,397,147,250
2005,780,Trinidad and Tobago,Cuba,42,23,19
2005,188,Costa Rica,Cuba,2876,1511,1365
2005,222,El Salvador,Cuba,102,56,46
2005,320,Guatemala,Cuba,496,279,217
2005,340,Honduras,Cuba,446,302,144
2005,484,Mexico,Cuba,9021,4484,4537
2005,558,Nicaragua,Cuba,817,502,315
2005,591,Panama,Cuba,1993,1138,855
2005,32,Argentina,Cuba,1711,893,818
2005,68,Bolivia (Plurinational State of),Cuba,1018,525,493
2005,76,Brazil,Cuba,1715,1006,709
2005,152,Chile,Cuba,4479,2373,2106
2005,170,Colombia,Cuba,1451,889,562
2005,218,Ecuador,Cuba,1466,825,641
2005,604,Peru,Cuba,776,462,314
2005,862,Venezuela (Bolivarian Republic of),Cuba,10372,5346,5026
2005,36,Australia,Cuba,610,325,285
2005,112,Belarus,Cuba,45,42,3
2005,100,Bulgaria,Cuba,194,120,74
2005,203,Czechia,Cuba,320,236,84
2005,348,Hungary,Cuba,515,220,295
2005,616,Poland,Cuba,209,139,70
2005,642,Romania,Cuba,1,1,0
2005,643,Russian Federation,Cuba,2238,1385,853
2005,703,Slovakia,Cuba,101,72,29
2005,208,Denmark,Cuba,302,132,170
2005,246,Finland,Cuba,242,150,92
2005,352,Iceland,Cuba,25,12,13
2005,372,Ireland,Cuba,96,47,49
2005,428,Latvia,Cuba,64,41,23
2005,578,Norway,Cuba,492,158,334
2005,752,Sweden,Cuba,1832,1017,815
2005,826,United Kingdom,Cuba,1641,781,860
2005,300,Greece,Cuba,284,80,204
2005,380,Italy,Cuba,22561,4677,17884
2005,620,Portugal,Cuba,996,277,719
2005,688,Serbia,Cuba,30,15,15
2005,705,Slovenia,Cuba,15,7,8
2005,724,Spain,Cuba,71614,32087,39527
2005,40,Austria,Cuba,681,210,471
2005,56,Belgium,Cuba,1210,407,803
2005,250,France,Cuba,3744,1612,2132
2005,276,Germany,Cuba,9720,4272,5448
2005,442,Luxembourg,Cuba,17,7,10
2005,528,Netherlands,Cuba,1002,388,614
2005,756,Switzerland,Cuba,2433,1111,1322
2005,60,Bermuda,Cuba,24,13,11
2005,124,Canada,Cuba,9129,4510,4619
2005,840,United States of America,Cuba,959480,463625,495855
2010,690,Seychelles,Cuba,39,16,23
2010,800,Uganda,Cuba,16,15,1
2010,178,Congo,Cuba,403,137,266
2010,516,Namibia,Cuba,680,277,403
2010,710,South Africa,Cuba,1326,761,565
2010,132,Cabo Verde,Cuba,82,39,43
2010,324,Guinea,Cuba,1875,1118,757
2010,196,Cyprus,Cuba,39,20,19
2010,268,Georgia,Cuba,12,7,5
2010,792,Turkey,Cuba,43,22,21
2010,626,Timor-Leste,Cuba,110,51,59
2010,28,Antigua and Barbuda,Cuba,19,9,10
2010,44,Bahamas,Cuba,370,117,253
2010,52,Barbados,Cuba,56,28,28
2010,535,"Bonaire, Sint Eustatius and Saba",Cuba,40,16,24
2010,136,Cayman Islands,Cuba,695,335,360
2010,531,Curaçao,Cuba,215,103,112
2010,212,Dominica,Cuba,10,2,8
2010,214,Dominican Republic,Cuba,3639,2016,1623
2010,332,Haiti,Cuba,1080,605,475
2010,388,Jamaica,Cuba,1830,911,919
2010,630,Puerto Rico,Cuba,12882,6039,6843
2010,662,Saint Lucia,Cuba,87,37,50
2010,534,Sint Maarten (Dutch part),Cuba,795,295,500
2010,780,Trinidad and Tobago,Cuba,74,43,31
2010,188,Costa Rica,Cuba,5669,2986,2683
2010,222,El Salvador,Cuba,123,68,55
2010,320,Guatemala,Cuba,574,341,233
2010,340,Honduras,Cuba,436,297,139
2010,484,Mexico,Cuba,11822,6050,5772
2010,558,Nicaragua,Cuba,873,539,334
2010,591,Panama,Cuba,2405,1405,1000
2010,32,Argentina,Cuba,1102,593,509
2010,68,Bolivia (Plurinational State of),Cuba,1520,773,747
2010,76,Brazil,Cuba,2059,1220,839
2010,152,Chile,Cuba,5973,3188,2785
2010,170,Colombia,Cuba,1699,1062,637
2010,218,Ecuador,Cuba,2059,1136,923
2010,604,Peru,Cuba,868,515,353
2010,862,Venezuela (Bolivarian Republic of),Cuba,10941,5562,5379
2010,36,Australia,Cuba,750,403,347
2010,112,Belarus,Cuba,43,40,3
2010,100,Bulgaria,Cuba,247,152,95
2010,203,Czechia,Cuba,363,255,108
2010,348,Hungary,Cuba,613,266,347
2010,616,Poland,Cuba,234,155,79
2010,642,Romania,Cuba,4,3,1
2010,643,Russian Federation,Cuba,2185,1347,838
2010,703,Slovakia,Cuba,113,81,32
2010,208,Denmark,Cuba,425,189,236
2010,233,Estonia,Cuba,19,10,9
2010,246,Finland,Cuba,417,237,180
2010,352,Iceland,Cuba,35,15,20
2010,372,Ireland,Cuba,81,37,44
2010,428,Latvia,Cuba,57,36,21
2010,578,Norway,Cuba,720,232,488
2010,752,Sweden,Cuba,2339,1271,1068
2010,826,United Kingdom,Cuba,1728,841,887
2010,300,Greece,Cuba,374,110,264
2010,380,Italy,Cuba,32329,7586,24743
2010,620,Portugal,Cuba,1431,336,1095
2010,688,Serbia,Cuba,30,15,15
2010,705,Slovenia,Cuba,41,18,23
2010,724,Spain,Cuba,103189,46653,56536
2010,40,Austria,Cuba,752,221,531
2010,56,Belgium,Cuba,1397,512,885
2010,250,France,Cuba,4488,1759,2729
2010,276,Germany,Cuba,11753,5058,6695
2010,442,Luxembourg,Cuba,15,7,8
2010,528,Netherlands,Cuba,1179,420,759
2010,756,Switzerland,Cuba,2831,1206,1625
2010,60,Bermuda,Cuba,30,18,12
2010,124,Canada,Cuba,13340,6664,6676
2010,840,United States of America,Cuba,1055229,502388,552841
2015,690,Seychelles,Cuba,43,19,24
2015,800,Uganda,Cuba,16,15,1
2015,178,Congo,Cuba,536,167,369
2015,516,Namibia,Cuba,665,272,393
2015,710,South Africa,Cuba,2391,1321,1070
2015,132,Cabo Verde,Cuba,85,40,45
2015,324,Guinea,Cuba,1786,1064,722
2015,196,Cyprus,Cuba,37,19,18
2015,268,Georgia,Cuba,12,7,5
2015,792,Turkey,Cuba,42,21,21
2015,626,Timor-Leste,Cuba,29,17,12
2015,28,Antigua and Barbuda,Cuba,20,9,11
2015,44,Bahamas,Cuba,401,125,276
2015,52,Barbados,Cuba,58,29,29
2015,535,"Bonaire, Sint Eustatius and Saba",Cuba,45,18,27
2015,136,Cayman Islands,Cuba,756,364,392
2015,531,Curaçao,Cuba,233,112,121
2015,212,Dominica,Cuba,12,3,9
2015,214,Dominican Republic,Cuba,3259,1903,1356
2015,332,Haiti,Cuba,1133,635,498
2015,388,Jamaica,Cuba,1791,892,899
2015,630,Puerto Rico,Cuba,13321,6214,7107
2015,662,Saint Lucia,Cuba,83,36,47
2015,534,Sint Maarten (Dutch part),Cuba,828,306,522
2015,780,Trinidad and Tobago,Cuba,157,86,71
2015,188,Costa Rica,Cuba,5756,3015,2741
2015,222,El Salvador,Cuba,128,71,57
2015,320,Guatemala,Cuba,660,396,264
2015,340,Honduras,Cuba,612,417,195
2015,484,Mexico,Cuba,12532,6690,5842
2015,558,Nicaragua,Cuba,941,583,358
2015,591,Panama,Cuba,2825,1648,1177
2015,32,Argentina,Cuba,1106,595,511
2015,68,Bolivia (Plurinational State of),Cuba,1770,900,870
2015,76,Brazil,Cuba,2479,1469,1010
2015,152,Chile,Cuba,2051,1074,977
2015,170,Colombia,Cuba,1902,1196,706
2015,218,Ecuador,Cuba,2994,1642,1352
2015,604,Peru,Cuba,922,558,364
2015,862,Venezuela (Bolivarian Republic of),Cuba,11423,5728,5695
2015,36,Australia,Cuba,880,489,391
2015,112,Belarus,Cuba,44,41,3
2015,100,Bulgaria,Cuba,275,169,106
2015,203,Czechia,Cuba,431,288,143
2015,348,Hungary,Cuba,576,273,303
2015,616,Poland,Cuba,225,151,74
2015,642,Romania,Cuba,42,27,15
2015,643,Russian Federation,Cuba,2227,1369,858
2015,703,Slovakia,Cuba,137,99,38
2015,208,Denmark,Cuba,503,224,279
2015,233,Estonia,Cuba,16,8,8
2015,246,Finland,Cuba,574,339,235
2015,352,Iceland,Cuba,57,26,31
2015,372,Ireland,Cuba,83,37,46
2015,428,Latvia,Cuba,46,29,17
2015,578,Norway,Cuba,976,351,625
2015,752,Sweden,Cuba,2724,1449,1275
2015,826,United Kingdom,Cuba,2209,1042,1167
2015,300,Greece,Cuba,351,93,258
2015,380,Italy,Cuba,33739,7876,25863
2015,620,Portugal,Cuba,1621,317,1304
2015,688,Serbia,Cuba,29,15,14
2015,705,Slovenia,Cuba,70,36,34
2015,724,Spain,Cuba,131134,58864,72270
2015,40,Austria,Cuba,879,262,617
2015,56,Belgium,Cuba,1724,660,1064
2015,250,France,Cuba,4972,1867,3105
2015,276,Germany,Cuba,12246,5254,6992
2015,442,Luxembourg,Cuba,22,10,12
2015,528,Netherlands,Cuba,1313,483,830
2015,756,Switzerland,Cuba,3316,1438,1878
2015,60,Bermuda,Cuba,30,18,12
2015,124,Canada,Cuba,17740,8518,9222
2015,840,United States of America,Cuba,1210674,571563,639111
2019,690,Seychelles,Cuba,43,19,24
2019,800,Uganda,Cuba,16,15,1
2019,178,Congo,Cuba,552,172,380
2019,516,Namibia,Cuba,703,287,416
2019,710,South Africa,Cuba,2679,1482,1197
2019,132,Cabo Verde,Cuba,89,42,47
2019,324,Guinea,Cuba,1704,1015,689
2019,196,Cyprus,Cuba,36,19,17
2019,268,Georgia,Cuba,12,7,5
2019,792,Turkey,Cuba,56,28,28
2019,626,Timor-Leste,Cuba,28,17,11
2019,28,Antigua and Barbuda,Cuba,20,9,11
2019,44,Bahamas,Cuba,425,132,293
2019,52,Barbados,Cuba,58,29,29
2019,535,"Bonaire, Sint Eustatius and Saba",Cuba,53,21,32
2019,136,Cayman Islands,Cuba,837,403,434
2019,531,Curaçao,Cuba,253,122,131
2019,212,Dominica,Cuba,12,3,9
2019,214,Dominican Republic,Cuba,3367,1966,1401
2019,332,Haiti,Cuba,1178,661,517
2019,388,Jamaica,Cuba,1814,904,910
2019,630,Puerto Rico,Cuba,13645,6337,7308
2019,662,Saint Lucia,Cuba,80,35,45
2019,534,Sint Maarten (Dutch part),Cuba,857,317,540
2019,780,Trinidad and Tobago,Cuba,1005,533,472
2019,188,Costa Rica,Cuba,5840,3077,2763
2019,222,El Salvador,Cuba,129,72,57
2019,320,Guatemala,Cuba,677,407,270
2019,340,Honduras,Cuba,621,423,198
2019,484,Mexico,Cuba,12920,6897,6023
2019,558,Nicaragua,Cuba,985,610,375
2019,591,Panama,Cuba,1944,1152,792
2019,32,Argentina,Cuba,1125,605,520
2019,68,Bolivia (Plurinational State of),Cuba,1932,983,949
2019,76,Brazil,Cuba,2791,1654,1137
2019,152,Chile,Cuba,1805,427,1378
2019,170,Colombia,Cuba,1945,1223,722
2019,218,Ecuador,Cuba,2947,1616,1331
2019,604,Peru,Cuba,1098,683,415
2019,862,Venezuela (Bolivarian Republic of),Cuba,11189,5586,5603
2019,36,Australia,Cuba,973,538,435
2019,112,Belarus,Cuba,43,41,2
2019,100,Bulgaria,Cuba,317,199,118
2019,203,Czechia,Cuba,508,330,178
2019,348,Hungary,Cuba,602,285,317
2019,616,Poland,Cuba,238,163,75
2019,642,Romania,Cuba,88,49,39
2019,643,Russian Federation,Cuba,2226,1369,857
2019,703,Slovakia,Cuba,151,107,44
2019,208,Denmark,Cuba,574,256,318
2019,233,Estonia,Cuba,24,14,10
2019,246,Finland,Cuba,685,413,272
2019,352,Iceland,Cuba,64,33,31
2019,372,Ireland,Cuba,91,41,50
2019,428,Latvia,Cuba,43,27,16
2019,578,Norway,Cuba,1132,413,719
2019,752,Sweden,Cuba,3018,1593,1425
2019,826,United Kingdom,Cuba,2508,1187,1321
2019,300,Greece,Cuba,342,100,242
2019,380,Italy,Cuba,37307,9007,28300
2019,620,Portugal,Cuba,1648,325,1323
2019,688,Serbia,Cuba,29,15,14
2019,705,Slovenia,Cuba,76,38,38
2019,724,Spain,Cuba,141447,62277,79170
2019,40,Austria,Cuba,1037,322,715
2019,56,Belgium,Cuba,1901,735,1166
2019,250,France,Cuba,5262,1968,3294
2019,276,Germany,Cuba,13433,5897,7536
2019,442,Luxembourg,Cuba,191,74,117
2019,528,Netherlands,Cuba,1406,537,869
2019,756,Switzerland,Cuba,3509,1522,1987
2019,60,Bermuda,Cuba,30,18,12
2019,124,Canada,Cuba,19010,9128,9882
2019,840,United States of America,Cuba,1337371,630041,707330
1990,28,Antigua and Barbuda,Curaçao,10,5,5
1990,533,Aruba,Curaçao,438,231,207
1990,535,"Bonaire, Sint Eustatius and Saba",Curaçao,2367,1254,1113
1990,136,Cayman Islands,Curaçao,3,3,0
1990,662,Saint Lucia,Curaçao,50,29,21
1990,670,Saint Vincent and the Grenadines,Curaçao,134,63,71
1990,850,United States Virgin Islands,Curaçao,231,116,115
1990,591,Panama,Curaçao,61,12,49
1990,68,Bolivia (Plurinational State of),Curaçao,110,56,54
1990,170,Colombia,Curaçao,83,36,47
1990,862,Venezuela (Bolivarian Republic of),Curaçao,636,301,335
1990,36,Australia,Curaçao,35,17,18
1990,528,Netherlands,Curaçao,38636,19596,19040
1990,124,Canada,Curaçao,396,192,204
1995,28,Antigua and Barbuda,Curaçao,13,6,7
1995,533,Aruba,Curaçao,1095,578,517
1995,535,"Bonaire, Sint Eustatius and Saba",Curaçao,2310,1221,1089
1995,136,Cayman Islands,Curaçao,7,7,0
1995,662,Saint Lucia,Curaçao,50,25,25
1995,670,Saint Vincent and the Grenadines,Curaçao,139,66,73
1995,850,United States Virgin Islands,Curaçao,259,130,129
1995,591,Panama,Curaçao,88,17,71
1995,68,Bolivia (Plurinational State of),Curaçao,138,71,67
1995,170,Colombia,Curaçao,81,35,46
1995,862,Venezuela (Bolivarian Republic of),Curaçao,627,297,330
1995,36,Australia,Curaçao,54,30,24
1995,528,Netherlands,Curaçao,44774,22285,22489
1995,124,Canada,Curaçao,379,183,196
2000,28,Antigua and Barbuda,Curaçao,16,7,9
2000,533,Aruba,Curaçao,1751,925,826
2000,535,"Bonaire, Sint Eustatius and Saba",Curaçao,2253,1188,1065
2000,136,Cayman Islands,Curaçao,13,12,1
2000,662,Saint Lucia,Curaçao,94,48,46
2000,670,Saint Vincent and the Grenadines,Curaçao,144,69,75
2000,850,United States Virgin Islands,Curaçao,288,145,143
2000,591,Panama,Curaçao,122,24,98
2000,68,Bolivia (Plurinational State of),Curaçao,275,140,135
2000,170,Colombia,Curaçao,79,35,44
2000,862,Venezuela (Bolivarian Republic of),Curaçao,615,291,324
2000,36,Australia,Curaçao,90,45,45
2000,528,Netherlands,Curaçao,52458,25682,26776
2000,124,Canada,Curaçao,371,179,192
2005,28,Antigua and Barbuda,Curaçao,17,7,10
2005,533,Aruba,Curaçao,2063,1090,973
2005,535,"Bonaire, Sint Eustatius and Saba",Curaçao,2400,1265,1135
2005,136,Cayman Islands,Curaçao,12,11,1
2005,662,Saint Lucia,Curaçao,94,48,46
2005,670,Saint Vincent and the Grenadines,Curaçao,147,72,75
2005,534,Sint Maarten (Dutch part),Curaçao,684,348,336
2005,850,United States Virgin Islands,Curaçao,282,142,140
2005,591,Panama,Curaçao,72,18,54
2005,68,Bolivia (Plurinational State of),Curaçao,138,70,68
2005,170,Colombia,Curaçao,75,33,42
2005,862,Venezuela (Bolivarian Republic of),Curaçao,645,305,340
2005,36,Australia,Curaçao,100,45,55
2005,528,Netherlands,Curaçao,61709,30158,31551
2005,124,Canada,Curaçao,368,172,196
2010,28,Antigua and Barbuda,Curaçao,18,8,10
2010,533,Aruba,Curaçao,2334,1233,1101
2010,535,"Bonaire, Sint Eustatius and Saba",Curaçao,3617,1732,1885
2010,136,Cayman Islands,Curaçao,12,10,2
2010,662,Saint Lucia,Curaçao,87,43,44
2010,670,Saint Vincent and the Grenadines,Curaçao,150,74,76
2010,534,Sint Maarten (Dutch part),Curaçao,1368,696,672
2010,850,United States Virgin Islands,Curaçao,278,140,138
2010,591,Panama,Curaçao,26,13,13
2010,68,Bolivia (Plurinational State of),Curaçao,152,78,74
2010,170,Colombia,Curaçao,85,39,46
2010,862,Venezuela (Bolivarian Republic of),Curaçao,686,326,360
2010,36,Australia,Curaçao,120,52,68
2010,528,Netherlands,Curaçao,60419,29738,30681
2010,124,Canada,Curaçao,40015,18255,21760
2015,28,Antigua and Barbuda,Curaçao,19,8,11
2015,533,Aruba,Curaçao,2455,1297,1158
2015,535,"Bonaire, Sint Eustatius and Saba",Curaçao,4115,1971,2144
2015,136,Cayman Islands,Curaçao,12,11,1
2015,662,Saint Lucia,Curaçao,83,41,42
2015,670,Saint Vincent and the Grenadines,Curaçao,152,76,76
2015,534,Sint Maarten (Dutch part),Curaçao,1425,724,701
2015,850,United States Virgin Islands,Curaçao,278,140,138
2015,591,Panama,Curaçao,31,16,15
2015,68,Bolivia (Plurinational State of),Curaçao,167,85,82
2015,170,Colombia,Curaçao,95,44,51
2015,862,Venezuela (Bolivarian Republic of),Curaçao,718,336,382
2015,36,Australia,Curaçao,150,65,85
2015,528,Netherlands,Curaçao,61301,30308,30993
2015,124,Canada,Curaçao,467,194,273
2019,28,Antigua and Barbuda,Curaçao,19,8,11
2019,533,Aruba,Curaçao,2483,1312,1171
2019,535,"Bonaire, Sint Eustatius and Saba",Curaçao,4900,2348,2552
2019,136,Cayman Islands,Curaçao,13,12,1
2019,662,Saint Lucia,Curaçao,80,40,40
2019,670,Saint Vincent and the Grenadines,Curaçao,152,76,76
2019,534,Sint Maarten (Dutch part),Curaçao,1475,750,725
2019,850,United States Virgin Islands,Curaçao,279,141,138
2019,591,Panama,Curaçao,32,18,14
2019,68,Bolivia (Plurinational State of),Curaçao,182,93,89
2019,170,Colombia,Curaçao,97,45,52
2019,862,Venezuela (Bolivarian Republic of),Curaçao,704,328,376
2019,36,Australia,Curaçao,158,69,89
2019,528,Netherlands,Curaçao,70097,35074,35023
2019,124,Canada,Curaçao,500,208,292
1990,140,Central African Republic,Cyprus,5,3,2
1990,710,South Africa,Cyprus,944,366,578
1990,818,Egypt,Cyprus,98,53,45
1990,400,Jordan,Cyprus,13,4,9
1990,792,Turkey,Cyprus,9195,4420,4775
1990,144,Sri Lanka,Cyprus,2,1,1
1990,188,Costa Rica,Cyprus,2,1,1
1990,32,Argentina,Cyprus,103,45,58
1990,68,Bolivia (Plurinational State of),Cyprus,9,4,5
1990,152,Chile,Cyprus,8,7,1
1990,862,Venezuela (Bolivarian Republic of),Cyprus,14,7,7
1990,36,Australia,Cyprus,24036,12420,11616
1990,100,Bulgaria,Cyprus,103,52,51
1990,203,Czechia,Cyprus,13,10,3
1990,348,Hungary,Cyprus,387,254,133
1990,616,Poland,Cyprus,62,43,19
1990,642,Romania,Cyprus,18,7,11
1990,643,Russian Federation,Cyprus,479,235,244
1990,703,Slovakia,Cyprus,4,3,1
1990,208,Denmark,Cyprus,111,45,66
1990,246,Finland,Cyprus,42,34,8
1990,352,Iceland,Cyprus,1,1,0
1990,372,Ireland,Cyprus,20,10,10
1990,428,Latvia,Cyprus,2,1,1
1990,440,Lithuania,Cyprus,3,0,3
1990,578,Norway,Cyprus,70,58,12
1990,752,Sweden,Cyprus,355,225,130
1990,826,United Kingdom,Cyprus,76295,39551,36744
1990,300,Greece,Cyprus,45588,24000,21588
1990,380,Italy,Cyprus,42,14,28
1990,470,Malta,Cyprus,21,10,11
1990,620,Portugal,Cyprus,5,3,2
1990,688,Serbia,Cyprus,21,12,9
1990,724,Spain,Cyprus,149,76,73
1990,40,Austria,Cyprus,178,95,83
1990,56,Belgium,Cyprus,77,32,45
1990,250,France,Cyprus,1073,528,545
1990,276,Germany,Cyprus,328,219,109
1990,442,Luxembourg,Cyprus,3,2,1
1990,528,Netherlands,Cyprus,124,77,47
1990,756,Switzerland,Cyprus,204,128,76
1990,124,Canada,Cyprus,4111,2002,2109
1990,840,United States of America,Cyprus,10060,5678,4382
1995,140,Central African Republic,Cyprus,8,4,4
1995,710,South Africa,Cyprus,1304,641,663
1995,818,Egypt,Cyprus,77,41,36
1995,400,Jordan,Cyprus,87,40,47
1995,792,Turkey,Cyprus,9419,4449,4970
1995,144,Sri Lanka,Cyprus,31,25,6
1995,188,Costa Rica,Cyprus,2,2,0
1995,32,Argentina,Cyprus,101,45,56
1995,68,Bolivia (Plurinational State of),Cyprus,6,2,4
1995,152,Chile,Cyprus,10,7,3
1995,862,Venezuela (Bolivarian Republic of),Cyprus,13,6,7
1995,36,Australia,Cyprus,23918,12265,11653
1995,100,Bulgaria,Cyprus,126,68,58
1995,203,Czechia,Cyprus,20,16,4
1995,348,Hungary,Cyprus,288,173,115
1995,616,Poland,Cyprus,53,37,16
1995,642,Romania,Cyprus,32,14,18
1995,643,Russian Federation,Cyprus,466,246,220
1995,703,Slovakia,Cyprus,32,18,14
1995,208,Denmark,Cyprus,131,54,77
1995,246,Finland,Cyprus,53,42,11
1995,352,Iceland,Cyprus,2,1,1
1995,372,Ireland,Cyprus,70,34,36
1995,428,Latvia,Cyprus,2,1,1
1995,440,Lithuania,Cyprus,4,0,4
1995,578,Norway,Cyprus,91,69,22
1995,752,Sweden,Cyprus,422,267,155
1995,826,United Kingdom,Cyprus,75065,38512,36553
1995,300,Greece,Cyprus,33684,16762,16922
1995,380,Italy,Cyprus,119,50,69
1995,470,Malta,Cyprus,25,12,13
1995,620,Portugal,Cyprus,11,6,5
1995,688,Serbia,Cyprus,134,75,59
1995,724,Spain,Cyprus,165,86,79
1995,40,Austria,Cyprus,201,108,93
1995,56,Belgium,Cyprus,77,32,45
1995,250,France,Cyprus,1108,536,572
1995,276,Germany,Cyprus,631,370,261
1995,442,Luxembourg,Cyprus,2,2,0
1995,528,Netherlands,Cyprus,182,111,71
1995,756,Switzerland,Cyprus,234,146,88
1995,124,Canada,Cyprus,4165,2018,2147
1995,840,United States of America,Cyprus,10714,6088,4626
2000,140,Central African Republic,Cyprus,11,5,6
2000,710,South Africa,Cyprus,2065,1085,980
2000,818,Egypt,Cyprus,63,33,30
2000,400,Jordan,Cyprus,160,75,85
2000,792,Turkey,Cyprus,9679,4487,5192
2000,144,Sri Lanka,Cyprus,61,43,18
2000,188,Costa Rica,Cyprus,2,2,0
2000,32,Argentina,Cyprus,99,45,54
2000,68,Bolivia (Plurinational State of),Cyprus,2,0,2
2000,152,Chile,Cyprus,12,8,4
2000,862,Venezuela (Bolivarian Republic of),Cyprus,13,6,7
2000,36,Australia,Cyprus,22810,11552,11258
2000,100,Bulgaria,Cyprus,149,84,65
2000,203,Czechia,Cyprus,27,22,5
2000,348,Hungary,Cyprus,189,93,96
2000,616,Poland,Cyprus,46,32,14
2000,642,Romania,Cyprus,48,21,27
2000,643,Russian Federation,Cyprus,437,248,189
2000,703,Slovakia,Cyprus,69,38,31
2000,208,Denmark,Cyprus,151,64,87
2000,246,Finland,Cyprus,64,50,14
2000,352,Iceland,Cyprus,3,2,1
2000,372,Ireland,Cyprus,158,80,78
2000,428,Latvia,Cyprus,3,1,2
2000,440,Lithuania,Cyprus,3,0,3
2000,578,Norway,Cyprus,105,78,27
2000,752,Sweden,Cyprus,453,285,168
2000,826,United Kingdom,Cyprus,75098,38027,37071
2000,300,Greece,Cyprus,22334,9493,12841
2000,380,Italy,Cyprus,195,85,110
2000,470,Malta,Cyprus,31,16,15
2000,620,Portugal,Cyprus,19,9,10
2000,688,Serbia,Cyprus,183,100,83
2000,705,Slovenia,Cyprus,4,2,2
2000,724,Spain,Cyprus,254,135,119
2000,40,Austria,Cyprus,224,122,102
2000,56,Belgium,Cyprus,74,30,44
2000,250,France,Cyprus,1142,543,599
2000,276,Germany,Cyprus,933,520,413
2000,442,Luxembourg,Cyprus,2,1,1
2000,528,Netherlands,Cyprus,247,147,100
2000,756,Switzerland,Cyprus,265,163,102
2000,124,Canada,Cyprus,4318,2083,2235
2000,840,United States of America,Cyprus,11368,6504,4864
2005,140,Central African Republic,Cyprus,8,3,5
2005,710,South Africa,Cyprus,2716,1370,1346
2005,818,Egypt,Cyprus,75,41,34
2005,400,Jordan,Cyprus,231,124,107
2005,792,Turkey,Cyprus,9974,4503,5471
2005,144,Sri Lanka,Cyprus,122,63,59
2005,188,Costa Rica,Cyprus,1,1,0
2005,32,Argentina,Cyprus,73,34,39
2005,68,Bolivia (Plurinational State of),Cyprus,2,0,2
2005,152,Chile,Cyprus,18,13,5
2005,862,Venezuela (Bolivarian Republic of),Cyprus,13,6,7
2005,36,Australia,Cyprus,22450,11231,11219
2005,100,Bulgaria,Cyprus,196,116,80
2005,203,Czechia,Cyprus,56,46,10
2005,348,Hungary,Cyprus,233,117,116
2005,616,Poland,Cyprus,128,82,46
2005,642,Romania,Cyprus,56,25,31
2005,643,Russian Federation,Cyprus,575,306,269
2005,703,Slovakia,Cyprus,78,43,35
2005,208,Denmark,Cyprus,155,66,89
2005,246,Finland,Cyprus,96,72,24
2005,352,Iceland,Cyprus,4,3,1
2005,372,Ireland,Cyprus,240,128,112
2005,428,Latvia,Cyprus,12,5,7
2005,440,Lithuania,Cyprus,19,12,7
2005,578,Norway,Cyprus,114,82,32
2005,752,Sweden,Cyprus,444,267,177
2005,826,United Kingdom,Cyprus,72352,36190,36162
2005,300,Greece,Cyprus,22208,9622,12586
2005,380,Italy,Cyprus,423,188,235
2005,470,Malta,Cyprus,38,19,19
2005,620,Portugal,Cyprus,24,12,12
2005,688,Serbia,Cyprus,181,98,83
2005,705,Slovenia,Cyprus,2,1,1
2005,724,Spain,Cyprus,192,111,81
2005,40,Austria,Cyprus,251,134,117
2005,56,Belgium,Cyprus,184,89,95
2005,250,France,Cyprus,937,483,454
2005,276,Germany,Cyprus,1243,702,541
2005,442,Luxembourg,Cyprus,21,11,10
2005,528,Netherlands,Cyprus,297,175,122
2005,756,Switzerland,Cyprus,290,171,119
2005,124,Canada,Cyprus,3942,1959,1983
2005,840,United States of America,Cyprus,13569,7796,5773
2010,140,Central African Republic,Cyprus,8,3,5
2010,710,South Africa,Cyprus,4254,2138,2116
2010,818,Egypt,Cyprus,81,43,38
2010,400,Jordan,Cyprus,297,167,130
2010,792,Turkey,Cyprus,10278,4513,5765
2010,144,Sri Lanka,Cyprus,247,129,118
2010,188,Costa Rica,Cyprus,3,3,0
2010,32,Argentina,Cyprus,47,23,24
2010,68,Bolivia (Plurinational State of),Cyprus,2,0,2
2010,152,Chile,Cyprus,24,17,7
2010,862,Venezuela (Bolivarian Republic of),Cyprus,15,7,8
2010,36,Australia,Cyprus,21350,10568,10782
2010,100,Bulgaria,Cyprus,234,143,91
2010,203,Czechia,Cyprus,79,65,14
2010,348,Hungary,Cyprus,277,142,135
2010,616,Poland,Cyprus,216,136,80
2010,642,Romania,Cyprus,74,34,40
2010,643,Russian Federation,Cyprus,703,358,345
2010,703,Slovakia,Cyprus,87,49,38
2010,208,Denmark,Cyprus,155,67,88
2010,233,Estonia,Cyprus,13,6,7
2010,246,Finland,Cyprus,145,105,40
2010,352,Iceland,Cyprus,5,4,1
2010,372,Ireland,Cyprus,282,141,141
2010,428,Latvia,Cyprus,22,9,13
2010,440,Lithuania,Cyprus,33,21,12
2010,578,Norway,Cyprus,121,91,30
2010,752,Sweden,Cyprus,538,316,222
2010,826,United Kingdom,Cyprus,76219,38906,37313
2010,300,Greece,Cyprus,22974,10150,12824
2010,380,Italy,Cyprus,696,316,380
2010,470,Malta,Cyprus,36,21,15
2010,620,Portugal,Cyprus,26,14,12
2010,688,Serbia,Cyprus,177,95,82
2010,705,Slovenia,Cyprus,7,3,4
2010,724,Spain,Cyprus,309,166,143
2010,40,Austria,Cyprus,277,146,131
2010,56,Belgium,Cyprus,382,197,185
2010,250,France,Cyprus,967,449,518
2010,276,Germany,Cyprus,1498,853,645
2010,442,Luxembourg,Cyprus,41,21,20
2010,528,Netherlands,Cyprus,382,210,172
2010,756,Switzerland,Cyprus,351,201,150
2010,124,Canada,Cyprus,3780,1947,1833
2010,840,United States of America,Cyprus,16244,9168,7076
2015,140,Central African Republic,Cyprus,7,3,4
2015,710,South Africa,Cyprus,7673,3662,4011
2015,818,Egypt,Cyprus,60,36,24
2015,400,Jordan,Cyprus,127,59,68
2015,792,Turkey,Cyprus,10433,4449,5984
2015,144,Sri Lanka,Cyprus,251,129,122
2015,188,Costa Rica,Cyprus,3,3,0
2015,32,Argentina,Cyprus,47,23,24
2015,68,Bolivia (Plurinational State of),Cyprus,2,0,2
2015,152,Chile,Cyprus,36,26,10
2015,862,Venezuela (Bolivarian Republic of),Cyprus,15,7,8
2015,36,Australia,Cyprus,20100,9995,10105
2015,100,Bulgaria,Cyprus,1008,554,454
2015,203,Czechia,Cyprus,106,84,22
2015,348,Hungary,Cyprus,295,163,132
2015,616,Poland,Cyprus,208,133,75
2015,642,Romania,Cyprus,307,162,145
2015,643,Russian Federation,Cyprus,716,362,354
2015,703,Slovakia,Cyprus,120,73,47
2015,208,Denmark,Cyprus,191,85,106
2015,233,Estonia,Cyprus,20,13,7
2015,246,Finland,Cyprus,202,142,60
2015,352,Iceland,Cyprus,5,3,2
2015,372,Ireland,Cyprus,288,142,146
2015,428,Latvia,Cyprus,44,26,18
2015,440,Lithuania,Cyprus,33,19,14
2015,578,Norway,Cyprus,198,139,59
2015,752,Sweden,Cyprus,759,434,325
2015,826,United Kingdom,Cyprus,97472,48340,49132
2015,300,Greece,Cyprus,21562,9013,12549
2015,380,Italy,Cyprus,604,261,343
2015,470,Malta,Cyprus,61,38,23
2015,620,Portugal,Cyprus,29,15,14
2015,688,Serbia,Cyprus,173,93,80
2015,705,Slovenia,Cyprus,16,7,9
2015,724,Spain,Cyprus,366,193,173
2015,40,Austria,Cyprus,325,173,152
2015,56,Belgium,Cyprus,488,251,237
2015,250,France,Cyprus,1003,461,542
2015,276,Germany,Cyprus,1561,887,674
2015,442,Luxembourg,Cyprus,62,32,30
2015,528,Netherlands,Cyprus,563,315,248
2015,756,Switzerland,Cyprus,477,274,203
2015,124,Canada,Cyprus,3990,2007,1983
2015,840,United States of America,Cyprus,20420,11480,8940
2019,140,Central African Republic,Cyprus,7,3,4
2019,710,South Africa,Cyprus,8600,4109,4491
2019,818,Egypt,Cyprus,85,47,38
2019,400,Jordan,Cyprus,136,63,73
2019,792,Turkey,Cyprus,14107,6096,8011
2019,144,Sri Lanka,Cyprus,252,130,122
2019,188,Costa Rica,Cyprus,3,3,0
2019,32,Argentina,Cyprus,47,23,24
2019,68,Bolivia (Plurinational State of),Cyprus,2,0,2
2019,152,Chile,Cyprus,48,34,14
2019,862,Venezuela (Bolivarian Republic of),Cyprus,14,7,7
2019,36,Australia,Cyprus,20514,10117,10397
2019,100,Bulgaria,Cyprus,1372,748,624
2019,203,Czechia,Cyprus,114,90,24
2019,348,Hungary,Cyprus,299,169,130
2019,616,Poland,Cyprus,220,144,76
2019,642,Romania,Cyprus,913,487,426
2019,643,Russian Federation,Cyprus,715,362,353
2019,703,Slovakia,Cyprus,151,93,58
2019,208,Denmark,Cyprus,274,138,136
2019,233,Estonia,Cyprus,26,19,7
2019,246,Finland,Cyprus,249,176,73
2019,352,Iceland,Cyprus,7,4,3
2019,372,Ireland,Cyprus,316,157,159
2019,428,Latvia,Cyprus,47,25,22
2019,440,Lithuania,Cyprus,36,20,16
2019,578,Norway,Cyprus,227,146,81
2019,752,Sweden,Cyprus,902,488,414
2019,826,United Kingdom,Cyprus,110689,55036,55653
2019,300,Greece,Cyprus,21057,9266,11791
2019,380,Italy,Cyprus,455,199,256
2019,470,Malta,Cyprus,98,62,36
2019,620,Portugal,Cyprus,29,15,14
2019,688,Serbia,Cyprus,175,94,81
2019,705,Slovenia,Cyprus,11,5,6
2019,724,Spain,Cyprus,379,196,183
2019,40,Austria,Cyprus,383,207,176
2019,56,Belgium,Cyprus,553,286,267
2019,250,France,Cyprus,1061,486,575
2019,276,Germany,Cyprus,2292,1263,1029
2019,442,Luxembourg,Cyprus,141,78,63
2019,528,Netherlands,Cyprus,797,443,354
2019,756,Switzerland,Cyprus,536,301,235
2019,124,Canada,Cyprus,4275,2150,2125
2019,840,United States of America,Cyprus,22050,12293,9757
1990,516,Namibia,Czechia,112,35,77
1990,710,South Africa,Czechia,953,514,439
1990,818,Egypt,Czechia,250,114,136
1990,196,Cyprus,Czechia,168,62,106
1990,400,Jordan,Czechia,18,6,12
1990,792,Turkey,Czechia,274,145,129
1990,496,Mongolia,Czechia,7,3,4
1990,192,Cuba,Czechia,406,177,229
1990,214,Dominican Republic,Czechia,12,6,6
1990,484,Mexico,Czechia,348,232,116
1990,591,Panama,Czechia,16,8,8
1990,32,Argentina,Czechia,3946,1409,2537
1990,68,Bolivia (Plurinational State of),Czechia,129,60,69
1990,76,Brazil,Czechia,1535,862,673
1990,170,Colombia,Czechia,122,64,58
1990,218,Ecuador,Czechia,105,76,29
1990,604,Peru,Czechia,55,31,24
1990,862,Venezuela (Bolivarian Republic of),Czechia,332,166,166
1990,36,Australia,Czechia,17760,10051,7709
1990,554,New Zealand,Czechia,195,106,89
1990,112,Belarus,Czechia,83,39,44
1990,100,Bulgaria,Czechia,162,56,106
1990,348,Hungary,Czechia,68,17,51
1990,616,Poland,Czechia,8798,3756,5042
1990,498,Republic of Moldova,Czechia,520,274,246
1990,642,Romania,Czechia,829,298,531
1990,643,Russian Federation,Czechia,13710,6728,6982
1990,703,Slovakia,Czechia,26268,11934,14334
1990,208,Denmark,Czechia,189,68,121
1990,246,Finland,Czechia,260,129,131
1990,352,Iceland,Czechia,43,17,26
1990,372,Ireland,Czechia,265,130,135
1990,428,Latvia,Czechia,48,21,27
1990,440,Lithuania,Czechia,66,33,33
1990,578,Norway,Czechia,148,81,67
1990,752,Sweden,Czechia,252,89,163
1990,826,United Kingdom,Czechia,8523,3825,4698
1990,300,Greece,Czechia,2296,908,1388
1990,380,Italy,Czechia,937,326,611
1990,470,Malta,Czechia,10,5,5
1990,807,North Macedonia,Czechia,54,23,31
1990,620,Portugal,Czechia,37,15,22
1990,688,Serbia,Czechia,63,22,41
1990,705,Slovenia,Czechia,396,113,283
1990,724,Spain,Czechia,685,277,408
1990,40,Austria,Czechia,30293,11654,18639
1990,56,Belgium,Czechia,37,19,18
1990,250,France,Czechia,11542,4581,6961
1990,276,Germany,Czechia,27873,14931,12942
1990,438,Liechtenstein,Czechia,9,9,0
1990,442,Luxembourg,Czechia,76,32,44
1990,528,Netherlands,Czechia,3382,1125,2257
1990,756,Switzerland,Czechia,9776,4389,5387
1990,124,Canada,Czechia,15799,7691,8108
1990,840,United States of America,Czechia,87020,42565,44455
1995,516,Namibia,Czechia,107,34,73
1995,710,South Africa,Czechia,779,433,346
1995,818,Egypt,Czechia,191,83,108
1995,196,Cyprus,Czechia,238,82,156
1995,400,Jordan,Czechia,24,9,15
1995,792,Turkey,Czechia,663,337,326
1995,496,Mongolia,Czechia,6,3,3
1995,192,Cuba,Czechia,308,127,181
1995,214,Dominican Republic,Czechia,14,7,7
1995,484,Mexico,Czechia,331,175,156
1995,591,Panama,Czechia,20,10,10
1995,32,Argentina,Czechia,3852,1402,2450
1995,68,Bolivia (Plurinational State of),Czechia,76,36,40
1995,76,Brazil,Czechia,1347,733,614
1995,152,Chile,Czechia,72,34,38
1995,170,Colombia,Czechia,93,47,46
1995,218,Ecuador,Czechia,118,85,33
1995,604,Peru,Czechia,56,31,25
1995,862,Venezuela (Bolivarian Republic of),Czechia,327,164,163
1995,36,Australia,Czechia,15921,8753,7168
1995,554,New Zealand,Czechia,260,137,123
1995,112,Belarus,Czechia,91,34,57
1995,100,Bulgaria,Czechia,313,119,194
1995,348,Hungary,Czechia,578,207,371
1995,616,Poland,Czechia,7526,3148,4378
1995,498,Republic of Moldova,Czechia,351,180,171
1995,642,Romania,Czechia,691,255,436
1995,643,Russian Federation,Czechia,14104,7054,7050
1995,703,Slovakia,Czechia,37407,15280,22127
1995,208,Denmark,Czechia,203,73,130
1995,246,Finland,Czechia,272,136,136
1995,352,Iceland,Czechia,64,26,38
1995,372,Ireland,Czechia,1437,683,754
1995,428,Latvia,Czechia,112,41,71
1995,440,Lithuania,Czechia,74,37,37
1995,578,Norway,Czechia,185,96,89
1995,752,Sweden,Czechia,299,104,195
1995,826,United Kingdom,Czechia,10086,3755,6331
1995,191,Croatia,Czechia,428,92,336
1995,300,Greece,Czechia,2970,1265,1705
1995,380,Italy,Czechia,3306,379,2927
1995,470,Malta,Czechia,12,6,6
1995,807,North Macedonia,Czechia,50,21,29
1995,620,Portugal,Czechia,81,33,48
1995,688,Serbia,Czechia,400,129,271
1995,705,Slovenia,Czechia,349,103,246
1995,724,Spain,Czechia,958,371,587
1995,40,Austria,Czechia,34176,13492,20684
1995,56,Belgium,Czechia,55,25,30
1995,250,France,Czechia,11915,4608,7307
1995,276,Germany,Czechia,64364,39369,24995
1995,438,Liechtenstein,Czechia,11,11,0
1995,442,Luxembourg,Czechia,79,30,49
1995,528,Netherlands,Czechia,3953,1264,2689
1995,756,Switzerland,Czechia,9600,4390,5210
1995,124,Canada,Czechia,15865,7687,8178
1995,840,United States of America,Czechia,86188,42514,43674
2000,516,Namibia,Czechia,101,32,69
2000,710,South Africa,Czechia,838,466,372
2000,818,Egypt,Czechia,148,60,88
2000,196,Cyprus,Czechia,307,101,206
2000,268,Georgia,Czechia,34,12,22
2000,400,Jordan,Czechia,29,11,18
2000,792,Turkey,Czechia,1056,530,526
2000,496,Mongolia,Czechia,7,3,4
2000,192,Cuba,Czechia,210,77,133
2000,214,Dominican Republic,Czechia,15,7,8
2000,484,Mexico,Czechia,330,127,203
2000,591,Panama,Czechia,26,13,13
2000,32,Argentina,Czechia,3758,1395,2363
2000,68,Bolivia (Plurinational State of),Czechia,22,11,11
2000,76,Brazil,Czechia,1158,604,554
2000,152,Chile,Czechia,144,67,77
2000,170,Colombia,Czechia,64,30,34
2000,218,Ecuador,Czechia,131,95,36
2000,604,Peru,Czechia,66,36,30
2000,862,Venezuela (Bolivarian Republic of),Czechia,321,161,160
2000,36,Australia,Czechia,13110,6961,6149
2000,554,New Zealand,Czechia,644,313,331
2000,112,Belarus,Czechia,99,30,69
2000,100,Bulgaria,Czechia,464,182,282
2000,348,Hungary,Czechia,1088,398,690
2000,616,Poland,Czechia,6438,2635,3803
2000,498,Republic of Moldova,Czechia,237,118,119
2000,642,Romania,Czechia,546,208,338
2000,643,Russian Federation,Czechia,13987,7126,6861
2000,703,Slovakia,Czechia,58709,22911,35798
2000,208,Denmark,Czechia,217,79,138
2000,246,Finland,Czechia,283,142,141
2000,352,Iceland,Czechia,85,35,50
2000,372,Ireland,Czechia,3400,1673,1727
2000,428,Latvia,Czechia,176,61,115
2000,440,Lithuania,Czechia,57,28,29
2000,578,Norway,Czechia,506,233,273
2000,752,Sweden,Czechia,321,110,211
2000,826,United Kingdom,Czechia,11819,3732,8087
2000,191,Croatia,Czechia,810,179,631
2000,300,Greece,Czechia,3692,1612,2080
2000,380,Italy,Czechia,5675,433,5242
2000,470,Malta,Czechia,30,16,14
2000,807,North Macedonia,Czechia,47,20,27
2000,620,Portugal,Czechia,129,53,76
2000,688,Serbia,Czechia,545,168,377
2000,705,Slovenia,Czechia,460,139,321
2000,724,Spain,Czechia,1645,642,1003
2000,40,Austria,Czechia,38058,15330,22728
2000,56,Belgium,Czechia,71,29,42
2000,250,France,Czechia,12288,4636,7652
2000,276,Germany,Czechia,100855,63808,37047
2000,438,Liechtenstein,Czechia,13,13,0
2000,442,Luxembourg,Czechia,83,27,56
2000,528,Netherlands,Czechia,4661,1439,3222
2000,756,Switzerland,Czechia,9460,4423,5037
2000,124,Canada,Czechia,16308,7867,8441
2000,840,United States of America,Czechia,85190,42435,42755
2005,516,Namibia,Czechia,79,25,54
2005,710,South Africa,Czechia,1102,589,513
2005,818,Egypt,Czechia,176,78,98
2005,196,Cyprus,Czechia,449,145,304
2005,268,Georgia,Czechia,32,12,20
2005,400,Jordan,Czechia,42,19,23
2005,792,Turkey,Czechia,1088,534,554
2005,496,Mongolia,Czechia,10,6,4
2005,192,Cuba,Czechia,140,51,89
2005,214,Dominican Republic,Czechia,22,11,11
2005,484,Mexico,Czechia,311,117,194
2005,591,Panama,Czechia,28,12,16
2005,32,Argentina,Czechia,2773,1057,1716
2005,68,Bolivia (Plurinational State of),Czechia,34,14,20
2005,76,Brazil,Czechia,806,427,379
2005,152,Chile,Czechia,216,103,113
2005,170,Colombia,Czechia,46,20,26
2005,218,Ecuador,Czechia,155,114,41
2005,604,Peru,Czechia,78,42,36
2005,862,Venezuela (Bolivarian Republic of),Czechia,337,170,167
2005,36,Australia,Czechia,13700,6965,6735
2005,554,New Zealand,Czechia,854,415,439
2005,112,Belarus,Czechia,95,29,66
2005,100,Bulgaria,Czechia,689,285,404
2005,348,Hungary,Czechia,1344,507,837
2005,616,Poland,Czechia,5473,2349,3124
2005,498,Republic of Moldova,Czechia,164,80,84
2005,642,Romania,Czechia,561,223,338
2005,643,Russian Federation,Czechia,12647,6395,6252
2005,703,Slovakia,Czechia,65367,25972,39395
2005,208,Denmark,Czechia,558,237,321
2005,246,Finland,Czechia,444,226,218
2005,352,Iceland,Czechia,122,54,68
2005,372,Ireland,Czechia,5096,2825,2271
2005,428,Latvia,Czechia,215,97,118
2005,440,Lithuania,Czechia,81,40,41
2005,578,Norway,Czechia,889,380,509
2005,752,Sweden,Czechia,622,260,362
2005,826,United Kingdom,Czechia,23471,8869,14602
2005,191,Croatia,Czechia,877,216,661
2005,300,Greece,Czechia,4110,1690,2420
2005,380,Italy,Czechia,8038,1218,6820
2005,470,Malta,Czechia,48,24,24
2005,807,North Macedonia,Czechia,48,21,27
2005,620,Portugal,Czechia,189,68,121
2005,688,Serbia,Czechia,538,161,377
2005,705,Slovenia,Czechia,412,124,288
2005,724,Spain,Czechia,4368,1716,2652
2005,40,Austria,Czechia,42540,16528,26012
2005,56,Belgium,Czechia,188,71,117
2005,250,France,Czechia,4616,1702,2914
2005,276,Germany,Czechia,285873,131267,154606
2005,438,Liechtenstein,Czechia,33,15,18
2005,442,Luxembourg,Czechia,336,109,227
2005,528,Netherlands,Czechia,6170,1949,4221
2005,756,Switzerland,Czechia,10682,4731,5951
2005,124,Canada,Czechia,17965,8719,9246
2005,840,United States of America,Czechia,79662,39903,39759
2010,516,Namibia,Czechia,76,25,51
2010,710,South Africa,Czechia,1725,919,806
2010,818,Egypt,Czechia,190,80,110
2010,196,Cyprus,Czechia,735,244,491
2010,268,Georgia,Czechia,32,12,20
2010,400,Jordan,Czechia,55,26,29
2010,792,Turkey,Czechia,1121,538,583
2010,496,Mongolia,Czechia,15,10,5
2010,192,Cuba,Czechia,77,28,49
2010,214,Dominican Republic,Czechia,28,15,13
2010,484,Mexico,Czechia,329,120,209
2010,591,Panama,Czechia,33,13,20
2010,32,Argentina,Czechia,1787,719,1068
2010,68,Bolivia (Plurinational State of),Czechia,45,16,29
2010,76,Brazil,Czechia,443,244,199
2010,152,Chile,Czechia,288,138,150
2010,170,Colombia,Czechia,37,15,22
2010,218,Ecuador,Czechia,217,158,59
2010,604,Peru,Czechia,87,48,39
2010,862,Venezuela (Bolivarian Republic of),Czechia,358,180,178
2010,36,Australia,Czechia,13620,6639,6981
2010,554,New Zealand,Czechia,1104,536,568
2010,112,Belarus,Czechia,91,28,63
2010,100,Bulgaria,Czechia,885,375,510
2010,348,Hungary,Czechia,1600,616,984
2010,616,Poland,Czechia,4680,2115,2565
2010,498,Republic of Moldova,Czechia,162,81,81
2010,642,Romania,Czechia,636,257,379
2010,643,Russian Federation,Czechia,11047,5535,5512
2010,703,Slovakia,Czechia,73744,30179,43565
2010,208,Denmark,Czechia,883,390,493
2010,233,Estonia,Czechia,67,40,27
2010,246,Finland,Czechia,140,73,67
2010,352,Iceland,Czechia,158,74,84
2010,372,Ireland,Czechia,5953,3224,2729
2010,428,Latvia,Czechia,249,128,121
2010,440,Lithuania,Czechia,94,44,50
2010,578,Norway,Czechia,1354,658,696
2010,752,Sweden,Czechia,1274,623,651
2010,826,United Kingdom,Czechia,24725,9659,15066
2010,191,Croatia,Czechia,943,252,691
2010,300,Greece,Czechia,4710,1840,2870
2010,380,Italy,Czechia,10566,2000,8566
2010,470,Malta,Czechia,66,22,44
2010,499,Montenegro,Czechia,115,66,49
2010,807,North Macedonia,Czechia,50,22,28
2010,620,Portugal,Czechia,218,72,146
2010,688,Serbia,Czechia,526,157,369
2010,705,Slovenia,Czechia,333,107,226
2010,724,Spain,Czechia,8540,3633,4907
2010,40,Austria,Czechia,47022,17727,29295
2010,56,Belgium,Czechia,347,175,172
2010,250,France,Czechia,8551,3107,5444
2010,276,Germany,Czechia,439737,190037,249700
2010,438,Liechtenstein,Czechia,54,16,38
2010,442,Luxembourg,Czechia,594,192,402
2010,528,Netherlands,Czechia,407,208,199
2010,756,Switzerland,Czechia,12499,5106,7393
2010,124,Canada,Czechia,20390,9968,10422
2010,840,United States of America,Czechia,76438,37764,38674
2015,516,Namibia,Czechia,74,25,49
2015,710,South Africa,Czechia,3111,1584,1527
2015,818,Egypt,Czechia,140,70,70
2015,196,Cyprus,Czechia,706,238,468
2015,268,Georgia,Czechia,33,13,20
2015,400,Jordan,Czechia,23,8,15
2015,792,Turkey,Czechia,1137,532,605
2015,496,Mongolia,Czechia,18,11,7
2015,192,Cuba,Czechia,61,22,39
2015,214,Dominican Republic,Czechia,29,16,13
2015,484,Mexico,Czechia,349,126,223
2015,591,Panama,Czechia,38,15,23
2015,32,Argentina,Czechia,1793,721,1072
2015,68,Bolivia (Plurinational State of),Czechia,52,18,34
2015,76,Brazil,Czechia,533,293,240
2015,152,Chile,Czechia,436,204,232
2015,170,Colombia,Czechia,41,17,24
2015,218,Ecuador,Czechia,315,229,86
2015,604,Peru,Czechia,91,51,40
2015,862,Venezuela (Bolivarian Republic of),Czechia,376,187,189
2015,36,Australia,Czechia,13240,6284,6956
2015,554,New Zealand,Czechia,1337,647,690
2015,112,Belarus,Czechia,96,29,67
2015,100,Bulgaria,Czechia,1186,525,661
2015,348,Hungary,Czechia,1555,628,927
2015,616,Poland,Czechia,4512,2086,2426
2015,498,Republic of Moldova,Czechia,185,93,92
2015,642,Romania,Czechia,138,62,76
2015,643,Russian Federation,Czechia,11257,5611,5646
2015,703,Slovakia,Czechia,87989,39855,48134
2015,208,Denmark,Czechia,1202,534,668
2015,233,Estonia,Czechia,190,81,109
2015,246,Finland,Czechia,263,114,149
2015,352,Iceland,Czechia,246,141,105
2015,372,Ireland,Czechia,6081,3259,2822
2015,428,Latvia,Czechia,137,48,89
2015,440,Lithuania,Czechia,87,39,48
2015,578,Norway,Czechia,2162,1114,1048
2015,752,Sweden,Czechia,1831,844,987
2015,826,United Kingdom,Czechia,31619,11781,19838
2015,191,Croatia,Czechia,949,252,697
2015,300,Greece,Czechia,4420,1612,2808
2015,380,Italy,Czechia,10404,1907,8497
2015,470,Malta,Czechia,112,42,70
2015,499,Montenegro,Czechia,120,69,51
2015,807,North Macedonia,Czechia,53,23,30
2015,620,Portugal,Czechia,247,72,175
2015,688,Serbia,Czechia,514,153,361
2015,705,Slovenia,Czechia,388,113,275
2015,724,Spain,Czechia,8548,3396,5152
2015,40,Austria,Czechia,54997,20921,34076
2015,56,Belgium,Czechia,657,319,338
2015,250,France,Czechia,8989,3138,5851
2015,276,Germany,Czechia,458182,197394,260788
2015,438,Liechtenstein,Czechia,58,18,40
2015,442,Luxembourg,Czechia,906,303,603
2015,528,Netherlands,Czechia,681,349,332
2015,756,Switzerland,Czechia,15128,6305,8823
2015,124,Canada,Czechia,20930,9913,11017
2015,840,United States of America,Czechia,75864,37284,38580
2019,516,Namibia,Czechia,78,27,51
2019,710,South Africa,Czechia,3486,1777,1709
2019,818,Egypt,Czechia,199,88,111
2019,196,Cyprus,Czechia,705,243,462
2019,268,Georgia,Czechia,34,14,20
2019,400,Jordan,Czechia,24,8,16
2019,792,Turkey,Czechia,1537,728,809
2019,496,Mongolia,Czechia,19,12,7
2019,192,Cuba,Czechia,56,20,36
2019,214,Dominican Republic,Czechia,29,16,13
2019,484,Mexico,Czechia,359,130,229
2019,591,Panama,Czechia,39,16,23
2019,32,Argentina,Czechia,1824,732,1092
2019,68,Bolivia (Plurinational State of),Czechia,56,19,37
2019,76,Brazil,Czechia,600,330,270
2019,152,Chile,Czechia,582,255,327
2019,170,Colombia,Czechia,41,17,24
2019,218,Ecuador,Czechia,310,226,84
2019,604,Peru,Czechia,108,63,45
2019,862,Venezuela (Bolivarian Republic of),Czechia,368,183,185
2019,36,Australia,Czechia,13796,6509,7287
2019,554,New Zealand,Czechia,1374,665,709
2019,112,Belarus,Czechia,94,28,66
2019,100,Bulgaria,Czechia,1514,670,844
2019,348,Hungary,Czechia,1497,607,890
2019,616,Poland,Czechia,4778,2308,2470
2019,498,Republic of Moldova,Czechia,182,92,90
2019,642,Romania,Czechia,407,206,201
2019,643,Russian Federation,Czechia,11254,5610,5644
2019,703,Slovakia,Czechia,88794,40294,48500
2019,208,Denmark,Czechia,2010,960,1050
2019,233,Estonia,Czechia,225,102,123
2019,246,Finland,Czechia,383,170,213
2019,352,Iceland,Czechia,420,228,192
2019,372,Ireland,Czechia,6676,3588,3088
2019,428,Latvia,Czechia,135,49,86
2019,440,Lithuania,Czechia,87,39,48
2019,578,Norway,Czechia,2443,1240,1203
2019,752,Sweden,Czechia,2492,1194,1298
2019,826,United Kingdom,Czechia,35906,13435,22471
2019,191,Croatia,Czechia,876,231,645
2019,300,Greece,Czechia,4316,1678,2638
2019,380,Italy,Czechia,10542,1956,8586
2019,470,Malta,Czechia,180,68,112
2019,499,Montenegro,Czechia,120,70,50
2019,807,North Macedonia,Czechia,53,23,30
2019,620,Portugal,Czechia,251,74,177
2019,688,Serbia,Czechia,522,156,366
2019,705,Slovenia,Czechia,367,105,262
2019,724,Spain,Czechia,8857,3392,5465
2019,40,Austria,Czechia,64923,25389,39534
2019,56,Belgium,Czechia,746,355,391
2019,250,France,Czechia,9514,3307,6207
2019,276,Germany,Czechia,502609,224600,278009
2019,438,Liechtenstein,Czechia,60,17,43
2019,442,Luxembourg,Czechia,1095,431,664
2019,528,Netherlands,Czechia,1041,500,541
2019,756,Switzerland,Czechia,16122,6803,9319
2019,124,Canada,Czechia,22428,10623,11805
2019,840,United States of America,Czechia,81926,39816,42110
1990,800,Uganda,Dem. People's Republic of Korea,51,42,9
1990,266,Gabon,Dem. People's Republic of Korea,50,30,20
1990,516,Namibia,Dem. People's Republic of Korea,149,149,0
1990,710,South Africa,Dem. People's Republic of Korea,137,4,133
1990,694,Sierra Leone,Dem. People's Republic of Korea,7,6,1
1990,818,Egypt,Dem. People's Republic of Korea,117,69,48
1990,196,Cyprus,Dem. People's Republic of Korea,8,3,5
1990,400,Jordan,Dem. People's Republic of Korea,40,25,15
1990,792,Turkey,Dem. People's Republic of Korea,7,4,3
1990,398,Kazakhstan,Dem. People's Republic of Korea,19805,9331,10474
1990,417,Kyrgyzstan,Dem. People's Republic of Korea,800,344,456
1990,762,Tajikistan,Dem. People's Republic of Korea,238,105,133
1990,496,Mongolia,Dem. People's Republic of Korea,51,24,27
1990,116,Cambodia,Dem. People's Republic of Korea,20,12,8
1990,608,Philippines,Dem. People's Republic of Korea,1321,721,600
1990,704,Viet Nam,Dem. People's Republic of Korea,56,31,25
1990,188,Costa Rica,Dem. People's Republic of Korea,21,12,9
1990,340,Honduras,Dem. People's Republic of Korea,48,34,14
1990,484,Mexico,Dem. People's Republic of Korea,336,151,185
1990,32,Argentina,Dem. People's Republic of Korea,31,31,0
1990,68,Bolivia (Plurinational State of),Dem. People's Republic of Korea,122,63,59
1990,152,Chile,Dem. People's Republic of Korea,371,204,167
1990,170,Colombia,Dem. People's Republic of Korea,99,13,86
1990,218,Ecuador,Dem. People's Republic of Korea,162,89,73
1990,604,Peru,Dem. People's Republic of Korea,53,30,23
1990,862,Venezuela (Bolivarian Republic of),Dem. People's Republic of Korea,41,20,21
1990,36,Australia,Dem. People's Republic of Korea,50,25,25
1990,112,Belarus,Dem. People's Republic of Korea,97,44,53
1990,100,Bulgaria,Dem. People's Republic of Korea,1,1,0
1990,203,Czechia,Dem. People's Republic of Korea,21,5,16
1990,643,Russian Federation,Dem. People's Republic of Korea,9699,4759,4940
1990,208,Denmark,Dem. People's Republic of Korea,163,63,100
1990,246,Finland,Dem. People's Republic of Korea,3,1,2
1990,372,Ireland,Dem. People's Republic of Korea,25,10,15
1990,428,Latvia,Dem. People's Republic of Korea,204,91,113
1990,578,Norway,Dem. People's Republic of Korea,26,14,12
1990,752,Sweden,Dem. People's Republic of Korea,44,31,13
1990,300,Greece,Dem. People's Republic of Korea,541,541,0
1990,380,Italy,Dem. People's Republic of Korea,1,0,1
1990,620,Portugal,Dem. People's Republic of Korea,1,1,0
1990,724,Spain,Dem. People's Republic of Korea,17,9,8
1990,40,Austria,Dem. People's Republic of Korea,1481,546,935
1990,56,Belgium,Dem. People's Republic of Korea,1679,683,996
1990,250,France,Dem. People's Republic of Korea,99,39,60
1990,276,Germany,Dem. People's Republic of Korea,1277,720,557
1990,528,Netherlands,Dem. People's Republic of Korea,2,2,0
1990,756,Switzerland,Dem. People's Republic of Korea,106,53,53
1990,124,Canada,Dem. People's Republic of Korea,106,52,54
1995,800,Uganda,Dem. People's Republic of Korea,48,40,8
1995,266,Gabon,Dem. People's Republic of Korea,67,41,26
1995,516,Namibia,Dem. People's Republic of Korea,142,142,0
1995,710,South Africa,Dem. People's Republic of Korea,85,9,76
1995,694,Sierra Leone,Dem. People's Republic of Korea,6,5,1
1995,818,Egypt,Dem. People's Republic of Korea,93,55,38
1995,196,Cyprus,Dem. People's Republic of Korea,12,4,8
1995,400,Jordan,Dem. People's Republic of Korea,71,48,23
1995,792,Turkey,Dem. People's Republic of Korea,17,10,7
1995,398,Kazakhstan,Dem. People's Republic of Korea,32525,15581,16944
1995,417,Kyrgyzstan,Dem. People's Republic of Korea,1058,466,592
1995,762,Tajikistan,Dem. People's Republic of Korea,193,110,83
1995,496,Mongolia,Dem. People's Republic of Korea,56,29,27
1995,116,Cambodia,Dem. People's Republic of Korea,53,32,21
1995,608,Philippines,Dem. People's Republic of Korea,1777,954,823
1995,704,Viet Nam,Dem. People's Republic of Korea,228,124,104
1995,188,Costa Rica,Dem. People's Republic of Korea,20,11,9
1995,340,Honduras,Dem. People's Republic of Korea,48,33,15
1995,484,Mexico,Dem. People's Republic of Korea,1219,614,605
1995,32,Argentina,Dem. People's Republic of Korea,30,30,0
1995,68,Bolivia (Plurinational State of),Dem. People's Republic of Korea,63,33,30
1995,152,Chile,Dem. People's Republic of Korea,188,157,31
1995,170,Colombia,Dem. People's Republic of Korea,122,38,84
1995,218,Ecuador,Dem. People's Republic of Korea,182,100,82
1995,604,Peru,Dem. People's Republic of Korea,54,30,24
1995,862,Venezuela (Bolivarian Republic of),Dem. People's Republic of Korea,40,20,20
1995,36,Australia,Dem. People's Republic of Korea,237,126,111
1995,112,Belarus,Dem. People's Republic of Korea,80,32,48
1995,100,Bulgaria,Dem. People's Republic of Korea,1,1,0
1995,203,Czechia,Dem. People's Republic of Korea,32,8,24
1995,643,Russian Federation,Dem. People's Republic of Korea,9245,4987,4258
1995,208,Denmark,Dem. People's Republic of Korea,211,87,124
1995,246,Finland,Dem. People's Republic of Korea,2,0,2
1995,372,Ireland,Dem. People's Republic of Korea,70,27,43
1995,428,Latvia,Dem. People's Republic of Korea,109,50,59
1995,578,Norway,Dem. People's Republic of Korea,23,10,13
1995,752,Sweden,Dem. People's Republic of Korea,52,37,15
1995,826,United Kingdom,Dem. People's Republic of Korea,5,5,0
1995,300,Greece,Dem. People's Republic of Korea,274,271,3
1995,380,Italy,Dem. People's Republic of Korea,21,6,15
1995,620,Portugal,Dem. People's Republic of Korea,2,1,1
1995,724,Spain,Dem. People's Republic of Korea,27,14,13
1995,40,Austria,Dem. People's Republic of Korea,1671,633,1038
1995,56,Belgium,Dem. People's Republic of Korea,1674,678,996
1995,250,France,Dem. People's Republic of Korea,102,39,63
1995,276,Germany,Dem. People's Republic of Korea,1453,755,698
1995,528,Netherlands,Dem. People's Republic of Korea,2,2,0
1995,756,Switzerland,Dem. People's Republic of Korea,233,98,135
1995,124,Canada,Dem. People's Republic of Korea,106,51,55
2000,800,Uganda,Dem. People's Republic of Korea,136,104,32
2000,266,Gabon,Dem. People's Republic of Korea,83,50,33
2000,516,Namibia,Dem. People's Republic of Korea,133,133,0
2000,710,South Africa,Dem. People's Republic of Korea,58,14,44
2000,694,Sierra Leone,Dem. People's Republic of Korea,5,4,1
2000,818,Egypt,Dem. People's Republic of Korea,76,45,31
2000,196,Cyprus,Dem. People's Republic of Korea,15,5,10
2000,400,Jordan,Dem. People's Republic of Korea,102,72,30
2000,792,Turkey,Dem. People's Republic of Korea,28,15,13
2000,398,Kazakhstan,Dem. People's Republic of Korea,45244,21830,23414
2000,417,Kyrgyzstan,Dem. People's Republic of Korea,1280,570,710
2000,762,Tajikistan,Dem. People's Republic of Korea,166,98,68
2000,496,Mongolia,Dem. People's Republic of Korea,62,33,29
2000,116,Cambodia,Dem. People's Republic of Korea,85,51,34
2000,608,Philippines,Dem. People's Republic of Korea,6033,3060,2973
2000,704,Viet Nam,Dem. People's Republic of Korea,648,374,274
2000,188,Costa Rica,Dem. People's Republic of Korea,28,14,14
2000,340,Honduras,Dem. People's Republic of Korea,47,32,15
2000,484,Mexico,Dem. People's Republic of Korea,2156,1108,1048
2000,32,Argentina,Dem. People's Republic of Korea,29,29,0
2000,68,Bolivia (Plurinational State of),Dem. People's Republic of Korea,3,2,1
2000,152,Chile,Dem. People's Republic of Korea,6,5,1
2000,170,Colombia,Dem. People's Republic of Korea,145,64,81
2000,218,Ecuador,Dem. People's Republic of Korea,202,111,91
2000,604,Peru,Dem. People's Republic of Korea,64,35,29
2000,862,Venezuela (Bolivarian Republic of),Dem. People's Republic of Korea,40,20,20
2000,36,Australia,Dem. People's Republic of Korea,380,213,167
2000,112,Belarus,Dem. People's Republic of Korea,62,19,43
2000,100,Bulgaria,Dem. People's Republic of Korea,1,1,0
2000,203,Czechia,Dem. People's Republic of Korea,43,11,32
2000,643,Russian Federation,Dem. People's Republic of Korea,8456,5035,3421
2000,208,Denmark,Dem. People's Republic of Korea,258,110,148
2000,246,Finland,Dem. People's Republic of Korea,1,0,1
2000,372,Ireland,Dem. People's Republic of Korea,153,63,90
2000,428,Latvia,Dem. People's Republic of Korea,14,9,5
2000,578,Norway,Dem. People's Republic of Korea,25,10,15
2000,752,Sweden,Dem. People's Republic of Korea,56,39,17
2000,826,United Kingdom,Dem. People's Republic of Korea,11,10,1
2000,300,Greece,Dem. People's Republic of Korea,11,4,7
2000,380,Italy,Dem. People's Republic of Korea,40,11,29
2000,620,Portugal,Dem. People's Republic of Korea,5,2,3
2000,724,Spain,Dem. People's Republic of Korea,334,183,151
2000,40,Austria,Dem. People's Republic of Korea,1860,720,1140
2000,56,Belgium,Dem. People's Republic of Korea,1623,662,961
2000,250,France,Dem. People's Republic of Korea,105,39,66
2000,276,Germany,Dem. People's Republic of Korea,1628,790,838
2000,528,Netherlands,Dem. People's Republic of Korea,4,4,0
2000,756,Switzerland,Dem. People's Republic of Korea,361,143,218
2000,124,Canada,Dem. People's Republic of Korea,109,52,57
2005,800,Uganda,Dem. People's Republic of Korea,131,100,31
2005,266,Gabon,Dem. People's Republic of Korea,90,54,36
2005,516,Namibia,Dem. People's Republic of Korea,105,105,0
2005,710,South Africa,Dem. People's Republic of Korea,76,16,60
2005,694,Sierra Leone,Dem. People's Republic of Korea,3,2,1
2005,818,Egypt,Dem. People's Republic of Korea,90,55,35
2005,196,Cyprus,Dem. People's Republic of Korea,22,7,15
2005,400,Jordan,Dem. People's Republic of Korea,148,110,38
2005,792,Turkey,Dem. People's Republic of Korea,28,15,13
2005,398,Kazakhstan,Dem. People's Republic of Korea,51580,25595,25985
2005,417,Kyrgyzstan,Dem. People's Republic of Korea,1654,736,918
2005,762,Tajikistan,Dem. People's Republic of Korea,159,95,64
2005,496,Mongolia,Dem. People's Republic of Korea,271,192,79
2005,116,Cambodia,Dem. People's Republic of Korea,66,40,26
2005,608,Philippines,Dem. People's Republic of Korea,4883,2515,2368
2005,704,Viet Nam,Dem. People's Republic of Korea,867,515,352
2005,188,Costa Rica,Dem. People's Republic of Korea,18,8,10
2005,340,Honduras,Dem. People's Republic of Korea,46,31,15
2005,484,Mexico,Dem. People's Republic of Korea,1032,531,501
2005,32,Argentina,Dem. People's Republic of Korea,22,22,0
2005,68,Bolivia (Plurinational State of),Dem. People's Republic of Korea,6,4,2
2005,76,Brazil,Dem. People's Republic of Korea,71,43,28
2005,152,Chile,Dem. People's Republic of Korea,9,8,1
2005,170,Colombia,Dem. People's Republic of Korea,153,77,76
2005,218,Ecuador,Dem. People's Republic of Korea,238,133,105
2005,604,Peru,Dem. People's Republic of Korea,75,41,34
2005,862,Venezuela (Bolivarian Republic of),Dem. People's Republic of Korea,41,21,20
2005,36,Australia,Dem. People's Republic of Korea,430,254,176
2005,112,Belarus,Dem. People's Republic of Korea,60,18,42
2005,100,Bulgaria,Dem. People's Republic of Korea,18,9,9
2005,203,Czechia,Dem. People's Republic of Korea,35,17,18
2005,643,Russian Federation,Dem. People's Republic of Korea,9538,6616,2922
2005,208,Denmark,Dem. People's Republic of Korea,306,135,171
2005,246,Finland,Dem. People's Republic of Korea,2,0,2
2005,372,Ireland,Dem. People's Republic of Korea,153,68,85
2005,428,Latvia,Dem. People's Republic of Korea,14,9,5
2005,578,Norway,Dem. People's Republic of Korea,27,14,13
2005,752,Sweden,Dem. People's Republic of Korea,74,45,29
2005,826,United Kingdom,Dem. People's Republic of Korea,8001,3368,4633
2005,300,Greece,Dem. People's Republic of Korea,23,11,12
2005,380,Italy,Dem. People's Republic of Korea,83,33,50
2005,620,Portugal,Dem. People's Republic of Korea,38,16,22
2005,724,Spain,Dem. People's Republic of Korea,161,87,74
2005,40,Austria,Dem. People's Republic of Korea,2079,774,1305
2005,56,Belgium,Dem. People's Republic of Korea,1090,451,639
2005,250,France,Dem. People's Republic of Korea,80,30,50
2005,276,Germany,Dem. People's Republic of Korea,2063,820,1243
2005,528,Netherlands,Dem. People's Republic of Korea,27,21,6
2005,756,Switzerland,Dem. People's Republic of Korea,389,145,244
2005,124,Canada,Dem. People's Republic of Korea,355,164,191
2010,800,Uganda,Dem. People's Republic of Korea,131,100,31
2010,266,Gabon,Dem. People's Republic of Korea,105,64,41
2010,516,Namibia,Dem. People's Republic of Korea,101,101,0
2010,710,South Africa,Dem. People's Republic of Korea,118,24,94
2010,466,Mali,Dem. People's Republic of Korea,1447,648,799
2010,694,Sierra Leone,Dem. People's Republic of Korea,3,2,1
2010,818,Egypt,Dem. People's Republic of Korea,97,58,39
2010,196,Cyprus,Dem. People's Republic of Korea,36,12,24
2010,400,Jordan,Dem. People's Republic of Korea,190,143,47
2010,792,Turkey,Dem. People's Republic of Korea,28,15,13
2010,398,Kazakhstan,Dem. People's Republic of Korea,57915,29359,28556
2010,417,Kyrgyzstan,Dem. People's Republic of Korea,2017,895,1122
2010,762,Tajikistan,Dem. People's Republic of Korea,158,95,63
2010,496,Mongolia,Dem. People's Republic of Korea,512,382,130
2010,116,Cambodia,Dem. People's Republic of Korea,47,29,18
2010,608,Philippines,Dem. People's Republic of Korea,5665,2807,2858
2010,704,Viet Nam,Dem. People's Republic of Korea,1246,708,538
2010,188,Costa Rica,Dem. People's Republic of Korea,36,17,19
2010,340,Honduras,Dem. People's Republic of Korea,45,31,14
2010,484,Mexico,Dem. People's Republic of Korea,29,17,12
2010,32,Argentina,Dem. People's Republic of Korea,14,14,0
2010,68,Bolivia (Plurinational State of),Dem. People's Republic of Korea,9,6,3
2010,76,Brazil,Dem. People's Republic of Korea,143,87,56
2010,152,Chile,Dem. People's Republic of Korea,12,11,1
2010,170,Colombia,Dem. People's Republic of Korea,187,103,84
2010,218,Ecuador,Dem. People's Republic of Korea,334,183,151
2010,604,Peru,Dem. People's Republic of Korea,83,46,37
2010,862,Venezuela (Bolivarian Republic of),Dem. People's Republic of Korea,44,22,22
2010,36,Australia,Dem. People's Republic of Korea,230,113,117
2010,112,Belarus,Dem. People's Republic of Korea,57,17,40
2010,100,Bulgaria,Dem. People's Republic of Korea,34,17,17
2010,203,Czechia,Dem. People's Republic of Korea,25,23,2
2010,643,Russian Federation,Dem. People's Republic of Korea,10425,8062,2363
2010,208,Denmark,Dem. People's Republic of Korea,346,157,189
2010,233,Estonia,Dem. People's Republic of Korea,6,5,1
2010,246,Finland,Dem. People's Republic of Korea,2,1,1
2010,372,Ireland,Dem. People's Republic of Korea,128,51,77
2010,428,Latvia,Dem. People's Republic of Korea,14,9,5
2010,578,Norway,Dem. People's Republic of Korea,42,23,19
2010,752,Sweden,Dem. People's Republic of Korea,86,50,36
2010,826,United Kingdom,Dem. People's Republic of Korea,8428,3648,4780
2010,300,Greece,Dem. People's Republic of Korea,36,19,17
2010,380,Italy,Dem. People's Republic of Korea,102,40,62
2010,620,Portugal,Dem. People's Republic of Korea,65,27,38
2010,724,Spain,Dem. People's Republic of Korea,103,46,57
2010,40,Austria,Dem. People's Republic of Korea,2298,829,1469
2010,56,Belgium,Dem. People's Republic of Korea,73,34,39
2010,250,France,Dem. People's Republic of Korea,56,21,35
2010,276,Germany,Dem. People's Republic of Korea,2419,848,1571
2010,528,Netherlands,Dem. People's Republic of Korea,30,18,12
2010,756,Switzerland,Dem. People's Republic of Korea,478,157,321
2010,124,Canada,Dem. People's Republic of Korea,340,157,183
2015,800,Uganda,Dem. People's Republic of Korea,131,100,31
2015,266,Gabon,Dem. People's Republic of Korea,146,96,50
2015,516,Namibia,Dem. People's Republic of Korea,98,98,0
2015,710,South Africa,Dem. People's Republic of Korea,211,34,177
2015,324,Guinea,Dem. People's Republic of Korea,1232,718,514
2015,466,Mali,Dem. People's Republic of Korea,1792,803,989
2015,694,Sierra Leone,Dem. People's Republic of Korea,3,2,1
2015,818,Egypt,Dem. People's Republic of Korea,71,46,25
2015,196,Cyprus,Dem. People's Republic of Korea,34,12,22
2015,400,Jordan,Dem. People's Republic of Korea,81,57,24
2015,792,Turkey,Dem. People's Republic of Korea,28,15,13
2015,398,Kazakhstan,Dem. People's Republic of Korea,61600,31724,29876
2015,417,Kyrgyzstan,Dem. People's Republic of Korea,1777,783,994
2015,762,Tajikistan,Dem. People's Republic of Korea,155,93,62
2015,496,Mongolia,Dem. People's Republic of Korea,633,428,205
2015,116,Cambodia,Dem. People's Republic of Korea,42,26,16
2015,608,Philippines,Dem. People's Republic of Korea,5753,2855,2898
2015,704,Viet Nam,Dem. People's Republic of Korea,1503,847,656
2015,188,Costa Rica,Dem. People's Republic of Korea,36,17,19
2015,340,Honduras,Dem. People's Republic of Korea,62,43,19
2015,484,Mexico,Dem. People's Republic of Korea,1744,1122,622
2015,32,Argentina,Dem. People's Republic of Korea,14,14,0
2015,68,Bolivia (Plurinational State of),Dem. People's Republic of Korea,10,7,3
2015,76,Brazil,Dem. People's Republic of Korea,172,105,67
2015,152,Chile,Dem. People's Republic of Korea,18,17,1
2015,170,Colombia,Dem. People's Republic of Korea,209,116,93
2015,218,Ecuador,Dem. People's Republic of Korea,485,264,221
2015,604,Peru,Dem. People's Republic of Korea,88,50,38
2015,862,Venezuela (Bolivarian Republic of),Dem. People's Republic of Korea,46,22,24
2015,36,Australia,Dem. People's Republic of Korea,220,99,121
2015,112,Belarus,Dem. People's Republic of Korea,60,19,41
2015,100,Bulgaria,Dem. People's Republic of Korea,33,13,20
2015,203,Czechia,Dem. People's Republic of Korea,13,8,5
2015,643,Russian Federation,Dem. People's Republic of Korea,10624,8203,2421
2015,208,Denmark,Dem. People's Republic of Korea,402,191,211
2015,233,Estonia,Dem. People's Republic of Korea,4,3,1
2015,246,Finland,Dem. People's Republic of Korea,4,1,3
2015,372,Ireland,Dem. People's Republic of Korea,131,51,80
2015,428,Latvia,Dem. People's Republic of Korea,11,6,5
2015,578,Norway,Dem. People's Republic of Korea,37,19,18
2015,752,Sweden,Dem. People's Republic of Korea,83,50,33
2015,826,United Kingdom,Dem. People's Republic of Korea,10778,4484,6294
2015,300,Greece,Dem. People's Republic of Korea,33,17,16
2015,380,Italy,Dem. People's Republic of Korea,110,54,56
2015,620,Portugal,Dem. People's Republic of Korea,73,28,45
2015,724,Spain,Dem. People's Republic of Korea,115,52,63
2015,40,Austria,Dem. People's Republic of Korea,2687,978,1709
2015,56,Belgium,Dem. People's Republic of Korea,131,66,65
2015,250,France,Dem. People's Republic of Korea,63,24,39
2015,276,Germany,Dem. People's Republic of Korea,2521,880,1641
2015,528,Netherlands,Dem. People's Republic of Korea,97,55,42
2015,756,Switzerland,Dem. People's Republic of Korea,348,113,235
2015,124,Canada,Dem. People's Republic of Korea,775,413,362
2019,800,Uganda,Dem. People's Republic of Korea,131,100,31
2019,266,Gabon,Dem. People's Republic of Korea,158,105,53
2019,516,Namibia,Dem. People's Republic of Korea,103,103,0
2019,710,South Africa,Dem. People's Republic of Korea,235,38,197
2019,324,Guinea,Dem. People's Republic of Korea,1176,686,490
2019,466,Mali,Dem. People's Republic of Korea,1995,894,1101
2019,694,Sierra Leone,Dem. People's Republic of Korea,3,2,1
2019,818,Egypt,Dem. People's Republic of Korea,101,62,39
2019,196,Cyprus,Dem. People's Republic of Korea,33,12,21
2019,400,Jordan,Dem. People's Republic of Korea,87,62,25
2019,792,Turkey,Dem. People's Republic of Korea,37,20,17
2019,398,Kazakhstan,Dem. People's Republic of Korea,64370,33151,31219
2019,417,Kyrgyzstan,Dem. People's Republic of Korea,1741,768,973
2019,762,Tajikistan,Dem. People's Republic of Korea,154,93,61
2019,496,Mongolia,Dem. People's Republic of Korea,672,455,217
2019,116,Cambodia,Dem. People's Republic of Korea,44,27,17
2019,608,Philippines,Dem. People's Republic of Korea,5934,2945,2989
2019,704,Viet Nam,Dem. People's Republic of Korea,1571,886,685
2019,188,Costa Rica,Dem. People's Republic of Korea,36,17,19
2019,340,Honduras,Dem. People's Republic of Korea,62,43,19
2019,484,Mexico,Dem. People's Republic of Korea,1798,1157,641
2019,32,Argentina,Dem. People's Republic of Korea,14,14,0
2019,68,Bolivia (Plurinational State of),Dem. People's Republic of Korea,10,7,3
2019,76,Brazil,Dem. People's Republic of Korea,193,118,75
2019,152,Chile,Dem. People's Republic of Korea,24,23,1
2019,170,Colombia,Dem. People's Republic of Korea,213,118,95
2019,218,Ecuador,Dem. People's Republic of Korea,477,260,217
2019,604,Peru,Dem. People's Republic of Korea,104,61,43
2019,862,Venezuela (Bolivarian Republic of),Dem. People's Republic of Korea,45,22,23
2019,36,Australia,Dem. People's Republic of Korea,264,131,133
2019,112,Belarus,Dem. People's Republic of Korea,59,19,40
2019,100,Bulgaria,Dem. People's Republic of Korea,52,27,25
2019,203,Czechia,Dem. People's Republic of Korea,14,10,4
2019,643,Russian Federation,Dem. People's Republic of Korea,10621,8201,2420
2019,208,Denmark,Dem. People's Republic of Korea,430,192,238
2019,233,Estonia,Dem. People's Republic of Korea,3,3,0
2019,246,Finland,Dem. People's Republic of Korea,6,2,4
2019,372,Ireland,Dem. People's Republic of Korea,143,56,87
2019,428,Latvia,Dem. People's Republic of Korea,10,6,4
2019,578,Norway,Dem. People's Republic of Korea,42,23,19
2019,752,Sweden,Dem. People's Republic of Korea,84,43,41
2019,826,United Kingdom,Dem. People's Republic of Korea,12239,5110,7129
2019,300,Greece,Dem. People's Republic of Korea,32,17,15
2019,380,Italy,Dem. People's Republic of Korea,75,41,34
2019,620,Portugal,Dem. People's Republic of Korea,74,29,45
2019,724,Spain,Dem. People's Republic of Korea,119,53,66
2019,40,Austria,Dem. People's Republic of Korea,3171,1189,1982
2019,56,Belgium,Dem. People's Republic of Korea,111,54,57
2019,250,France,Dem. People's Republic of Korea,66,25,41
2019,276,Germany,Dem. People's Republic of Korea,2765,1137,1628
2019,528,Netherlands,Dem. People's Republic of Korea,100,60,40
2019,756,Switzerland,Dem. People's Republic of Korea,290,84,206
2019,124,Canada,Dem. People's Republic of Korea,830,443,387
1990,108,Burundi,Democratic Republic of the Congo,36654,17963,18691
1990,232,Eritrea,Democratic Republic of the Congo,407,235,172
1990,231,Ethiopia,Democratic Republic of the Congo,48,25,23
1990,404,Kenya,Democratic Republic of the Congo,394,216,178
1990,454,Malawi,Democratic Republic of the Congo,1338,488,850
1990,508,Mozambique,Democratic Republic of the Congo,2315,1254,1061
1990,646,Rwanda,Democratic Republic of the Congo,62526,30697,31829
1990,800,Uganda,Democratic Republic of the Congo,65659,32113,33546
1990,834,United Republic of Tanzania,Democratic Republic of the Congo,19354,9212,10142
1990,894,Zambia,Democratic Republic of the Congo,27297,14121,13176
1990,24,Angola,Democratic Republic of the Congo,12178,6411,5767
1990,140,Central African Republic,Democratic Republic of the Congo,13173,7063,6110
1990,148,Chad,Democratic Republic of the Congo,98,53,45
1990,178,Congo,Democratic Republic of the Congo,67316,30736,36580
1990,266,Gabon,Democratic Republic of the Congo,2754,1483,1271
1990,72,Botswana,Democratic Republic of the Congo,526,281,245
1990,748,Eswatini,Democratic Republic of the Congo,6,4,2
1990,516,Namibia,Democratic Republic of the Congo,4707,2254,2453
1990,710,South Africa,Democratic Republic of the Congo,7456,3725,3731
1990,288,Ghana,Democratic Republic of the Congo,16,7,9
1990,478,Mauritania,Democratic Republic of the Congo,31,13,18
1990,768,Togo,Democratic Republic of the Congo,277,129,148
1990,818,Egypt,Democratic Republic of the Congo,99,62,37
1990,434,Libya,Democratic Republic of the Congo,283,177,106
1990,729,Sudan,Democratic Republic of the Congo,15855,8055,7800
1990,196,Cyprus,Democratic Republic of the Congo,170,81,89
1990,792,Turkey,Democratic Republic of the Congo,7,5,2
1990,608,Philippines,Democratic Republic of the Congo,1,1,0
1990,188,Costa Rica,Democratic Republic of the Congo,2,0,2
1990,484,Mexico,Democratic Republic of the Congo,12,12,0
1990,558,Nicaragua,Democratic Republic of the Congo,21,15,6
1990,68,Bolivia (Plurinational State of),Democratic Republic of the Congo,5,4,1
1990,152,Chile,Democratic Republic of the Congo,13,7,6
1990,36,Australia,Democratic Republic of the Congo,255,130,125
1990,100,Bulgaria,Democratic Republic of the Congo,3,2,1
1990,203,Czechia,Democratic Republic of the Congo,8,7,1
1990,348,Hungary,Democratic Republic of the Congo,11,7,4
1990,208,Denmark,Democratic Republic of the Congo,70,43,27
1990,246,Finland,Democratic Republic of the Congo,10,9,1
1990,352,Iceland,Democratic Republic of the Congo,1,1,0
1990,372,Ireland,Democratic Republic of the Congo,10,5,5
1990,578,Norway,Democratic Republic of the Congo,32,19,13
1990,752,Sweden,Democratic Republic of the Congo,784,441,343
1990,826,United Kingdom,Democratic Republic of the Congo,1195,748,447
1990,300,Greece,Democratic Republic of the Congo,657,406,251
1990,380,Italy,Democratic Republic of the Congo,205,71,134
1990,620,Portugal,Democratic Republic of the Congo,472,229,243
1990,724,Spain,Democratic Republic of the Congo,621,362,259
1990,40,Austria,Democratic Republic of the Congo,386,213,173
1990,56,Belgium,Democratic Republic of the Congo,45711,23531,22180
1990,250,France,Democratic Republic of the Congo,32512,16524,15988
1990,276,Germany,Democratic Republic of the Congo,4459,3275,1184
1990,442,Luxembourg,Democratic Republic of the Congo,94,44,50
1990,528,Netherlands,Democratic Republic of the Congo,2252,1351,901
1990,756,Switzerland,Democratic Republic of the Congo,805,467,338
1990,124,Canada,Democratic Republic of the Congo,1588,773,815
1990,840,United States of America,Democratic Republic of the Congo,3387,1657,1730
1995,108,Burundi,Democratic Republic of the Congo,41447,20152,21295
1995,232,Eritrea,Democratic Republic of the Congo,816,438,378
1995,231,Ethiopia,Democratic Republic of the Congo,63,37,26
1995,404,Kenya,Democratic Republic of the Congo,391,211,180
1995,454,Malawi,Democratic Republic of the Congo,2481,1321,1160
1995,508,Mozambique,Democratic Republic of the Congo,3185,1732,1453
1995,646,Rwanda,Democratic Republic of the Congo,89770,44038,45732
1995,800,Uganda,Democratic Republic of the Congo,73273,34931,38342
1995,834,United Republic of Tanzania,Democratic Republic of the Congo,21834,10698,11136
1995,894,Zambia,Democratic Republic of the Congo,31525,16328,15197
1995,24,Angola,Democratic Republic of the Congo,14957,7565,7392
1995,140,Central African Republic,Democratic Republic of the Congo,20510,10164,10346
1995,148,Chad,Democratic Republic of the Congo,200,108,92
1995,178,Congo,Democratic Republic of the Congo,110720,52653,58067
1995,266,Gabon,Democratic Republic of the Congo,3683,1983,1700
1995,72,Botswana,Democratic Republic of the Congo,849,439,410
1995,748,Eswatini,Democratic Republic of the Congo,180,107,73
1995,516,Namibia,Democratic Republic of the Congo,4501,2171,2330
1995,710,South Africa,Democratic Republic of the Congo,7488,3994,3494
1995,288,Ghana,Democratic Republic of the Congo,16,8,8
1995,478,Mauritania,Democratic Republic of the Congo,33,16,17
1995,686,Senegal,Democratic Republic of the Congo,29,13,16
1995,768,Togo,Democratic Republic of the Congo,312,146,166
1995,818,Egypt,Democratic Republic of the Congo,94,59,35
1995,434,Libya,Democratic Republic of the Congo,299,202,97
1995,729,Sudan,Democratic Republic of the Congo,13976,7153,6823
1995,196,Cyprus,Democratic Republic of the Congo,241,110,131
1995,792,Turkey,Democratic Republic of the Congo,17,13,4
1995,608,Philippines,Democratic Republic of the Congo,1,1,0
1995,188,Costa Rica,Democratic Republic of the Congo,2,0,2
1995,484,Mexico,Democratic Republic of the Congo,13,12,1
1995,558,Nicaragua,Democratic Republic of the Congo,17,12,5
1995,68,Bolivia (Plurinational State of),Democratic Republic of the Congo,3,2,1
1995,152,Chile,Democratic Republic of the Congo,12,10,2
1995,36,Australia,Democratic Republic of the Congo,291,144,147
1995,100,Bulgaria,Democratic Republic of the Congo,6,5,1
1995,203,Czechia,Democratic Republic of the Congo,12,10,2
1995,348,Hungary,Democratic Republic of the Congo,15,10,5
1995,208,Denmark,Democratic Republic of the Congo,120,71,49
1995,246,Finland,Democratic Republic of the Congo,144,95,49
1995,352,Iceland,Democratic Republic of the Congo,2,2,0
1995,372,Ireland,Democratic Republic of the Congo,27,12,15
1995,578,Norway,Democratic Republic of the Congo,27,19,8
1995,752,Sweden,Democratic Republic of the Congo,931,521,410
1995,826,United Kingdom,Democratic Republic of the Congo,4698,2460,2238
1995,300,Greece,Democratic Republic of the Congo,928,471,457
1995,380,Italy,Democratic Republic of the Congo,1118,506,612
1995,620,Portugal,Democratic Republic of the Congo,1018,493,525
1995,724,Spain,Democratic Republic of the Congo,950,573,377
1995,40,Austria,Democratic Republic of the Congo,436,244,192
1995,56,Belgium,Democratic Republic of the Congo,47249,25101,22148
1995,250,France,Democratic Republic of the Congo,33563,16780,16783
1995,276,Germany,Democratic Republic of the Congo,9428,5695,3733
1995,442,Luxembourg,Democratic Republic of the Congo,89,42,47
1995,528,Netherlands,Democratic Republic of the Congo,3316,1960,1356
1995,756,Switzerland,Democratic Republic of the Congo,2594,1431,1163
1995,124,Canada,Democratic Republic of the Congo,5693,2749,2944
1995,840,United States of America,Democratic Republic of the Congo,4243,2098,2145
2000,108,Burundi,Democratic Republic of the Congo,37951,18451,19500
2000,232,Eritrea,Democratic Republic of the Congo,1224,640,584
2000,231,Ethiopia,Democratic Republic of the Congo,90,57,33
2000,404,Kenya,Democratic Republic of the Congo,672,335,337
2000,454,Malawi,Democratic Republic of the Congo,2389,1269,1120
2000,508,Mozambique,Democratic Republic of the Congo,3705,1960,1745
2000,646,Rwanda,Democratic Republic of the Congo,163420,79600,83820
2000,800,Uganda,Democratic Republic of the Congo,84966,39672,45294
2000,834,United Republic of Tanzania,Democratic Republic of the Congo,112286,57136,55150
2000,894,Zambia,Democratic Republic of the Congo,58237,29971,28266
2000,24,Angola,Democratic Republic of the Congo,17735,8719,9016
2000,140,Central African Republic,Democratic Republic of the Congo,26065,12376,13689
2000,148,Chad,Democratic Republic of the Congo,301,162,139
2000,178,Congo,Democratic Republic of the Congo,183780,88538,95242
2000,266,Gabon,Democratic Republic of the Congo,4607,2494,2113
2000,72,Botswana,Democratic Republic of the Congo,1261,642,619
2000,748,Eswatini,Democratic Republic of the Congo,193,99,94
2000,516,Namibia,Democratic Republic of the Congo,4179,2025,2154
2000,710,South Africa,Democratic Republic of the Congo,8332,4889,3443
2000,288,Ghana,Democratic Republic of the Congo,18,8,10
2000,478,Mauritania,Democratic Republic of the Congo,42,27,15
2000,686,Senegal,Democratic Republic of the Congo,104,46,58
2000,768,Togo,Democratic Republic of the Congo,351,164,187
2000,818,Egypt,Democratic Republic of the Congo,96,61,35
2000,434,Libya,Democratic Republic of the Congo,320,231,89
2000,729,Sudan,Democratic Republic of the Congo,12378,6389,5989
2000,196,Cyprus,Democratic Republic of the Congo,311,138,173
2000,792,Turkey,Democratic Republic of the Congo,28,20,8
2000,608,Philippines,Democratic Republic of the Congo,2,1,1
2000,764,Thailand,Democratic Republic of the Congo,2,1,1
2000,188,Costa Rica,Democratic Republic of the Congo,2,0,2
2000,484,Mexico,Democratic Republic of the Congo,15,12,3
2000,558,Nicaragua,Democratic Republic of the Congo,29,20,9
2000,68,Bolivia (Plurinational State of),Democratic Republic of the Congo,1,1,0
2000,152,Chile,Democratic Republic of the Congo,12,9,3
2000,36,Australia,Democratic Republic of the Congo,310,154,156
2000,100,Bulgaria,Democratic Republic of the Congo,8,7,1
2000,203,Czechia,Democratic Republic of the Congo,16,13,3
2000,348,Hungary,Democratic Republic of the Congo,18,12,6
2000,208,Denmark,Democratic Republic of the Congo,169,98,71
2000,246,Finland,Democratic Republic of the Congo,277,180,97
2000,352,Iceland,Democratic Republic of the Congo,2,2,0
2000,372,Ireland,Democratic Republic of the Congo,60,27,33
2000,578,Norway,Democratic Republic of the Congo,34,21,13
2000,752,Sweden,Democratic Republic of the Congo,999,556,443
2000,826,United Kingdom,Democratic Republic of the Congo,8280,4206,4074
2000,300,Greece,Democratic Republic of the Congo,1215,536,679
2000,380,Italy,Democratic Republic of the Congo,2031,941,1090
2000,620,Portugal,Democratic Republic of the Congo,1607,779,828
2000,705,Slovenia,Democratic Republic of the Congo,1,1,0
2000,724,Spain,Democratic Republic of the Congo,1688,1039,649
2000,40,Austria,Democratic Republic of the Congo,485,275,210
2000,56,Belgium,Democratic Republic of the Congo,46718,23993,22725
2000,250,France,Democratic Republic of the Congo,34614,17037,17577
2000,276,Germany,Democratic Republic of the Congo,14396,8115,6281
2000,442,Luxembourg,Democratic Republic of the Congo,85,39,46
2000,528,Netherlands,Democratic Republic of the Congo,4492,2629,1863
2000,756,Switzerland,Democratic Republic of the Congo,4393,2403,1990
2000,124,Canada,Democratic Republic of the Congo,9934,4792,5142
2000,840,United States of America,Democratic Republic of the Congo,5115,2549,2566
2005,108,Burundi,Democratic Republic of the Congo,84099,42404,41695
2005,232,Eritrea,Democratic Republic of the Congo,1442,769,673
2005,231,Ethiopia,Democratic Republic of the Congo,75,43,32
2005,404,Kenya,Democratic Republic of the Congo,2749,1448,1301
2005,454,Malawi,Democratic Republic of the Congo,2277,1206,1071
2005,508,Mozambique,Democratic Republic of the Congo,5012,2432,2580
2005,646,Rwanda,Democratic Republic of the Congo,197717,95331,102386
2005,800,Uganda,Democratic Republic of the Congo,93208,43223,49985
2005,834,United Republic of Tanzania,Democratic Republic of the Congo,150345,102486,47859
2005,894,Zambia,Democratic Republic of the Congo,73742,37795,35947
2005,24,Angola,Democratic Republic of the Congo,24340,11634,12706
2005,120,Cameroon,Democratic Republic of the Congo,4102,2138,1964
2005,140,Central African Republic,Democratic Republic of the Congo,19930,9476,10454
2005,148,Chad,Democratic Republic of the Congo,209,95,114
2005,178,Congo,Democratic Republic of the Congo,230684,123139,107545
2005,266,Gabon,Democratic Republic of the Congo,5023,2743,2280
2005,72,Botswana,Democratic Republic of the Congo,1903,956,947
2005,748,Eswatini,Democratic Republic of the Congo,246,120,126
2005,516,Namibia,Democratic Republic of the Congo,3522,1711,1811
2005,710,South Africa,Democratic Republic of the Congo,16849,6833,10016
2005,288,Ghana,Democratic Republic of the Congo,25,12,13
2005,478,Mauritania,Democratic Republic of the Congo,64,38,26
2005,686,Senegal,Democratic Republic of the Congo,254,114,140
2005,694,Sierra Leone,Democratic Republic of the Congo,8,5,3
2005,768,Togo,Democratic Republic of the Congo,515,236,279
2005,818,Egypt,Democratic Republic of the Congo,114,75,39
2005,434,Libya,Democratic Republic of the Congo,352,273,79
2005,729,Sudan,Democratic Republic of the Congo,13625,6987,6638
2005,196,Cyprus,Democratic Republic of the Congo,455,200,255
2005,792,Turkey,Democratic Republic of the Congo,30,22,8
2005,608,Philippines,Democratic Republic of the Congo,1,1,0
2005,764,Thailand,Democratic Republic of the Congo,8,5,3
2005,188,Costa Rica,Democratic Republic of the Congo,1,0,1
2005,484,Mexico,Democratic Republic of the Congo,43,30,13
2005,558,Nicaragua,Democratic Republic of the Congo,42,28,14
2005,68,Bolivia (Plurinational State of),Democratic Republic of the Congo,2,1,1
2005,76,Brazil,Democratic Republic of the Congo,48,35,13
2005,152,Chile,Democratic Republic of the Congo,18,14,4
2005,36,Australia,Democratic Republic of the Congo,360,172,188
2005,100,Bulgaria,Democratic Republic of the Congo,11,9,2
2005,203,Czechia,Democratic Republic of the Congo,37,27,10
2005,348,Hungary,Democratic Republic of the Congo,22,15,7
2005,208,Denmark,Democratic Republic of the Congo,395,208,187
2005,246,Finland,Democratic Republic of the Congo,684,373,311
2005,352,Iceland,Democratic Republic of the Congo,2,2,0
2005,372,Ireland,Democratic Republic of the Congo,60,29,31
2005,578,Norway,Democratic Republic of the Congo,145,83,62
2005,752,Sweden,Democratic Republic of the Congo,1360,731,629
2005,826,United Kingdom,Democratic Republic of the Congo,12947,5998,6949
2005,300,Greece,Democratic Republic of the Congo,715,318,397
2005,380,Italy,Democratic Republic of the Congo,4059,1980,2079
2005,620,Portugal,Democratic Republic of the Congo,1750,1009,741
2005,705,Slovenia,Democratic Republic of the Congo,2,2,0
2005,724,Spain,Democratic Republic of the Congo,1194,757,437
2005,40,Austria,Democratic Republic of the Congo,542,301,241
2005,56,Belgium,Democratic Republic of the Congo,61060,30015,31045
2005,250,France,Democratic Republic of the Congo,49330,23628,25702
2005,276,Germany,Democratic Republic of the Congo,10422,5767,4655
2005,442,Luxembourg,Democratic Republic of the Congo,74,37,37
2005,528,Netherlands,Democratic Republic of the Congo,5681,3051,2630
2005,756,Switzerland,Democratic Republic of the Congo,5070,2648,2422
2005,124,Canada,Democratic Republic of the Congo,14201,6747,7454
2005,840,United States of America,Democratic Republic of the Congo,12195,6112,6083
2010,108,Burundi,Democratic Republic of the Congo,137611,70011,67600
2010,232,Eritrea,Democratic Republic of the Congo,1659,899,760
2010,231,Ethiopia,Democratic Republic of the Congo,683,343,340
2010,404,Kenya,Democratic Republic of the Congo,9133,4491,4642
2010,454,Malawi,Democratic Republic of the Congo,2237,1183,1054
2010,508,Mozambique,Democratic Republic of the Congo,5804,2816,2988
2010,646,Rwanda,Democratic Republic of the Congo,207397,100320,107077
2010,728,South Sudan,Democratic Republic of the Congo,67795,36414,31381
2010,800,Uganda,Democratic Republic of the Congo,159519,76985,82534
2010,834,United Republic of Tanzania,Democratic Republic of the Congo,62386,30474,31912
2010,894,Zambia,Democratic Republic of the Congo,20933,10588,10345
2010,24,Angola,Democratic Republic of the Congo,30944,14549,16395
2010,120,Cameroon,Democratic Republic of the Congo,3265,1772,1493
2010,140,Central African Republic,Democratic Republic of the Congo,19723,9385,10338
2010,148,Chad,Democratic Republic of the Congo,247,111,136
2010,178,Congo,Democratic Republic of the Congo,252142,128758,123384
2010,266,Gabon,Democratic Republic of the Congo,5818,3228,2590
2010,72,Botswana,Democratic Republic of the Congo,970,580,390
2010,748,Eswatini,Democratic Republic of the Congo,267,124,143
2010,516,Namibia,Democratic Republic of the Congo,3548,1729,1820
2010,710,South Africa,Democratic Republic of the Congo,26394,10645,15749
2010,288,Ghana,Democratic Republic of the Congo,25,13,12
2010,466,Mali,Democratic Republic of the Congo,1826,897,929
2010,478,Mauritania,Democratic Republic of the Congo,137,82,55
2010,686,Senegal,Democratic Republic of the Congo,238,123,115
2010,768,Togo,Democratic Republic of the Congo,589,291,298
2010,818,Egypt,Democratic Republic of the Congo,123,79,44
2010,434,Libya,Democratic Republic of the Congo,385,300,85
2010,729,Sudan,Democratic Republic of the Congo,24549,12430,12119
2010,196,Cyprus,Democratic Republic of the Congo,745,333,412
2010,792,Turkey,Democratic Republic of the Congo,40,27,13
2010,608,Philippines,Democratic Republic of the Congo,32,16,16
2010,764,Thailand,Democratic Republic of the Congo,15,8,7
2010,188,Costa Rica,Democratic Republic of the Congo,3,0,3
2010,484,Mexico,Democratic Republic of the Congo,78,53,25
2010,558,Nicaragua,Democratic Republic of the Congo,44,30,14
2010,68,Bolivia (Plurinational State of),Democratic Republic of the Congo,3,1,2
2010,76,Brazil,Democratic Republic of the Congo,96,70,26
2010,152,Chile,Democratic Republic of the Congo,24,19,5
2010,36,Australia,Democratic Republic of the Congo,2470,1242,1228
2010,100,Bulgaria,Democratic Republic of the Congo,14,12,2
2010,203,Czechia,Democratic Republic of the Congo,54,38,16
2010,348,Hungary,Democratic Republic of the Congo,26,18,8
2010,208,Denmark,Democratic Republic of the Congo,610,313,297
2010,233,Estonia,Democratic Republic of the Congo,2,2,0
2010,246,Finland,Democratic Republic of the Congo,1188,574,614
2010,352,Iceland,Democratic Republic of the Congo,2,2,0
2010,372,Ireland,Democratic Republic of the Congo,51,24,27
2010,578,Norway,Democratic Republic of the Congo,147,76,71
2010,752,Sweden,Democratic Republic of the Congo,2246,1148,1098
2010,826,United Kingdom,Democratic Republic of the Congo,13639,6469,7170
2010,300,Greece,Democratic Republic of the Congo,222,103,119
2010,380,Italy,Democratic Republic of the Congo,6198,3092,3106
2010,620,Portugal,Democratic Republic of the Congo,1603,1072,531
2010,705,Slovenia,Democratic Republic of the Congo,2,2,0
2010,724,Spain,Democratic Republic of the Congo,1614,1009,605
2010,40,Austria,Democratic Republic of the Congo,599,328,271
2010,56,Belgium,Democratic Republic of the Congo,76187,35615,40572
2010,250,France,Democratic Republic of the Congo,72046,33608,38438
2010,276,Germany,Democratic Republic of the Congo,7060,3719,3341
2010,442,Luxembourg,Democratic Republic of the Congo,64,35,29
2010,528,Netherlands,Democratic Republic of the Congo,5018,2572,2446
2010,756,Switzerland,Democratic Republic of the Congo,5805,2883,2922
2010,124,Canada,Democratic Republic of the Congo,18445,8714,9731
2010,840,United States of America,Democratic Republic of the Congo,19833,9804,10029
2015,108,Burundi,Democratic Republic of the Congo,167768,85415,82353
2015,232,Eritrea,Democratic Republic of the Congo,1688,924,764
2015,231,Ethiopia,Democratic Republic of the Congo,1582,799,783
2015,404,Kenya,Democratic Republic of the Congo,24738,12369,12369
2015,454,Malawi,Democratic Republic of the Congo,2210,1169,1041
2015,508,Mozambique,Democratic Republic of the Congo,10094,4879,5215
2015,646,Rwanda,Democratic Republic of the Congo,233744,112178,121566
2015,728,South Sudan,Democratic Republic of the Congo,87755,48538,39217
2015,800,Uganda,Democratic Republic of the Congo,286214,138217,147997
2015,834,United Republic of Tanzania,Democratic Republic of the Congo,59508,28415,31093
2015,894,Zambia,Democratic Republic of the Congo,26440,13374,13066
2015,24,Angola,Democratic Republic of the Congo,77548,37464,40084
2015,120,Cameroon,Democratic Republic of the Congo,4170,2006,2164
2015,140,Central African Republic,Democratic Republic of the Congo,17219,8131,9088
2015,148,Chad,Democratic Republic of the Congo,306,141,165
2015,178,Congo,Democratic Republic of the Congo,170368,87000,83368
2015,266,Gabon,Democratic Republic of the Congo,8135,5019,3116
2015,72,Botswana,Democratic Republic of the Congo,1058,632,426
2015,748,Eswatini,Democratic Republic of the Congo,570,282,288
2015,516,Namibia,Democratic Republic of the Congo,3472,1696,1776
2015,710,South Africa,Democratic Republic of the Congo,47609,17755,29854
2015,288,Ghana,Democratic Republic of the Congo,30,16,14
2015,324,Guinea,Democratic Republic of the Congo,77,49,28
2015,466,Mali,Democratic Republic of the Congo,2262,1112,1150
2015,478,Mauritania,Democratic Republic of the Congo,90,55,35
2015,686,Senegal,Democratic Republic of the Congo,295,152,143
2015,768,Togo,Democratic Republic of the Congo,651,320,331
2015,818,Egypt,Democratic Republic of the Congo,91,63,28
2015,434,Libya,Democratic Republic of the Congo,434,337,97
2015,729,Sudan,Democratic Republic of the Congo,7445,4549,2896
2015,196,Cyprus,Democratic Republic of the Congo,715,322,393
2015,792,Turkey,Democratic Republic of the Congo,73,46,27
2015,608,Philippines,Democratic Republic of the Congo,32,15,17
2015,764,Thailand,Democratic Republic of the Congo,16,9,7
2015,188,Costa Rica,Democratic Republic of the Congo,3,0,3
2015,484,Mexico,Democratic Republic of the Congo,82,56,26
2015,558,Nicaragua,Democratic Republic of the Congo,47,32,15
2015,68,Bolivia (Plurinational State of),Democratic Republic of the Congo,3,1,2
2015,76,Brazil,Democratic Republic of the Congo,116,85,31
2015,152,Chile,Democratic Republic of the Congo,36,29,7
2015,36,Australia,Democratic Republic of the Congo,4270,2150,2120
2015,100,Bulgaria,Democratic Republic of the Congo,14,12,2
2015,203,Czechia,Democratic Republic of the Congo,88,53,35
2015,348,Hungary,Democratic Republic of the Congo,38,28,10
2015,208,Denmark,Democratic Republic of the Congo,1031,538,493
2015,233,Estonia,Democratic Republic of the Congo,3,3,0
2015,246,Finland,Democratic Republic of the Congo,1893,824,1069
2015,352,Iceland,Democratic Republic of the Congo,2,2,0
2015,372,Ireland,Democratic Republic of the Congo,52,24,28
2015,578,Norway,Democratic Republic of the Congo,2210,1100,1110
2015,752,Sweden,Democratic Republic of the Congo,3381,1689,1692
2015,826,United Kingdom,Democratic Republic of the Congo,17442,8001,9441
2015,300,Greece,Democratic Republic of the Congo,208,92,116
2015,380,Italy,Democratic Republic of the Congo,6010,2901,3109
2015,620,Portugal,Democratic Republic of the Congo,1816,1183,633
2015,705,Slovenia,Democratic Republic of the Congo,6,3,3
2015,724,Spain,Democratic Republic of the Congo,1468,876,592
2015,40,Austria,Democratic Republic of the Congo,700,384,316
2015,56,Belgium,Democratic Republic of the Congo,83629,38440,45189
2015,250,France,Democratic Republic of the Congo,79812,36059,43753
2015,276,Germany,Democratic Republic of the Congo,7356,3867,3489
2015,442,Luxembourg,Democratic Republic of the Congo,97,54,43
2015,528,Netherlands,Democratic Republic of the Congo,5122,2574,2548
2015,756,Switzerland,Democratic Republic of the Congo,6836,3250,3586
2015,124,Canada,Democratic Republic of the Congo,25492,12134,13358
2015,840,United States of America,Democratic Republic of the Congo,25560,12571,12989
2019,108,Burundi,Democratic Republic of the Congo,185833,94611,91222
2019,232,Eritrea,Democratic Republic of the Congo,1704,933,771
2019,231,Ethiopia,Democratic Republic of the Congo,1706,862,844
2019,404,Kenya,Democratic Republic of the Congo,22937,11477,11460
2019,454,Malawi,Democratic Republic of the Congo,9406,4576,4830
2019,508,Mozambique,Democratic Republic of the Congo,11497,5557,5940
2019,646,Rwanda,Democratic Republic of the Congo,248670,121602,127068
2019,728,South Sudan,Democratic Republic of the Congo,89982,49750,40232
2019,800,Uganda,Democratic Republic of the Congo,315753,149712,166041
2019,834,United Republic of Tanzania,Democratic Republic of the Congo,79456,37787,41669
2019,894,Zambia,Democratic Republic of the Congo,44073,22494,21579
2019,24,Angola,Democratic Republic of the Congo,92242,55346,36896
2019,120,Cameroon,Democratic Republic of the Congo,4148,1997,2151
2019,140,Central African Republic,Democratic Republic of the Congo,19128,9045,10083
2019,148,Chad,Democratic Republic of the Congo,335,154,181
2019,178,Congo,Democratic Republic of the Congo,175608,89629,85979
2019,266,Gabon,Democratic Republic of the Congo,8838,5450,3388
2019,72,Botswana,Democratic Republic of the Congo,1133,677,456
2019,748,Eswatini,Democratic Republic of the Congo,664,326,338
2019,516,Namibia,Democratic Republic of the Congo,3675,1796,1879
2019,710,South Africa,Democratic Republic of the Congo,53363,19933,33430
2019,288,Ghana,Democratic Republic of the Congo,33,18,15
2019,324,Guinea,Democratic Republic of the Congo,73,47,26
2019,466,Mali,Democratic Republic of the Congo,2518,1238,1280
2019,478,Mauritania,Democratic Republic of the Congo,93,57,36
2019,686,Senegal,Democratic Republic of the Congo,366,189,177
2019,768,Togo,Democratic Republic of the Congo,655,324,331
2019,818,Egypt,Democratic Republic of the Congo,129,85,44
2019,434,Libya,Democratic Republic of the Congo,460,358,102
2019,729,Sudan,Democratic Republic of the Congo,9181,5555,3626
2019,196,Cyprus,Democratic Republic of the Congo,714,326,388
2019,792,Turkey,Democratic Republic of the Congo,98,62,36
2019,608,Philippines,Democratic Republic of the Congo,33,16,17
2019,764,Thailand,Democratic Republic of the Congo,16,9,7
2019,188,Costa Rica,Democratic Republic of the Congo,3,0,3
2019,484,Mexico,Democratic Republic of the Congo,84,58,26
2019,558,Nicaragua,Democratic Republic of the Congo,49,34,15
2019,68,Bolivia (Plurinational State of),Democratic Republic of the Congo,3,1,2
2019,76,Brazil,Democratic Republic of the Congo,130,96,34
2019,152,Chile,Democratic Republic of the Congo,48,39,9
2019,36,Australia,Democratic Republic of the Congo,5438,2783,2655
2019,100,Bulgaria,Democratic Republic of the Congo,16,14,2
2019,203,Czechia,Democratic Republic of the Congo,95,59,36
2019,348,Hungary,Democratic Republic of the Congo,49,33,16
2019,208,Denmark,Democratic Republic of the Congo,1813,914,899
2019,233,Estonia,Democratic Republic of the Congo,8,8,0
2019,246,Finland,Democratic Republic of the Congo,2439,1078,1361
2019,352,Iceland,Democratic Republic of the Congo,2,2,0
2019,372,Ireland,Democratic Republic of the Congo,57,27,30
2019,578,Norway,Democratic Republic of the Congo,2526,1254,1272
2019,752,Sweden,Democratic Republic of the Congo,5354,2622,2732
2019,826,United Kingdom,Democratic Republic of the Congo,19807,9113,10694
2019,300,Greece,Democratic Republic of the Congo,1101,538,563
2019,380,Italy,Democratic Republic of the Congo,6821,3341,3480
2019,620,Portugal,Democratic Republic of the Congo,1846,1204,642
2019,705,Slovenia,Democratic Republic of the Congo,13,9,4
2019,724,Spain,Democratic Republic of the Congo,1521,893,628
2019,40,Austria,Democratic Republic of the Congo,826,460,366
2019,56,Belgium,Democratic Republic of the Congo,89101,41059,48042
2019,250,France,Democratic Republic of the Congo,84481,38063,46418
2019,276,Germany,Democratic Republic of the Congo,8069,4286,3783
2019,442,Luxembourg,Democratic Republic of the Congo,989,502,487
2019,528,Netherlands,Democratic Republic of the Congo,5280,2641,2639
2019,756,Switzerland,Democratic Republic of the Congo,7308,3473,3835
2019,124,Canada,Democratic Republic of the Congo,27317,13003,14314
2019,840,United States of America,Democratic Republic of the Congo,27601,13424,14177
1990,800,Uganda,Denmark,170,93,77
1990,140,Central African Republic,Denmark,1,1,0
1990,72,Botswana,Denmark,102,55,47
1990,516,Namibia,Denmark,168,113,55
1990,710,South Africa,Denmark,977,310,667
1990,818,Egypt,Denmark,279,140,139
1990,434,Libya,Denmark,796,400,396
1990,196,Cyprus,Denmark,42,19,23
1990,376,Israel,Denmark,1040,411,629
1990,400,Jordan,Denmark,49,23,26
1990,792,Turkey,Denmark,814,415,399
1990,762,Tajikistan,Denmark,199,88,111
1990,64,Bhutan,Denmark,18,12,6
1990,392,Japan,Denmark,450,229,221
1990,608,Philippines,Denmark,182,119,63
1990,764,Thailand,Denmark,429,329,100
1990,44,Bahamas,Denmark,8,5,3
1990,136,Cayman Islands,Denmark,5,4,1
1990,214,Dominican Republic,Denmark,70,59,11
1990,188,Costa Rica,Denmark,48,29,19
1990,484,Mexico,Denmark,255,151,104
1990,558,Nicaragua,Denmark,55,35,20
1990,591,Panama,Denmark,19,12,7
1990,32,Argentina,Denmark,540,246,294
1990,68,Bolivia (Plurinational State of),Denmark,21,12,9
1990,76,Brazil,Denmark,525,261,264
1990,152,Chile,Denmark,170,85,85
1990,170,Colombia,Denmark,77,47,30
1990,218,Ecuador,Denmark,61,42,19
1990,604,Peru,Denmark,150,83,67
1990,862,Venezuela (Bolivarian Republic of),Denmark,128,82,46
1990,36,Australia,Denmark,9739,5525,4214
1990,554,New Zealand,Denmark,781,427,354
1990,112,Belarus,Denmark,130,86,44
1990,100,Bulgaria,Denmark,10,7,3
1990,203,Czechia,Denmark,32,20,12
1990,348,Hungary,Denmark,42,18,24
1990,616,Poland,Denmark,998,429,569
1990,642,Romania,Denmark,51,20,31
1990,643,Russian Federation,Denmark,2445,1200,1245
1990,703,Slovakia,Denmark,6,4,2
1990,233,Estonia,Denmark,25,17,8
1990,234,Faroe Islands,Denmark,3173,1852,1321
1990,246,Finland,Denmark,559,317,242
1990,352,Iceland,Denmark,2048,887,1161
1990,372,Ireland,Denmark,394,217,177
1990,428,Latvia,Denmark,35,14,21
1990,440,Lithuania,Denmark,100,72,28
1990,578,Norway,Denmark,21160,9996,11164
1990,752,Sweden,Denmark,30009,15748,14261
1990,826,United Kingdom,Denmark,13911,5033,8878
1990,20,Andorra,Denmark,84,45,39
1990,191,Croatia,Denmark,44,16,28
1990,300,Greece,Denmark,1836,478,1358
1990,380,Italy,Denmark,4729,1142,3587
1990,470,Malta,Denmark,12,6,6
1990,620,Portugal,Denmark,276,138,138
1990,688,Serbia,Denmark,11,6,5
1990,705,Slovenia,Denmark,14,7,7
1990,724,Spain,Denmark,3729,1674,2055
1990,40,Austria,Denmark,782,338,444
1990,56,Belgium,Denmark,2030,939,1091
1990,250,France,Denmark,6772,2570,4202
1990,276,Germany,Denmark,16667,6712,9955
1990,438,Liechtenstein,Denmark,16,12,4
1990,442,Luxembourg,Denmark,1263,590,673
1990,528,Netherlands,Denmark,2095,834,1261
1990,756,Switzerland,Denmark,3655,1402,2253
1990,60,Bermuda,Denmark,23,15,8
1990,124,Canada,Denmark,20678,10066,10612
1990,304,Greenland,Denmark,8550,5930,2620
1990,840,United States of America,Denmark,34999,12921,22078
1995,800,Uganda,Denmark,161,86,75
1995,140,Central African Republic,Denmark,2,1,1
1995,72,Botswana,Denmark,98,52,46
1995,516,Namibia,Denmark,160,108,52
1995,710,South Africa,Denmark,886,393,493
1995,818,Egypt,Denmark,240,119,121
1995,434,Libya,Denmark,675,366,309
1995,196,Cyprus,Denmark,60,26,34
1995,376,Israel,Denmark,1261,466,795
1995,400,Jordan,Denmark,56,29,27
1995,792,Turkey,Denmark,1970,964,1006
1995,762,Tajikistan,Denmark,161,92,69
1995,64,Bhutan,Denmark,21,14,7
1995,392,Japan,Denmark,577,277,300
1995,608,Philippines,Denmark,244,158,86
1995,764,Thailand,Denmark,392,294,98
1995,44,Bahamas,Denmark,22,12,10
1995,136,Cayman Islands,Denmark,11,7,4
1995,214,Dominican Republic,Denmark,78,65,13
1995,188,Costa Rica,Denmark,39,24,15
1995,484,Mexico,Denmark,298,167,131
1995,558,Nicaragua,Denmark,44,28,16
1995,591,Panama,Denmark,28,19,9
1995,32,Argentina,Denmark,527,243,284
1995,68,Bolivia (Plurinational State of),Denmark,55,29,26
1995,76,Brazil,Denmark,489,286,203
1995,152,Chile,Denmark,199,101,98
1995,170,Colombia,Denmark,77,46,31
1995,218,Ecuador,Denmark,69,47,22
1995,604,Peru,Denmark,151,83,68
1995,862,Venezuela (Bolivarian Republic of),Denmark,126,81,45
1995,36,Australia,Denmark,10006,5595,4411
1995,554,New Zealand,Denmark,962,506,456
1995,112,Belarus,Denmark,168,104,64
1995,100,Bulgaria,Denmark,21,15,6
1995,203,Czechia,Denmark,48,30,18
1995,348,Hungary,Denmark,146,81,65
1995,616,Poland,Denmark,853,360,493
1995,642,Romania,Denmark,52,25,27
1995,643,Russian Federation,Denmark,2546,1257,1289
1995,703,Slovakia,Denmark,72,46,26
1995,233,Estonia,Denmark,39,26,13
1995,234,Faroe Islands,Denmark,2071,1170,901
1995,246,Finland,Denmark,577,337,240
1995,352,Iceland,Denmark,2175,964,1211
1995,372,Ireland,Denmark,359,192,167
1995,428,Latvia,Denmark,93,67,26
1995,440,Lithuania,Denmark,112,81,31
1995,578,Norway,Denmark,21161,9869,11292
1995,752,Sweden,Denmark,35611,18558,17053
1995,826,United Kingdom,Denmark,15833,5916,9917
1995,20,Andorra,Denmark,111,58,53
1995,191,Croatia,Denmark,38,15,23
1995,300,Greece,Denmark,1314,365,949
1995,380,Italy,Denmark,3670,927,2743
1995,470,Malta,Denmark,15,8,7
1995,620,Portugal,Denmark,315,156,159
1995,688,Serbia,Denmark,91,47,44
1995,705,Slovenia,Denmark,19,9,10
1995,724,Spain,Denmark,4479,2069,2410
1995,40,Austria,Denmark,882,389,493
1995,56,Belgium,Denmark,2442,1144,1298
1995,250,France,Denmark,6991,2580,4411
1995,276,Germany,Denmark,18466,7531,10935
1995,438,Liechtenstein,Denmark,19,15,4
1995,442,Luxembourg,Denmark,1438,683,755
1995,528,Netherlands,Denmark,2527,975,1552
1995,756,Switzerland,Denmark,3830,1656,2174
1995,60,Bermuda,Denmark,26,16,10
1995,124,Canada,Denmark,19098,9257,9841
1995,304,Greenland,Denmark,6476,4434,2042
1995,840,United States of America,Denmark,33654,12592,21062
2000,800,Uganda,Denmark,160,80,80
2000,140,Central African Republic,Denmark,3,1,2
2000,72,Botswana,Denmark,104,55,49
2000,516,Namibia,Denmark,150,100,50
2000,710,South Africa,Denmark,1062,574,488
2000,818,Egypt,Denmark,221,109,112
2000,434,Libya,Denmark,567,347,220
2000,196,Cyprus,Denmark,77,32,45
2000,376,Israel,Denmark,1411,503,908
2000,400,Jordan,Denmark,62,34,28
2000,792,Turkey,Denmark,3135,1515,1620
2000,762,Tajikistan,Denmark,139,83,56
2000,64,Bhutan,Denmark,24,16,8
2000,392,Japan,Denmark,542,250,292
2000,608,Philippines,Denmark,846,388,458
2000,764,Thailand,Denmark,437,318,119
2000,44,Bahamas,Denmark,37,21,16
2000,136,Cayman Islands,Denmark,19,12,7
2000,214,Dominican Republic,Denmark,85,71,14
2000,188,Costa Rica,Denmark,49,29,20
2000,484,Mexico,Denmark,355,191,164
2000,558,Nicaragua,Denmark,44,29,15
2000,591,Panama,Denmark,40,27,13
2000,32,Argentina,Denmark,514,240,274
2000,68,Bolivia (Plurinational State of),Denmark,88,45,43
2000,76,Brazil,Denmark,453,312,141
2000,152,Chile,Denmark,228,115,113
2000,170,Colombia,Denmark,77,45,32
2000,218,Ecuador,Denmark,76,52,24
2000,604,Peru,Denmark,177,88,89
2000,862,Venezuela (Bolivarian Republic of),Denmark,124,79,45
2000,36,Australia,Denmark,9920,5403,4517
2000,554,New Zealand,Denmark,1395,679,716
2000,112,Belarus,Denmark,206,122,84
2000,100,Bulgaria,Denmark,31,22,9
2000,203,Czechia,Denmark,64,40,24
2000,348,Hungary,Denmark,249,144,105
2000,616,Poland,Denmark,729,301,428
2000,642,Romania,Denmark,53,30,23
2000,643,Russian Federation,Denmark,2556,1270,1286
2000,703,Slovakia,Denmark,158,99,59
2000,233,Estonia,Denmark,52,35,17
2000,234,Faroe Islands,Denmark,2528,1384,1144
2000,246,Finland,Denmark,595,358,237
2000,352,Iceland,Denmark,2302,1041,1261
2000,372,Ireland,Denmark,522,287,235
2000,428,Latvia,Denmark,151,119,32
2000,440,Lithuania,Denmark,87,63,24
2000,578,Norway,Denmark,21713,10409,11304
2000,752,Sweden,Denmark,38190,19783,18407
2000,826,United Kingdom,Denmark,18023,6873,11150
2000,20,Andorra,Denmark,138,72,66
2000,191,Croatia,Denmark,27,12,15
2000,300,Greece,Denmark,813,240,573
2000,380,Italy,Denmark,2610,712,1898
2000,470,Malta,Denmark,37,20,17
2000,620,Portugal,Denmark,368,181,187
2000,688,Serbia,Denmark,155,77,78
2000,705,Slovenia,Denmark,32,15,17
2000,724,Spain,Denmark,7156,3418,3738
2000,40,Austria,Denmark,982,441,541
2000,56,Belgium,Denmark,2783,1320,1463
2000,250,France,Denmark,7210,2590,4620
2000,276,Germany,Denmark,20265,8351,11914
2000,438,Liechtenstein,Denmark,22,18,4
2000,442,Luxembourg,Denmark,1630,785,845
2000,528,Netherlands,Denmark,3048,1147,1901
2000,756,Switzerland,Denmark,4020,1923,2097
2000,60,Bermuda,Denmark,28,16,12
2000,124,Canada,Denmark,17972,8670,9302
2000,304,Greenland,Denmark,5726,4025,1701
2000,840,United States of America,Denmark,32219,12252,19967
2005,800,Uganda,Denmark,154,76,78
2005,140,Central African Republic,Denmark,2,0,2
2005,72,Botswana,Denmark,200,104,96
2005,516,Namibia,Denmark,118,79,39
2005,710,South Africa,Denmark,1397,727,670
2005,818,Egypt,Denmark,263,138,125
2005,434,Libya,Denmark,624,426,198
2005,196,Cyprus,Denmark,112,46,66
2005,376,Israel,Denmark,1625,552,1073
2005,400,Jordan,Denmark,88,53,35
2005,792,Turkey,Denmark,3230,1523,1707
2005,762,Tajikistan,Denmark,134,81,53
2005,64,Bhutan,Denmark,30,20,10
2005,392,Japan,Denmark,471,215,256
2005,608,Philippines,Denmark,684,320,364
2005,764,Thailand,Denmark,497,354,143
2005,44,Bahamas,Denmark,26,14,12
2005,136,Cayman Islands,Denmark,18,12,6
2005,214,Dominican Republic,Denmark,55,43,12
2005,188,Costa Rica,Denmark,32,18,14
2005,484,Mexico,Denmark,286,159,127
2005,558,Nicaragua,Denmark,46,30,16
2005,591,Panama,Denmark,81,62,19
2005,32,Argentina,Denmark,379,179,200
2005,68,Bolivia (Plurinational State of),Denmark,90,42,48
2005,76,Brazil,Denmark,474,324,150
2005,152,Chile,Denmark,342,176,166
2005,170,Colombia,Denmark,75,43,32
2005,218,Ecuador,Denmark,90,63,27
2005,604,Peru,Denmark,208,114,94
2005,862,Venezuela (Bolivarian Republic of),Denmark,129,82,47
2005,36,Australia,Denmark,10480,5597,4883
2005,554,New Zealand,Denmark,1425,692,733
2005,112,Belarus,Denmark,198,117,81
2005,100,Bulgaria,Denmark,46,33,13
2005,203,Czechia,Denmark,172,127,45
2005,348,Hungary,Denmark,307,180,127
2005,616,Poland,Denmark,814,387,427
2005,642,Romania,Denmark,67,36,31
2005,643,Russian Federation,Denmark,1405,704,701
2005,703,Slovakia,Denmark,178,112,66
2005,233,Estonia,Denmark,94,67,27
2005,234,Faroe Islands,Denmark,3137,1728,1409
2005,246,Finland,Denmark,750,453,297
2005,352,Iceland,Denmark,2637,1245,1392
2005,372,Ireland,Denmark,807,402,405
2005,428,Latvia,Denmark,222,177,45
2005,440,Lithuania,Denmark,236,152,84
2005,578,Norway,Denmark,22182,11042,11140
2005,752,Sweden,Denmark,42602,22658,19944
2005,826,United Kingdom,Denmark,19339,7684,11655
2005,20,Andorra,Denmark,140,73,67
2005,191,Croatia,Denmark,64,31,33
2005,300,Greece,Denmark,867,277,590
2005,380,Italy,Denmark,2924,903,2021
2005,470,Malta,Denmark,60,31,29
2005,620,Portugal,Denmark,390,197,193
2005,688,Serbia,Denmark,192,94,98
2005,705,Slovenia,Denmark,30,16,14
2005,724,Spain,Denmark,8358,4072,4286
2005,40,Austria,Denmark,1098,479,619
2005,56,Belgium,Denmark,2722,1291,1431
2005,250,France,Denmark,6496,2608,3888
2005,276,Germany,Denmark,20711,8980,11731
2005,438,Liechtenstein,Denmark,18,13,5
2005,442,Luxembourg,Denmark,1637,789,848
2005,528,Netherlands,Denmark,3284,1310,1974
2005,756,Switzerland,Denmark,4521,2058,2463
2005,60,Bermuda,Denmark,32,19,13
2005,124,Canada,Denmark,15986,8153,7833
2005,304,Greenland,Denmark,5733,3891,1842
2005,840,United States of America,Denmark,31350,12030,19320
2010,800,Uganda,Denmark,154,75,79
2010,140,Central African Republic,Denmark,2,0,2
2010,72,Botswana,Denmark,297,154,143
2010,516,Namibia,Denmark,113,76,37
2010,710,South Africa,Denmark,2187,1134,1053
2010,818,Egypt,Denmark,284,144,140
2010,434,Libya,Denmark,683,468,215
2010,196,Cyprus,Denmark,183,77,106
2010,376,Israel,Denmark,1858,605,1253
2010,400,Jordan,Denmark,113,70,43
2010,792,Turkey,Denmark,3328,1530,1798
2010,762,Tajikistan,Denmark,133,81,52
2010,64,Bhutan,Denmark,36,24,12
2010,392,Japan,Denmark,499,225,274
2010,608,Philippines,Denmark,436,195,241
2010,764,Thailand,Denmark,593,417,176
2010,44,Bahamas,Denmark,15,7,8
2010,136,Cayman Islands,Denmark,18,11,7
2010,214,Dominican Republic,Denmark,24,15,9
2010,188,Costa Rica,Denmark,63,36,27
2010,484,Mexico,Denmark,252,147,105
2010,558,Nicaragua,Denmark,49,33,16
2010,591,Panama,Denmark,126,100,26
2010,32,Argentina,Denmark,244,119,125
2010,68,Bolivia (Plurinational State of),Denmark,92,40,52
2010,76,Brazil,Denmark,489,331,158
2010,152,Chile,Denmark,456,236,220
2010,170,Colombia,Denmark,85,49,36
2010,218,Ecuador,Denmark,126,87,39
2010,604,Peru,Denmark,233,128,105
2010,862,Venezuela (Bolivarian Republic of),Denmark,137,88,49
2010,36,Australia,Denmark,10610,5575,5035
2010,554,New Zealand,Denmark,1456,706,750
2010,112,Belarus,Denmark,190,113,77
2010,100,Bulgaria,Denmark,60,44,16
2010,203,Czechia,Denmark,264,204,60
2010,348,Hungary,Denmark,364,215,149
2010,616,Poland,Denmark,926,483,443
2010,642,Romania,Denmark,89,44,45
2010,643,Russian Federation,Denmark,227,125,102
2010,703,Slovakia,Denmark,199,126,73
2010,233,Estonia,Denmark,135,98,37
2010,234,Faroe Islands,Denmark,3341,1824,1517
2010,246,Finland,Denmark,1081,632,449
2010,352,Iceland,Denmark,2967,1448,1519
2010,372,Ireland,Denmark,959,400,559
2010,428,Latvia,Denmark,288,229,59
2010,440,Lithuania,Denmark,354,216,138
2010,578,Norway,Denmark,22651,11506,11145
2010,752,Sweden,Denmark,45548,24315,21233
2010,826,United Kingdom,Denmark,20372,8347,12025
2010,20,Andorra,Denmark,121,64,57
2010,191,Croatia,Denmark,101,51,50
2010,300,Greece,Denmark,958,327,631
2010,380,Italy,Denmark,3592,1230,2362
2010,470,Malta,Denmark,107,63,44
2010,499,Montenegro,Denmark,93,18,75
2010,620,Portugal,Denmark,349,182,167
2010,688,Serbia,Denmark,188,92,96
2010,705,Slovenia,Denmark,47,24,23
2010,724,Spain,Denmark,11171,5615,5556
2010,40,Austria,Denmark,1213,516,697
2010,56,Belgium,Denmark,2618,1202,1416
2010,250,France,Denmark,6085,2098,3987
2010,276,Germany,Denmark,21013,9427,11586
2010,438,Liechtenstein,Denmark,15,8,7
2010,442,Luxembourg,Denmark,1662,800,862
2010,528,Netherlands,Denmark,3242,1298,1944
2010,756,Switzerland,Denmark,5312,2234,3078
2010,60,Bermuda,Denmark,36,22,14
2010,124,Canada,Denmark,14720,8016,6704
2010,304,Greenland,Denmark,4983,3384,1599
2010,840,United States of America,Denmark,31422,11791,19631
2015,800,Uganda,Denmark,154,74,80
2015,140,Central African Republic,Denmark,2,0,2
2015,72,Botswana,Denmark,324,168,156
2015,516,Namibia,Denmark,110,74,36
2015,710,South Africa,Denmark,3944,1948,1996
2015,324,Guinea,Denmark,66,38,28
2015,818,Egypt,Denmark,210,120,90
2015,434,Libya,Denmark,770,525,245
2015,196,Cyprus,Denmark,175,74,101
2015,376,Israel,Denmark,1916,617,1299
2015,400,Jordan,Denmark,48,25,23
2015,792,Turkey,Denmark,3378,1512,1866
2015,762,Tajikistan,Denmark,130,79,51
2015,64,Bhutan,Denmark,38,25,13
2015,392,Japan,Denmark,574,257,317
2015,608,Philippines,Denmark,442,198,244
2015,764,Thailand,Denmark,641,451,190
2015,44,Bahamas,Denmark,16,7,9
2015,136,Cayman Islands,Denmark,18,12,6
2015,214,Dominican Republic,Denmark,25,16,9
2015,188,Costa Rica,Denmark,63,36,27
2015,484,Mexico,Denmark,267,155,112
2015,558,Nicaragua,Denmark,52,35,17
2015,591,Panama,Denmark,147,117,30
2015,32,Argentina,Denmark,245,119,126
2015,68,Bolivia (Plurinational State of),Denmark,107,46,61
2015,76,Brazil,Denmark,589,399,190
2015,152,Chile,Denmark,690,350,340
2015,170,Colombia,Denmark,95,56,39
2015,218,Ecuador,Denmark,183,126,57
2015,604,Peru,Denmark,247,139,108
2015,862,Venezuela (Bolivarian Republic of),Denmark,145,92,53
2015,36,Australia,Denmark,10230,5346,4884
2015,554,New Zealand,Denmark,1465,709,756
2015,112,Belarus,Denmark,199,118,81
2015,100,Bulgaria,Denmark,229,145,84
2015,203,Czechia,Denmark,308,229,79
2015,348,Hungary,Denmark,465,291,174
2015,616,Poland,Denmark,892,473,419
2015,642,Romania,Denmark,263,149,114
2015,643,Russian Federation,Denmark,231,126,105
2015,703,Slovakia,Denmark,260,173,87
2015,233,Estonia,Denmark,168,137,31
2015,234,Faroe Islands,Denmark,3547,1903,1644
2015,246,Finland,Denmark,1193,705,488
2015,352,Iceland,Denmark,3283,1619,1664
2015,372,Ireland,Denmark,980,402,578
2015,428,Latvia,Denmark,203,160,43
2015,440,Lithuania,Denmark,377,220,157
2015,578,Norway,Denmark,25595,13362,12233
2015,752,Sweden,Denmark,41870,22217,19653
2015,826,United Kingdom,Denmark,26052,10218,15834
2015,20,Andorra,Denmark,112,112,0
2015,191,Croatia,Denmark,102,52,50
2015,300,Greece,Denmark,899,282,617
2015,380,Italy,Denmark,3043,1010,2033
2015,470,Malta,Denmark,181,111,70
2015,499,Montenegro,Denmark,97,19,78
2015,620,Portugal,Denmark,395,195,200
2015,688,Serbia,Denmark,183,89,94
2015,705,Slovenia,Denmark,58,30,28
2015,724,Spain,Denmark,11539,5815,5724
2015,40,Austria,Denmark,1418,607,811
2015,56,Belgium,Denmark,2405,1084,1321
2015,250,France,Denmark,5786,2310,3476
2015,276,Germany,Denmark,21894,9793,12101
2015,438,Liechtenstein,Denmark,16,8,8
2015,442,Luxembourg,Denmark,2535,1241,1294
2015,528,Netherlands,Denmark,3514,1488,2026
2015,756,Switzerland,Denmark,5616,2445,3171
2015,60,Bermuda,Denmark,36,22,14
2015,124,Canada,Denmark,12433,6383,6050
2015,304,Greenland,Denmark,4460,2943,1517
2015,840,United States of America,Denmark,31599,11757,19842
2019,800,Uganda,Denmark,154,74,80
2019,140,Central African Republic,Denmark,2,0,2
2019,72,Botswana,Denmark,346,179,167
2019,516,Namibia,Denmark,116,78,38
2019,710,South Africa,Denmark,4420,2186,2234
2019,324,Guinea,Denmark,63,37,26
2019,818,Egypt,Denmark,299,156,143
2019,434,Libya,Denmark,817,558,259
2019,196,Cyprus,Denmark,174,75,99
2019,376,Israel,Denmark,1863,600,1263
2019,400,Jordan,Denmark,51,27,24
2019,792,Turkey,Denmark,4567,2069,2498
2019,762,Tajikistan,Denmark,129,79,50
2019,64,Bhutan,Denmark,39,26,13
2019,392,Japan,Denmark,641,287,354
2019,608,Philippines,Denmark,455,204,251
2019,764,Thailand,Denmark,668,470,198
2019,44,Bahamas,Denmark,16,7,9
2019,136,Cayman Islands,Denmark,20,13,7
2019,214,Dominican Republic,Denmark,25,16,9
2019,188,Costa Rica,Denmark,63,36,27
2019,484,Mexico,Denmark,275,160,115
2019,558,Nicaragua,Denmark,54,37,17
2019,591,Panama,Denmark,155,125,30
2019,32,Argentina,Denmark,249,121,128
2019,68,Bolivia (Plurinational State of),Denmark,116,50,66
2019,76,Brazil,Denmark,663,450,213
2019,152,Chile,Denmark,921,442,479
2019,170,Colombia,Denmark,97,58,39
2019,218,Ecuador,Denmark,180,124,56
2019,604,Peru,Denmark,293,170,123
2019,862,Venezuela (Bolivarian Republic of),Denmark,142,90,52
2019,36,Australia,Denmark,10685,5514,5171
2019,554,New Zealand,Denmark,1505,728,777
2019,112,Belarus,Denmark,196,117,79
2019,100,Bulgaria,Denmark,395,229,166
2019,203,Czechia,Denmark,339,256,83
2019,348,Hungary,Denmark,513,310,203
2019,616,Poland,Denmark,944,518,426
2019,642,Romania,Denmark,845,442,403
2019,643,Russian Federation,Denmark,230,126,104
2019,703,Slovakia,Denmark,292,193,99
2019,233,Estonia,Denmark,178,138,40
2019,234,Faroe Islands,Denmark,4066,2175,1891
2019,246,Finland,Denmark,1360,810,550
2019,352,Iceland,Denmark,3843,1952,1891
2019,372,Ireland,Denmark,1075,443,632
2019,428,Latvia,Denmark,206,163,43
2019,440,Lithuania,Denmark,428,258,170
2019,578,Norway,Denmark,26866,14023,12843
2019,752,Sweden,Denmark,39205,20652,18553
2019,826,United Kingdom,Denmark,29584,11649,17935
2019,20,Andorra,Denmark,119,119,0
2019,191,Croatia,Denmark,94,48,46
2019,300,Greece,Denmark,877,298,579
2019,380,Italy,Denmark,3196,1109,2087
2019,470,Malta,Denmark,292,180,112
2019,499,Montenegro,Denmark,97,20,77
2019,620,Portugal,Denmark,401,199,202
2019,688,Serbia,Denmark,185,90,95
2019,705,Slovenia,Denmark,54,27,27
2019,724,Spain,Denmark,11640,5779,5861
2019,40,Austria,Denmark,1673,733,940
2019,56,Belgium,Denmark,2609,1194,1415
2019,250,France,Denmark,6124,2437,3687
2019,276,Germany,Denmark,24016,11400,12616
2019,438,Liechtenstein,Denmark,15,8,7
2019,442,Luxembourg,Denmark,1839,953,886
2019,528,Netherlands,Denmark,4030,1716,2314
2019,756,Switzerland,Denmark,5707,2498,3209
2019,60,Bermuda,Denmark,36,22,14
2019,124,Canada,Denmark,13323,6840,6483
2019,304,Greenland,Denmark,4387,2887,1500
2019,840,United States of America,Denmark,34123,12467,21656
1990,231,Ethiopia,Djibouti,904,475,429
1990,818,Egypt,Djibouti,243,151,92
1990,434,Libya,Djibouti,694,432,262
1990,196,Cyprus,Djibouti,1,0,1
1990,36,Australia,Djibouti,34,16,18
1990,100,Bulgaria,Djibouti,1,1,0
1990,203,Czechia,Djibouti,1,1,0
1990,208,Denmark,Djibouti,14,8,6
1990,578,Norway,Djibouti,6,3,3
1990,752,Sweden,Djibouti,44,18,26
1990,826,United Kingdom,Djibouti,33,21,12
1990,300,Greece,Djibouti,3,1,2
1990,380,Italy,Djibouti,2,1,1
1990,724,Spain,Djibouti,1,1,0
1990,40,Austria,Djibouti,4,3,1
1990,56,Belgium,Djibouti,76,39,37
1990,250,France,Djibouti,3050,1623,1427
1990,528,Netherlands,Djibouti,48,26,22
1990,756,Switzerland,Djibouti,38,16,22
1990,124,Canada,Djibouti,111,54,57
1995,231,Ethiopia,Djibouti,1901,1154,747
1995,818,Egypt,Djibouti,247,150,97
1995,434,Libya,Djibouti,863,562,301
1995,196,Cyprus,Djibouti,2,0,2
1995,36,Australia,Djibouti,63,28,35
1995,100,Bulgaria,Djibouti,2,2,0
1995,203,Czechia,Djibouti,2,1,1
1995,208,Denmark,Djibouti,15,7,8
1995,246,Finland,Djibouti,1,0,1
1995,372,Ireland,Djibouti,1,1,0
1995,578,Norway,Djibouti,3,0,3
1995,752,Sweden,Djibouti,53,22,31
1995,826,United Kingdom,Djibouti,131,65,66
1995,300,Greece,Djibouti,13,5,8
1995,380,Italy,Djibouti,12,5,7
1995,724,Spain,Djibouti,3,2,1
1995,40,Austria,Djibouti,5,3,2
1995,56,Belgium,Djibouti,76,39,37
1995,250,France,Djibouti,3149,1651,1498
1995,528,Netherlands,Djibouti,70,37,33
1995,756,Switzerland,Djibouti,52,25,27
1995,124,Canada,Djibouti,300,145,155
2000,231,Ethiopia,Djibouti,3258,2053,1205
2000,818,Egypt,Djibouti,271,161,110
2000,434,Libya,Djibouti,1047,709,338
2000,196,Cyprus,Djibouti,2,0,2
2000,36,Australia,Djibouti,80,40,40
2000,100,Bulgaria,Djibouti,2,2,0
2000,203,Czechia,Djibouti,3,2,1
2000,208,Denmark,Djibouti,16,7,9
2000,246,Finland,Djibouti,2,1,1
2000,372,Ireland,Djibouti,2,1,1
2000,578,Norway,Djibouti,11,3,8
2000,752,Sweden,Djibouti,57,23,34
2000,826,United Kingdom,Djibouti,232,109,123
2000,300,Greece,Djibouti,24,10,14
2000,380,Italy,Djibouti,22,10,12
2000,724,Spain,Djibouti,41,29,12
2000,40,Austria,Djibouti,5,3,2
2000,56,Belgium,Djibouti,73,38,35
2000,250,France,Djibouti,3247,1678,1569
2000,528,Netherlands,Djibouti,96,48,48
2000,756,Switzerland,Djibouti,68,35,33
2000,124,Canada,Djibouti,496,239,257
2005,231,Ethiopia,Djibouti,2740,1583,1157
2005,818,Egypt,Djibouti,323,200,123
2005,434,Libya,Djibouti,1154,848,306
2005,196,Cyprus,Djibouti,3,0,3
2005,36,Australia,Djibouti,120,51,69
2005,100,Bulgaria,Djibouti,3,3,0
2005,203,Czechia,Djibouti,3,1,2
2005,208,Denmark,Djibouti,19,7,12
2005,246,Finland,Djibouti,4,1,3
2005,352,Iceland,Djibouti,1,1,0
2005,372,Ireland,Djibouti,2,1,1
2005,578,Norway,Djibouti,12,3,9
2005,752,Sweden,Djibouti,69,29,40
2005,826,United Kingdom,Djibouti,319,139,180
2005,300,Greece,Djibouti,32,13,19
2005,380,Italy,Djibouti,56,25,31
2005,724,Spain,Djibouti,20,14,6
2005,40,Austria,Djibouti,6,4,2
2005,56,Belgium,Djibouti,312,161,151
2005,250,France,Djibouti,6015,2943,3072
2005,528,Netherlands,Djibouti,107,39,68
2005,756,Switzerland,Djibouti,76,39,37
2005,124,Canada,Djibouti,943,410,533
2010,231,Ethiopia,Djibouti,3025,1584,1441
2010,818,Egypt,Djibouti,349,211,138
2010,434,Libya,Djibouti,1264,933,331
2010,196,Cyprus,Djibouti,4,0,4
2010,36,Australia,Djibouti,130,60,70
2010,100,Bulgaria,Djibouti,3,3,0
2010,203,Czechia,Djibouti,3,1,2
2010,208,Denmark,Djibouti,21,8,13
2010,246,Finland,Djibouti,7,0,7
2010,352,Iceland,Djibouti,1,1,0
2010,372,Ireland,Djibouti,1,0,1
2010,578,Norway,Djibouti,34,12,22
2010,752,Sweden,Djibouti,104,43,61
2010,826,United Kingdom,Djibouti,336,151,185
2010,300,Greece,Djibouti,41,18,23
2010,380,Italy,Djibouti,101,47,54
2010,724,Spain,Djibouti,23,12,11
2010,40,Austria,Djibouti,6,4,2
2010,56,Belgium,Djibouti,687,349,338
2010,250,France,Djibouti,6170,3121,3049
2010,528,Netherlands,Djibouti,102,37,65
2010,756,Switzerland,Djibouti,90,41,49
2010,124,Canada,Djibouti,1330,558,772
2015,231,Ethiopia,Djibouti,3705,1889,1816
2015,324,Guinea,Djibouti,18,14,4
2015,818,Egypt,Djibouti,258,169,89
2015,434,Libya,Djibouti,1425,1047,378
2015,196,Cyprus,Djibouti,3,0,3
2015,36,Australia,Djibouti,190,99,91
2015,100,Bulgaria,Djibouti,3,3,0
2015,203,Czechia,Djibouti,3,1,2
2015,208,Denmark,Djibouti,21,6,15
2015,246,Finland,Djibouti,8,3,5
2015,372,Ireland,Djibouti,1,0,1
2015,578,Norway,Djibouti,58,19,39
2015,752,Sweden,Djibouti,333,153,180
2015,826,United Kingdom,Djibouti,429,186,243
2015,300,Greece,Djibouti,38,16,22
2015,380,Italy,Djibouti,85,34,51
2015,724,Spain,Djibouti,21,15,6
2015,40,Austria,Djibouti,7,5,2
2015,56,Belgium,Djibouti,1212,606,606
2015,250,France,Djibouti,6835,3365,3470
2015,528,Netherlands,Djibouti,96,32,64
2015,756,Switzerland,Djibouti,109,53,56
2015,124,Canada,Djibouti,2221,994,1227
2019,231,Ethiopia,Djibouti,3996,2038,1958
2019,324,Guinea,Djibouti,17,14,3
2019,818,Egypt,Djibouti,367,226,141
2019,434,Libya,Djibouti,1511,1110,401
2019,196,Cyprus,Djibouti,2,0,2
2019,36,Australia,Djibouti,211,111,100
2019,100,Bulgaria,Djibouti,3,3,0
2019,203,Czechia,Djibouti,1,0,1
2019,208,Denmark,Djibouti,21,8,13
2019,246,Finland,Djibouti,16,7,9
2019,352,Iceland,Djibouti,1,1,0
2019,372,Ireland,Djibouti,1,0,1
2019,578,Norway,Djibouti,67,24,43
2019,752,Sweden,Djibouti,517,221,296
2019,826,United Kingdom,Djibouti,487,212,275
2019,300,Greece,Djibouti,37,17,20
2019,380,Italy,Djibouti,87,38,49
2019,724,Spain,Djibouti,21,15,6
2019,40,Austria,Djibouti,8,6,2
2019,56,Belgium,Djibouti,1452,723,729
2019,250,France,Djibouti,7234,3553,3681
2019,528,Netherlands,Djibouti,117,39,78
2019,756,Switzerland,Djibouti,123,59,64
2019,124,Canada,Djibouti,2380,1066,1314
1990,28,Antigua and Barbuda,Dominica,2442,1174,1268
1990,533,Aruba,Dominica,143,45,98
1990,44,Bahamas,Dominica,35,15,20
1990,52,Barbados,Dominica,451,138,313
1990,92,British Virgin Islands,Dominica,619,295,324
1990,535,"Bonaire, Sint Eustatius and Saba",Dominica,1820,708,1112
1990,214,Dominican Republic,Dominica,24,18,6
1990,308,Grenada,Dominica,42,21,21
1990,312,Guadeloupe,Dominica,5560,2025,3535
1990,388,Jamaica,Dominica,107,53,54
1990,474,Martinique,Dominica,184,89,95
1990,500,Montserrat,Dominica,412,192,220
1990,630,Puerto Rico,Dominica,2567,1216,1351
1990,659,Saint Kitts and Nevis,Dominica,87,45,42
1990,662,Saint Lucia,Dominica,96,49,47
1990,670,Saint Vincent and the Grenadines,Dominica,75,30,45
1990,850,United States Virgin Islands,Dominica,3219,1534,1685
1990,188,Costa Rica,Dominica,3,0,3
1990,591,Panama,Dominica,12,4,8
1990,32,Argentina,Dominica,9,0,9
1990,68,Bolivia (Plurinational State of),Dominica,6,5,1
1990,152,Chile,Dominica,8,2,6
1990,170,Colombia,Dominica,46,22,24
1990,254,French Guiana,Dominica,443,153,290
1990,328,Guyana,Dominica,13,8,5
1990,862,Venezuela (Bolivarian Republic of),Dominica,200,86,114
1990,36,Australia,Dominica,6,6,0
1990,208,Denmark,Dominica,4,2,2
1990,752,Sweden,Dominica,36,19,17
1990,826,United Kingdom,Dominica,941,567,374
1990,300,Greece,Dominica,410,227,183
1990,724,Spain,Dominica,359,95,264
1990,40,Austria,Dominica,28,8,20
1990,56,Belgium,Dominica,97,49,48
1990,250,France,Dominica,744,264,480
1990,442,Luxembourg,Dominica,112,31,81
1990,528,Netherlands,Dominica,33,16,17
1990,756,Switzerland,Dominica,66,18,48
1990,124,Canada,Dominica,1449,705,744
1990,840,United States of America,Dominica,19529,9374,10155
1995,28,Antigua and Barbuda,Dominica,3170,1448,1722
1995,533,Aruba,Dominica,134,43,91
1995,44,Bahamas,Dominica,41,22,19
1995,52,Barbados,Dominica,492,156,336
1995,92,British Virgin Islands,Dominica,728,337,391
1995,535,"Bonaire, Sint Eustatius and Saba",Dominica,960,380,580
1995,214,Dominican Republic,Dominica,27,20,7
1995,308,Grenada,Dominica,54,27,27
1995,312,Guadeloupe,Dominica,5604,2325,3279
1995,388,Jamaica,Dominica,128,63,65
1995,474,Martinique,Dominica,279,130,149
1995,500,Montserrat,Dominica,331,154,177
1995,630,Puerto Rico,Dominica,2575,1221,1354
1995,659,Saint Kitts and Nevis,Dominica,115,61,54
1995,662,Saint Lucia,Dominica,129,67,62
1995,670,Saint Vincent and the Grenadines,Dominica,78,32,46
1995,850,United States Virgin Islands,Dominica,4060,1935,2125
1995,188,Costa Rica,Dominica,3,0,3
1995,591,Panama,Dominica,17,6,11
1995,32,Argentina,Dominica,9,0,9
1995,68,Bolivia (Plurinational State of),Dominica,3,2,1
1995,152,Chile,Dominica,17,9,8
1995,170,Colombia,Dominica,45,21,24
1995,254,French Guiana,Dominica,493,155,338
1995,328,Guyana,Dominica,19,11,8
1995,862,Venezuela (Bolivarian Republic of),Dominica,40,22,18
1995,36,Australia,Dominica,3,3,0
1995,208,Denmark,Dominica,7,4,3
1995,246,Finland,Dominica,1,1,0
1995,352,Iceland,Dominica,1,1,0
1995,372,Ireland,Dominica,1,1,0
1995,752,Sweden,Dominica,42,22,20
1995,826,United Kingdom,Dominica,3697,1822,1875
1995,300,Greece,Dominica,401,135,266
1995,380,Italy,Dominica,22,7,15
1995,724,Spain,Dominica,408,111,297
1995,40,Austria,Dominica,32,9,23
1995,56,Belgium,Dominica,97,49,48
1995,250,France,Dominica,768,264,504
1995,442,Luxembourg,Dominica,105,28,77
1995,528,Netherlands,Dominica,48,22,26
1995,756,Switzerland,Dominica,131,46,85
1995,124,Canada,Dominica,2099,1016,1083
1995,840,United States of America,Dominica,17818,8621,9197
2000,28,Antigua and Barbuda,Dominica,3898,1722,2176
2000,533,Aruba,Dominica,125,42,83
2000,44,Bahamas,Dominica,47,30,17
2000,52,Barbados,Dominica,534,175,359
2000,92,British Virgin Islands,Dominica,836,379,457
2000,535,"Bonaire, Sint Eustatius and Saba",Dominica,101,53,48
2000,214,Dominican Republic,Dominica,29,21,8
2000,308,Grenada,Dominica,67,33,34
2000,312,Guadeloupe,Dominica,5648,2626,3022
2000,388,Jamaica,Dominica,148,72,76
2000,474,Martinique,Dominica,374,170,204
2000,500,Montserrat,Dominica,250,116,134
2000,630,Puerto Rico,Dominica,2591,1229,1362
2000,659,Saint Kitts and Nevis,Dominica,158,85,73
2000,662,Saint Lucia,Dominica,177,92,85
2000,670,Saint Vincent and the Grenadines,Dominica,81,34,47
2000,850,United States Virgin Islands,Dominica,4909,2339,2570
2000,188,Costa Rica,Dominica,4,0,4
2000,591,Panama,Dominica,24,9,15
2000,32,Argentina,Dominica,9,0,9
2000,152,Chile,Dominica,27,14,13
2000,170,Colombia,Dominica,43,20,23
2000,254,French Guiana,Dominica,542,157,385
2000,328,Guyana,Dominica,25,15,10
2000,862,Venezuela (Bolivarian Republic of),Dominica,8,5,3
2000,36,Australia,Dominica,20,10,10
2000,208,Denmark,Dominica,9,5,4
2000,246,Finland,Dominica,1,1,0
2000,352,Iceland,Dominica,1,1,0
2000,372,Ireland,Dominica,2,1,1
2000,752,Sweden,Dominica,46,24,22
2000,826,United Kingdom,Dominica,6517,3104,3413
2000,300,Greece,Dominica,398,40,358
2000,380,Italy,Dominica,44,15,29
2000,724,Spain,Dominica,634,183,451
2000,40,Austria,Dominica,35,10,25
2000,56,Belgium,Dominica,93,49,44
2000,250,France,Dominica,792,264,528
2000,442,Luxembourg,Dominica,101,27,74
2000,528,Netherlands,Dominica,67,30,37
2000,756,Switzerland,Dominica,197,74,123
2000,124,Canada,Dominica,2798,1350,1448
2000,840,United States of America,Dominica,16036,7845,8191
2005,28,Antigua and Barbuda,Dominica,4180,1844,2336
2005,533,Aruba,Dominica,115,37,78
2005,44,Bahamas,Dominica,58,31,27
2005,52,Barbados,Dominica,426,141,285
2005,92,British Virgin Islands,Dominica,958,434,524
2005,535,"Bonaire, Sint Eustatius and Saba",Dominica,107,56,51
2005,214,Dominican Republic,Dominica,22,14,8
2005,308,Grenada,Dominica,70,35,35
2005,312,Guadeloupe,Dominica,4932,2095,2837
2005,388,Jamaica,Dominica,144,70,74
2005,474,Martinique,Dominica,391,173,218
2005,500,Montserrat,Dominica,257,118,139
2005,630,Puerto Rico,Dominica,2030,963,1067
2005,659,Saint Kitts and Nevis,Dominica,180,96,84
2005,662,Saint Lucia,Dominica,234,121,113
2005,670,Saint Vincent and the Grenadines,Dominica,82,36,46
2005,534,Sint Maarten (Dutch part),Dominica,717,369,348
2005,850,United States Virgin Islands,Dominica,5206,2494,2712
2005,188,Costa Rica,Dominica,3,0,3
2005,591,Panama,Dominica,35,13,22
2005,32,Argentina,Dominica,7,0,7
2005,68,Bolivia (Plurinational State of),Dominica,2,1,1
2005,76,Brazil,Dominica,10,5,5
2005,152,Chile,Dominica,40,21,19
2005,170,Colombia,Dominica,41,20,21
2005,254,French Guiana,Dominica,571,162,409
2005,328,Guyana,Dominica,31,18,13
2005,862,Venezuela (Bolivarian Republic of),Dominica,4,3,1
2005,36,Australia,Dominica,20,10,10
2005,100,Bulgaria,Dominica,1,1,0
2005,203,Czechia,Dominica,1,1,0
2005,208,Denmark,Dominica,10,4,6
2005,246,Finland,Dominica,2,2,0
2005,352,Iceland,Dominica,2,1,1
2005,372,Ireland,Dominica,2,1,1
2005,752,Sweden,Dominica,45,23,22
2005,826,United Kingdom,Dominica,6061,2832,3229
2005,300,Greece,Dominica,209,20,189
2005,380,Italy,Dominica,191,54,137
2005,724,Spain,Dominica,753,235,518
2005,40,Austria,Dominica,39,10,29
2005,56,Belgium,Dominica,119,56,63
2005,250,France,Dominica,7416,2452,4964
2005,442,Luxembourg,Dominica,88,28,60
2005,528,Netherlands,Dominica,82,35,47
2005,756,Switzerland,Dominica,251,81,170
2005,124,Canada,Dominica,2818,1224,1594
2005,840,United States of America,Dominica,25276,12436,12840
2010,28,Antigua and Barbuda,Dominica,4462,1966,2496
2010,533,Aruba,Dominica,102,31,71
2010,44,Bahamas,Dominica,69,32,37
2010,52,Barbados,Dominica,321,107,214
2010,92,British Virgin Islands,Dominica,1098,498,600
2010,535,"Bonaire, Sint Eustatius and Saba",Dominica,20,13,7
2010,531,Curaçao,Dominica,99,17,82
2010,214,Dominican Republic,Dominica,14,6,8
2010,308,Grenada,Dominica,74,37,37
2010,312,Guadeloupe,Dominica,4215,1563,2652
2010,388,Jamaica,Dominica,140,69,71
2010,474,Martinique,Dominica,408,175,233
2010,500,Montserrat,Dominica,265,121,144
2010,630,Puerto Rico,Dominica,1215,569,646
2010,659,Saint Kitts and Nevis,Dominica,195,105,90
2010,662,Saint Lucia,Dominica,273,140,133
2010,670,Saint Vincent and the Grenadines,Dominica,84,38,46
2010,534,Sint Maarten (Dutch part),Dominica,1435,739,696
2010,850,United States Virgin Islands,Dominica,5505,2650,2855
2010,188,Costa Rica,Dominica,5,0,5
2010,591,Panama,Dominica,49,18,31
2010,32,Argentina,Dominica,4,0,4
2010,68,Bolivia (Plurinational State of),Dominica,3,2,1
2010,76,Brazil,Dominica,21,10,11
2010,152,Chile,Dominica,54,29,25
2010,170,Colombia,Dominica,46,23,23
2010,254,French Guiana,Dominica,599,166,433
2010,328,Guyana,Dominica,37,21,16
2010,862,Venezuela (Bolivarian Republic of),Dominica,2,1,1
2010,36,Australia,Dominica,30,15,15
2010,100,Bulgaria,Dominica,1,1,0
2010,203,Czechia,Dominica,1,1,0
2010,208,Denmark,Dominica,10,4,6
2010,246,Finland,Dominica,3,3,0
2010,352,Iceland,Dominica,2,1,1
2010,372,Ireland,Dominica,1,0,1
2010,752,Sweden,Dominica,46,25,21
2010,826,United Kingdom,Dominica,6385,3054,3331
2010,300,Greece,Dominica,19,0,19
2010,380,Italy,Dominica,265,72,193
2010,724,Spain,Dominica,935,319,616
2010,40,Austria,Dominica,43,11,32
2010,56,Belgium,Dominica,101,30,71
2010,250,France,Dominica,6049,1926,4123
2010,442,Luxembourg,Dominica,76,29,47
2010,528,Netherlands,Dominica,72,35,37
2010,756,Switzerland,Dominica,261,80,181
2010,124,Canada,Dominica,3045,1191,1854
2010,840,United States of America,Dominica,35534,15405,20129
2015,324,Guinea,Dominica,13,4,9
2015,28,Antigua and Barbuda,Dominica,4745,2089,2656
2015,533,Aruba,Dominica,107,32,75
2015,44,Bahamas,Dominica,75,35,40
2015,52,Barbados,Dominica,337,113,224
2015,92,British Virgin Islands,Dominica,1230,558,672
2015,535,"Bonaire, Sint Eustatius and Saba",Dominica,22,15,7
2015,531,Curaçao,Dominica,107,19,88
2015,214,Dominican Republic,Dominica,14,6,8
2015,308,Grenada,Dominica,74,37,37
2015,312,Guadeloupe,Dominica,4373,1595,2778
2015,388,Jamaica,Dominica,137,68,69
2015,474,Martinique,Dominica,422,179,243
2015,500,Montserrat,Dominica,283,127,156
2015,630,Puerto Rico,Dominica,1190,556,634
2015,659,Saint Kitts and Nevis,Dominica,200,106,94
2015,662,Saint Lucia,Dominica,261,134,127
2015,670,Saint Vincent and the Grenadines,Dominica,87,41,46
2015,534,Sint Maarten (Dutch part),Dominica,1495,768,727
2015,850,United States Virgin Islands,Dominica,5508,2651,2857
2015,188,Costa Rica,Dominica,5,0,5
2015,591,Panama,Dominica,58,21,37
2015,32,Argentina,Dominica,4,0,4
2015,68,Bolivia (Plurinational State of),Dominica,3,2,1
2015,76,Brazil,Dominica,25,12,13
2015,152,Chile,Dominica,81,43,38
2015,170,Colombia,Dominica,51,26,25
2015,254,French Guiana,Dominica,723,194,529
2015,328,Guyana,Dominica,43,24,19
2015,36,Australia,Dominica,40,23,17
2015,203,Czechia,Dominica,2,2,0
2015,208,Denmark,Dominica,15,6,9
2015,246,Finland,Dominica,6,6,0
2015,352,Iceland,Dominica,2,1,1
2015,372,Ireland,Dominica,1,0,1
2015,752,Sweden,Dominica,42,22,20
2015,826,United Kingdom,Dominica,8165,3779,4386
2015,300,Greece,Dominica,17,7,10
2015,380,Italy,Dominica,296,80,216
2015,724,Spain,Dominica,966,322,644
2015,40,Austria,Dominica,51,14,37
2015,56,Belgium,Dominica,147,49,98
2015,250,France,Dominica,6701,2009,4692
2015,442,Luxembourg,Dominica,115,45,70
2015,528,Netherlands,Dominica,75,35,40
2015,756,Switzerland,Dominica,401,105,296
2015,124,Canada,Dominica,2762,1137,1625
2015,840,United States of America,Dominica,32379,13943,18436
2019,324,Guinea,Dominica,12,4,8
2019,28,Antigua and Barbuda,Dominica,4934,2172,2762
2019,533,Aruba,Dominica,108,33,75
2019,44,Bahamas,Dominica,79,37,42
2019,52,Barbados,Dominica,340,114,226
2019,92,British Virgin Islands,Dominica,1335,606,729
2019,535,"Bonaire, Sint Eustatius and Saba",Dominica,26,18,8
2019,531,Curaçao,Dominica,116,21,95
2019,214,Dominican Republic,Dominica,14,6,8
2019,308,Grenada,Dominica,74,37,37
2019,312,Guadeloupe,Dominica,4440,1620,2820
2019,388,Jamaica,Dominica,138,69,69
2019,474,Martinique,Dominica,421,179,242
2019,500,Montserrat,Dominica,293,130,163
2019,630,Puerto Rico,Dominica,1132,527,605
2019,659,Saint Kitts and Nevis,Dominica,203,108,95
2019,662,Saint Lucia,Dominica,252,130,122
2019,670,Saint Vincent and the Grenadines,Dominica,87,41,46
2019,534,Sint Maarten (Dutch part),Dominica,1547,795,752
2019,850,United States Virgin Islands,Dominica,5510,2652,2858
2019,188,Costa Rica,Dominica,5,0,5
2019,591,Panama,Dominica,60,22,38
2019,32,Argentina,Dominica,4,0,4
2019,68,Bolivia (Plurinational State of),Dominica,3,2,1
2019,76,Brazil,Dominica,28,14,14
2019,152,Chile,Dominica,108,55,53
2019,170,Colombia,Dominica,52,27,25
2019,254,French Guiana,Dominica,799,214,585
2019,328,Guyana,Dominica,43,24,19
2019,36,Australia,Dominica,42,22,20
2019,203,Czechia,Dominica,2,2,0
2019,208,Denmark,Dominica,14,4,10
2019,246,Finland,Dominica,8,8,0
2019,352,Iceland,Dominica,4,1,3
2019,372,Ireland,Dominica,1,0,1
2019,752,Sweden,Dominica,49,29,20
2019,826,United Kingdom,Dominica,9272,4304,4968
2019,300,Greece,Dominica,16,7,9
2019,380,Italy,Dominica,316,97,219
2019,724,Spain,Dominica,1000,317,683
2019,40,Austria,Dominica,60,18,42
2019,56,Belgium,Dominica,179,67,112
2019,250,France,Dominica,7093,2116,4977
2019,442,Luxembourg,Dominica,2,1,1
2019,528,Netherlands,Dominica,83,39,44
2019,756,Switzerland,Dominica,416,104,312
2019,124,Canada,Dominica,2959,1218,1741
2019,840,United States of America,Dominica,34965,14843,20122
1990,196,Cyprus,Dominican Republic,3,1,2
1990,660,Anguilla,Dominican Republic,308,201,107
1990,28,Antigua and Barbuda,Dominican Republic,621,298,323
1990,533,Aruba,Dominican Republic,2042,530,1512
1990,44,Bahamas,Dominican Republic,44,22,22
1990,92,British Virgin Islands,Dominican Republic,748,376,372
1990,535,"Bonaire, Sint Eustatius and Saba",Dominican Republic,8195,2525,5670
1990,136,Cayman Islands,Dominican Republic,20,16,4
1990,192,Cuba,Dominican Republic,267,118,149
1990,312,Guadeloupe,Dominican Republic,3440,1655,1785
1990,332,Haiti,Dominican Republic,2406,1345,1061
1990,474,Martinique,Dominican Republic,16,3,13
1990,500,Montserrat,Dominican Republic,37,25,12
1990,630,Puerto Rico,Dominican Republic,37207,16335,20872
1990,662,Saint Lucia,Dominican Republic,20,8,12
1990,796,Turks and Caicos Islands,Dominican Republic,349,181,168
1990,850,United States Virgin Islands,Dominican Republic,533,207,326
1990,188,Costa Rica,Dominican Republic,553,204,349
1990,222,El Salvador,Dominican Republic,38,18,20
1990,320,Guatemala,Dominican Republic,59,13,46
1990,340,Honduras,Dominican Republic,103,66,37
1990,484,Mexico,Dominican Republic,522,279,243
1990,558,Nicaragua,Dominican Republic,65,32,33
1990,591,Panama,Dominican Republic,1474,417,1057
1990,32,Argentina,Dominican Republic,265,127,138
1990,68,Bolivia (Plurinational State of),Dominican Republic,44,17,27
1990,76,Brazil,Dominican Republic,277,85,192
1990,152,Chile,Dominican Republic,124,56,68
1990,170,Colombia,Dominican Republic,361,173,188
1990,218,Ecuador,Dominican Republic,118,52,66
1990,604,Peru,Dominican Republic,111,55,56
1990,862,Venezuela (Bolivarian Republic of),Dominican Republic,18280,6911,11369
1990,36,Australia,Dominican Republic,23,9,14
1990,100,Bulgaria,Dominican Republic,5,2,3
1990,203,Czechia,Dominican Republic,1,0,1
1990,616,Poland,Dominican Republic,4,3,1
1990,208,Denmark,Dominican Republic,35,12,23
1990,246,Finland,Dominican Republic,10,8,2
1990,352,Iceland,Dominican Republic,2,0,2
1990,372,Ireland,Dominican Republic,2,1,1
1990,578,Norway,Dominican Republic,53,15,38
1990,752,Sweden,Dominican Republic,192,98,94
1990,826,United Kingdom,Dominican Republic,72,44,28
1990,300,Greece,Dominican Republic,218,120,98
1990,380,Italy,Dominican Republic,9060,3149,5911
1990,620,Portugal,Dominican Republic,10,3,7
1990,705,Slovenia,Dominican Republic,3,2,1
1990,724,Spain,Dominican Republic,15160,3627,11533
1990,40,Austria,Dominican Republic,1722,499,1223
1990,56,Belgium,Dominican Republic,1804,558,1246
1990,250,France,Dominican Republic,454,161,293
1990,276,Germany,Dominican Republic,1012,303,709
1990,442,Luxembourg,Dominican Republic,35,12,23
1990,528,Netherlands,Dominican Republic,2403,730,1673
1990,756,Switzerland,Dominican Republic,4751,1253,3498
1990,60,Bermuda,Dominican Republic,9,5,4
1990,124,Canada,Dominican Republic,2668,1299,1369
1990,840,United States of America,Dominican Republic,347858,154429,193429
1995,196,Cyprus,Dominican Republic,4,1,3
1995,660,Anguilla,Dominican Republic,397,256,141
1995,28,Antigua and Barbuda,Dominican Republic,1044,426,618
1995,533,Aruba,Dominican Republic,2829,812,2017
1995,44,Bahamas,Dominican Republic,64,33,31
1995,92,British Virgin Islands,Dominican Republic,879,430,449
1995,535,"Bonaire, Sint Eustatius and Saba",Dominican Republic,8267,2604,5663
1995,136,Cayman Islands,Dominican Republic,39,31,8
1995,192,Cuba,Dominican Republic,203,85,118
1995,312,Guadeloupe,Dominican Republic,2517,1092,1425
1995,332,Haiti,Dominican Republic,2285,1278,1007
1995,474,Martinique,Dominican Republic,69,30,39
1995,500,Montserrat,Dominican Republic,29,20,9
1995,630,Puerto Rico,Dominican Republic,49325,22749,26576
1995,662,Saint Lucia,Dominican Republic,26,10,16
1995,796,Turks and Caicos Islands,Dominican Republic,520,285,235
1995,850,United States Virgin Islands,Dominican Republic,1861,723,1138
1995,188,Costa Rica,Dominican Republic,556,202,354
1995,222,El Salvador,Dominican Republic,41,21,20
1995,320,Guatemala,Dominican Republic,64,23,41
1995,340,Honduras,Dominican Republic,102,64,38
1995,484,Mexico,Dominican Republic,842,413,429
1995,558,Nicaragua,Dominican Republic,52,25,27
1995,591,Panama,Dominican Republic,3554,1022,2532
1995,32,Argentina,Dominican Republic,849,230,619
1995,68,Bolivia (Plurinational State of),Dominican Republic,22,8,14
1995,76,Brazil,Dominican Republic,190,60,130
1995,152,Chile,Dominican Republic,197,91,106
1995,170,Colombia,Dominican Republic,350,167,183
1995,218,Ecuador,Dominican Republic,133,59,74
1995,604,Peru,Dominican Republic,112,54,58
1995,862,Venezuela (Bolivarian Republic of),Dominican Republic,16240,6273,9967
1995,36,Australia,Dominican Republic,42,20,22
1995,100,Bulgaria,Dominican Republic,8,3,5
1995,203,Czechia,Dominican Republic,2,1,1
1995,348,Hungary,Dominican Republic,12,6,6
1995,616,Poland,Dominican Republic,3,3,0
1995,208,Denmark,Dominican Republic,56,18,38
1995,246,Finland,Dominican Republic,22,13,9
1995,352,Iceland,Dominican Republic,4,1,3
1995,372,Ireland,Dominican Republic,5,3,2
1995,578,Norway,Dominican Republic,128,37,91
1995,752,Sweden,Dominican Republic,228,115,113
1995,826,United Kingdom,Dominican Republic,285,142,143
1995,300,Greece,Dominican Republic,192,72,120
1995,380,Italy,Dominican Republic,13427,3291,10136
1995,620,Portugal,Dominican Republic,22,6,16
1995,705,Slovenia,Dominican Republic,6,4,2
1995,724,Spain,Dominican Republic,21654,5926,15728
1995,40,Austria,Dominican Republic,1943,586,1357
1995,56,Belgium,Dominican Republic,1792,552,1240
1995,250,France,Dominican Republic,469,161,308
1995,276,Germany,Dominican Republic,2828,651,2177
1995,438,Liechtenstein,Dominican Republic,1,1,0
1995,442,Luxembourg,Dominican Republic,32,11,21
1995,528,Netherlands,Dominican Republic,3933,1130,2803
1995,756,Switzerland,Dominican Republic,5976,1884,4092
1995,60,Bermuda,Dominican Republic,11,6,5
1995,124,Canada,Dominican Republic,3841,1858,1983
1995,840,United States of America,Dominican Republic,524698,230385,294313
2000,196,Cyprus,Dominican Republic,5,1,4
2000,660,Anguilla,Dominican Republic,486,311,175
2000,28,Antigua and Barbuda,Dominican Republic,1466,554,912
2000,533,Aruba,Dominican Republic,3615,1094,2521
2000,44,Bahamas,Dominican Republic,84,45,39
2000,92,British Virgin Islands,Dominican Republic,1010,485,525
2000,535,"Bonaire, Sint Eustatius and Saba",Dominican Republic,8340,2683,5657
2000,136,Cayman Islands,Dominican Republic,68,53,15
2000,192,Cuba,Dominican Republic,138,52,86
2000,312,Guadeloupe,Dominican Republic,1593,529,1064
2000,332,Haiti,Dominican Republic,2170,1214,956
2000,474,Martinique,Dominican Republic,122,56,66
2000,500,Montserrat,Dominican Republic,22,16,6
2000,630,Puerto Rico,Dominican Republic,61563,29214,32349
2000,662,Saint Lucia,Dominican Republic,37,15,22
2000,796,Turks and Caicos Islands,Dominican Republic,692,389,303
2000,850,United States Virgin Islands,Dominican Republic,3194,1240,1954
2000,188,Costa Rica,Dominican Republic,838,288,550
2000,222,El Salvador,Dominican Republic,43,23,20
2000,320,Guatemala,Dominican Republic,68,32,36
2000,340,Honduras,Dominican Republic,101,62,39
2000,484,Mexico,Dominican Republic,1199,567,632
2000,558,Nicaragua,Dominican Republic,55,28,27
2000,591,Panama,Dominican Republic,5859,1677,4182
2000,32,Argentina,Dominican Republic,1434,335,1099
2000,76,Brazil,Dominican Republic,102,35,67
2000,152,Chile,Dominican Republic,271,124,147
2000,170,Colombia,Dominican Republic,338,160,178
2000,218,Ecuador,Dominican Republic,147,65,82
2000,604,Peru,Dominican Republic,132,64,68
2000,862,Venezuela (Bolivarian Republic of),Dominican Republic,14293,5625,8668
2000,36,Australia,Dominican Republic,70,35,35
2000,100,Bulgaria,Dominican Republic,11,4,7
2000,203,Czechia,Dominican Republic,3,2,1
2000,348,Hungary,Dominican Republic,24,13,11
2000,616,Poland,Dominican Republic,3,2,1
2000,208,Denmark,Dominican Republic,77,24,53
2000,246,Finland,Dominican Republic,34,18,16
2000,352,Iceland,Dominican Republic,5,1,4
2000,372,Ireland,Dominican Republic,12,8,4
2000,578,Norway,Dominican Republic,236,75,161
2000,752,Sweden,Dominican Republic,245,123,122
2000,826,United Kingdom,Dominican Republic,504,242,262
2000,300,Greece,Dominican Republic,169,23,146
2000,380,Italy,Dominican Republic,17793,3432,14361
2000,620,Portugal,Dominican Republic,36,10,26
2000,705,Slovenia,Dominican Republic,1,0,1
2000,724,Spain,Dominican Republic,36953,10353,26600
2000,40,Austria,Dominican Republic,2163,672,1491
2000,56,Belgium,Dominican Republic,1728,536,1192
2000,250,France,Dominican Republic,483,161,322
2000,276,Germany,Dominican Republic,4643,998,3645
2000,438,Liechtenstein,Dominican Republic,2,1,1
2000,442,Luxembourg,Dominican Republic,31,11,20
2000,528,Netherlands,Dominican Republic,5593,1559,4034
2000,756,Switzerland,Dominican Republic,7223,2534,4689
2000,60,Bermuda,Dominican Republic,13,7,6
2000,124,Canada,Dominican Republic,5106,2463,2643
2000,840,United States of America,Dominican Republic,705139,308374,396765
2005,196,Cyprus,Dominican Republic,7,1,6
2005,660,Anguilla,Dominican Republic,560,359,201
2005,28,Antigua and Barbuda,Dominican Republic,1572,593,979
2005,533,Aruba,Dominican Republic,3903,1282,2621
2005,44,Bahamas,Dominican Republic,177,103,74
2005,92,British Virgin Islands,Dominican Republic,1157,556,601
2005,535,"Bonaire, Sint Eustatius and Saba",Dominican Republic,8887,2857,6030
2005,136,Cayman Islands,Dominican Republic,62,48,14
2005,192,Cuba,Dominican Republic,92,35,57
2005,312,Guadeloupe,Dominican Republic,1253,428,825
2005,332,Haiti,Dominican Republic,2061,1153,908
2005,474,Martinique,Dominican Republic,128,57,71
2005,500,Montserrat,Dominican Republic,22,16,6
2005,630,Puerto Rico,Dominican Republic,66983,31706,35277
2005,662,Saint Lucia,Dominican Republic,40,17,23
2005,534,Sint Maarten (Dutch part),Dominican Republic,1701,613,1088
2005,796,Turks and Caicos Islands,Dominican Republic,722,401,321
2005,850,United States Virgin Islands,Dominican Republic,3915,1530,2385
2005,188,Costa Rica,Dominican Republic,549,184,365
2005,222,El Salvador,Dominican Republic,56,30,26
2005,320,Guatemala,Dominican Republic,82,45,37
2005,340,Honduras,Dominican Republic,99,61,38
2005,484,Mexico,Dominican Republic,1324,645,679
2005,558,Nicaragua,Dominican Republic,60,31,29
2005,591,Panama,Dominican Republic,6227,1884,4343
2005,32,Argentina,Dominican Republic,1058,260,798
2005,68,Bolivia (Plurinational State of),Dominican Republic,50,27,23
2005,76,Brazil,Dominican Republic,207,52,155
2005,152,Chile,Dominican Republic,406,190,216
2005,170,Colombia,Dominican Republic,321,153,168
2005,218,Ecuador,Dominican Republic,173,78,95
2005,604,Peru,Dominican Republic,155,75,80
2005,862,Venezuela (Bolivarian Republic of),Dominican Republic,14286,5520,8766
2005,36,Australia,Dominican Republic,110,51,59
2005,100,Bulgaria,Dominican Republic,16,6,10
2005,203,Czechia,Dominican Republic,18,11,7
2005,348,Hungary,Dominican Republic,30,17,13
2005,616,Poland,Dominican Republic,11,4,7
2005,208,Denmark,Dominican Republic,103,31,72
2005,246,Finland,Dominican Republic,81,44,37
2005,352,Iceland,Dominican Republic,13,4,9
2005,372,Ireland,Dominican Republic,12,8,4
2005,578,Norway,Dominican Republic,382,129,253
2005,752,Sweden,Dominican Republic,399,196,203
2005,826,United Kingdom,Dominican Republic,877,453,424
2005,300,Greece,Dominican Republic,374,64,310
2005,380,Italy,Dominican Republic,30028,8312,21716
2005,620,Portugal,Dominican Republic,51,17,34
2005,705,Slovenia,Dominican Republic,31,0,31
2005,724,Spain,Dominican Republic,73049,24951,48098
2005,40,Austria,Dominican Republic,2418,712,1706
2005,56,Belgium,Dominican Republic,1731,646,1085
2005,250,France,Dominican Republic,4454,1311,3143
2005,276,Germany,Dominican Republic,7013,2039,4974
2005,438,Liechtenstein,Dominican Republic,32,11,21
2005,442,Luxembourg,Dominican Republic,26,10,16
2005,528,Netherlands,Dominican Republic,7037,2040,4997
2005,756,Switzerland,Dominican Republic,8108,2598,5510
2005,60,Bermuda,Dominican Republic,17,9,8
2005,124,Canada,Dominican Republic,6737,3328,3409
2005,840,United States of America,Dominican Republic,761989,335606,426383
2010,196,Cyprus,Dominican Republic,11,2,9
2010,660,Anguilla,Dominican Republic,610,392,218
2010,28,Antigua and Barbuda,Dominican Republic,1678,632,1046
2010,533,Aruba,Dominican Republic,4113,1544,2569
2010,44,Bahamas,Dominican Republic,269,160,109
2010,92,British Virgin Islands,Dominican Republic,1526,754,772
2010,535,"Bonaire, Sint Eustatius and Saba",Dominican Republic,1198,493,705
2010,136,Cayman Islands,Dominican Republic,61,47,14
2010,192,Cuba,Dominican Republic,51,20,31
2010,531,Curaçao,Dominican Republic,5259,1242,4017
2010,312,Guadeloupe,Dominican Republic,913,328,585
2010,332,Haiti,Dominican Republic,2164,1211,953
2010,474,Martinique,Dominican Republic,134,58,76
2010,500,Montserrat,Dominican Republic,23,17,6
2010,630,Puerto Rico,Dominican Republic,63981,29989,33992
2010,662,Saint Lucia,Dominican Republic,40,16,24
2010,534,Sint Maarten (Dutch part),Dominican Republic,3403,1227,2176
2010,796,Turks and Caicos Islands,Dominican Republic,1354,677,677
2010,850,United States Virgin Islands,Dominican Republic,4638,1821,2817
2010,188,Costa Rica,Dominican Republic,1082,364,718
2010,222,El Salvador,Dominican Republic,69,38,31
2010,320,Guatemala,Dominican Republic,95,57,38
2010,340,Honduras,Dominican Republic,96,60,36
2010,484,Mexico,Dominican Republic,1603,799,804
2010,558,Nicaragua,Dominican Republic,64,34,30
2010,591,Panama,Dominican Republic,6893,2249,4644
2010,32,Argentina,Dominican Republic,682,185,497
2010,68,Bolivia (Plurinational State of),Dominican Republic,100,54,46
2010,76,Brazil,Dominican Republic,309,69,240
2010,152,Chile,Dominican Republic,542,256,286
2010,170,Colombia,Dominican Republic,359,174,185
2010,218,Ecuador,Dominican Republic,243,107,136
2010,604,Peru,Dominican Republic,174,85,89
2010,862,Venezuela (Bolivarian Republic of),Dominican Republic,14423,5477,8946
2010,36,Australia,Dominican Republic,140,59,81
2010,100,Bulgaria,Dominican Republic,20,8,12
2010,203,Czechia,Dominican Republic,32,19,13
2010,348,Hungary,Dominican Republic,36,21,15
2010,616,Poland,Dominican Republic,21,6,15
2010,642,Romania,Dominican Republic,1,0,1
2010,208,Denmark,Dominican Republic,126,38,88
2010,233,Estonia,Dominican Republic,1,1,0
2010,246,Finland,Dominican Republic,145,73,72
2010,352,Iceland,Dominican Republic,21,7,14
2010,372,Ireland,Dominican Republic,10,6,4
2010,428,Latvia,Dominican Republic,1,1,0
2010,578,Norway,Dominican Republic,563,202,361
2010,752,Sweden,Dominican Republic,574,283,291
2010,826,United Kingdom,Dominican Republic,923,486,437
2010,300,Greece,Dominican Republic,601,108,493
2010,380,Italy,Dominican Republic,40445,12266,28179
2010,620,Portugal,Dominican Republic,59,22,37
2010,705,Slovenia,Dominican Republic,151,10,141
2010,724,Spain,Dominican Republic,136976,53143,83833
2010,40,Austria,Dominican Republic,2672,751,1921
2010,56,Belgium,Dominican Republic,2006,721,1285
2010,250,France,Dominican Republic,3277,1043,2234
2010,276,Germany,Dominican Republic,8972,2922,6050
2010,438,Liechtenstein,Dominican Republic,64,22,42
2010,442,Luxembourg,Dominican Republic,23,10,13
2010,528,Netherlands,Dominican Republic,7792,2327,5465
2010,756,Switzerland,Dominican Republic,9543,2660,6883
2010,60,Bermuda,Dominican Republic,21,12,9
2010,124,Canada,Dominican Republic,8450,4240,4210
2010,840,United States of America,Dominican Republic,843720,365108,478612
2015,324,Guinea,Dominican Republic,2,1,1
2015,196,Cyprus,Dominican Republic,10,2,8
2015,660,Anguilla,Dominican Republic,653,420,233
2015,28,Antigua and Barbuda,Dominican Republic,1784,671,1113
2015,533,Aruba,Dominican Republic,4327,1619,2708
2015,44,Bahamas,Dominican Republic,291,172,119
2015,92,British Virgin Islands,Dominican Republic,1709,845,864
2015,535,"Bonaire, Sint Eustatius and Saba",Dominican Republic,1362,560,802
2015,136,Cayman Islands,Dominican Republic,66,52,14
2015,192,Cuba,Dominican Republic,40,15,25
2015,531,Curaçao,Dominican Republic,5715,1357,4358
2015,312,Guadeloupe,Dominican Republic,947,334,613
2015,332,Haiti,Dominican Republic,2272,1272,1000
2015,474,Martinique,Dominican Republic,138,59,79
2015,500,Montserrat,Dominican Republic,24,18,6
2015,630,Puerto Rico,Dominican Republic,57891,27004,30887
2015,662,Saint Lucia,Dominican Republic,38,16,22
2015,534,Sint Maarten (Dutch part),Dominican Republic,3546,1275,2271
2015,796,Turks and Caicos Islands,Dominican Republic,1756,879,877
2015,850,United States Virgin Islands,Dominican Republic,4641,1822,2819
2015,188,Costa Rica,Dominican Republic,1098,365,733
2015,222,El Salvador,Dominican Republic,72,40,32
2015,320,Guatemala,Dominican Republic,109,66,43
2015,340,Honduras,Dominican Republic,135,85,50
2015,484,Mexico,Dominican Republic,2874,1154,1720
2015,558,Nicaragua,Dominican Republic,69,37,32
2015,591,Panama,Dominican Republic,8095,2627,5468
2015,32,Argentina,Dominican Republic,684,185,499
2015,68,Bolivia (Plurinational State of),Dominican Republic,116,62,54
2015,76,Brazil,Dominican Republic,372,83,289
2015,152,Chile,Dominican Republic,821,379,442
2015,170,Colombia,Dominican Republic,401,196,205
2015,218,Ecuador,Dominican Republic,353,154,199
2015,604,Peru,Dominican Republic,184,92,92
2015,862,Venezuela (Bolivarian Republic of),Dominican Republic,14743,5470,9273
2015,36,Australia,Dominican Republic,210,90,120
2015,100,Bulgaria,Dominican Republic,46,19,27
2015,203,Czechia,Dominican Republic,58,32,26
2015,348,Hungary,Dominican Republic,35,19,16
2015,616,Poland,Dominican Republic,20,6,14
2015,642,Romania,Dominican Republic,17,9,8
2015,208,Denmark,Dominican Republic,170,58,112
2015,233,Estonia,Dominican Republic,3,3,0
2015,246,Finland,Dominican Republic,202,105,97
2015,352,Iceland,Dominican Republic,32,9,23
2015,372,Ireland,Dominican Republic,10,6,4
2015,428,Latvia,Dominican Republic,1,0,1
2015,578,Norway,Dominican Republic,799,308,491
2015,752,Sweden,Dominican Republic,733,359,374
2015,826,United Kingdom,Dominican Republic,1180,605,575
2015,300,Greece,Dominican Republic,564,82,482
2015,380,Italy,Dominican Republic,42011,12880,29131
2015,620,Portugal,Dominican Republic,66,22,44
2015,705,Slovenia,Dominican Republic,166,22,144
2015,724,Spain,Dominican Republic,156905,61042,95863
2015,40,Austria,Dominican Republic,3125,891,2234
2015,56,Belgium,Dominican Republic,2666,969,1697
2015,250,France,Dominican Republic,3631,1089,2542
2015,276,Germany,Dominican Republic,9349,3030,6319
2015,438,Liechtenstein,Dominican Republic,73,20,53
2015,442,Luxembourg,Dominican Republic,35,16,19
2015,528,Netherlands,Dominican Republic,8688,2727,5961
2015,756,Switzerland,Dominican Republic,11481,3348,8133
2015,60,Bermuda,Dominican Republic,21,12,9
2015,124,Canada,Dominican Republic,10535,5087,5448
2015,840,United States of America,Dominican Republic,1086819,467139,619680
2019,324,Guinea,Dominican Republic,1,1,0
2019,196,Cyprus,Dominican Republic,9,2,7
2019,660,Anguilla,Dominican Republic,677,436,241
2019,28,Antigua and Barbuda,Dominican Republic,1855,698,1157
2019,533,Aruba,Dominican Republic,4377,1638,2739
2019,44,Bahamas,Dominican Republic,308,182,126
2019,92,British Virgin Islands,Dominican Republic,1856,918,938
2019,535,"Bonaire, Sint Eustatius and Saba",Dominican Republic,1621,667,954
2019,136,Cayman Islands,Dominican Republic,72,57,15
2019,192,Cuba,Dominican Republic,36,13,23
2019,531,Curaçao,Dominican Republic,6212,1475,4737
2019,312,Guadeloupe,Dominican Republic,961,339,622
2019,332,Haiti,Dominican Republic,2362,1323,1039
2019,474,Martinique,Dominican Republic,137,59,78
2019,500,Montserrat,Dominican Republic,24,18,6
2019,630,Puerto Rico,Dominican Republic,50643,23518,27125
2019,662,Saint Lucia,Dominican Republic,36,16,20
2019,534,Sint Maarten (Dutch part),Dominican Republic,3671,1320,2351
2019,796,Turks and Caicos Islands,Dominican Republic,1896,950,946
2019,850,United States Virgin Islands,Dominican Republic,4642,1822,2820
2019,188,Costa Rica,Dominican Republic,1114,376,738
2019,222,El Salvador,Dominican Republic,72,40,32
2019,320,Guatemala,Dominican Republic,111,67,44
2019,340,Honduras,Dominican Republic,137,87,50
2019,484,Mexico,Dominican Republic,2963,1190,1773
2019,558,Nicaragua,Dominican Republic,72,39,33
2019,591,Panama,Dominican Republic,8606,2790,5816
2019,32,Argentina,Dominican Republic,695,187,508
2019,68,Bolivia (Plurinational State of),Dominican Republic,126,68,58
2019,76,Brazil,Dominican Republic,418,93,325
2019,152,Chile,Dominican Republic,1096,473,623
2019,170,Colombia,Dominican Republic,410,201,209
2019,218,Ecuador,Dominican Republic,347,151,196
2019,604,Peru,Dominican Republic,219,114,105
2019,862,Venezuela (Bolivarian Republic of),Dominican Republic,14441,5318,9123
2019,36,Australia,Dominican Republic,232,84,148
2019,100,Bulgaria,Dominican Republic,57,23,34
2019,203,Czechia,Dominican Republic,75,41,34
2019,348,Hungary,Dominican Republic,50,24,26
2019,616,Poland,Dominican Republic,21,7,14
2019,642,Romania,Dominican Republic,46,22,24
2019,208,Denmark,Dominican Republic,209,78,131
2019,233,Estonia,Dominican Republic,5,5,0
2019,246,Finland,Dominican Republic,244,127,117
2019,352,Iceland,Dominican Republic,50,19,31
2019,372,Ireland,Dominican Republic,10,6,4
2019,578,Norway,Dominican Republic,962,375,587
2019,752,Sweden,Dominican Republic,914,432,482
2019,826,United Kingdom,Dominican Republic,1340,689,651
2019,300,Greece,Dominican Republic,550,98,452
2019,380,Italy,Dominican Republic,46127,14472,31655
2019,620,Portugal,Dominican Republic,137,44,93
2019,705,Slovenia,Dominican Republic,186,29,157
2019,724,Spain,Dominican Republic,167176,64140,103036
2019,40,Austria,Dominican Republic,3689,1098,2591
2019,56,Belgium,Dominican Republic,3003,1136,1867
2019,250,France,Dominican Republic,3843,1147,2696
2019,276,Germany,Dominican Republic,10255,3513,6742
2019,438,Liechtenstein,Dominican Republic,87,24,63
2019,442,Luxembourg,Dominican Republic,520,154,366
2019,528,Netherlands,Dominican Republic,9513,3098,6415
2019,756,Switzerland,Dominican Republic,12214,3700,8514
2019,60,Bermuda,Dominican Republic,21,12,9
2019,124,Canada,Dominican Republic,11289,5451,5838
2019,840,United States of America,Dominican Republic,1173662,497264,676398
1990,818,Egypt,Ecuador,9,2,7
1990,196,Cyprus,Ecuador,2,1,1
1990,608,Philippines,Ecuador,105,58,47
1990,44,Bahamas,Ecuador,10,3,7
1990,192,Cuba,Ecuador,135,67,68
1990,214,Dominican Republic,Ecuador,950,439,511
1990,630,Puerto Rico,Ecuador,573,271,302
1990,188,Costa Rica,Ecuador,736,406,330
1990,222,El Salvador,Ecuador,155,70,85
1990,320,Guatemala,Ecuador,120,46,74
1990,340,Honduras,Ecuador,348,239,109
1990,484,Mexico,Ecuador,719,338,381
1990,558,Nicaragua,Ecuador,98,55,43
1990,591,Panama,Ecuador,1414,883,531
1990,32,Argentina,Ecuador,999,509,490
1990,68,Bolivia (Plurinational State of),Ecuador,299,138,161
1990,76,Brazil,Ecuador,614,402,212
1990,152,Chile,Ecuador,2163,1012,1151
1990,170,Colombia,Ecuador,11870,6223,5647
1990,604,Peru,Ecuador,2488,1066,1422
1990,862,Venezuela (Bolivarian Republic of),Ecuador,24600,12181,12419
1990,36,Australia,Ecuador,1085,573,512
1990,100,Bulgaria,Ecuador,1,1,0
1990,203,Czechia,Ecuador,10,7,3
1990,348,Hungary,Ecuador,22,14,8
1990,616,Poland,Ecuador,43,33,10
1990,643,Russian Federation,Ecuador,336,165,171
1990,703,Slovakia,Ecuador,1,1,0
1990,208,Denmark,Ecuador,159,67,92
1990,246,Finland,Ecuador,24,13,11
1990,352,Iceland,Ecuador,7,3,4
1990,372,Ireland,Ecuador,8,3,5
1990,578,Norway,Ecuador,177,90,87
1990,752,Sweden,Ecuador,746,387,359
1990,826,United Kingdom,Ecuador,423,244,179
1990,300,Greece,Ecuador,51,28,23
1990,380,Italy,Ecuador,997,347,650
1990,620,Portugal,Ecuador,65,32,33
1990,724,Spain,Ecuador,3734,1518,2216
1990,40,Austria,Ecuador,364,160,204
1990,56,Belgium,Ecuador,1603,621,982
1990,250,France,Ecuador,1585,598,987
1990,276,Germany,Ecuador,1252,563,689
1990,528,Netherlands,Ecuador,439,184,255
1990,756,Switzerland,Ecuador,1470,580,890
1990,124,Canada,Ecuador,7685,3742,3943
1990,840,United States of America,Ecuador,143314,71263,72051
1995,818,Egypt,Ecuador,9,2,7
1995,196,Cyprus,Ecuador,3,1,2
1995,608,Philippines,Ecuador,141,77,64
1995,44,Bahamas,Ecuador,12,3,9
1995,192,Cuba,Ecuador,102,48,54
1995,214,Dominican Republic,Ecuador,1055,473,582
1995,630,Puerto Rico,Ecuador,675,320,355
1995,188,Costa Rica,Ecuador,683,382,301
1995,222,El Salvador,Ecuador,126,57,69
1995,320,Guatemala,Ecuador,113,50,63
1995,340,Honduras,Ecuador,345,233,112
1995,484,Mexico,Ecuador,1222,580,642
1995,558,Nicaragua,Ecuador,78,43,35
1995,591,Panama,Ecuador,1604,958,646
1995,32,Argentina,Ecuador,1501,731,770
1995,68,Bolivia (Plurinational State of),Ecuador,521,251,270
1995,76,Brazil,Ecuador,903,545,358
1995,152,Chile,Ecuador,5512,2467,3045
1995,170,Colombia,Ecuador,11917,6216,5701
1995,604,Peru,Ecuador,2491,1050,1441
1995,862,Venezuela (Bolivarian Republic of),Ecuador,26835,13121,13714
1995,36,Australia,Ecuador,1316,665,651
1995,100,Bulgaria,Ecuador,4,2,2
1995,203,Czechia,Ecuador,15,10,5
1995,348,Hungary,Ecuador,49,30,19
1995,616,Poland,Ecuador,36,28,8
1995,643,Russian Federation,Ecuador,313,172,141
1995,703,Slovakia,Ecuador,10,7,3
1995,208,Denmark,Ecuador,269,122,147
1995,246,Finland,Ecuador,35,19,16
1995,352,Iceland,Ecuador,10,4,6
1995,372,Ireland,Ecuador,21,6,15
1995,578,Norway,Ecuador,272,138,134
1995,752,Sweden,Ecuador,885,456,429
1995,826,United Kingdom,Ecuador,1665,766,899
1995,300,Greece,Ecuador,48,17,31
1995,380,Italy,Ecuador,11373,3700,7673
1995,620,Portugal,Ecuador,140,70,70
1995,724,Spain,Ecuador,11606,5098,6508
1995,40,Austria,Ecuador,411,184,227
1995,56,Belgium,Ecuador,1598,617,981
1995,250,France,Ecuador,1637,601,1036
1995,276,Germany,Ecuador,2397,955,1442
1995,528,Netherlands,Ecuador,646,262,384
1995,756,Switzerland,Ecuador,2337,1004,1333
1995,124,Canada,Ecuador,9362,4533,4829
1995,840,United States of America,Ecuador,223927,112591,111336
2000,818,Egypt,Ecuador,9,2,7
2000,196,Cyprus,Ecuador,4,2,2
2000,608,Philippines,Ecuador,481,244,237
2000,44,Bahamas,Ecuador,15,5,10
2000,192,Cuba,Ecuador,69,29,40
2000,214,Dominican Republic,Ecuador,1160,507,653
2000,630,Puerto Rico,Ecuador,780,370,410
2000,188,Costa Rica,Ecuador,971,535,436
2000,222,El Salvador,Ecuador,97,44,53
2000,320,Guatemala,Ecuador,105,54,51
2000,340,Honduras,Ecuador,342,228,114
2000,484,Mexico,Ecuador,1778,850,928
2000,558,Nicaragua,Ecuador,86,50,36
2000,591,Panama,Ecuador,1896,1089,807
2000,32,Argentina,Ecuador,2004,954,1050
2000,68,Bolivia (Plurinational State of),Ecuador,738,362,376
2000,76,Brazil,Ecuador,1191,688,503
2000,152,Chile,Ecuador,8857,3937,4920
2000,170,Colombia,Ecuador,11964,6209,5755
2000,604,Peru,Ecuador,2911,1235,1676
2000,862,Venezuela (Bolivarian Republic of),Ecuador,28999,13977,15022
2000,36,Australia,Ecuador,1460,723,737
2000,100,Bulgaria,Ecuador,6,2,4
2000,203,Czechia,Ecuador,19,12,7
2000,348,Hungary,Ecuador,76,47,29
2000,616,Poland,Ecuador,31,24,7
2000,643,Russian Federation,Ecuador,280,174,106
2000,703,Slovakia,Ecuador,22,13,9
2000,208,Denmark,Ecuador,379,178,201
2000,246,Finland,Ecuador,45,25,20
2000,352,Iceland,Ecuador,13,6,7
2000,372,Ireland,Ecuador,46,15,31
2000,578,Norway,Ecuador,376,194,182
2000,752,Sweden,Ecuador,950,486,464
2000,826,United Kingdom,Ecuador,2936,1298,1638
2000,300,Greece,Ecuador,46,5,41
2000,380,Italy,Ecuador,21748,7053,14695
2000,620,Portugal,Ecuador,222,111,111
2000,705,Slovenia,Ecuador,16,14,2
2000,724,Spain,Ecuador,24472,11046,13426
2000,40,Austria,Ecuador,457,208,249
2000,56,Belgium,Ecuador,1547,600,947
2000,250,France,Ecuador,1688,603,1085
2000,276,Germany,Ecuador,3541,1346,2195
2000,528,Netherlands,Ecuador,876,348,528
2000,756,Switzerland,Ecuador,3213,1436,1777
2000,124,Canada,Ecuador,11261,5433,5828
2000,840,United States of America,Ecuador,306208,154967,151241
2005,818,Egypt,Ecuador,11,3,8
2005,196,Cyprus,Ecuador,6,3,3
2005,608,Philippines,Ecuador,389,201,188
2005,44,Bahamas,Ecuador,28,16,12
2005,192,Cuba,Ecuador,46,20,26
2005,214,Dominican Republic,Ecuador,859,397,462
2005,630,Puerto Rico,Ecuador,949,449,500
2005,188,Costa Rica,Ecuador,636,347,289
2005,222,El Salvador,Ecuador,108,50,58
2005,320,Guatemala,Ecuador,125,68,57
2005,340,Honduras,Ecuador,335,224,111
2005,484,Mexico,Ecuador,1880,913,967
2005,558,Nicaragua,Ecuador,97,58,39
2005,591,Panama,Ecuador,2037,1124,913
2005,32,Argentina,Ecuador,1478,716,762
2005,68,Bolivia (Plurinational State of),Ecuador,800,419,381
2005,76,Brazil,Ecuador,1463,784,679
2005,152,Chile,Ecuador,13414,6082,7332
2005,170,Colombia,Ecuador,11617,6056,5561
2005,604,Peru,Ecuador,3419,1462,1957
2005,862,Venezuela (Bolivarian Republic of),Ecuador,31597,15452,16145
2005,36,Australia,Ecuador,1650,804,846
2005,100,Bulgaria,Ecuador,9,3,6
2005,203,Czechia,Ecuador,50,31,19
2005,348,Hungary,Ecuador,94,59,35
2005,616,Poland,Ecuador,38,35,3
2005,643,Russian Federation,Ecuador,260,170,90
2005,703,Slovakia,Ecuador,25,15,10
2005,208,Denmark,Ecuador,462,211,251
2005,246,Finland,Ecuador,103,59,44
2005,352,Iceland,Ecuador,20,8,12
2005,372,Ireland,Ecuador,46,17,29
2005,578,Norway,Ecuador,478,241,237
2005,752,Sweden,Ecuador,1391,712,679
2005,826,United Kingdom,Ecuador,5440,2476,2964
2005,300,Greece,Ecuador,66,11,55
2005,380,Italy,Ecuador,55031,21026,34005
2005,620,Portugal,Ecuador,335,166,169
2005,705,Slovenia,Ecuador,4,3,1
2005,724,Spain,Ecuador,456379,220296,236083
2005,40,Austria,Ecuador,511,226,285
2005,56,Belgium,Ecuador,2764,1064,1700
2005,250,France,Ecuador,3500,1400,2100
2005,276,Germany,Ecuador,5360,2042,3318
2005,528,Netherlands,Ecuador,1433,546,887
2005,756,Switzerland,Ecuador,3720,1560,2160
2005,124,Canada,Ecuador,12238,5678,6560
2005,840,United States of America,Ecuador,364358,185391,178967
2010,818,Egypt,Ecuador,12,3,9
2010,196,Cyprus,Ecuador,9,5,4
2010,608,Philippines,Ecuador,452,224,228
2010,44,Bahamas,Ecuador,40,26,14
2010,192,Cuba,Ecuador,25,11,14
2010,214,Dominican Republic,Ecuador,551,283,268
2010,630,Puerto Rico,Ecuador,999,468,531
2010,188,Costa Rica,Ecuador,1253,684,569
2010,222,El Salvador,Ecuador,118,56,62
2010,320,Guatemala,Ecuador,145,82,63
2010,340,Honduras,Ecuador,328,221,107
2010,484,Mexico,Ecuador,2201,1084,1117
2010,558,Nicaragua,Ecuador,103,62,41
2010,591,Panama,Ecuador,2275,1225,1050
2010,32,Argentina,Ecuador,952,478,474
2010,68,Bolivia (Plurinational State of),Ecuador,861,476,385
2010,76,Brazil,Ecuador,1715,868,847
2010,152,Chile,Ecuador,17966,8227,9739
2010,170,Colombia,Ecuador,13284,7036,6248
2010,604,Peru,Ecuador,5312,2578,2734
2010,862,Venezuela (Bolivarian Republic of),Ecuador,34782,17270,17512
2010,36,Australia,Ecuador,1940,954,986
2010,100,Bulgaria,Ecuador,12,4,8
2010,203,Czechia,Ecuador,76,47,29
2010,348,Hungary,Ecuador,112,71,41
2010,616,Poland,Ecuador,47,47,0
2010,643,Russian Federation,Ecuador,236,163,73
2010,703,Slovakia,Ecuador,28,17,11
2010,208,Denmark,Ecuador,535,240,295
2010,233,Estonia,Ecuador,7,5,2
2010,246,Finland,Ecuador,172,94,78
2010,352,Iceland,Ecuador,25,9,16
2010,372,Ireland,Ecuador,38,12,26
2010,578,Norway,Ecuador,585,300,285
2010,752,Sweden,Ecuador,1992,1020,972
2010,826,United Kingdom,Ecuador,5730,2672,3058
2010,300,Greece,Ecuador,89,19,70
2010,380,Italy,Ecuador,89989,35368,54621
2010,620,Portugal,Ecuador,394,194,200
2010,705,Slovenia,Ecuador,13,7,6
2010,724,Spain,Ecuador,496666,240847,255819
2010,40,Austria,Ecuador,565,244,321
2010,56,Belgium,Ecuador,4358,1748,2610
2010,250,France,Ecuador,3884,1331,2553
2010,276,Germany,Ecuador,6865,2637,4228
2010,528,Netherlands,Ecuador,1798,691,1107
2010,756,Switzerland,Ecuador,4245,1636,2609
2010,124,Canada,Ecuador,13635,6141,7494
2010,840,United States of America,Ecuador,435209,218500,216709
2015,324,Guinea,Ecuador,2,2,0
2015,818,Egypt,Ecuador,8,3,5
2015,196,Cyprus,Ecuador,8,5,3
2015,608,Philippines,Ecuador,459,227,232
2015,44,Bahamas,Ecuador,43,28,15
2015,192,Cuba,Ecuador,20,9,11
2015,214,Dominican Republic,Ecuador,581,298,283
2015,630,Puerto Rico,Ecuador,851,397,454
2015,188,Costa Rica,Ecuador,1272,691,581
2015,222,El Salvador,Ecuador,123,58,65
2015,320,Guatemala,Ecuador,167,96,71
2015,340,Honduras,Ecuador,461,312,149
2015,484,Mexico,Ecuador,3236,1376,1860
2015,558,Nicaragua,Ecuador,111,67,44
2015,591,Panama,Ecuador,2672,1435,1237
2015,32,Argentina,Ecuador,955,479,476
2015,68,Bolivia (Plurinational State of),Ecuador,1002,554,448
2015,76,Brazil,Ecuador,2065,1045,1020
2015,152,Chile,Ecuador,22146,9881,12265
2015,170,Colombia,Ecuador,14872,7945,6927
2015,604,Peru,Ecuador,6855,3683,3172
2015,862,Venezuela (Bolivarian Republic of),Ecuador,36973,18095,18878
2015,36,Australia,Ecuador,2810,1397,1413
2015,100,Bulgaria,Ecuador,17,4,13
2015,203,Czechia,Ecuador,93,57,36
2015,348,Hungary,Ecuador,114,69,45
2015,616,Poland,Ecuador,45,45,0
2015,643,Russian Federation,Ecuador,241,166,75
2015,703,Slovakia,Ecuador,36,22,14
2015,208,Denmark,Ecuador,620,277,343
2015,233,Estonia,Ecuador,11,7,4
2015,246,Finland,Ecuador,232,126,106
2015,352,Iceland,Ecuador,32,12,20
2015,372,Ireland,Ecuador,39,12,27
2015,428,Latvia,Ecuador,2,0,2
2015,578,Norway,Ecuador,767,386,381
2015,752,Sweden,Ecuador,2422,1251,1171
2015,826,United Kingdom,Ecuador,7327,3301,4026
2015,300,Greece,Ecuador,83,15,68
2015,380,Italy,Ecuador,84513,32772,51741
2015,620,Portugal,Ecuador,447,210,237
2015,705,Slovenia,Ecuador,9,4,5
2015,724,Spain,Ecuador,416394,195324,221070
2015,40,Austria,Ecuador,662,288,374
2015,56,Belgium,Ecuador,6145,2469,3676
2015,250,France,Ecuador,4302,1396,2906
2015,276,Germany,Ecuador,7153,2737,4416
2015,528,Netherlands,Ecuador,2182,842,1340
2015,756,Switzerland,Ecuador,6505,2641,3864
2015,124,Canada,Ecuador,14873,6755,8118
2015,840,United States of America,Ecuador,478039,238781,239258
2019,324,Guinea,Ecuador,1,1,0
2019,818,Egypt,Ecuador,11,4,7
2019,196,Cyprus,Ecuador,7,5,2
2019,608,Philippines,Ecuador,473,234,239
2019,44,Bahamas,Ecuador,45,30,15
2019,192,Cuba,Ecuador,18,8,10
2019,214,Dominican Republic,Ecuador,600,308,292
2019,630,Puerto Rico,Ecuador,376,175,201
2019,188,Costa Rica,Ecuador,1290,705,585
2019,222,El Salvador,Ecuador,124,59,65
2019,320,Guatemala,Ecuador,171,99,72
2019,340,Honduras,Ecuador,468,317,151
2019,484,Mexico,Ecuador,3336,1419,1917
2019,558,Nicaragua,Ecuador,116,70,46
2019,591,Panama,Ecuador,2837,1525,1312
2019,32,Argentina,Ecuador,971,486,485
2019,68,Bolivia (Plurinational State of),Ecuador,1093,604,489
2019,76,Brazil,Ecuador,2325,1177,1148
2019,152,Chile,Ecuador,30325,13025,17300
2019,170,Colombia,Ecuador,15212,8127,7085
2019,604,Peru,Ecuador,8171,4544,3627
2019,862,Venezuela (Bolivarian Republic of),Ecuador,36215,17641,18574
2019,36,Australia,Ecuador,2898,1442,1456
2019,100,Bulgaria,Ecuador,19,6,13
2019,203,Czechia,Ecuador,112,69,43
2019,348,Hungary,Ecuador,180,98,82
2019,616,Poland,Ecuador,47,47,0
2019,643,Russian Federation,Ecuador,240,166,74
2019,703,Slovakia,Ecuador,40,25,15
2019,208,Denmark,Ecuador,677,299,378
2019,233,Estonia,Ecuador,14,12,2
2019,246,Finland,Ecuador,276,144,132
2019,352,Iceland,Ecuador,42,16,26
2019,372,Ireland,Ecuador,42,13,29
2019,428,Latvia,Ecuador,1,0,1
2019,578,Norway,Ecuador,851,421,430
2019,752,Sweden,Ecuador,2623,1298,1325
2019,826,United Kingdom,Ecuador,8320,3760,4560
2019,300,Greece,Ecuador,81,18,63
2019,380,Italy,Ecuador,85272,33348,51924
2019,620,Portugal,Ecuador,454,214,240
2019,705,Slovenia,Ecuador,11,4,7
2019,724,Spain,Ecuador,415310,191519,223791
2019,40,Austria,Ecuador,781,348,433
2019,56,Belgium,Ecuador,6635,2696,3939
2019,250,France,Ecuador,4553,1470,3083
2019,276,Germany,Ecuador,7846,3326,4520
2019,528,Netherlands,Ecuador,2618,1008,1610
2019,756,Switzerland,Ecuador,7442,3097,4345
2019,124,Canada,Ecuador,15938,7239,8699
2019,840,United States of America,Ecuador,516236,255081,261155
1990,800,Uganda,Egypt,44,35,9
1990,894,Zambia,Egypt,235,134,101
1990,140,Central African Republic,Egypt,67,46,21
1990,516,Namibia,Egypt,257,156,101
1990,710,South Africa,Egypt,837,442,395
1990,288,Ghana,Egypt,21,11,10
1990,478,Mauritania,Egypt,202,89,113
1990,434,Libya,Egypt,8384,4625,3759
1990,504,Morocco,Egypt,1271,673,598
1990,729,Sudan,Egypt,21455,11031,10424
1990,788,Tunisia,Egypt,607,302,305
1990,48,Bahrain,Egypt,21908,13549,8359
1990,196,Cyprus,Egypt,1290,774,516
1990,368,Iraq,Egypt,11075,8898,2177
1990,376,Israel,Egypt,21780,10470,11310
1990,400,Jordan,Egypt,171413,121445,49968
1990,414,Kuwait,Egypt,135880,65940,69940
1990,422,Lebanon,Egypt,78308,55481,22827
1990,512,Oman,Egypt,18811,10270,8541
1990,634,Qatar,Egypt,250,183,67
1990,682,Saudi Arabia,Egypt,357540,237829,119711
1990,275,State of Palestine,Egypt,17920,8003,9917
1990,792,Turkey,Egypt,2318,1314,1004
1990,784,United Arab Emirates,Egypt,165980,103608,62372
1990,887,Yemen,Egypt,8579,4760,3819
1990,462,Maldives,Egypt,15,8,7
1990,144,Sri Lanka,Egypt,1,1,0
1990,392,Japan,Egypt,368,187,181
1990,608,Philippines,Egypt,33,25,8
1990,28,Antigua and Barbuda,Egypt,12,6,6
1990,44,Bahamas,Egypt,9,4,5
1990,630,Puerto Rico,Egypt,69,33,36
1990,188,Costa Rica,Egypt,19,13,6
1990,320,Guatemala,Egypt,22,4,18
1990,484,Mexico,Egypt,197,93,104
1990,591,Panama,Egypt,21,9,12
1990,32,Argentina,Egypt,522,278,244
1990,68,Bolivia (Plurinational State of),Egypt,39,23,16
1990,76,Brazil,Egypt,4192,2260,1932
1990,152,Chile,Egypt,84,50,34
1990,170,Colombia,Egypt,179,104,75
1990,218,Ecuador,Egypt,28,19,9
1990,604,Peru,Egypt,11,10,1
1990,862,Venezuela (Bolivarian Republic of),Egypt,472,254,218
1990,36,Australia,Egypt,40628,21092,19536
1990,554,New Zealand,Egypt,234,129,105
1990,100,Bulgaria,Egypt,30,23,7
1990,203,Czechia,Egypt,39,30,9
1990,348,Hungary,Egypt,251,220,31
1990,616,Poland,Egypt,289,211,78
1990,642,Romania,Egypt,7,4,3
1990,643,Russian Federation,Egypt,1499,736,763
1990,703,Slovakia,Egypt,9,8,1
1990,208,Denmark,Egypt,869,581,288
1990,246,Finland,Egypt,209,186,23
1990,352,Iceland,Egypt,8,6,2
1990,372,Ireland,Egypt,102,70,32
1990,428,Latvia,Egypt,5,4,1
1990,440,Lithuania,Egypt,3,2,1
1990,578,Norway,Egypt,290,215,75
1990,752,Sweden,Egypt,1638,1057,581
1990,826,United Kingdom,Egypt,22368,11880,10488
1990,300,Greece,Egypt,12485,8991,3494
1990,380,Italy,Egypt,40045,26385,13660
1990,470,Malta,Egypt,255,157,98
1990,807,North Macedonia,Egypt,1969,821,1148
1990,620,Portugal,Egypt,30,17,13
1990,688,Serbia,Egypt,9,7,2
1990,705,Slovenia,Egypt,14,7,7
1990,724,Spain,Egypt,1040,691,349
1990,40,Austria,Egypt,8202,5199,3003
1990,56,Belgium,Egypt,1638,1152,486
1990,250,France,Egypt,22453,14584,7869
1990,276,Germany,Egypt,10932,8301,2631
1990,442,Luxembourg,Egypt,25,15,10
1990,528,Netherlands,Egypt,4725,3679,1046
1990,756,Switzerland,Egypt,3959,2367,1592
1990,124,Canada,Egypt,26881,13086,13795
1990,840,United States of America,Egypt,66313,37580,28733
1995,800,Uganda,Egypt,41,33,8
1995,894,Zambia,Egypt,139,80,59
1995,140,Central African Republic,Egypt,65,38,27
1995,516,Namibia,Egypt,245,150,95
1995,710,South Africa,Egypt,1204,667,537
1995,288,Ghana,Egypt,21,12,9
1995,478,Mauritania,Egypt,215,106,109
1995,434,Libya,Egypt,11822,7208,4614
1995,504,Morocco,Egypt,1166,609,557
1995,729,Sudan,Egypt,21886,11275,10611
1995,788,Tunisia,Egypt,602,303,299
1995,48,Bahrain,Egypt,23628,15058,8570
1995,196,Cyprus,Egypt,1824,1065,759
1995,368,Iraq,Egypt,13058,9848,3210
1995,376,Israel,Egypt,22829,10811,12018
1995,400,Jordan,Egypt,229396,162571,66825
1995,414,Kuwait,Egypt,107006,59047,47959
1995,422,Lebanon,Egypt,104377,72174,32203
1995,512,Oman,Egypt,27544,16042,11502
1995,634,Qatar,Egypt,271,203,68
1995,682,Saudi Arabia,Egypt,366429,244383,122046
1995,275,State of Palestine,Egypt,17515,7771,9744
1995,792,Turkey,Egypt,1514,867,647
1995,784,United Arab Emirates,Egypt,207924,137088,70836
1995,887,Yemen,Egypt,8886,4991,3895
1995,462,Maldives,Egypt,24,12,12
1995,144,Sri Lanka,Egypt,15,13,2
1995,392,Japan,Egypt,645,309,336
1995,608,Philippines,Egypt,44,34,10
1995,28,Antigua and Barbuda,Egypt,10,5,5
1995,44,Bahamas,Egypt,8,3,5
1995,630,Puerto Rico,Egypt,72,35,37
1995,188,Costa Rica,Egypt,11,8,3
1995,320,Guatemala,Egypt,21,3,18
1995,484,Mexico,Egypt,174,95,79
1995,591,Panama,Egypt,30,13,17
1995,32,Argentina,Egypt,510,274,236
1995,68,Bolivia (Plurinational State of),Egypt,33,18,15
1995,76,Brazil,Egypt,3796,1956,1840
1995,152,Chile,Egypt,81,52,29
1995,170,Colombia,Egypt,159,94,65
1995,218,Ecuador,Egypt,32,22,10
1995,604,Peru,Egypt,12,10,2
1995,862,Venezuela (Bolivarian Republic of),Egypt,350,183,167
1995,36,Australia,Egypt,39901,20541,19360
1995,554,New Zealand,Egypt,435,252,183
1995,100,Bulgaria,Egypt,50,38,12
1995,203,Czechia,Egypt,58,45,13
1995,348,Hungary,Egypt,390,315,75
1995,616,Poland,Egypt,246,179,67
1995,642,Romania,Egypt,13,9,4
1995,643,Russian Federation,Egypt,1488,771,717
1995,703,Slovakia,Egypt,55,53,2
1995,208,Denmark,Egypt,1076,720,356
1995,246,Finland,Egypt,276,245,31
1995,352,Iceland,Egypt,12,9,3
1995,372,Ireland,Egypt,284,192,92
1995,428,Latvia,Egypt,8,7,1
1995,440,Lithuania,Egypt,4,3,1
1995,578,Norway,Egypt,310,228,82
1995,752,Sweden,Egypt,1944,1249,695
1995,826,United Kingdom,Egypt,22933,12296,10637
1995,300,Greece,Egypt,22258,12917,9341
1995,380,Italy,Egypt,41691,27107,14584
1995,470,Malta,Egypt,299,186,113
1995,807,North Macedonia,Egypt,1843,769,1074
1995,620,Portugal,Egypt,64,36,28
1995,688,Serbia,Egypt,59,40,19
1995,705,Slovenia,Egypt,29,15,14
1995,724,Spain,Egypt,1267,858,409
1995,40,Austria,Egypt,9253,5920,3333
1995,56,Belgium,Egypt,1627,1144,483
1995,250,France,Egypt,23179,14919,8260
1995,276,Germany,Egypt,12245,9138,3107
1995,442,Luxembourg,Egypt,23,14,9
1995,528,Netherlands,Egypt,6789,5253,1536
1995,756,Switzerland,Egypt,4155,2629,1526
1995,124,Canada,Egypt,31290,15151,16139
1995,840,United States of America,Egypt,91056,52011,39045
2000,800,Uganda,Egypt,1,1,0
2000,894,Zambia,Egypt,83,48,35
2000,140,Central African Republic,Egypt,58,27,31
2000,516,Namibia,Egypt,229,139,90
2000,710,South Africa,Egypt,1942,1074,868
2000,288,Ghana,Egypt,23,12,11
2000,478,Mauritania,Egypt,222,121,101
2000,434,Libya,Egypt,15455,10019,5436
2000,504,Morocco,Egypt,1228,631,597
2000,729,Sudan,Egypt,22327,11525,10802
2000,788,Tunisia,Egypt,698,355,343
2000,48,Bahrain,Egypt,25417,16501,8916
2000,196,Cyprus,Egypt,2358,1356,1002
2000,368,Iraq,Egypt,12375,8585,3790
2000,376,Israel,Egypt,22599,10674,11925
2000,400,Jordan,Egypt,287377,204045,83332
2000,414,Kuwait,Egypt,119693,75635,44058
2000,422,Lebanon,Egypt,130459,88862,41597
2000,512,Oman,Egypt,28536,18558,9978
2000,634,Qatar,Egypt,253,193,60
2000,682,Saudi Arabia,Egypt,376493,251628,124865
2000,275,State of Palestine,Egypt,17104,7542,9562
2000,792,Turkey,Egypt,717,422,295
2000,784,United Arab Emirates,Egypt,261934,177635,84299
2000,887,Yemen,Egypt,9206,4943,4263
2000,462,Maldives,Egypt,33,18,15
2000,144,Sri Lanka,Egypt,31,25,6
2000,392,Japan,Egypt,1103,510,593
2000,608,Philippines,Egypt,336,163,173
2000,28,Antigua and Barbuda,Egypt,8,4,4
2000,44,Bahamas,Egypt,7,3,4
2000,630,Puerto Rico,Egypt,77,37,40
2000,188,Costa Rica,Egypt,8,7,1
2000,320,Guatemala,Egypt,20,3,17
2000,484,Mexico,Egypt,159,102,57
2000,591,Panama,Egypt,42,18,24
2000,32,Argentina,Egypt,498,271,227
2000,68,Bolivia (Plurinational State of),Egypt,27,14,13
2000,76,Brazil,Egypt,3400,1652,1748
2000,152,Chile,Egypt,78,49,29
2000,170,Colombia,Egypt,139,85,54
2000,218,Ecuador,Egypt,35,24,11
2000,604,Peru,Egypt,15,12,3
2000,862,Venezuela (Bolivarian Republic of),Egypt,258,131,127
2000,36,Australia,Egypt,37600,19277,18323
2000,554,New Zealand,Egypt,1146,558,588
2000,100,Bulgaria,Egypt,69,53,16
2000,203,Czechia,Egypt,77,60,17
2000,348,Hungary,Egypt,529,411,118
2000,616,Poland,Egypt,211,152,59
2000,642,Romania,Egypt,20,13,7
2000,643,Russian Federation,Egypt,1425,779,646
2000,703,Slovakia,Egypt,118,113,5
2000,208,Denmark,Egypt,1282,858,424
2000,246,Finland,Egypt,342,304,38
2000,352,Iceland,Egypt,15,11,4
2000,372,Ireland,Egypt,621,425,196
2000,428,Latvia,Egypt,11,10,1
2000,440,Lithuania,Egypt,3,3,0
2000,578,Norway,Egypt,383,267,116
2000,752,Sweden,Egypt,2085,1334,751
2000,826,United Kingdom,Egypt,23885,12892,10993
2000,300,Greece,Egypt,32396,16886,15510
2000,380,Italy,Egypt,43336,27828,15508
2000,470,Malta,Egypt,379,238,141
2000,807,North Macedonia,Egypt,1717,716,1001
2000,620,Portugal,Egypt,101,55,46
2000,688,Serbia,Egypt,81,54,27
2000,705,Slovenia,Egypt,51,32,19
2000,724,Spain,Egypt,2041,1407,634
2000,40,Austria,Egypt,10304,6642,3662
2000,56,Belgium,Egypt,1570,1105,465
2000,250,France,Egypt,23905,15254,8651
2000,276,Germany,Egypt,13558,9976,3582
2000,442,Luxembourg,Egypt,22,13,9
2000,528,Netherlands,Egypt,9082,7000,2082
2000,756,Switzerland,Egypt,4368,2906,1462
2000,124,Canada,Egypt,36444,17581,18863
2000,840,United States of America,Egypt,116275,66779,49496
2005,894,Zambia,Egypt,116,68,48
2005,140,Central African Republic,Egypt,44,20,24
2005,516,Namibia,Egypt,181,110,71
2005,710,South Africa,Egypt,2553,1361,1192
2005,288,Ghana,Egypt,32,17,15
2005,478,Mauritania,Egypt,223,125,98
2005,434,Libya,Egypt,17029,12110,4919
2005,504,Morocco,Egypt,1260,639,621
2005,729,Sudan,Egypt,23620,12193,11427
2005,788,Tunisia,Egypt,667,342,325
2005,48,Bahrain,Egypt,41784,27252,14532
2005,196,Cyprus,Egypt,3451,1975,1476
2005,368,Iraq,Egypt,14186,11062,3124
2005,376,Israel,Egypt,21399,10110,11289
2005,400,Jordan,Egypt,188554,133590,54964
2005,414,Kuwait,Egypt,128020,80448,47572
2005,422,Lebanon,Egypt,114723,79932,34791
2005,512,Oman,Egypt,27249,17568,9681
2005,634,Qatar,Egypt,48490,35811,12679
2005,682,Saudi Arabia,Egypt,465079,319728,145351
2005,275,State of Palestine,Egypt,17871,8030,9841
2005,792,Turkey,Egypt,741,430,311
2005,784,United Arab Emirates,Egypt,341789,227694,114095
2005,887,Yemen,Egypt,9808,5141,4667
2005,462,Maldives,Egypt,27,16,11
2005,144,Sri Lanka,Egypt,63,42,21
2005,392,Japan,Egypt,1503,685,818
2005,608,Philippines,Egypt,271,134,137
2005,28,Antigua and Barbuda,Egypt,9,4,5
2005,44,Bahamas,Egypt,18,10,8
2005,630,Puerto Rico,Egypt,60,29,31
2005,188,Costa Rica,Egypt,5,4,1
2005,320,Guatemala,Egypt,24,2,22
2005,484,Mexico,Egypt,167,121,46
2005,591,Panama,Egypt,50,27,23
2005,32,Argentina,Egypt,368,203,165
2005,68,Bolivia (Plurinational State of),Egypt,23,14,9
2005,76,Brazil,Egypt,3268,1663,1605
2005,152,Chile,Egypt,117,75,42
2005,170,Colombia,Egypt,124,78,46
2005,218,Ecuador,Egypt,41,28,13
2005,604,Peru,Egypt,18,14,4
2005,862,Venezuela (Bolivarian Republic of),Egypt,225,119,106
2005,36,Australia,Egypt,38740,19889,18851
2005,554,New Zealand,Egypt,1282,623,659
2005,100,Bulgaria,Egypt,100,78,22
2005,203,Czechia,Egypt,289,260,29
2005,348,Hungary,Egypt,653,510,143
2005,616,Poland,Egypt,334,245,89
2005,642,Romania,Egypt,23,16,7
2005,643,Russian Federation,Egypt,1245,757,488
2005,703,Slovakia,Egypt,133,127,6
2005,208,Denmark,Egypt,1415,946,469
2005,246,Finland,Egypt,588,492,96
2005,352,Iceland,Egypt,22,17,5
2005,372,Ireland,Egypt,622,438,184
2005,428,Latvia,Egypt,26,22,4
2005,440,Lithuania,Egypt,31,25,6
2005,578,Norway,Egypt,504,351,153
2005,752,Sweden,Egypt,2499,1602,897
2005,826,United Kingdom,Egypt,25881,14472,11409
2005,191,Croatia,Egypt,123,56,67
2005,300,Greece,Egypt,30642,16578,14064
2005,380,Italy,Egypt,75904,52891,23013
2005,470,Malta,Egypt,446,283,163
2005,807,North Macedonia,Egypt,1765,737,1028
2005,620,Portugal,Egypt,256,205,51
2005,688,Serbia,Egypt,80,53,27
2005,705,Slovenia,Egypt,56,35,21
2005,724,Spain,Egypt,3185,2334,851
2005,40,Austria,Egypt,11518,7327,4191
2005,56,Belgium,Egypt,2231,1542,689
2005,250,France,Egypt,26659,17180,9479
2005,276,Germany,Egypt,16492,11954,4538
2005,442,Luxembourg,Egypt,19,12,7
2005,528,Netherlands,Egypt,11081,7929,3152
2005,756,Switzerland,Egypt,4875,3181,1694
2005,124,Canada,Egypt,41983,21520,20463
2005,840,United States of America,Egypt,124709,71916,52793
2010,728,South Sudan,Egypt,5287,3041,2246
2010,894,Zambia,Egypt,164,104,60
2010,140,Central African Republic,Egypt,44,20,24
2010,516,Namibia,Egypt,174,106,68
2010,710,South Africa,Egypt,3999,2126,1873
2010,288,Ghana,Egypt,32,18,14
2010,466,Mali,Egypt,594,281,313
2010,478,Mauritania,Egypt,224,128,96
2010,434,Libya,Egypt,18630,13311,5319
2010,504,Morocco,Egypt,1410,711,699
2010,729,Sudan,Egypt,14675,7576,7099
2010,788,Tunisia,Egypt,880,453,427
2010,48,Bahrain,Egypt,67374,44061,23313
2010,196,Cyprus,Egypt,5651,3265,2386
2010,368,Iraq,Egypt,14326,11360,2966
2010,376,Israel,Egypt,20459,9646,10813
2010,400,Jordan,Egypt,135994,110942,25052
2010,414,Kuwait,Egypt,168272,105907,62365
2010,422,Lebanon,Egypt,99001,71000,28001
2010,512,Oman,Egypt,30361,19852,10509
2010,634,Qatar,Egypt,136060,107320,28740
2010,682,Saudi Arabia,Egypt,603000,424412,178588
2010,275,State of Palestine,Egypt,18633,8520,10113
2010,792,Turkey,Egypt,766,438,328
2010,784,United Arab Emirates,Egypt,755158,514424,240734
2010,887,Yemen,Egypt,10621,5512,5109
2010,462,Maldives,Egypt,32,25,7
2010,144,Sri Lanka,Egypt,128,86,42
2010,392,Japan,Egypt,1593,717,876
2010,608,Philippines,Egypt,158,75,83
2010,28,Antigua and Barbuda,Egypt,9,4,5
2010,44,Bahamas,Egypt,29,17,12
2010,630,Puerto Rico,Egypt,36,17,19
2010,188,Costa Rica,Egypt,11,10,1
2010,320,Guatemala,Egypt,28,1,27
2010,484,Mexico,Egypt,195,154,41
2010,591,Panama,Egypt,62,38,24
2010,32,Argentina,Egypt,237,134,103
2010,68,Bolivia (Plurinational State of),Egypt,18,13,5
2010,76,Brazil,Egypt,3089,1649,1440
2010,152,Chile,Egypt,156,100,56
2010,170,Colombia,Egypt,131,85,46
2010,218,Ecuador,Egypt,58,40,18
2010,604,Peru,Egypt,19,15,4
2010,862,Venezuela (Bolivarian Republic of),Egypt,198,108,90
2010,36,Australia,Egypt,41830,22238,19592
2010,554,New Zealand,Egypt,1313,637,676
2010,100,Bulgaria,Egypt,126,99,27
2010,203,Czechia,Egypt,474,437,37
2010,348,Hungary,Egypt,777,609,168
2010,616,Poland,Egypt,469,345,124
2010,642,Romania,Egypt,41,29,12
2010,643,Russian Federation,Egypt,1041,720,321
2010,703,Slovakia,Egypt,149,143,6
2010,208,Denmark,Egypt,1519,1016,503
2010,233,Estonia,Egypt,41,37,4
2010,246,Finland,Egypt,985,785,200
2010,352,Iceland,Egypt,27,22,5
2010,372,Ireland,Egypt,521,355,166
2010,428,Latvia,Egypt,42,35,7
2010,440,Lithuania,Egypt,56,43,13
2010,578,Norway,Egypt,728,502,226
2010,752,Sweden,Egypt,3718,2428,1290
2010,826,United Kingdom,Egypt,27264,15492,11772
2010,191,Croatia,Egypt,245,112,133
2010,300,Greece,Egypt,30056,16933,13123
2010,380,Italy,Egypt,107072,77478,29594
2010,470,Malta,Egypt,383,264,119
2010,807,North Macedonia,Egypt,1813,757,1056
2010,620,Portugal,Egypt,370,322,48
2010,688,Serbia,Egypt,79,52,27
2010,705,Slovenia,Egypt,91,60,31
2010,724,Spain,Egypt,4053,2925,1128
2010,40,Austria,Egypt,12732,8012,4720
2010,56,Belgium,Egypt,3196,2209,987
2010,250,France,Egypt,29051,18302,10749
2010,276,Germany,Egypt,18891,13579,5312
2010,442,Luxembourg,Egypt,17,11,6
2010,528,Netherlands,Egypt,11824,8311,3513
2010,756,Switzerland,Egypt,5772,3625,2147
2010,124,Canada,Egypt,49935,26748,23187
2010,840,United States of America,Egypt,137193,72430,64763
2015,728,South Sudan,Egypt,5145,3099,2046
2015,894,Zambia,Egypt,144,91,53
2015,140,Central African Republic,Egypt,38,17,21
2015,516,Namibia,Egypt,170,104,66
2015,710,South Africa,Egypt,7213,3663,3550
2015,288,Ghana,Egypt,39,22,17
2015,324,Guinea,Egypt,27,21,6
2015,466,Mali,Egypt,735,348,387
2015,478,Mauritania,Egypt,225,130,95
2015,434,Libya,Egypt,21004,14925,6079
2015,504,Morocco,Egypt,1837,923,914
2015,729,Sudan,Egypt,13423,6930,6493
2015,788,Tunisia,Egypt,1136,587,549
2015,48,Bahrain,Egypt,80889,52478,28411
2015,196,Cyprus,Egypt,5429,3152,2277
2015,368,Iraq,Egypt,14364,11848,2516
2015,376,Israel,Egypt,21100,9894,11206
2015,400,Jordan,Egypt,97716,63516,34200
2015,414,Kuwait,Egypt,387993,224387,163606
2015,422,Lebanon,Egypt,83361,39902,43459
2015,512,Oman,Egypt,69046,48744,20302
2015,634,Qatar,Egypt,163569,131290,32279
2015,682,Saudi Arabia,Egypt,770483,533727,236756
2015,275,State of Palestine,Egypt,18451,8414,10037
2015,792,Turkey,Egypt,788,443,345
2015,784,United Arab Emirates,Egypt,825178,551748,273430
2015,887,Yemen,Egypt,7596,3943,3653
2015,462,Maldives,Egypt,37,33,4
2015,144,Sri Lanka,Egypt,130,87,43
2015,392,Japan,Egypt,1747,780,967
2015,608,Philippines,Egypt,161,76,85
2015,28,Antigua and Barbuda,Egypt,10,5,5
2015,44,Bahamas,Egypt,31,18,13
2015,630,Puerto Rico,Egypt,35,16,19
2015,188,Costa Rica,Egypt,11,10,1
2015,320,Guatemala,Egypt,32,1,31
2015,484,Mexico,Egypt,206,163,43
2015,591,Panama,Egypt,73,45,28
2015,32,Argentina,Egypt,238,135,103
2015,68,Bolivia (Plurinational State of),Egypt,21,15,6
2015,76,Brazil,Egypt,3720,1986,1734
2015,152,Chile,Egypt,236,150,86
2015,170,Colombia,Egypt,146,95,51
2015,218,Ecuador,Egypt,84,58,26
2015,604,Peru,Egypt,20,16,4
2015,862,Venezuela (Bolivarian Republic of),Egypt,185,100,85
2015,36,Australia,Egypt,44680,23477,21203
2015,554,New Zealand,Egypt,1324,641,683
2015,100,Bulgaria,Egypt,239,179,60
2015,203,Czechia,Egypt,728,654,74
2015,348,Hungary,Egypt,1351,901,450
2015,616,Poland,Egypt,452,335,117
2015,642,Romania,Egypt,105,80,25
2015,643,Russian Federation,Egypt,1060,731,329
2015,703,Slovakia,Egypt,195,185,10
2015,208,Denmark,Egypt,1775,1195,580
2015,233,Estonia,Egypt,68,61,7
2015,246,Finland,Egypt,1367,1068,299
2015,352,Iceland,Egypt,29,21,8
2015,372,Ireland,Egypt,532,360,172
2015,428,Latvia,Egypt,37,28,9
2015,440,Lithuania,Egypt,54,38,16
2015,578,Norway,Egypt,1082,738,344
2015,752,Sweden,Egypt,6256,4010,2246
2015,826,United Kingdom,Egypt,34866,19365,15501
2015,191,Croatia,Egypt,247,113,134
2015,300,Greece,Egypt,28209,15367,12842
2015,380,Italy,Egypt,108907,77023,31884
2015,470,Malta,Egypt,648,460,188
2015,807,North Macedonia,Egypt,1964,817,1147
2015,620,Portugal,Egypt,420,362,58
2015,688,Serbia,Egypt,77,51,26
2015,705,Slovenia,Egypt,113,86,27
2015,724,Spain,Egypt,4128,2768,1360
2015,40,Austria,Egypt,14891,9400,5491
2015,56,Belgium,Egypt,4322,2952,1370
2015,250,France,Egypt,32182,19948,12234
2015,276,Germany,Egypt,19683,14136,5547
2015,442,Luxembourg,Egypt,25,16,9
2015,528,Netherlands,Egypt,12893,8945,3948
2015,756,Switzerland,Egypt,6303,4025,2278
2015,124,Canada,Egypt,64223,33907,30316
2015,840,United States of America,Egypt,188170,98887,89283
2019,728,South Sudan,Egypt,5275,3177,2098
2019,894,Zambia,Egypt,185,117,68
2019,140,Central African Republic,Egypt,42,19,23
2019,516,Namibia,Egypt,179,110,69
2019,710,South Africa,Egypt,8084,4110,3974
2019,288,Ghana,Egypt,43,24,19
2019,324,Guinea,Egypt,25,20,5
2019,466,Mali,Egypt,818,388,430
2019,478,Mauritania,Egypt,233,135,98
2019,434,Libya,Egypt,22286,15836,6450
2019,504,Morocco,Egypt,1959,985,974
2019,729,Sudan,Egypt,16553,8422,8131
2019,788,Tunisia,Egypt,1154,597,557
2019,48,Bahrain,Egypt,85142,55238,29904
2019,196,Cyprus,Egypt,5426,3174,2252
2019,368,Iraq,Egypt,14710,12134,2576
2019,376,Israel,Egypt,20519,9622,10897
2019,400,Jordan,Egypt,105084,68306,36778
2019,414,Kuwait,Egypt,410831,237595,173236
2019,422,Lebanon,Egypt,78742,37691,41051
2019,512,Oman,Egypt,85040,60036,25004
2019,634,Qatar,Egypt,186840,148336,38504
2019,682,Saudi Arabia,Egypt,938649,643861,294788
2019,275,State of Palestine,Egypt,18323,8356,9967
2019,792,Turkey,Egypt,1065,604,461
2019,784,United Arab Emirates,Egypt,886291,592561,293730
2019,887,Yemen,Egypt,7710,4002,3708
2019,462,Maldives,Egypt,39,35,4
2019,144,Sri Lanka,Egypt,131,88,43
2019,392,Japan,Egypt,1977,883,1094
2019,608,Philippines,Egypt,166,79,87
2019,28,Antigua and Barbuda,Egypt,10,5,5
2019,44,Bahamas,Egypt,32,19,13
2019,630,Puerto Rico,Egypt,33,16,17
2019,188,Costa Rica,Egypt,11,10,1
2019,320,Guatemala,Egypt,32,1,31
2019,484,Mexico,Egypt,212,168,44
2019,591,Panama,Egypt,76,48,28
2019,32,Argentina,Egypt,242,138,104
2019,68,Bolivia (Plurinational State of),Egypt,22,16,6
2019,76,Brazil,Egypt,4189,2237,1952
2019,152,Chile,Egypt,315,194,121
2019,170,Colombia,Egypt,149,97,52
2019,218,Ecuador,Egypt,82,57,25
2019,604,Peru,Egypt,23,19,4
2019,862,Venezuela (Bolivarian Republic of),Egypt,181,98,83
2019,36,Australia,Egypt,48382,25421,22961
2019,554,New Zealand,Egypt,1360,658,702
2019,100,Bulgaria,Egypt,317,233,84
2019,203,Czechia,Egypt,907,782,125
2019,348,Hungary,Egypt,1690,1112,578
2019,616,Poland,Egypt,478,359,119
2019,642,Romania,Egypt,436,336,100
2019,643,Russian Federation,Egypt,1059,731,328
2019,703,Slovakia,Egypt,228,215,13
2019,208,Denmark,Egypt,2022,1344,678
2019,233,Estonia,Egypt,104,94,10
2019,246,Finland,Egypt,1767,1346,421
2019,352,Iceland,Egypt,41,29,12
2019,372,Ireland,Egypt,584,396,188
2019,428,Latvia,Egypt,53,42,11
2019,440,Lithuania,Egypt,51,37,14
2019,578,Norway,Egypt,1278,866,412
2019,752,Sweden,Egypt,8846,5514,3332
2019,826,United Kingdom,Egypt,39593,22035,17558
2019,191,Croatia,Egypt,228,104,124
2019,300,Greece,Egypt,27549,15483,12066
2019,380,Italy,Egypt,122040,86076,35964
2019,470,Malta,Egypt,1045,744,301
2019,807,North Macedonia,Egypt,1970,820,1150
2019,620,Portugal,Egypt,427,369,58
2019,688,Serbia,Egypt,78,52,26
2019,705,Slovenia,Egypt,118,91,27
2019,724,Spain,Egypt,4277,2835,1442
2019,40,Austria,Egypt,17578,11208,6370
2019,56,Belgium,Egypt,4895,3310,1585
2019,250,France,Egypt,34064,21085,12979
2019,276,Germany,Egypt,21591,15464,6127
2019,442,Luxembourg,Egypt,288,165,123
2019,528,Netherlands,Egypt,14735,10060,4675
2019,756,Switzerland,Egypt,6641,4258,2383
2019,124,Canada,Egypt,68822,36335,32487
2019,840,United States of America,Egypt,203205,105752,97453
1990,818,Egypt,El Salvador,160,65,95
1990,434,Libya,El Salvador,458,188,270
1990,196,Cyprus,El Salvador,3,2,1
1990,44,Bahamas,El Salvador,5,0,5
1990,214,Dominican Republic,El Salvador,366,191,175
1990,388,Jamaica,El Salvador,130,55,75
1990,630,Puerto Rico,El Salvador,519,246,273
1990,84,Belize,El Salvador,6691,3702,2989
1990,188,Costa Rica,El Salvador,56257,27798,28459
1990,320,Guatemala,El Salvador,236655,104058,132597
1990,340,Honduras,El Salvador,114810,55397,59413
1990,484,Mexico,El Salvador,301106,150796,150310
1990,558,Nicaragua,El Salvador,12443,6324,6119
1990,591,Panama,El Salvador,2396,1283,1113
1990,32,Argentina,El Salvador,182,88,94
1990,68,Bolivia (Plurinational State of),El Salvador,57,23,34
1990,76,Brazil,El Salvador,405,335,70
1990,152,Chile,El Salvador,226,111,115
1990,170,Colombia,El Salvador,297,149,148
1990,218,Ecuador,El Salvador,174,82,92
1990,604,Peru,El Salvador,66,32,34
1990,862,Venezuela (Bolivarian Republic of),El Salvador,1017,445,572
1990,36,Australia,El Salvador,8774,4331,4443
1990,100,Bulgaria,El Salvador,1,0,1
1990,203,Czechia,El Salvador,3,2,1
1990,348,Hungary,El Salvador,12,7,5
1990,208,Denmark,El Salvador,25,11,14
1990,246,Finland,El Salvador,4,3,1
1990,372,Ireland,El Salvador,5,2,3
1990,578,Norway,El Salvador,54,25,29
1990,752,Sweden,El Salvador,1832,967,865
1990,826,United Kingdom,El Salvador,81,44,37
1990,300,Greece,El Salvador,18,9,9
1990,380,Italy,El Salvador,724,252,472
1990,620,Portugal,El Salvador,6,3,3
1990,724,Spain,El Salvador,1195,392,803
1990,40,Austria,El Salvador,38,16,22
1990,56,Belgium,El Salvador,276,114,162
1990,250,France,El Salvador,999,420,579
1990,276,Germany,El Salvador,524,272,252
1990,528,Netherlands,El Salvador,134,61,73
1990,756,Switzerland,El Salvador,369,159,210
1990,124,Canada,El Salvador,27145,13215,13930
1990,840,United States of America,El Salvador,465433,236909,228524
1995,818,Egypt,El Salvador,151,62,89
1995,434,Libya,El Salvador,485,239,246
1995,196,Cyprus,El Salvador,4,2,2
1995,44,Bahamas,El Salvador,4,1,3
1995,214,Dominican Republic,El Salvador,407,208,199
1995,388,Jamaica,El Salvador,137,58,79
1995,630,Puerto Rico,El Salvador,504,239,265
1995,84,Belize,El Salvador,6661,3568,3093
1995,188,Costa Rica,El Salvador,26046,12961,13085
1995,320,Guatemala,El Salvador,124346,54107,70239
1995,340,Honduras,El Salvador,60692,29173,31519
1995,484,Mexico,El Salvador,4931,2279,2652
1995,558,Nicaragua,El Salvador,2136,1200,936
1995,591,Panama,El Salvador,2146,1127,1019
1995,32,Argentina,El Salvador,169,82,87
1995,68,Bolivia (Plurinational State of),El Salvador,82,38,44
1995,76,Brazil,El Salvador,443,332,111
1995,152,Chile,El Salvador,227,119,108
1995,170,Colombia,El Salvador,306,160,146
1995,218,Ecuador,El Salvador,196,93,103
1995,604,Peru,El Salvador,67,31,36
1995,862,Venezuela (Bolivarian Republic of),El Salvador,965,425,540
1995,36,Australia,El Salvador,10028,4898,5130
1995,100,Bulgaria,El Salvador,2,1,1
1995,203,Czechia,El Salvador,5,3,2
1995,348,Hungary,El Salvador,11,5,6
1995,208,Denmark,El Salvador,38,16,22
1995,246,Finland,El Salvador,11,6,5
1995,352,Iceland,El Salvador,1,0,1
1995,372,Ireland,El Salvador,14,5,9
1995,578,Norway,El Salvador,81,36,45
1995,752,Sweden,El Salvador,2174,1140,1034
1995,826,United Kingdom,El Salvador,322,131,191
1995,300,Greece,El Salvador,26,10,16
1995,380,Italy,El Salvador,3013,860,2153
1995,620,Portugal,El Salvador,14,7,7
1995,724,Spain,El Salvador,1441,490,951
1995,40,Austria,El Salvador,43,18,25
1995,56,Belgium,El Salvador,272,110,162
1995,250,France,El Salvador,1032,424,608
1995,276,Germany,El Salvador,504,227,277
1995,528,Netherlands,El Salvador,197,87,110
1995,756,Switzerland,El Salvador,428,193,235
1995,124,Canada,El Salvador,32598,15783,16815
1995,840,United States of America,El Salvador,649970,332169,317801
2000,818,Egypt,El Salvador,155,65,90
2000,434,Libya,El Salvador,520,298,222
2000,196,Cyprus,El Salvador,5,3,2
2000,44,Bahamas,El Salvador,4,0,4
2000,214,Dominican Republic,El Salvador,447,224,223
2000,388,Jamaica,El Salvador,143,61,82
2000,630,Puerto Rico,El Salvador,492,233,259
2000,84,Belize,El Salvador,6631,3434,3197
2000,188,Costa Rica,El Salvador,8857,4065,4792
2000,320,Guatemala,El Salvador,12037,4156,7881
2000,340,Honduras,El Salvador,6574,2949,3625
2000,484,Mexico,El Salvador,5786,2691,3095
2000,558,Nicaragua,El Salvador,2102,1161,941
2000,591,Panama,El Salvador,2032,1036,996
2000,32,Argentina,El Salvador,156,77,79
2000,68,Bolivia (Plurinational State of),El Salvador,107,53,54
2000,76,Brazil,El Salvador,481,330,151
2000,152,Chile,El Salvador,228,118,110
2000,170,Colombia,El Salvador,315,171,144
2000,218,Ecuador,El Salvador,217,103,114
2000,604,Peru,El Salvador,79,37,42
2000,862,Venezuela (Bolivarian Republic of),El Salvador,908,402,506
2000,36,Australia,El Salvador,10670,5193,5477
2000,100,Bulgaria,El Salvador,3,2,1
2000,203,Czechia,El Salvador,7,4,3
2000,348,Hungary,El Salvador,9,3,6
2000,208,Denmark,El Salvador,50,21,29
2000,246,Finland,El Salvador,17,9,8
2000,352,Iceland,El Salvador,1,0,1
2000,372,Ireland,El Salvador,31,13,18
2000,578,Norway,El Salvador,108,49,59
2000,752,Sweden,El Salvador,2332,1215,1117
2000,826,United Kingdom,El Salvador,569,219,350
2000,300,Greece,El Salvador,34,11,23
2000,380,Italy,El Salvador,5302,1469,3833
2000,620,Portugal,El Salvador,23,11,12
2000,724,Spain,El Salvador,2307,823,1484
2000,40,Austria,El Salvador,47,20,27
2000,56,Belgium,El Salvador,264,110,154
2000,250,France,El Salvador,1064,428,636
2000,276,Germany,El Salvador,483,182,301
2000,528,Netherlands,El Salvador,267,113,154
2000,756,Switzerland,El Salvador,490,228,262
2000,124,Canada,El Salvador,38826,18730,20096
2000,840,United States of America,El Salvador,838090,429782,408308
2005,818,Egypt,El Salvador,185,84,101
2005,434,Libya,El Salvador,573,372,201
2005,196,Cyprus,El Salvador,7,4,3
2005,44,Bahamas,El Salvador,36,31,5
2005,214,Dominican Republic,El Salvador,351,172,179
2005,388,Jamaica,El Salvador,139,60,79
2005,630,Puerto Rico,El Salvador,970,458,512
2005,84,Belize,El Salvador,7059,3638,3421
2005,188,Costa Rica,El Salvador,6446,2884,3562
2005,320,Guatemala,El Salvador,14364,3877,10487
2005,340,Honduras,El Salvador,6439,2931,3508
2005,484,Mexico,El Salvador,6923,3268,3655
2005,558,Nicaragua,El Salvador,2121,1144,977
2005,591,Panama,El Salvador,2333,1165,1168
2005,32,Argentina,El Salvador,115,57,58
2005,68,Bolivia (Plurinational State of),El Salvador,108,50,58
2005,76,Brazil,El Salvador,356,250,106
2005,152,Chile,El Salvador,342,180,162
2005,170,Colombia,El Salvador,310,172,138
2005,218,Ecuador,El Salvador,256,125,131
2005,604,Peru,El Salvador,93,44,49
2005,862,Venezuela (Bolivarian Republic of),El Salvador,937,413,524
2005,36,Australia,El Salvador,10750,5243,5507
2005,100,Bulgaria,El Salvador,5,3,2
2005,203,Czechia,El Salvador,9,4,5
2005,348,Hungary,El Salvador,11,4,7
2005,208,Denmark,El Salvador,62,26,36
2005,246,Finland,El Salvador,34,15,19
2005,352,Iceland,El Salvador,6,3,3
2005,372,Ireland,El Salvador,31,14,17
2005,578,Norway,El Salvador,129,65,64
2005,752,Sweden,El Salvador,2451,1254,1197
2005,826,United Kingdom,El Salvador,679,267,412
2005,300,Greece,El Salvador,43,11,32
2005,380,Italy,El Salvador,8882,2862,6020
2005,620,Portugal,El Salvador,53,10,43
2005,724,Spain,El Salvador,4372,1670,2702
2005,40,Austria,El Salvador,53,22,31
2005,56,Belgium,El Salvador,361,150,211
2005,250,France,El Salvador,1418,794,624
2005,276,Germany,El Salvador,807,332,475
2005,528,Netherlands,El Salvador,317,141,176
2005,756,Switzerland,El Salvador,555,246,309
2005,124,Canada,El Salvador,39970,19738,20232
2005,840,United States of America,El Salvador,997858,514399,483459
2010,818,Egypt,El Salvador,200,87,113
2010,434,Libya,El Salvador,628,410,218
2010,196,Cyprus,El Salvador,11,7,4
2010,44,Bahamas,El Salvador,67,62,5
2010,214,Dominican Republic,El Salvador,253,120,133
2010,388,Jamaica,El Salvador,135,59,76
2010,630,Puerto Rico,El Salvador,1327,622,705
2010,84,Belize,El Salvador,7486,3859,3627
2010,188,Costa Rica,El Salvador,13688,6112,7576
2010,320,Guatemala,El Salvador,16691,3599,13092
2010,340,Honduras,El Salvador,6303,2913,3390
2010,484,Mexico,El Salvador,8864,4230,4634
2010,558,Nicaragua,El Salvador,2267,1230,1037
2010,591,Panama,El Salvador,2747,1369,1378
2010,32,Argentina,El Salvador,73,37,36
2010,68,Bolivia (Plurinational State of),El Salvador,109,48,61
2010,76,Brazil,El Salvador,226,166,60
2010,152,Chile,El Salvador,456,242,214
2010,170,Colombia,El Salvador,358,205,153
2010,218,Ecuador,El Salvador,359,170,189
2010,604,Peru,El Salvador,103,49,54
2010,862,Venezuela (Bolivarian Republic of),El Salvador,978,430,548
2010,36,Australia,El Salvador,10960,5349,5611
2010,100,Bulgaria,El Salvador,7,5,2
2010,203,Czechia,El Salvador,11,4,7
2010,348,Hungary,El Salvador,13,5,8
2010,208,Denmark,El Salvador,72,30,42
2010,233,Estonia,El Salvador,2,2,0
2010,246,Finland,El Salvador,54,18,36
2010,352,Iceland,El Salvador,11,6,5
2010,372,Ireland,El Salvador,26,11,15
2010,578,Norway,El Salvador,156,81,75
2010,752,Sweden,El Salvador,2677,1352,1325
2010,826,United Kingdom,El Salvador,715,290,425
2010,300,Greece,El Salvador,53,12,41
2010,380,Italy,El Salvador,11705,3865,7840
2010,620,Portugal,El Salvador,76,8,68
2010,724,Spain,El Salvador,7951,3068,4883
2010,40,Austria,El Salvador,58,24,34
2010,56,Belgium,El Salvador,386,166,220
2010,250,France,El Salvador,1046,407,639
2010,276,Germany,El Salvador,1077,461,616
2010,528,Netherlands,El Salvador,347,147,200
2010,756,Switzerland,El Salvador,648,262,386
2010,124,Canada,El Salvador,43655,22058,21597
2010,840,United States of America,El Salvador,1192423,606751,585672
2015,324,Guinea,El Salvador,4,2,2
2015,818,Egypt,El Salvador,148,76,72
2015,434,Libya,El Salvador,708,459,249
2015,196,Cyprus,El Salvador,10,7,3
2015,44,Bahamas,El Salvador,73,68,5
2015,214,Dominican Republic,El Salvador,267,127,140
2015,388,Jamaica,El Salvador,132,58,74
2015,630,Puerto Rico,El Salvador,846,395,451
2015,84,Belize,El Salvador,8828,4525,4303
2015,188,Costa Rica,El Salvador,13900,6160,7740
2015,320,Guatemala,El Salvador,19198,4353,14845
2015,340,Honduras,El Salvador,8853,4101,4752
2015,484,Mexico,El Salvador,10582,5318,5264
2015,558,Nicaragua,El Salvador,2444,1332,1112
2015,591,Panama,El Salvador,3225,1602,1623
2015,32,Argentina,El Salvador,73,37,36
2015,68,Bolivia (Plurinational State of),El Salvador,127,56,71
2015,76,Brazil,El Salvador,272,200,72
2015,152,Chile,El Salvador,690,360,330
2015,170,Colombia,El Salvador,400,231,169
2015,218,Ecuador,El Salvador,522,246,276
2015,604,Peru,El Salvador,110,55,55
2015,862,Venezuela (Bolivarian Republic of),El Salvador,1015,439,576
2015,36,Australia,El Salvador,11350,5565,5785
2015,100,Bulgaria,El Salvador,8,5,3
2015,203,Czechia,El Salvador,26,18,8
2015,348,Hungary,El Salvador,15,5,10
2015,208,Denmark,El Salvador,88,35,53
2015,233,Estonia,El Salvador,1,1,0
2015,246,Finland,El Salvador,77,28,49
2015,352,Iceland,El Salvador,13,5,8
2015,372,Ireland,El Salvador,27,11,16
2015,578,Norway,El Salvador,204,101,103
2015,752,Sweden,El Salvador,2942,1487,1455
2015,826,United Kingdom,El Salvador,914,355,559
2015,300,Greece,El Salvador,49,9,40
2015,380,Italy,El Salvador,13070,4461,8609
2015,620,Portugal,El Salvador,85,5,80
2015,724,Spain,El Salvador,9192,3301,5891
2015,40,Austria,El Salvador,68,29,39
2015,56,Belgium,El Salvador,547,236,311
2015,250,France,El Salvador,1158,430,728
2015,276,Germany,El Salvador,1122,479,643
2015,528,Netherlands,El Salvador,377,159,218
2015,756,Switzerland,El Salvador,874,360,514
2015,124,Canada,El Salvador,47785,23713,24072
2015,840,United States of America,El Salvador,1352357,683083,669274
2019,324,Guinea,El Salvador,3,2,1
2019,818,Egypt,El Salvador,210,96,114
2019,434,Libya,El Salvador,751,487,264
2019,196,Cyprus,El Salvador,9,7,2
2019,44,Bahamas,El Salvador,77,72,5
2019,214,Dominican Republic,El Salvador,275,131,144
2019,388,Jamaica,El Salvador,133,59,74
2019,630,Puerto Rico,El Salvador,140,66,74
2019,84,Belize,El Salvador,9687,4965,4722
2019,188,Costa Rica,El Salvador,14104,6301,7803
2019,320,Guatemala,El Salvador,19704,4468,15236
2019,340,Honduras,El Salvador,8995,4167,4828
2019,484,Mexico,El Salvador,10910,5483,5427
2019,558,Nicaragua,El Salvador,2559,1395,1164
2019,591,Panama,El Salvador,3674,1845,1829
2019,32,Argentina,El Salvador,74,38,36
2019,68,Bolivia (Plurinational State of),El Salvador,138,61,77
2019,76,Brazil,El Salvador,306,225,81
2019,152,Chile,El Salvador,921,456,465
2019,170,Colombia,El Salvador,409,237,172
2019,218,Ecuador,El Salvador,513,242,271
2019,604,Peru,El Salvador,130,68,62
2019,862,Venezuela (Bolivarian Republic of),El Salvador,994,428,566
2019,36,Australia,El Salvador,12092,5877,6215
2019,100,Bulgaria,El Salvador,11,8,3
2019,203,Czechia,El Salvador,29,18,11
2019,348,Hungary,El Salvador,16,8,8
2019,208,Denmark,El Salvador,106,42,64
2019,233,Estonia,El Salvador,2,2,0
2019,246,Finland,El Salvador,94,38,56
2019,352,Iceland,El Salvador,21,7,14
2019,372,Ireland,El Salvador,29,12,17
2019,578,Norway,El Salvador,228,118,110
2019,752,Sweden,El Salvador,3158,1582,1576
2019,826,United Kingdom,El Salvador,1037,404,633
2019,300,Greece,El Salvador,47,10,37
2019,380,Italy,El Salvador,14682,5306,9376
2019,620,Portugal,El Salvador,86,5,81
2019,724,Spain,El Salvador,9524,3275,6249
2019,40,Austria,El Salvador,80,35,45
2019,56,Belgium,El Salvador,741,344,397
2019,250,France,El Salvador,1225,453,772
2019,276,Germany,El Salvador,1230,561,669
2019,528,Netherlands,El Salvador,442,187,255
2019,756,Switzerland,El Salvador,969,414,555
2019,124,Canada,El Salvador,51207,25412,25795
2019,840,United States of America,El Salvador,1429155,720535,708620
1990,178,Congo,Equatorial Guinea,485,260,225
1990,266,Gabon,Equatorial Guinea,26892,13227,13665
1990,678,Sao Tome and Principe,Equatorial Guinea,305,122,183
1990,768,Togo,Equatorial Guinea,50,30,20
1990,152,Chile,Equatorial Guinea,3,2,1
1990,203,Czechia,Equatorial Guinea,1,1,0
1990,643,Russian Federation,Equatorial Guinea,29,14,15
1990,352,Iceland,Equatorial Guinea,1,0,1
1990,752,Sweden,Equatorial Guinea,8,2,6
1990,826,United Kingdom,Equatorial Guinea,6,4,2
1990,300,Greece,Equatorial Guinea,2,2,0
1990,380,Italy,Equatorial Guinea,6,2,4
1990,620,Portugal,Equatorial Guinea,16,5,11
1990,724,Spain,Equatorial Guinea,6040,2555,3485
1990,40,Austria,Equatorial Guinea,6,3,3
1990,56,Belgium,Equatorial Guinea,2142,1393,749
1990,250,France,Equatorial Guinea,144,64,80
1990,528,Netherlands,Equatorial Guinea,9,6,3
1990,756,Switzerland,Equatorial Guinea,23,13,10
1990,124,Canada,Equatorial Guinea,10,5,5
1995,178,Congo,Equatorial Guinea,560,288,272
1995,266,Gabon,Equatorial Guinea,35966,17678,18288
1995,678,Sao Tome and Principe,Equatorial Guinea,286,111,175
1995,768,Togo,Equatorial Guinea,56,34,22
1995,152,Chile,Equatorial Guinea,2,2,0
1995,203,Czechia,Equatorial Guinea,1,0,1
1995,643,Russian Federation,Equatorial Guinea,33,15,18
1995,352,Iceland,Equatorial Guinea,1,0,1
1995,752,Sweden,Equatorial Guinea,10,3,7
1995,826,United Kingdom,Equatorial Guinea,29,14,15
1995,300,Greece,Equatorial Guinea,1,1,0
1995,380,Italy,Equatorial Guinea,33,20,13
1995,620,Portugal,Equatorial Guinea,34,11,23
1995,724,Spain,Equatorial Guinea,7506,3168,4338
1995,40,Austria,Equatorial Guinea,7,4,3
1995,56,Belgium,Equatorial Guinea,1692,1032,660
1995,250,France,Equatorial Guinea,149,65,84
1995,528,Netherlands,Equatorial Guinea,13,8,5
1995,756,Switzerland,Equatorial Guinea,23,13,10
1995,124,Canada,Equatorial Guinea,12,6,6
2000,178,Congo,Equatorial Guinea,786,393,393
2000,266,Gabon,Equatorial Guinea,44984,22273,22711
2000,678,Sao Tome and Principe,Equatorial Guinea,268,100,168
2000,694,Sierra Leone,Equatorial Guinea,1,1,0
2000,768,Togo,Equatorial Guinea,63,39,24
2000,152,Chile,Equatorial Guinea,2,1,1
2000,203,Czechia,Equatorial Guinea,1,0,1
2000,643,Russian Federation,Equatorial Guinea,37,15,22
2000,352,Iceland,Equatorial Guinea,1,0,1
2000,752,Sweden,Equatorial Guinea,11,3,8
2000,826,United Kingdom,Equatorial Guinea,53,23,30
2000,380,Italy,Equatorial Guinea,60,38,22
2000,620,Portugal,Equatorial Guinea,55,18,37
2000,724,Spain,Equatorial Guinea,12201,5259,6942
2000,40,Austria,Equatorial Guinea,7,4,3
2000,56,Belgium,Equatorial Guinea,1191,639,552
2000,250,France,Equatorial Guinea,153,65,88
2000,528,Netherlands,Equatorial Guinea,19,9,10
2000,756,Switzerland,Equatorial Guinea,24,13,11
2000,124,Canada,Equatorial Guinea,15,7,8
2005,120,Cameroon,Equatorial Guinea,3377,1600,1777
2005,178,Congo,Equatorial Guinea,500,309,191
2005,266,Gabon,Equatorial Guinea,49050,24532,24518
2005,678,Sao Tome and Principe,Equatorial Guinea,210,77,133
2005,694,Sierra Leone,Equatorial Guinea,3,2,1
2005,768,Togo,Equatorial Guinea,71,44,27
2005,76,Brazil,Equatorial Guinea,27,7,20
2005,152,Chile,Equatorial Guinea,3,2,1
2005,203,Czechia,Equatorial Guinea,1,0,1
2005,643,Russian Federation,Equatorial Guinea,70,41,29
2005,246,Finland,Equatorial Guinea,5,2,3
2005,352,Iceland,Equatorial Guinea,2,0,2
2005,752,Sweden,Equatorial Guinea,26,12,14
2005,826,United Kingdom,Equatorial Guinea,159,56,103
2005,300,Greece,Equatorial Guinea,1,0,1
2005,380,Italy,Equatorial Guinea,91,44,47
2005,620,Portugal,Equatorial Guinea,135,19,116
2005,724,Spain,Equatorial Guinea,17628,6914,10714
2005,40,Austria,Equatorial Guinea,8,4,4
2005,56,Belgium,Equatorial Guinea,19,13,6
2005,250,France,Equatorial Guinea,347,97,250
2005,528,Netherlands,Equatorial Guinea,31,15,16
2005,756,Switzerland,Equatorial Guinea,30,14,16
2005,124,Canada,Equatorial Guinea,40,24,16
2010,120,Cameroon,Equatorial Guinea,2688,1338,1350
2010,178,Congo,Equatorial Guinea,1190,670,520
2010,266,Gabon,Equatorial Guinea,56815,28964,27851
2010,678,Sao Tome and Principe,Equatorial Guinea,165,60,105
2010,466,Mali,Equatorial Guinea,659,325,334
2010,694,Sierra Leone,Equatorial Guinea,3,2,1
2010,768,Togo,Equatorial Guinea,95,59,36
2010,76,Brazil,Equatorial Guinea,55,14,41
2010,152,Chile,Equatorial Guinea,4,3,1
2010,203,Czechia,Equatorial Guinea,1,0,1
2010,643,Russian Federation,Equatorial Guinea,102,66,36
2010,246,Finland,Equatorial Guinea,11,3,8
2010,352,Iceland,Equatorial Guinea,3,1,2
2010,752,Sweden,Equatorial Guinea,35,15,20
2010,826,United Kingdom,Equatorial Guinea,167,61,106
2010,300,Greece,Equatorial Guinea,1,0,1
2010,380,Italy,Equatorial Guinea,121,51,70
2010,620,Portugal,Equatorial Guinea,194,17,177
2010,724,Spain,Equatorial Guinea,21552,8234,13318
2010,40,Austria,Equatorial Guinea,9,5,4
2010,56,Belgium,Equatorial Guinea,39,11,28
2010,250,France,Equatorial Guinea,366,152,214
2010,528,Netherlands,Equatorial Guinea,38,14,24
2010,756,Switzerland,Equatorial Guinea,32,15,17
2010,124,Canada,Equatorial Guinea,55,36,19
2015,120,Cameroon,Equatorial Guinea,3433,1476,1957
2015,178,Congo,Equatorial Guinea,1582,861,721
2015,266,Gabon,Equatorial Guinea,79434,45939,33495
2015,678,Sao Tome and Principe,Equatorial Guinea,146,53,93
2015,324,Guinea,Equatorial Guinea,10695,6238,4457
2015,466,Mali,Equatorial Guinea,816,403,413
2015,768,Togo,Equatorial Guinea,107,67,40
2015,76,Brazil,Equatorial Guinea,66,17,49
2015,152,Chile,Equatorial Guinea,6,5,1
2015,643,Russian Federation,Equatorial Guinea,104,67,37
2015,246,Finland,Equatorial Guinea,17,7,10
2015,352,Iceland,Equatorial Guinea,9,2,7
2015,752,Sweden,Equatorial Guinea,45,20,25
2015,826,United Kingdom,Equatorial Guinea,213,74,139
2015,380,Italy,Equatorial Guinea,119,50,69
2015,620,Portugal,Equatorial Guinea,221,10,211
2015,724,Spain,Equatorial Guinea,19339,7462,11877
2015,40,Austria,Equatorial Guinea,10,6,4
2015,56,Belgium,Equatorial Guinea,82,22,60
2015,250,France,Equatorial Guinea,404,160,244
2015,528,Netherlands,Equatorial Guinea,47,10,37
2015,756,Switzerland,Equatorial Guinea,68,23,45
2015,124,Canada,Equatorial Guinea,59,35,24
2019,120,Cameroon,Equatorial Guinea,3415,1470,1945
2019,178,Congo,Equatorial Guinea,1630,887,743
2019,266,Gabon,Equatorial Guinea,86305,49878,36427
2019,678,Sao Tome and Principe,Equatorial Guinea,132,48,84
2019,324,Guinea,Equatorial Guinea,10208,5954,4254
2019,466,Mali,Equatorial Guinea,908,449,459
2019,768,Togo,Equatorial Guinea,107,67,40
2019,76,Brazil,Equatorial Guinea,74,19,55
2019,152,Chile,Equatorial Guinea,8,7,1
2019,203,Czechia,Equatorial Guinea,1,1,0
2019,643,Russian Federation,Equatorial Guinea,103,67,36
2019,246,Finland,Equatorial Guinea,18,7,11
2019,352,Iceland,Equatorial Guinea,15,5,10
2019,752,Sweden,Equatorial Guinea,54,25,29
2019,826,United Kingdom,Equatorial Guinea,241,84,157
2019,300,Greece,Equatorial Guinea,8,4,4
2019,380,Italy,Equatorial Guinea,154,71,83
2019,620,Portugal,Equatorial Guinea,224,10,214
2019,724,Spain,Equatorial Guinea,21323,7988,13335
2019,40,Austria,Equatorial Guinea,11,7,4
2019,56,Belgium,Equatorial Guinea,102,29,73
2019,250,France,Equatorial Guinea,427,169,258
2019,528,Netherlands,Equatorial Guinea,48,12,36
2019,756,Switzerland,Equatorial Guinea,91,28,63
2019,124,Canada,Equatorial Guinea,63,38,25
1990,231,Ethiopia,Eritrea,69681,36625,33056
1990,710,South Africa,Eritrea,521,257,264
1990,818,Egypt,Eritrea,358,180,178
1990,434,Libya,Eritrea,1023,517,506
1990,729,Sudan,Eritrea,64790,33309,31481
1990,48,Bahrain,Eritrea,508,363,145
1990,196,Cyprus,Eritrea,1,0,1
1990,368,Iraq,Eritrea,359,272,87
1990,400,Jordan,Eritrea,139,64,75
1990,414,Kuwait,Eritrea,3148,1906,1242
1990,634,Qatar,Eritrea,639,467,172
1990,784,United Arab Emirates,Eritrea,3846,2738,1108
1990,862,Venezuela (Bolivarian Republic of),Eritrea,25,13,12
1990,36,Australia,Eritrea,1272,664,608
1990,100,Bulgaria,Eritrea,1,1,0
1990,203,Czechia,Eritrea,1,1,0
1990,616,Poland,Eritrea,3,3,0
1990,208,Denmark,Eritrea,73,32,41
1990,372,Ireland,Eritrea,7,4,3
1990,578,Norway,Eritrea,19,14,5
1990,752,Sweden,Eritrea,2399,1274,1125
1990,826,United Kingdom,Eritrea,914,547,367
1990,300,Greece,Eritrea,137,75,62
1990,380,Italy,Eritrea,779,271,508
1990,470,Malta,Eritrea,10,8,2
1990,724,Spain,Eritrea,6,4,2
1990,40,Austria,Eritrea,57,25,32
1990,56,Belgium,Eritrea,1,1,0
1990,250,France,Eritrea,160,60,100
1990,276,Germany,Eritrea,2815,1629,1186
1990,528,Netherlands,Eritrea,155,91,64
1990,756,Switzerland,Eritrea,995,504,491
1990,124,Canada,Eritrea,4630,2254,2376
1990,840,United States of America,Eritrea,11131,5445,5686
1995,231,Ethiopia,Eritrea,34949,18680,16269
1995,404,Kenya,Eritrea,66,34,32
1995,710,South Africa,Eritrea,325,174,151
1995,818,Egypt,Eritrea,359,179,180
1995,434,Libya,Eritrea,1230,695,535
1995,729,Sudan,Eritrea,287519,150816,136703
1995,48,Bahrain,Eritrea,558,393,165
1995,196,Cyprus,Eritrea,2,0,2
1995,368,Iraq,Eritrea,732,429,303
1995,400,Jordan,Eritrea,115,57,58
1995,414,Kuwait,Eritrea,2522,1607,915
1995,634,Qatar,Eritrea,694,518,176
1995,784,United Arab Emirates,Eritrea,4928,3530,1398
1995,887,Yemen,Eritrea,2500,1452,1048
1995,68,Bolivia (Plurinational State of),Eritrea,1,0,1
1995,152,Chile,Eritrea,1,1,0
1995,862,Venezuela (Bolivarian Republic of),Eritrea,24,13,11
1995,36,Australia,Eritrea,1562,815,747
1995,100,Bulgaria,Eritrea,2,2,0
1995,203,Czechia,Eritrea,1,1,0
1995,348,Hungary,Eritrea,3,1,2
1995,616,Poland,Eritrea,2,2,0
1995,208,Denmark,Eritrea,79,35,44
1995,246,Finland,Eritrea,5,2,3
1995,352,Iceland,Eritrea,1,1,0
1995,372,Ireland,Eritrea,20,12,8
1995,578,Norway,Eritrea,44,22,22
1995,752,Sweden,Eritrea,2847,1501,1346
1995,826,United Kingdom,Eritrea,3593,1751,1842
1995,300,Greece,Eritrea,117,59,58
1995,380,Italy,Eritrea,4098,1064,3034
1995,470,Malta,Eritrea,12,9,3
1995,724,Spain,Eritrea,10,6,4
1995,40,Austria,Eritrea,65,29,36
1995,56,Belgium,Eritrea,1,1,0
1995,250,France,Eritrea,166,61,105
1995,276,Germany,Eritrea,3979,2188,1791
1995,528,Netherlands,Eritrea,228,132,96
1995,756,Switzerland,Eritrea,2734,1713,1021
1995,124,Canada,Eritrea,4649,2253,2396
1995,840,United States of America,Eritrea,14515,7176,7339
2000,231,Ethiopia,Eritrea,6843,4313,2530
2000,404,Kenya,Eritrea,961,479,482
2000,800,Uganda,Eritrea,39,20,19
2000,710,South Africa,Eritrea,225,137,88
2000,818,Egypt,Eritrea,388,192,196
2000,434,Libya,Eritrea,1459,897,562
2000,729,Sudan,Eritrea,435158,214993,220165
2000,48,Bahrain,Eritrea,610,421,189
2000,196,Cyprus,Eritrea,2,0,2
2000,368,Iraq,Eritrea,694,336,358
2000,400,Jordan,Eritrea,91,51,40
2000,414,Kuwait,Eritrea,2877,1943,934
2000,634,Qatar,Eritrea,646,493,153
2000,784,United Arab Emirates,Eritrea,6295,4509,1786
2000,887,Yemen,Eritrea,2766,1607,1159
2000,68,Bolivia (Plurinational State of),Eritrea,1,0,1
2000,152,Chile,Eritrea,2,0,2
2000,862,Venezuela (Bolivarian Republic of),Eritrea,24,13,11
2000,36,Australia,Eritrea,1780,929,851
2000,100,Bulgaria,Eritrea,2,2,0
2000,203,Czechia,Eritrea,1,1,0
2000,348,Hungary,Eritrea,6,2,4
2000,616,Poland,Eritrea,2,2,0
2000,208,Denmark,Eritrea,84,37,47
2000,246,Finland,Eritrea,9,3,6
2000,352,Iceland,Eritrea,1,1,0
2000,372,Ireland,Eritrea,45,29,16
2000,578,Norway,Eritrea,530,266,264
2000,752,Sweden,Eritrea,3054,1601,1453
2000,826,United Kingdom,Eritrea,6334,2980,3354
2000,300,Greece,Eritrea,99,42,57
2000,380,Italy,Eritrea,7417,1858,5559
2000,470,Malta,Eritrea,15,12,3
2000,724,Spain,Eritrea,128,81,47
2000,40,Austria,Eritrea,72,33,39
2000,56,Belgium,Eritrea,1,1,0
2000,250,France,Eritrea,171,61,110
2000,276,Germany,Eritrea,5143,2748,2395
2000,528,Netherlands,Eritrea,309,175,134
2000,756,Switzerland,Eritrea,4483,2930,1553
2000,124,Canada,Eritrea,4779,2306,2473
2000,840,United States of America,Eritrea,17962,8949,9013
2005,231,Ethiopia,Eritrea,5756,3328,2428
2005,404,Kenya,Eritrea,696,359,337
2005,706,Somalia,Eritrea,17,10,7
2005,800,Uganda,Eritrea,143,72,71
2005,710,South Africa,Eritrea,316,181,135
2005,818,Egypt,Eritrea,462,243,219
2005,434,Libya,Eritrea,1607,1098,509
2005,729,Sudan,Eritrea,196564,98041,98523
2005,48,Bahrain,Eritrea,926,629,297
2005,196,Cyprus,Eritrea,3,0,3
2005,368,Iraq,Eritrea,796,501,295
2005,400,Jordan,Eritrea,131,80,51
2005,414,Kuwait,Eritrea,3107,2049,1058
2005,634,Qatar,Eritrea,1083,807,276
2005,784,United Arab Emirates,Eritrea,7570,5236,2334
2005,887,Yemen,Eritrea,789,491,298
2005,68,Bolivia (Plurinational State of),Eritrea,1,0,1
2005,152,Chile,Eritrea,3,1,2
2005,862,Venezuela (Bolivarian Republic of),Eritrea,25,14,11
2005,36,Australia,Eritrea,2280,1171,1109
2005,100,Bulgaria,Eritrea,3,2,1
2005,203,Czechia,Eritrea,2,1,1
2005,348,Hungary,Eritrea,9,4,5
2005,616,Poland,Eritrea,13,1,12
2005,208,Denmark,Eritrea,152,70,82
2005,246,Finland,Eritrea,38,17,21
2005,352,Iceland,Eritrea,2,2,0
2005,372,Ireland,Eritrea,45,30,15
2005,578,Norway,Eritrea,1797,961,836
2005,752,Sweden,Eritrea,5371,2688,2683
2005,826,United Kingdom,Eritrea,11182,5379,5803
2005,300,Greece,Eritrea,193,88,105
2005,380,Italy,Eritrea,10504,4670,5834
2005,470,Malta,Eritrea,19,14,5
2005,724,Spain,Eritrea,62,39,23
2005,40,Austria,Eritrea,81,36,45
2005,56,Belgium,Eritrea,4,2,2
2005,250,France,Eritrea,270,103,167
2005,276,Germany,Eritrea,8806,4368,4438
2005,528,Netherlands,Eritrea,644,334,310
2005,756,Switzerland,Eritrea,5967,3629,2338
2005,124,Canada,Eritrea,6173,3061,3112
2005,840,United States of America,Eritrea,20907,10475,10432
2010,231,Ethiopia,Eritrea,40354,20329,20025
2010,404,Kenya,Eritrea,1686,829,857
2010,706,Somalia,Eritrea,37,19,18
2010,728,South Sudan,Eritrea,3410,1961,1449
2010,800,Uganda,Eritrea,5923,3034,2889
2010,710,South Africa,Eritrea,494,283,211
2010,818,Egypt,Eritrea,499,254,245
2010,434,Libya,Eritrea,1759,1208,551
2010,729,Sudan,Eritrea,142187,72306,69881
2010,48,Bahrain,Eritrea,1448,978,470
2010,196,Cyprus,Eritrea,4,0,4
2010,368,Iraq,Eritrea,804,524,280
2010,400,Jordan,Eritrea,168,106,62
2010,414,Kuwait,Eritrea,4114,2681,1433
2010,634,Qatar,Eritrea,2401,1925,476
2010,784,United Arab Emirates,Eritrea,16231,11367,4864
2010,887,Yemen,Eritrea,1515,943,572
2010,152,Chile,Eritrea,4,1,3
2010,862,Venezuela (Bolivarian Republic of),Eritrea,27,15,12
2010,36,Australia,Eritrea,3090,1538,1552
2010,100,Bulgaria,Eritrea,3,2,1
2010,203,Czechia,Eritrea,3,2,1
2010,348,Hungary,Eritrea,11,5,6
2010,616,Poland,Eritrea,25,0,25
2010,208,Denmark,Eritrea,216,103,113
2010,246,Finland,Eritrea,72,30,42
2010,352,Iceland,Eritrea,3,3,0
2010,372,Ireland,Eritrea,37,23,14
2010,578,Norway,Eritrea,4839,2495,2344
2010,752,Sweden,Eritrea,10301,4933,5368
2010,826,United Kingdom,Eritrea,11779,5792,5987
2010,300,Greece,Eritrea,297,138,159
2010,380,Italy,Eritrea,13557,7387,6170
2010,470,Malta,Eritrea,1354,689,665
2010,705,Slovenia,Eritrea,3,3,0
2010,724,Spain,Eritrea,140,89,51
2010,40,Austria,Eritrea,89,39,50
2010,56,Belgium,Eritrea,13,5,8
2010,250,France,Eritrea,599,205,394
2010,276,Germany,Eritrea,11840,5749,6091
2010,528,Netherlands,Eritrea,1081,547,534
2010,756,Switzerland,Eritrea,5923,3643,2280
2010,124,Canada,Eritrea,7750,3914,3836
2010,840,United States of America,Eritrea,24569,12141,12428
2015,231,Ethiopia,Eritrea,206030,104046,101984
2015,404,Kenya,Eritrea,2127,1057,1070
2015,706,Somalia,Eritrea,34,19,15
2015,728,South Sudan,Eritrea,3318,1999,1319
2015,800,Uganda,Eritrea,9250,4598,4652
2015,710,South Africa,Eritrea,890,491,399
2015,324,Guinea,Eritrea,23,15,8
2015,694,Sierra Leone,Eritrea,1,1,0
2015,818,Egypt,Eritrea,3168,1584,1584
2015,434,Libya,Eritrea,1983,1354,629
2015,729,Sudan,Eritrea,159748,81987,77761
2015,48,Bahrain,Eritrea,1550,1040,510
2015,196,Cyprus,Eritrea,3,0,3
2015,368,Iraq,Eritrea,806,568,238
2015,400,Jordan,Eritrea,72,40,32
2015,414,Kuwait,Eritrea,4725,2853,1872
2015,634,Qatar,Eritrea,1854,1511,343
2015,784,United Arab Emirates,Eritrea,17735,12211,5524
2015,887,Yemen,Eritrea,1902,1184,718
2015,152,Chile,Eritrea,6,2,4
2015,862,Venezuela (Bolivarian Republic of),Eritrea,28,15,13
2015,36,Australia,Eritrea,4660,2308,2352
2015,100,Bulgaria,Eritrea,3,2,1
2015,203,Czechia,Eritrea,9,6,3
2015,348,Hungary,Eritrea,30,18,12
2015,616,Poland,Eritrea,30,5,25
2015,208,Denmark,Eritrea,341,170,171
2015,246,Finland,Eritrea,165,101,64
2015,352,Iceland,Eritrea,7,4,3
2015,372,Ireland,Eritrea,38,24,14
2015,578,Norway,Eritrea,14824,8601,6223
2015,752,Sweden,Eritrea,28616,15892,12724
2015,826,United Kingdom,Eritrea,15063,7180,7883
2015,300,Greece,Eritrea,395,193,202
2015,380,Italy,Eritrea,13580,7454,6126
2015,470,Malta,Eritrea,929,473,456
2015,705,Slovenia,Eritrea,8,6,2
2015,724,Spain,Eritrea,137,81,56
2015,40,Austria,Eritrea,104,46,58
2015,56,Belgium,Eritrea,248,174,74
2015,250,France,Eritrea,3128,1526,1602
2015,276,Germany,Eritrea,12337,5975,6362
2015,528,Netherlands,Eritrea,2150,1121,1029
2015,756,Switzerland,Eritrea,24089,14694,9395
2015,124,Canada,Eritrea,14917,7739,7178
2015,840,United States of America,Eritrea,36332,17862,18470
2019,231,Ethiopia,Eritrea,222248,112237,110011
2019,404,Kenya,Eritrea,1972,981,991
2019,706,Somalia,Eritrea,40,22,18
2019,728,South Sudan,Eritrea,3402,2049,1353
2019,800,Uganda,Eritrea,14592,7072,7520
2019,710,South Africa,Eritrea,997,551,446
2019,324,Guinea,Eritrea,21,14,7
2019,818,Egypt,Eritrea,4515,1991,2524
2019,434,Libya,Eritrea,2104,1437,667
2019,729,Sudan,Eritrea,197001,99616,97385
2019,48,Bahrain,Eritrea,1631,1095,536
2019,196,Cyprus,Eritrea,2,0,2
2019,368,Iraq,Eritrea,825,582,243
2019,400,Jordan,Eritrea,77,43,34
2019,414,Kuwait,Eritrea,5003,3021,1982
2019,634,Qatar,Eritrea,5891,4724,1167
2019,784,United Arab Emirates,Eritrea,19048,13114,5934
2019,887,Yemen,Eritrea,1930,1202,728
2019,152,Chile,Eritrea,8,3,5
2019,862,Venezuela (Bolivarian Republic of),Eritrea,27,15,12
2019,36,Australia,Eritrea,5776,2888,2888
2019,100,Bulgaria,Eritrea,3,2,1
2019,203,Czechia,Eritrea,8,5,3
2019,348,Hungary,Eritrea,36,21,15
2019,616,Poland,Eritrea,31,5,26
2019,208,Denmark,Eritrea,5545,3528,2017
2019,246,Finland,Eritrea,512,380,132
2019,352,Iceland,Eritrea,7,4,3
2019,372,Ireland,Eritrea,41,26,15
2019,578,Norway,Eritrea,21788,13050,8738
2019,752,Sweden,Eritrea,53250,30097,23153
2019,826,United Kingdom,Eritrea,17105,8176,8929
2019,300,Greece,Eritrea,1055,515,540
2019,380,Italy,Eritrea,13034,6684,6350
2019,470,Malta,Eritrea,1499,769,730
2019,705,Slovenia,Eritrea,13,11,2
2019,724,Spain,Eritrea,141,82,59
2019,40,Austria,Eritrea,122,55,67
2019,56,Belgium,Eritrea,538,353,185
2019,250,France,Eritrea,3311,1612,1699
2019,276,Germany,Eritrea,52580,32333,20247
2019,528,Netherlands,Eritrea,11211,6873,4338
2019,756,Switzerland,Eritrea,27380,16345,11035
2019,124,Canada,Eritrea,15985,8293,7692
2019,840,United States of America,Eritrea,39234,19074,20160
1990,710,South Africa,Estonia,68,55,13
1990,818,Egypt,Estonia,14,8,6
1990,31,Azerbaijan,Estonia,662,287,375
1990,196,Cyprus,Estonia,7,2,5
1990,268,Georgia,Estonia,846,377,469
1990,792,Turkey,Estonia,27,11,16
1990,398,Kazakhstan,Estonia,358,153,205
1990,417,Kyrgyzstan,Estonia,1544,655,889
1990,188,Costa Rica,Estonia,2,0,2
1990,32,Argentina,Estonia,109,38,71
1990,152,Chile,Estonia,26,16,10
1990,170,Colombia,Estonia,19,9,10
1990,604,Peru,Estonia,9,5,4
1990,862,Venezuela (Bolivarian Republic of),Estonia,46,14,32
1990,36,Australia,Estonia,2731,1251,1480
1990,112,Belarus,Estonia,3429,1709,1720
1990,100,Bulgaria,Estonia,4,1,3
1990,203,Czechia,Estonia,15,6,9
1990,348,Hungary,Estonia,39,12,27
1990,616,Poland,Estonia,402,159,243
1990,643,Russian Federation,Estonia,62441,30641,31800
1990,703,Slovakia,Estonia,3,1,2
1990,804,Ukraine,Estonia,10585,4536,6049
1990,208,Denmark,Estonia,7,4,3
1990,372,Ireland,Estonia,190,93,97
1990,428,Latvia,Estonia,1675,723,952
1990,440,Lithuania,Estonia,1514,785,729
1990,578,Norway,Estonia,23,13,10
1990,752,Sweden,Estonia,8056,3535,4521
1990,826,United Kingdom,Estonia,545,371,174
1990,300,Greece,Estonia,146,81,65
1990,380,Italy,Estonia,31,11,20
1990,620,Portugal,Estonia,66,29,37
1990,724,Spain,Estonia,18,5,13
1990,40,Austria,Estonia,206,54,152
1990,56,Belgium,Estonia,58,26,32
1990,250,France,Estonia,828,322,506
1990,276,Germany,Estonia,1467,773,694
1990,438,Liechtenstein,Estonia,13,13,0
1990,442,Luxembourg,Estonia,18,3,15
1990,528,Netherlands,Estonia,83,25,58
1990,756,Switzerland,Estonia,195,61,134
1990,124,Canada,Estonia,6170,3004,3166
1990,840,United States of America,Estonia,9210,4442,4768
1995,710,South Africa,Estonia,56,46,10
1995,818,Egypt,Estonia,16,8,8
1995,31,Azerbaijan,Estonia,581,272,309
1995,196,Cyprus,Estonia,10,2,8
1995,268,Georgia,Estonia,720,318,402
1995,792,Turkey,Estonia,65,25,40
1995,398,Kazakhstan,Estonia,588,256,332
1995,417,Kyrgyzstan,Estonia,1307,554,753
1995,188,Costa Rica,Estonia,2,0,2
1995,32,Argentina,Estonia,106,37,69
1995,68,Bolivia (Plurinational State of),Estonia,2,0,2
1995,152,Chile,Estonia,35,18,17
1995,170,Colombia,Estonia,19,9,10
1995,604,Peru,Estonia,10,5,5
1995,862,Venezuela (Bolivarian Republic of),Estonia,45,14,31
1995,36,Australia,Estonia,2556,1161,1395
1995,112,Belarus,Estonia,3397,1427,1970
1995,100,Bulgaria,Estonia,16,5,11
1995,203,Czechia,Estonia,23,10,13
1995,348,Hungary,Estonia,63,17,46
1995,616,Poland,Estonia,343,133,210
1995,643,Russian Federation,Estonia,65943,32132,33811
1995,703,Slovakia,Estonia,15,4,11
1995,804,Ukraine,Estonia,11068,5154,5914
1995,208,Denmark,Estonia,234,73,161
1995,246,Finland,Estonia,3285,1501,1784
1995,352,Iceland,Estonia,11,4,7
1995,372,Ireland,Estonia,674,319,355
1995,428,Latvia,Estonia,2872,1299,1573
1995,440,Lithuania,Estonia,1414,735,679
1995,578,Norway,Estonia,159,61,98
1995,752,Sweden,Estonia,9560,4154,5406
1995,826,United Kingdom,Estonia,1233,643,590
1995,191,Croatia,Estonia,3,1,2
1995,300,Greece,Estonia,102,50,52
1995,380,Italy,Estonia,212,20,192
1995,620,Portugal,Estonia,141,61,80
1995,724,Spain,Estonia,58,22,36
1995,40,Austria,Estonia,232,63,169
1995,56,Belgium,Estonia,57,26,31
1995,250,France,Estonia,855,324,531
1995,276,Germany,Estonia,5310,1755,3555
1995,438,Liechtenstein,Estonia,15,15,0
1995,442,Luxembourg,Estonia,16,3,13
1995,528,Netherlands,Estonia,121,34,87
1995,756,Switzerland,Estonia,270,90,180
1995,124,Canada,Estonia,6196,3003,3193
1995,840,United States of America,Estonia,9624,4685,4939
2000,710,South Africa,Estonia,61,49,12
2000,818,Egypt,Estonia,19,9,10
2000,31,Azerbaijan,Estonia,586,270,316
2000,196,Cyprus,Estonia,13,3,10
2000,268,Georgia,Estonia,120,37,83
2000,792,Turkey,Estonia,105,39,66
2000,398,Kazakhstan,Estonia,817,359,458
2000,417,Kyrgyzstan,Estonia,1033,436,597
2000,188,Costa Rica,Estonia,2,0,2
2000,32,Argentina,Estonia,103,37,66
2000,68,Bolivia (Plurinational State of),Estonia,4,1,3
2000,152,Chile,Estonia,44,22,22
2000,170,Colombia,Estonia,18,8,10
2000,604,Peru,Estonia,12,6,6
2000,862,Venezuela (Bolivarian Republic of),Estonia,45,14,31
2000,36,Australia,Estonia,1970,882,1088
2000,112,Belarus,Estonia,3365,1145,2220
2000,100,Bulgaria,Estonia,27,8,19
2000,203,Czechia,Estonia,31,14,17
2000,348,Hungary,Estonia,87,22,65
2000,616,Poland,Estonia,293,110,183
2000,643,Russian Federation,Estonia,67055,32470,34585
2000,703,Slovakia,Estonia,33,8,25
2000,804,Ukraine,Estonia,11687,5835,5852
2000,208,Denmark,Estonia,460,141,319
2000,246,Finland,Estonia,6569,3001,3568
2000,352,Iceland,Estonia,21,8,13
2000,372,Ireland,Estonia,1529,750,779
2000,428,Latvia,Estonia,4069,1874,2195
2000,440,Lithuania,Estonia,1107,575,532
2000,578,Norway,Estonia,302,67,235
2000,752,Sweden,Estonia,10253,4417,5836
2000,826,United Kingdom,Estonia,1943,924,1019
2000,191,Croatia,Estonia,5,2,3
2000,300,Greece,Estonia,60,20,40
2000,380,Italy,Estonia,392,28,364
2000,620,Portugal,Estonia,223,97,126
2000,705,Slovenia,Estonia,3,3,0
2000,724,Spain,Estonia,124,49,75
2000,40,Austria,Estonia,258,73,185
2000,56,Belgium,Estonia,55,25,30
2000,250,France,Estonia,881,325,556
2000,276,Germany,Estonia,9153,2738,6415
2000,438,Liechtenstein,Estonia,17,17,0
2000,442,Luxembourg,Estonia,16,3,13
2000,528,Netherlands,Estonia,165,43,122
2000,756,Switzerland,Estonia,346,119,227
2000,124,Canada,Estonia,6369,3073,3296
2000,840,United States of America,Estonia,10033,4931,5102
2005,710,South Africa,Estonia,80,65,15
2005,818,Egypt,Estonia,23,12,11
2005,31,Azerbaijan,Estonia,556,247,309
2005,196,Cyprus,Estonia,19,4,15
2005,268,Georgia,Estonia,113,35,78
2005,792,Turkey,Estonia,108,39,69
2005,398,Kazakhstan,Estonia,932,423,509
2005,417,Kyrgyzstan,Estonia,848,356,492
2005,44,Bahamas,Estonia,8,3,5
2005,188,Costa Rica,Estonia,1,0,1
2005,32,Argentina,Estonia,76,27,49
2005,68,Bolivia (Plurinational State of),Estonia,5,1,4
2005,76,Brazil,Estonia,90,26,64
2005,152,Chile,Estonia,66,34,32
2005,170,Colombia,Estonia,17,8,9
2005,604,Peru,Estonia,15,7,8
2005,862,Venezuela (Bolivarian Republic of),Estonia,46,14,32
2005,36,Australia,Estonia,1660,737,923
2005,112,Belarus,Estonia,3232,1099,2133
2005,100,Bulgaria,Estonia,43,13,30
2005,203,Czechia,Estonia,83,36,47
2005,348,Hungary,Estonia,107,28,79
2005,616,Poland,Estonia,245,90,155
2005,643,Russian Federation,Estonia,63001,29942,33059
2005,703,Slovakia,Estonia,38,10,28
2005,804,Ukraine,Estonia,10678,5339,5339
2005,208,Denmark,Estonia,775,229,546
2005,246,Finland,Estonia,16373,7834,8539
2005,352,Iceland,Estonia,81,34,47
2005,372,Ireland,Estonia,2297,1101,1196
2005,428,Latvia,Estonia,3803,1758,2045
2005,440,Lithuania,Estonia,1107,561,546
2005,578,Norway,Estonia,632,164,468
2005,752,Sweden,Estonia,9870,4014,5856
2005,826,United Kingdom,Estonia,4937,1913,3024
2005,191,Croatia,Estonia,13,5,8
2005,300,Greece,Estonia,96,25,71
2005,380,Italy,Estonia,887,127,760
2005,620,Portugal,Estonia,182,70,112
2005,724,Spain,Estonia,575,242,333
2005,40,Austria,Estonia,289,77,212
2005,56,Belgium,Estonia,246,80,166
2005,250,France,Estonia,786,262,524
2005,276,Germany,Estonia,9351,3321,6030
2005,438,Liechtenstein,Estonia,9,9,0
2005,442,Luxembourg,Estonia,179,34,145
2005,528,Netherlands,Estonia,299,78,221
2005,756,Switzerland,Estonia,419,136,283
2005,124,Canada,Estonia,5058,2337,2721
2005,840,United States of America,Estonia,10073,4979,5094
2010,710,South Africa,Estonia,125,102,23
2010,818,Egypt,Estonia,25,13,12
2010,31,Azerbaijan,Estonia,509,236,273
2010,196,Cyprus,Estonia,31,7,24
2010,268,Georgia,Estonia,114,36,78
2010,792,Turkey,Estonia,111,39,72
2010,398,Kazakhstan,Estonia,1046,487,559
2010,417,Kyrgyzstan,Estonia,651,270,381
2010,44,Bahamas,Estonia,15,6,9
2010,188,Costa Rica,Estonia,3,0,3
2010,32,Argentina,Estonia,49,18,31
2010,68,Bolivia (Plurinational State of),Estonia,5,1,4
2010,76,Brazil,Estonia,180,52,128
2010,152,Chile,Estonia,88,46,42
2010,170,Colombia,Estonia,20,10,10
2010,604,Peru,Estonia,16,8,8
2010,862,Venezuela (Bolivarian Republic of),Estonia,49,14,35
2010,36,Australia,Estonia,2240,1028,1212
2010,112,Belarus,Estonia,3099,1054,2045
2010,100,Bulgaria,Estonia,57,18,39
2010,203,Czechia,Estonia,128,57,71
2010,348,Hungary,Estonia,126,33,93
2010,616,Poland,Estonia,206,72,134
2010,643,Russian Federation,Estonia,57651,26818,30833
2010,703,Slovakia,Estonia,42,11,31
2010,804,Ukraine,Estonia,10188,5101,5087
2010,208,Denmark,Estonia,1069,312,757
2010,246,Finland,Estonia,28289,12392,15897
2010,352,Iceland,Estonia,139,59,80
2010,372,Ireland,Estonia,2686,1119,1567
2010,428,Latvia,Estonia,3442,1568,1874
2010,440,Lithuania,Estonia,958,444,514
2010,578,Norway,Estonia,1999,1022,977
2010,752,Sweden,Estonia,10010,4062,5948
2010,826,United Kingdom,Estonia,5200,2080,3120
2010,191,Croatia,Estonia,20,7,13
2010,300,Greece,Estonia,137,31,106
2010,380,Italy,Estonia,1370,203,1167
2010,620,Portugal,Estonia,112,32,80
2010,705,Slovenia,Estonia,18,11,7
2010,724,Spain,Estonia,1254,469,785
2010,40,Austria,Estonia,319,81,238
2010,56,Belgium,Estonia,511,149,362
2010,250,France,Estonia,853,303,550
2010,276,Germany,Estonia,9484,3763,5721
2010,438,Liechtenstein,Estonia,2,1,1
2010,442,Luxembourg,Estonia,345,66,279
2010,528,Netherlands,Estonia,525,142,383
2010,756,Switzerland,Estonia,458,124,334
2010,124,Canada,Estonia,4090,1766,2324
2010,840,United States of America,Estonia,10425,5081,5344
2015,710,South Africa,Estonia,224,182,42
2015,818,Egypt,Estonia,18,11,7
2015,31,Azerbaijan,Estonia,486,231,255
2015,196,Cyprus,Estonia,29,7,22
2015,268,Georgia,Estonia,119,38,81
2015,792,Turkey,Estonia,112,38,74
2015,398,Kazakhstan,Estonia,1113,528,585
2015,417,Kyrgyzstan,Estonia,573,235,338
2015,44,Bahamas,Estonia,16,6,10
2015,188,Costa Rica,Estonia,3,0,3
2015,32,Argentina,Estonia,49,18,31
2015,68,Bolivia (Plurinational State of),Estonia,6,1,5
2015,76,Brazil,Estonia,217,63,154
2015,152,Chile,Estonia,133,69,64
2015,170,Colombia,Estonia,22,11,11
2015,604,Peru,Estonia,17,9,8
2015,862,Venezuela (Bolivarian Republic of),Estonia,52,15,37
2015,36,Australia,Estonia,3440,1472,1968
2015,112,Belarus,Estonia,3243,1104,2139
2015,100,Bulgaria,Estonia,73,25,48
2015,203,Czechia,Estonia,175,72,103
2015,348,Hungary,Estonia,158,47,111
2015,616,Poland,Estonia,198,72,126
2015,643,Russian Federation,Estonia,58751,27173,31578
2015,703,Slovakia,Estonia,55,18,37
2015,804,Ukraine,Estonia,10222,5126,5096
2015,208,Denmark,Estonia,1562,504,1058
2015,246,Finland,Estonia,53016,24353,28663
2015,352,Iceland,Estonia,129,45,84
2015,372,Ireland,Estonia,2744,1123,1621
2015,428,Latvia,Estonia,3081,1403,1678
2015,440,Lithuania,Estonia,816,366,450
2015,578,Norway,Estonia,5069,2980,2089
2015,752,Sweden,Estonia,10303,4383,5920
2015,826,United Kingdom,Estonia,6650,2542,4108
2015,191,Croatia,Estonia,20,7,13
2015,300,Greece,Estonia,128,25,103
2015,380,Italy,Estonia,1408,235,1173
2015,620,Portugal,Estonia,128,34,94
2015,705,Slovenia,Estonia,28,13,15
2015,724,Spain,Estonia,1875,699,1176
2015,40,Austria,Estonia,372,96,276
2015,56,Belgium,Estonia,729,241,488
2015,250,France,Estonia,1201,406,795
2015,276,Germany,Estonia,9883,3908,5975
2015,438,Liechtenstein,Estonia,2,0,2
2015,442,Luxembourg,Estonia,526,107,419
2015,528,Netherlands,Estonia,937,306,631
2015,756,Switzerland,Estonia,777,238,539
2015,124,Canada,Estonia,3180,1331,1849
2015,840,United States of America,Estonia,11086,5375,5711
2019,710,South Africa,Estonia,250,204,46
2019,818,Egypt,Estonia,25,14,11
2019,31,Azerbaijan,Estonia,466,221,245
2019,196,Cyprus,Estonia,28,7,21
2019,268,Georgia,Estonia,122,39,83
2019,792,Turkey,Estonia,151,52,99
2019,398,Kazakhstan,Estonia,1163,552,611
2019,417,Kyrgyzstan,Estonia,561,230,331
2019,44,Bahamas,Estonia,16,6,10
2019,188,Costa Rica,Estonia,3,0,3
2019,32,Argentina,Estonia,49,18,31
2019,68,Bolivia (Plurinational State of),Estonia,6,1,5
2019,76,Brazil,Estonia,244,71,173
2019,152,Chile,Estonia,177,87,90
2019,170,Colombia,Estonia,22,11,11
2019,604,Peru,Estonia,19,11,8
2019,862,Venezuela (Bolivarian Republic of),Estonia,50,14,36
2019,36,Australia,Estonia,3819,1609,2210
2019,112,Belarus,Estonia,3202,1090,2112
2019,100,Bulgaria,Estonia,100,33,67
2019,203,Czechia,Estonia,213,91,122
2019,348,Hungary,Estonia,155,43,112
2019,616,Poland,Estonia,209,81,128
2019,643,Russian Federation,Estonia,58737,27167,31570
2019,703,Slovakia,Estonia,62,21,41
2019,804,Ukraine,Estonia,10324,5178,5146
2019,208,Denmark,Estonia,1604,505,1099
2019,246,Finland,Estonia,61365,28802,32563
2019,352,Iceland,Estonia,150,61,89
2019,372,Ireland,Estonia,3012,1238,1774
2019,428,Latvia,Estonia,2811,1288,1523
2019,440,Lithuania,Estonia,717,313,404
2019,578,Norway,Estonia,5419,3056,2363
2019,752,Sweden,Estonia,10101,4556,5545
2019,826,United Kingdom,Estonia,7551,2898,4653
2019,191,Croatia,Estonia,18,6,12
2019,300,Greece,Estonia,125,29,96
2019,380,Italy,Estonia,1524,261,1263
2019,620,Portugal,Estonia,130,35,95
2019,705,Slovenia,Estonia,24,13,11
2019,724,Spain,Estonia,1942,695,1247
2019,40,Austria,Estonia,439,119,320
2019,56,Belgium,Estonia,1001,324,677
2019,250,France,Estonia,1271,428,843
2019,276,Germany,Estonia,10841,4297,6544
2019,438,Liechtenstein,Estonia,2,0,2
2019,442,Luxembourg,Estonia,626,196,430
2019,528,Netherlands,Estonia,1179,400,779
2019,756,Switzerland,Estonia,868,261,607
2019,124,Canada,Estonia,3407,1426,1981
2019,840,United States of America,Estonia,11970,5737,6233
1990,834,United Republic of Tanzania,Eswatini,51,34,17
1990,72,Botswana,Eswatini,108,62,46
1990,426,Lesotho,Eswatini,51,24,27
1990,516,Namibia,Eswatini,290,130,160
1990,710,South Africa,Eswatini,34114,25065,9049
1990,792,Turkey,Eswatini,18,7,11
1990,188,Costa Rica,Eswatini,1,0,1
1990,152,Chile,Eswatini,2,1,1
1990,36,Australia,Eswatini,117,48,69
1990,100,Bulgaria,Eswatini,1,0,1
1990,208,Denmark,Eswatini,37,23,14
1990,372,Ireland,Eswatini,4,2,2
1990,752,Sweden,Eswatini,12,5,7
1990,826,United Kingdom,Eswatini,118,72,46
1990,300,Greece,Eswatini,6,3,3
1990,380,Italy,Eswatini,1,0,1
1990,620,Portugal,Eswatini,48,21,27
1990,40,Austria,Eswatini,13,5,8
1990,250,France,Eswatini,8,3,5
1990,528,Netherlands,Eswatini,36,19,17
1990,756,Switzerland,Eswatini,44,16,28
1990,124,Canada,Eswatini,101,50,51
1995,834,United Republic of Tanzania,Eswatini,69,47,22
1995,72,Botswana,Eswatini,174,108,66
1995,426,Lesotho,Eswatini,44,21,23
1995,516,Namibia,Eswatini,277,125,152
1995,710,South Africa,Eswatini,28635,19006,9629
1995,792,Turkey,Eswatini,44,16,28
1995,188,Costa Rica,Eswatini,1,1,0
1995,152,Chile,Eswatini,2,2,0
1995,36,Australia,Eswatini,178,86,92
1995,100,Bulgaria,Eswatini,2,0,2
1995,203,Czechia,Eswatini,1,0,1
1995,208,Denmark,Eswatini,39,23,16
1995,372,Ireland,Eswatini,11,4,7
1995,752,Sweden,Eswatini,14,5,9
1995,826,United Kingdom,Eswatini,469,233,236
1995,300,Greece,Eswatini,9,3,6
1995,380,Italy,Eswatini,5,1,4
1995,620,Portugal,Eswatini,103,46,57
1995,40,Austria,Eswatini,15,6,9
1995,250,France,Eswatini,9,3,6
1995,528,Netherlands,Eswatini,52,26,26
1995,756,Switzerland,Eswatini,58,23,35
1995,124,Canada,Eswatini,131,64,67
2000,834,United Republic of Tanzania,Eswatini,74,50,24
2000,72,Botswana,Eswatini,259,167,92
2000,426,Lesotho,Eswatini,36,17,19
2000,516,Namibia,Eswatini,259,118,141
2000,710,South Africa,Eswatini,31743,17967,13776
2000,792,Turkey,Eswatini,71,25,46
2000,188,Costa Rica,Eswatini,1,1,0
2000,152,Chile,Eswatini,2,1,1
2000,36,Australia,Eswatini,240,114,126
2000,100,Bulgaria,Eswatini,2,0,2
2000,203,Czechia,Eswatini,1,0,1
2000,208,Denmark,Eswatini,40,23,17
2000,372,Ireland,Eswatini,25,10,15
2000,752,Sweden,Eswatini,16,6,10
2000,826,United Kingdom,Eswatini,828,397,431
2000,300,Greece,Eswatini,13,3,10
2000,380,Italy,Eswatini,8,1,7
2000,620,Portugal,Eswatini,164,74,90
2000,40,Austria,Eswatini,17,7,10
2000,250,France,Eswatini,9,3,6
2000,528,Netherlands,Eswatini,72,34,38
2000,756,Switzerland,Eswatini,74,30,44
2000,124,Canada,Eswatini,164,80,84
2005,834,United Republic of Tanzania,Eswatini,83,57,26
2005,72,Botswana,Eswatini,391,251,140
2005,426,Lesotho,Eswatini,36,17,19
2005,516,Namibia,Eswatini,204,92,112
2005,710,South Africa,Eswatini,41770,23131,18639
2005,792,Turkey,Eswatini,73,25,48
2005,44,Bahamas,Eswatini,6,3,3
2005,188,Costa Rica,Eswatini,1,1,0
2005,152,Chile,Eswatini,3,2,1
2005,36,Australia,Eswatini,270,134,136
2005,100,Bulgaria,Eswatini,3,0,3
2005,203,Czechia,Eswatini,1,0,1
2005,208,Denmark,Eswatini,44,26,18
2005,372,Ireland,Eswatini,25,11,14
2005,752,Sweden,Eswatini,18,7,11
2005,826,United Kingdom,Eswatini,1080,489,591
2005,300,Greece,Eswatini,18,10,8
2005,380,Italy,Eswatini,22,7,15
2005,620,Portugal,Eswatini,368,206,162
2005,40,Austria,Eswatini,19,7,12
2005,250,France,Eswatini,26,10,16
2005,528,Netherlands,Eswatini,88,38,50
2005,756,Switzerland,Eswatini,81,31,50
2005,124,Canada,Eswatini,235,90,145
2010,834,United Republic of Tanzania,Eswatini,86,59,27
2010,72,Botswana,Eswatini,524,335,189
2010,426,Lesotho,Eswatini,36,17,19
2010,516,Namibia,Eswatini,196,89,107
2010,710,South Africa,Eswatini,65433,36125,29308
2010,792,Turkey,Eswatini,75,25,50
2010,44,Bahamas,Eswatini,11,5,6
2010,188,Costa Rica,Eswatini,1,1,0
2010,152,Chile,Eswatini,4,3,1
2010,36,Australia,Eswatini,340,168,172
2010,100,Bulgaria,Eswatini,3,0,3
2010,203,Czechia,Eswatini,1,0,1
2010,208,Denmark,Eswatini,46,28,18
2010,372,Ireland,Eswatini,21,9,12
2010,752,Sweden,Eswatini,25,14,11
2010,826,United Kingdom,Eswatini,1137,528,609
2010,300,Greece,Eswatini,22,16,6
2010,380,Italy,Eswatini,37,15,22
2010,620,Portugal,Eswatini,511,303,208
2010,40,Austria,Eswatini,20,7,13
2010,250,France,Eswatini,19,5,14
2010,528,Netherlands,Eswatini,76,32,44
2010,756,Switzerland,Eswatini,99,34,65
2010,124,Canada,Eswatini,280,94,186
2015,834,United Republic of Tanzania,Eswatini,88,58,30
2015,72,Botswana,Eswatini,571,365,206
2015,426,Lesotho,Eswatini,36,17,19
2015,516,Namibia,Eswatini,191,87,104
2015,710,South Africa,Eswatini,82621,43730,38891
2015,324,Guinea,Eswatini,5,4,1
2015,792,Turkey,Eswatini,76,25,51
2015,44,Bahamas,Eswatini,12,5,7
2015,188,Costa Rica,Eswatini,1,1,0
2015,152,Chile,Eswatini,6,5,1
2015,36,Australia,Eswatini,390,181,209
2015,100,Bulgaria,Eswatini,2,0,2
2015,203,Czechia,Eswatini,1,0,1
2015,208,Denmark,Eswatini,50,33,17
2015,372,Ireland,Eswatini,21,9,12
2015,752,Sweden,Eswatini,32,17,15
2015,826,United Kingdom,Eswatini,1454,653,801
2015,300,Greece,Eswatini,20,15,5
2015,380,Italy,Eswatini,30,11,19
2015,620,Portugal,Eswatini,578,332,246
2015,40,Austria,Eswatini,23,8,15
2015,250,France,Eswatini,21,6,15
2015,528,Netherlands,Eswatini,83,34,49
2015,756,Switzerland,Eswatini,95,31,64
2015,124,Canada,Eswatini,397,159,238
2019,834,United Republic of Tanzania,Eswatini,78,54,24
2019,72,Botswana,Eswatini,611,391,220
2019,426,Lesotho,Eswatini,37,17,20
2019,516,Namibia,Eswatini,202,92,110
2019,710,South Africa,Eswatini,92608,49059,43549
2019,324,Guinea,Eswatini,4,4,0
2019,792,Turkey,Eswatini,102,34,68
2019,44,Bahamas,Eswatini,12,5,7
2019,188,Costa Rica,Eswatini,1,1,0
2019,152,Chile,Eswatini,8,7,1
2019,36,Australia,Eswatini,402,194,208
2019,100,Bulgaria,Eswatini,2,0,2
2019,203,Czechia,Eswatini,1,0,1
2019,208,Denmark,Eswatini,60,37,23
2019,372,Ireland,Eswatini,23,10,13
2019,752,Sweden,Eswatini,29,12,17
2019,826,United Kingdom,Eswatini,1651,744,907
2019,300,Greece,Eswatini,19,15,4
2019,380,Italy,Eswatini,43,16,27
2019,620,Portugal,Eswatini,587,338,249
2019,40,Austria,Eswatini,27,10,17
2019,250,France,Eswatini,22,7,15
2019,528,Netherlands,Eswatini,94,39,55
2019,756,Switzerland,Eswatini,84,31,53
2019,124,Canada,Eswatini,425,170,255
1990,262,Djibouti,Ethiopia,13405,5911,7494
1990,232,Eritrea,Ethiopia,1284,668,616
1990,404,Kenya,Ethiopia,26695,15293,11402
1990,706,Somalia,Ethiopia,460000,234861,225139
1990,800,Uganda,Ethiopia,162,83,79
1990,516,Namibia,Ethiopia,312,98,214
1990,710,South Africa,Ethiopia,2873,1438,1435
1990,288,Ghana,Ethiopia,16,7,9
1990,818,Egypt,Ethiopia,567,227,340
1990,434,Libya,Ethiopia,1618,653,965
1990,729,Sudan,Ethiopia,942295,463796,478499
1990,48,Bahrain,Ethiopia,357,255,102
1990,196,Cyprus,Ethiopia,20,8,12
1990,376,Israel,Ethiopia,40595,20567,20028
1990,400,Jordan,Ethiopia,21,12,9
1990,414,Kuwait,Ethiopia,2216,1342,874
1990,634,Qatar,Ethiopia,908,662,246
1990,682,Saudi Arabia,Ethiopia,61017,40588,20429
1990,792,Turkey,Ethiopia,23,15,8
1990,784,United Arab Emirates,Ethiopia,2708,1928,780
1990,887,Yemen,Ethiopia,15804,9175,6629
1990,28,Antigua and Barbuda,Ethiopia,1,0,1
1990,662,Saint Lucia,Ethiopia,2,0,2
1990,188,Costa Rica,Ethiopia,2,1,1
1990,558,Nicaragua,Ethiopia,36,24,12
1990,32,Argentina,Ethiopia,71,30,41
1990,68,Bolivia (Plurinational State of),Ethiopia,4,0,4
1990,152,Chile,Ethiopia,14,9,5
1990,862,Venezuela (Bolivarian Republic of),Ethiopia,29,19,10
1990,36,Australia,Ethiopia,1336,782,554
1990,554,New Zealand,Ethiopia,153,74,79
1990,112,Belarus,Ethiopia,11,11,0
1990,100,Bulgaria,Ethiopia,26,24,2
1990,203,Czechia,Ethiopia,19,16,3
1990,348,Hungary,Ethiopia,31,26,5
1990,616,Poland,Ethiopia,68,50,18
1990,643,Russian Federation,Ethiopia,438,215,223
1990,703,Slovakia,Ethiopia,5,4,1
1990,208,Denmark,Ethiopia,559,350,209
1990,246,Finland,Ethiopia,203,109,94
1990,352,Iceland,Ethiopia,13,6,7
1990,372,Ireland,Ethiopia,29,13,16
1990,578,Norway,Ethiopia,1681,1114,567
1990,752,Sweden,Ethiopia,9356,5054,4302
1990,826,United Kingdom,Ethiopia,1086,657,429
1990,300,Greece,Ethiopia,3422,1893,1529
1990,380,Italy,Ethiopia,16703,3697,13006
1990,470,Malta,Ethiopia,25,13,12
1990,620,Portugal,Ethiopia,3,1,2
1990,724,Spain,Ethiopia,118,66,52
1990,40,Austria,Ethiopia,703,291,412
1990,56,Belgium,Ethiopia,3433,2232,1201
1990,250,France,Ethiopia,3850,1514,2336
1990,276,Germany,Ethiopia,19612,12177,7435
1990,528,Netherlands,Ethiopia,3852,2237,1615
1990,756,Switzerland,Ethiopia,1595,807,788
1990,124,Canada,Ethiopia,13765,6701,7064
1990,840,United States of America,Ethiopia,34805,18499,16306
1995,262,Djibouti,Ethiopia,10943,4829,6114
1995,232,Eritrea,Ethiopia,687,357,330
1995,404,Kenya,Ethiopia,29521,16825,12696
1995,706,Somalia,Ethiopia,18044,9490,8554
1995,800,Uganda,Ethiopia,175,88,87
1995,748,Eswatini,Ethiopia,3,2,1
1995,516,Namibia,Ethiopia,298,95,203
1995,710,South Africa,Ethiopia,1792,969,823
1995,288,Ghana,Ethiopia,16,8,8
1995,818,Egypt,Ethiopia,503,203,300
1995,434,Libya,Ethiopia,1470,689,781
1995,729,Sudan,Ethiopia,496740,238328,258412
1995,48,Bahrain,Ethiopia,392,276,116
1995,196,Cyprus,Ethiopia,29,11,18
1995,376,Israel,Ethiopia,50287,25090,25197
1995,400,Jordan,Ethiopia,57,9,48
1995,414,Kuwait,Ethiopia,1776,1132,644
1995,634,Qatar,Ethiopia,986,736,250
1995,682,Saudi Arabia,Ethiopia,62534,41706,20828
1995,792,Turkey,Ethiopia,34,14,20
1995,784,United Arab Emirates,Ethiopia,3470,2486,984
1995,887,Yemen,Ethiopia,687,399,288
1995,28,Antigua and Barbuda,Ethiopia,38,17,21
1995,662,Saint Lucia,Ethiopia,2,0,2
1995,188,Costa Rica,Ethiopia,1,1,0
1995,558,Nicaragua,Ethiopia,29,19,10
1995,32,Argentina,Ethiopia,69,29,40
1995,68,Bolivia (Plurinational State of),Ethiopia,4,1,3
1995,152,Chile,Ethiopia,9,6,3
1995,862,Venezuela (Bolivarian Republic of),Ethiopia,28,18,10
1995,36,Australia,Ethiopia,2563,1373,1190
1995,554,New Zealand,Ethiopia,185,89,96
1995,112,Belarus,Ethiopia,18,17,1
1995,100,Bulgaria,Ethiopia,30,27,3
1995,203,Czechia,Ethiopia,29,24,5
1995,348,Hungary,Ethiopia,61,46,15
1995,616,Poland,Ethiopia,58,43,15
1995,643,Russian Federation,Ethiopia,372,225,147
1995,703,Slovakia,Ethiopia,10,8,2
1995,208,Denmark,Ethiopia,820,471,349
1995,246,Finland,Ethiopia,394,225,169
1995,352,Iceland,Ethiopia,22,11,11
1995,372,Ireland,Ethiopia,82,36,46
1995,578,Norway,Ethiopia,2227,1356,871
1995,752,Sweden,Ethiopia,11103,5959,5144
1995,826,United Kingdom,Ethiopia,4269,2118,2151
1995,300,Greece,Ethiopia,2929,1406,1523
1995,380,Italy,Ethiopia,11136,2646,8490
1995,470,Malta,Ethiopia,30,16,14
1995,620,Portugal,Ethiopia,7,2,5
1995,724,Spain,Ethiopia,174,100,74
1995,40,Austria,Ethiopia,793,336,457
1995,56,Belgium,Ethiopia,2711,1653,1058
1995,250,France,Ethiopia,3975,1523,2452
1995,276,Germany,Ethiopia,17204,10049,7155
1995,528,Netherlands,Ethiopia,5474,3128,2346
1995,756,Switzerland,Ethiopia,2441,1233,1208
1995,124,Canada,Ethiopia,13822,6697,7125
1995,840,United States of America,Ethiopia,52866,28370,24496
2000,262,Djibouti,Ethiopia,11023,4872,6151
2000,232,Eritrea,Ethiopia,91,48,43
2000,404,Kenya,Ethiopia,20846,11399,9447
2000,706,Somalia,Ethiopia,555,293,262
2000,800,Uganda,Ethiopia,291,148,143
2000,748,Eswatini,Ethiopia,15,8,7
2000,516,Namibia,Ethiopia,278,89,189
2000,710,South Africa,Ethiopia,1242,756,486
2000,288,Ghana,Ethiopia,18,8,10
2000,818,Egypt,Ethiopia,478,195,283
2000,434,Libya,Ethiopia,1347,754,593
2000,729,Sudan,Ethiopia,123478,62843,60635
2000,48,Bahrain,Ethiopia,430,297,133
2000,196,Cyprus,Ethiopia,37,14,23
2000,376,Israel,Ethiopia,57163,28478,28685
2000,400,Jordan,Ethiopia,93,7,86
2000,414,Kuwait,Ethiopia,2026,1369,657
2000,634,Qatar,Ethiopia,917,700,217
2000,682,Saudi Arabia,Ethiopia,64252,42943,21309
2000,792,Turkey,Ethiopia,56,22,34
2000,784,United Arab Emirates,Ethiopia,4433,3175,1258
2000,887,Yemen,Ethiopia,1703,990,713
2000,28,Antigua and Barbuda,Ethiopia,74,34,40
2000,662,Saint Lucia,Ethiopia,4,1,3
2000,188,Costa Rica,Ethiopia,1,1,0
2000,558,Nicaragua,Ethiopia,49,31,18
2000,32,Argentina,Ethiopia,67,29,38
2000,68,Bolivia (Plurinational State of),Ethiopia,4,2,2
2000,152,Chile,Ethiopia,5,3,2
2000,862,Venezuela (Bolivarian Republic of),Ethiopia,28,18,10
2000,36,Australia,Ethiopia,3640,1888,1752
2000,554,New Zealand,Ethiopia,635,309,326
2000,112,Belarus,Ethiopia,25,24,1
2000,100,Bulgaria,Ethiopia,34,30,4
2000,203,Czechia,Ethiopia,39,32,7
2000,348,Hungary,Ethiopia,90,66,24
2000,616,Poland,Ethiopia,50,37,13
2000,643,Russian Federation,Ethiopia,293,227,66
2000,703,Slovakia,Ethiopia,19,14,5
2000,208,Denmark,Ethiopia,1081,593,488
2000,234,Faroe Islands,Ethiopia,1,1,0
2000,246,Finland,Ethiopia,584,341,243
2000,352,Iceland,Ethiopia,31,16,15
2000,372,Ireland,Ethiopia,179,82,97
2000,578,Norway,Ethiopia,2567,1526,1041
2000,752,Sweden,Ethiopia,11907,6354,5553
2000,826,United Kingdom,Ethiopia,7524,3609,3915
2000,300,Greece,Ethiopia,2484,914,1570
2000,380,Italy,Ethiopia,5569,1595,3974
2000,470,Malta,Ethiopia,37,20,17
2000,620,Portugal,Ethiopia,12,2,10
2000,705,Slovenia,Ethiopia,13,4,9
2000,724,Spain,Ethiopia,305,177,128
2000,40,Austria,Ethiopia,883,381,502
2000,56,Belgium,Ethiopia,1909,1024,885
2000,250,France,Ethiopia,4099,1531,2568
2000,276,Germany,Ethiopia,14795,7921,6874
2000,528,Netherlands,Ethiopia,7281,4119,3162
2000,756,Switzerland,Ethiopia,3297,1668,1629
2000,124,Canada,Ethiopia,14208,6854,7354
2000,840,United States of America,Ethiopia,71296,38482,32814
2005,262,Djibouti,Ethiopia,10100,4830,5270
2005,232,Eritrea,Ethiopia,99,53,46
2005,404,Kenya,Ethiopia,20917,11759,9158
2005,706,Somalia,Ethiopia,1142,605,537
2005,800,Uganda,Ethiopia,337,171,166
2005,748,Eswatini,Ethiopia,20,10,10
2005,516,Namibia,Ethiopia,219,69,150
2005,710,South Africa,Ethiopia,1715,990,725
2005,288,Ghana,Ethiopia,25,12,13
2005,818,Egypt,Ethiopia,569,253,316
2005,434,Libya,Ethiopia,1484,948,536
2005,729,Sudan,Ethiopia,107732,55315,52417
2005,48,Bahrain,Ethiopia,565,384,181
2005,196,Cyprus,Ethiopia,54,20,34
2005,376,Israel,Ethiopia,67189,33443,33746
2005,400,Jordan,Ethiopia,134,25,109
2005,414,Kuwait,Ethiopia,2188,1444,744
2005,634,Qatar,Ethiopia,982,726,256
2005,682,Saudi Arabia,Ethiopia,79371,54566,24805
2005,792,Turkey,Ethiopia,59,23,36
2005,784,United Arab Emirates,Ethiopia,4607,3190,1417
2005,887,Yemen,Ethiopia,1916,1114,802
2005,28,Antigua and Barbuda,Ethiopia,80,37,43
2005,662,Saint Lucia,Ethiopia,3,1,2
2005,188,Costa Rica,Ethiopia,1,1,0
2005,558,Nicaragua,Ethiopia,72,44,28
2005,32,Argentina,Ethiopia,50,22,28
2005,68,Bolivia (Plurinational State of),Ethiopia,3,2,1
2005,76,Brazil,Ethiopia,5,0,5
2005,152,Chile,Ethiopia,7,5,2
2005,862,Venezuela (Bolivarian Republic of),Ethiopia,29,19,10
2005,36,Australia,Ethiopia,6110,3157,2953
2005,554,New Zealand,Ethiopia,889,432,457
2005,112,Belarus,Ethiopia,24,23,1
2005,100,Bulgaria,Ethiopia,43,37,6
2005,203,Czechia,Ethiopia,58,46,12
2005,348,Hungary,Ethiopia,111,82,29
2005,616,Poland,Ethiopia,46,33,13
2005,643,Russian Federation,Ethiopia,282,216,66
2005,703,Slovakia,Ethiopia,22,16,6
2005,208,Denmark,Ethiopia,1384,774,610
2005,234,Faroe Islands,Ethiopia,5,4,1
2005,246,Finland,Ethiopia,1080,636,444
2005,352,Iceland,Ethiopia,47,21,26
2005,372,Ireland,Ethiopia,180,88,92
2005,578,Norway,Ethiopia,3057,1683,1374
2005,752,Sweden,Ethiopia,11221,5891,5330
2005,826,United Kingdom,Ethiopia,10737,4891,5846
2005,300,Greece,Ethiopia,2479,852,1627
2005,380,Italy,Ethiopia,17983,7231,10752
2005,470,Malta,Ethiopia,45,24,21
2005,620,Portugal,Ethiopia,21,11,10
2005,705,Slovenia,Ethiopia,14,5,9
2005,724,Spain,Ethiopia,754,406,348
2005,40,Austria,Ethiopia,987,412,575
2005,56,Belgium,Ethiopia,1527,792,735
2005,250,France,Ethiopia,5594,2378,3216
2005,276,Germany,Ethiopia,15936,8242,7694
2005,528,Netherlands,Ethiopia,8004,4405,3599
2005,756,Switzerland,Ethiopia,3828,1839,1989
2005,124,Canada,Ethiopia,18889,9090,9799
2005,840,United States of America,Ethiopia,109858,59576,50282
2010,262,Djibouti,Ethiopia,11141,4901,6240
2010,232,Eritrea,Ethiopia,107,57,50
2010,404,Kenya,Ethiopia,35309,17361,17948
2010,706,Somalia,Ethiopia,26183,13356,12827
2010,728,South Sudan,Ethiopia,8605,4597,4008
2010,800,Uganda,Ethiopia,1900,975,925
2010,748,Eswatini,Ethiopia,26,12,14
2010,516,Namibia,Ethiopia,211,67,144
2010,710,South Africa,Ethiopia,2686,1547,1139
2010,288,Ghana,Ethiopia,25,13,12
2010,818,Egypt,Ethiopia,614,260,354
2010,434,Libya,Ethiopia,1624,1044,580
2010,729,Sudan,Ethiopia,73623,38693,34930
2010,48,Bahrain,Ethiopia,826,557,269
2010,196,Cyprus,Ethiopia,88,34,54
2010,376,Israel,Ethiopia,78029,38744,39285
2010,400,Jordan,Ethiopia,172,40,132
2010,414,Kuwait,Ethiopia,2897,1888,1009
2010,634,Qatar,Ethiopia,1846,1480,366
2010,682,Saudi Arabia,Ethiopia,102910,72127,30783
2010,792,Turkey,Ethiopia,78,34,44
2010,784,United Arab Emirates,Ethiopia,9276,6498,2778
2010,887,Yemen,Ethiopia,6181,3594,2587
2010,764,Thailand,Ethiopia,2,1,1
2010,28,Antigua and Barbuda,Ethiopia,85,39,46
2010,662,Saint Lucia,Ethiopia,3,1,2
2010,188,Costa Rica,Ethiopia,1,1,0
2010,558,Nicaragua,Ethiopia,76,47,29
2010,32,Argentina,Ethiopia,32,15,17
2010,68,Bolivia (Plurinational State of),Ethiopia,2,2,0
2010,76,Brazil,Ethiopia,10,0,10
2010,152,Chile,Ethiopia,10,7,3
2010,862,Venezuela (Bolivarian Republic of),Ethiopia,33,22,11
2010,36,Australia,Ethiopia,8970,4458,4512
2010,554,New Zealand,Ethiopia,1046,507,539
2010,112,Belarus,Ethiopia,23,22,1
2010,100,Bulgaria,Ethiopia,51,43,8
2010,203,Czechia,Ethiopia,71,55,16
2010,348,Hungary,Ethiopia,132,98,34
2010,616,Poland,Ethiopia,45,31,14
2010,643,Russian Federation,Ethiopia,266,201,65
2010,703,Slovakia,Ethiopia,25,18,7
2010,208,Denmark,Ethiopia,1656,939,717
2010,233,Estonia,Ethiopia,4,4,0
2010,234,Faroe Islands,Ethiopia,27,18,9
2010,246,Finland,Ethiopia,1864,1055,809
2010,352,Iceland,Ethiopia,63,28,35
2010,372,Ireland,Ethiopia,151,68,83
2010,578,Norway,Ethiopia,5170,2751,2419
2010,752,Sweden,Ethiopia,13822,7192,6630
2010,826,United Kingdom,Ethiopia,11310,5278,6032
2010,300,Greece,Ethiopia,2573,823,1750
2010,380,Italy,Ethiopia,30974,12919,18055
2010,470,Malta,Ethiopia,280,145,135
2010,620,Portugal,Ethiopia,27,18,9
2010,705,Slovenia,Ethiopia,13,5,8
2010,724,Spain,Ethiopia,2695,1465,1230
2010,40,Austria,Ethiopia,1091,443,648
2010,56,Belgium,Ethiopia,2562,1283,1279
2010,250,France,Ethiopia,8146,2928,5218
2010,276,Germany,Ethiopia,16835,8476,8359
2010,528,Netherlands,Ethiopia,8626,4646,3980
2010,756,Switzerland,Ethiopia,4357,1966,2391
2010,124,Canada,Ethiopia,24535,11817,12718
2010,840,United States of America,Ethiopia,152798,81900,70898
2015,262,Djibouti,Ethiopia,12323,5438,6885
2015,232,Eritrea,Ethiopia,108,58,50
2015,404,Kenya,Ethiopia,36889,20032,16857
2015,706,Somalia,Ethiopia,13641,6821,6820
2015,728,South Sudan,Ethiopia,12786,6784,6002
2015,800,Uganda,Ethiopia,2507,1248,1259
2015,748,Eswatini,Ethiopia,30,16,14
2015,516,Namibia,Ethiopia,206,66,140
2015,710,South Africa,Ethiopia,4844,2686,2158
2015,288,Ghana,Ethiopia,30,16,14
2015,324,Guinea,Ethiopia,12,7,5
2015,818,Egypt,Ethiopia,3457,1729,1728
2015,434,Libya,Ethiopia,1831,1169,662
2015,729,Sudan,Ethiopia,50734,24232,26502
2015,48,Bahrain,Ethiopia,678,454,224
2015,196,Cyprus,Ethiopia,84,33,51
2015,376,Israel,Ethiopia,80474,39760,40714
2015,400,Jordan,Ethiopia,74,5,69
2015,414,Kuwait,Ethiopia,3595,2171,1424
2015,634,Qatar,Ethiopia,1667,1359,308
2015,682,Saudi Arabia,Ethiopia,131493,91518,39975
2015,792,Turkey,Ethiopia,150,73,77
2015,784,United Arab Emirates,Ethiopia,10136,6981,3155
2015,887,Yemen,Ethiopia,15740,9153,6587
2015,764,Thailand,Ethiopia,2,1,1
2015,28,Antigua and Barbuda,Ethiopia,90,41,49
2015,662,Saint Lucia,Ethiopia,2,1,1
2015,188,Costa Rica,Ethiopia,1,1,0
2015,558,Nicaragua,Ethiopia,81,50,31
2015,32,Argentina,Ethiopia,32,15,17
2015,68,Bolivia (Plurinational State of),Ethiopia,2,2,0
2015,76,Brazil,Ethiopia,12,0,12
2015,152,Chile,Ethiopia,15,11,4
2015,862,Venezuela (Bolivarian Republic of),Ethiopia,35,23,12
2015,36,Australia,Ethiopia,13130,6451,6679
2015,554,New Zealand,Ethiopia,1187,574,613
2015,112,Belarus,Ethiopia,25,24,1
2015,100,Bulgaria,Ethiopia,56,42,14
2015,203,Czechia,Ethiopia,105,72,33
2015,348,Hungary,Ethiopia,135,88,47
2015,616,Poland,Ethiopia,43,30,13
2015,643,Russian Federation,Ethiopia,272,205,67
2015,703,Slovakia,Ethiopia,31,22,9
2015,208,Denmark,Ethiopia,2223,1285,938
2015,233,Estonia,Ethiopia,7,7,0
2015,234,Faroe Islands,Ethiopia,36,24,12
2015,246,Finland,Ethiopia,2385,1295,1090
2015,352,Iceland,Ethiopia,71,28,43
2015,372,Ireland,Ethiopia,154,68,86
2015,578,Norway,Ethiopia,7988,4101,3887
2015,752,Sweden,Ethiopia,16704,8378,8326
2015,826,United Kingdom,Ethiopia,14463,6521,7942
2015,300,Greece,Ethiopia,2414,702,1712
2015,380,Italy,Ethiopia,29545,12428,17117
2015,470,Malta,Ethiopia,475,262,213
2015,620,Portugal,Ethiopia,30,19,11
2015,705,Slovenia,Ethiopia,16,11,5
2015,724,Spain,Ethiopia,3713,2008,1705
2015,40,Austria,Ethiopia,1276,523,753
2015,56,Belgium,Ethiopia,4056,2218,1838
2015,250,France,Ethiopia,9024,3084,5940
2015,276,Germany,Ethiopia,17541,8811,8730
2015,528,Netherlands,Ethiopia,9451,4998,4453
2015,756,Switzerland,Ethiopia,7093,3298,3795
2015,124,Canada,Ethiopia,32588,15874,16714
2015,840,United States of America,Ethiopia,221489,108846,112643
2019,262,Djibouti,Ethiopia,12650,5582,7068
2019,232,Eritrea,Ethiopia,109,59,50
2019,404,Kenya,Ethiopia,34203,18585,15618
2019,706,Somalia,Ethiopia,19348,9675,9673
2019,728,South Sudan,Ethiopia,13110,6953,6157
2019,800,Uganda,Ethiopia,3238,1571,1667
2019,748,Eswatini,Ethiopia,29,15,14
2019,516,Namibia,Ethiopia,218,70,148
2019,710,South Africa,Ethiopia,5429,3013,2416
2019,288,Ghana,Ethiopia,33,18,15
2019,324,Guinea,Ethiopia,11,7,4
2019,818,Egypt,Ethiopia,4927,2174,2753
2019,434,Libya,Ethiopia,1942,1240,702
2019,729,Sudan,Ethiopia,62565,29375,33190
2019,48,Bahrain,Ethiopia,713,478,235
2019,196,Cyprus,Ethiopia,83,33,50
2019,376,Israel,Ethiopia,78258,38665,39593
2019,400,Jordan,Ethiopia,79,5,74
2019,414,Kuwait,Ethiopia,3806,2299,1507
2019,634,Qatar,Ethiopia,1700,1364,336
2019,682,Saudi Arabia,Ethiopia,160192,110419,49773
2019,792,Turkey,Ethiopia,202,99,103
2019,784,United Arab Emirates,Ethiopia,10886,7497,3389
2019,887,Yemen,Ethiopia,15978,9292,6686
2019,764,Thailand,Ethiopia,2,1,1
2019,28,Antigua and Barbuda,Ethiopia,93,43,50
2019,662,Saint Lucia,Ethiopia,1,1,0
2019,188,Costa Rica,Ethiopia,1,1,0
2019,558,Nicaragua,Ethiopia,84,52,32
2019,32,Argentina,Ethiopia,32,15,17
2019,68,Bolivia (Plurinational State of),Ethiopia,2,2,0
2019,76,Brazil,Ethiopia,13,0,13
2019,152,Chile,Ethiopia,20,15,5
2019,862,Venezuela (Bolivarian Republic of),Ethiopia,34,23,11
2019,36,Australia,Ethiopia,15668,7669,7999
2019,554,New Zealand,Ethiopia,1220,590,630
2019,112,Belarus,Ethiopia,24,24,0
2019,100,Bulgaria,Ethiopia,65,47,18
2019,203,Czechia,Ethiopia,128,91,37
2019,348,Hungary,Ethiopia,162,99,63
2019,616,Poland,Ethiopia,45,32,13
2019,643,Russian Federation,Ethiopia,271,205,66
2019,703,Slovakia,Ethiopia,33,24,9
2019,208,Denmark,Ethiopia,2422,1359,1063
2019,233,Estonia,Ethiopia,11,10,1
2019,234,Faroe Islands,Ethiopia,38,26,12
2019,246,Finland,Ethiopia,2845,1516,1329
2019,352,Iceland,Ethiopia,86,38,48
2019,372,Ireland,Ethiopia,169,75,94
2019,578,Norway,Ethiopia,9586,4936,4650
2019,752,Sweden,Ethiopia,22381,11530,10851
2019,826,United Kingdom,Ethiopia,16424,7428,8996
2019,300,Greece,Ethiopia,2357,749,1608
2019,380,Italy,Ethiopia,29662,12608,17054
2019,470,Malta,Ethiopia,766,425,341
2019,620,Portugal,Ethiopia,30,19,11
2019,705,Slovenia,Ethiopia,14,10,4
2019,724,Spain,Ethiopia,3847,2039,1808
2019,40,Austria,Ethiopia,1506,633,873
2019,56,Belgium,Ethiopia,4751,2577,2174
2019,250,France,Ethiopia,9551,3250,6301
2019,276,Germany,Ethiopia,19241,10391,8850
2019,528,Netherlands,Ethiopia,16434,9410,7024
2019,756,Switzerland,Ethiopia,8039,3885,4154
2019,124,Canada,Ethiopia,34921,17011,17910
2019,840,United States of America,Ethiopia,239186,116234,122952
1990,152,Chile,Falkland Islands (Malvinas),5,2,3
1990,218,Ecuador,Falkland Islands (Malvinas),18,9,9
1990,36,Australia,Falkland Islands (Malvinas),78,42,36
1990,372,Ireland,Falkland Islands (Malvinas),1,1,0
1990,826,United Kingdom,Falkland Islands (Malvinas),158,87,71
1995,152,Chile,Falkland Islands (Malvinas),3,3,0
1995,218,Ecuador,Falkland Islands (Malvinas),20,10,10
1995,36,Australia,Falkland Islands (Malvinas),112,58,54
1995,372,Ireland,Falkland Islands (Malvinas),2,2,0
1995,826,United Kingdom,Falkland Islands (Malvinas),626,266,360
2000,152,Chile,Falkland Islands (Malvinas),2,2,0
2000,218,Ecuador,Falkland Islands (Malvinas),22,11,11
2000,36,Australia,Falkland Islands (Malvinas),130,66,64
2000,372,Ireland,Falkland Islands (Malvinas),5,4,1
2000,826,United Kingdom,Falkland Islands (Malvinas),1105,447,658
2005,152,Chile,Falkland Islands (Malvinas),3,3,0
2005,218,Ecuador,Falkland Islands (Malvinas),26,13,13
2005,36,Australia,Falkland Islands (Malvinas),120,59,61
2005,372,Ireland,Falkland Islands (Malvinas),5,4,1
2005,826,United Kingdom,Falkland Islands (Malvinas),945,392,553
2010,152,Chile,Falkland Islands (Malvinas),4,4,0
2010,218,Ecuador,Falkland Islands (Malvinas),36,18,18
2010,36,Australia,Falkland Islands (Malvinas),130,65,65
2010,372,Ireland,Falkland Islands (Malvinas),4,3,1
2010,826,United Kingdom,Falkland Islands (Malvinas),995,425,570
2015,152,Chile,Falkland Islands (Malvinas),6,6,0
2015,218,Ecuador,Falkland Islands (Malvinas),52,26,26
2015,36,Australia,Falkland Islands (Malvinas),120,60,60
2015,372,Ireland,Falkland Islands (Malvinas),4,3,1
2015,826,United Kingdom,Falkland Islands (Malvinas),1272,522,750
2019,152,Chile,Falkland Islands (Malvinas),8,8,0
2019,218,Ecuador,Falkland Islands (Malvinas),51,26,25
2019,36,Australia,Falkland Islands (Malvinas),116,57,59
2019,372,Ireland,Falkland Islands (Malvinas),4,3,1
2019,826,United Kingdom,Falkland Islands (Malvinas),1444,595,849
1990,152,Chile,Faroe Islands,2,0,2
1990,36,Australia,Faroe Islands,17,5,12
1990,208,Denmark,Faroe Islands,6430,2448,3982
1990,352,Iceland,Faroe Islands,237,92,145
1990,372,Ireland,Faroe Islands,1,1,0
1990,578,Norway,Faroe Islands,527,212,315
1990,826,United Kingdom,Faroe Islands,38,21,17
1990,300,Greece,Faroe Islands,3,1,2
1990,250,France,Faroe Islands,4,1,3
1990,304,Greenland,Faroe Islands,261,208,53
1995,152,Chile,Faroe Islands,2,1,1
1995,36,Australia,Faroe Islands,19,8,11
1995,208,Denmark,Faroe Islands,8533,3400,5133
1995,352,Iceland,Faroe Islands,273,109,164
1995,372,Ireland,Faroe Islands,2,1,1
1995,578,Norway,Faroe Islands,742,318,424
1995,826,United Kingdom,Faroe Islands,150,63,87
1995,300,Greece,Faroe Islands,2,0,2
1995,250,France,Faroe Islands,4,1,3
1995,304,Greenland,Faroe Islands,278,213,65
2000,152,Chile,Faroe Islands,2,0,2
2000,36,Australia,Faroe Islands,30,15,15
2000,208,Denmark,Faroe Islands,10636,4352,6284
2000,352,Iceland,Faroe Islands,308,125,183
2000,372,Ireland,Faroe Islands,5,2,3
2000,578,Norway,Faroe Islands,902,442,460
2000,826,United Kingdom,Faroe Islands,266,107,159
2000,300,Greece,Faroe Islands,2,0,2
2000,250,France,Faroe Islands,4,1,3
2000,304,Greenland,Faroe Islands,257,192,65
2005,152,Chile,Faroe Islands,3,1,2
2005,36,Australia,Faroe Islands,40,20,20
2005,208,Denmark,Faroe Islands,10897,4442,6455
2005,352,Iceland,Faroe Islands,320,130,190
2005,372,Ireland,Faroe Islands,4,1,3
2005,578,Norway,Faroe Islands,778,356,422
2005,826,United Kingdom,Faroe Islands,310,121,189
2005,300,Greece,Faroe Islands,2,0,2
2005,250,France,Faroe Islands,3,0,3
2005,304,Greenland,Faroe Islands,190,157,33
2010,152,Chile,Faroe Islands,4,1,3
2010,36,Australia,Faroe Islands,40,20,20
2010,208,Denmark,Faroe Islands,10961,4456,6505
2010,233,Estonia,Faroe Islands,1,0,1
2010,352,Iceland,Faroe Islands,330,135,195
2010,372,Ireland,Faroe Islands,3,1,2
2010,578,Norway,Faroe Islands,813,393,420
2010,826,United Kingdom,Faroe Islands,326,131,195
2010,300,Greece,Faroe Islands,1,0,1
2010,250,France,Faroe Islands,3,0,3
2010,304,Greenland,Faroe Islands,254,206,48
2015,152,Chile,Faroe Islands,6,2,4
2015,36,Australia,Faroe Islands,30,18,12
2015,208,Denmark,Faroe Islands,12826,5370,7456
2015,233,Estonia,Faroe Islands,1,0,1
2015,352,Iceland,Faroe Islands,331,137,194
2015,372,Ireland,Faroe Islands,3,1,2
2015,578,Norway,Faroe Islands,892,457,435
2015,826,United Kingdom,Faroe Islands,416,160,256
2015,250,France,Faroe Islands,3,0,3
2015,304,Greenland,Faroe Islands,269,221,48
2019,152,Chile,Faroe Islands,8,3,5
2019,36,Australia,Faroe Islands,21,12,9
2019,208,Denmark,Faroe Islands,11834,4907,6927
2019,352,Iceland,Faroe Islands,345,152,193
2019,372,Ireland,Faroe Islands,3,1,2
2019,578,Norway,Faroe Islands,886,444,442
2019,826,United Kingdom,Faroe Islands,472,183,289
2019,250,France,Faroe Islands,5,2,3
2019,304,Greenland,Faroe Islands,264,217,47
1990,710,South Africa,Fiji,47,20,27
1990,196,Cyprus,Fiji,1,0,1
1990,356,India,Fiji,2385,985,1400
1990,188,Costa Rica,Fiji,1,0,1
1990,32,Argentina,Fiji,1,0,1
1990,152,Chile,Fiji,5,1,4
1990,36,Australia,Fiji,37472,17988,19484
1990,554,New Zealand,Fiji,16418,8277,8141
1990,598,Papua New Guinea,Fiji,128,73,55
1990,90,Solomon Islands,Fiji,220,107,113
1990,548,Vanuatu,Fiji,166,83,83
1990,296,Kiribati,Fiji,221,121,100
1990,584,Marshall Islands,Fiji,43,28,15
1990,520,Nauru,Fiji,221,131,90
1990,16,American Samoa,Fiji,50,26,24
1990,184,Cook Islands,Fiji,78,43,35
1990,258,French Polynesia,Fiji,27,13,14
1990,570,Niue,Fiji,24,12,12
1990,882,Samoa,Fiji,68,30,38
1990,776,Tonga,Fiji,369,192,177
1990,798,Tuvalu,Fiji,114,65,49
1990,203,Czechia,Fiji,2,1,1
1990,208,Denmark,Fiji,13,4,9
1990,246,Finland,Fiji,5,2,3
1990,372,Ireland,Fiji,3,1,2
1990,578,Norway,Fiji,12,8,4
1990,752,Sweden,Fiji,28,8,20
1990,826,United Kingdom,Fiji,483,303,180
1990,300,Greece,Fiji,11,6,5
1990,380,Italy,Fiji,3,1,2
1990,724,Spain,Fiji,3,1,2
1990,40,Austria,Fiji,10,4,6
1990,56,Belgium,Fiji,15,3,12
1990,250,France,Fiji,93,40,53
1990,528,Netherlands,Fiji,6,6,0
1990,756,Switzerland,Fiji,133,74,59
1990,124,Canada,Fiji,15352,7474,7878
1990,840,United States of America,Fiji,15935,7496,8439
1995,710,South Africa,Fiji,29,14,15
1995,196,Cyprus,Fiji,2,0,2
1995,356,India,Fiji,1298,538,760
1995,188,Costa Rica,Fiji,1,0,1
1995,32,Argentina,Fiji,1,0,1
1995,68,Bolivia (Plurinational State of),Fiji,1,0,1
1995,152,Chile,Fiji,7,4,3
1995,36,Australia,Fiji,40344,18887,21457
1995,554,New Zealand,Fiji,18262,8906,9356
1995,598,Papua New Guinea,Fiji,131,77,54
1995,90,Solomon Islands,Fiji,218,106,112
1995,548,Vanuatu,Fiji,146,77,69
1995,296,Kiribati,Fiji,248,137,111
1995,584,Marshall Islands,Fiji,56,39,17
1995,520,Nauru,Fiji,204,121,83
1995,16,American Samoa,Fiji,101,52,49
1995,184,Cook Islands,Fiji,81,44,37
1995,258,French Polynesia,Fiji,29,14,15
1995,570,Niue,Fiji,32,16,16
1995,882,Samoa,Fiji,120,53,67
1995,776,Tonga,Fiji,417,223,194
1995,798,Tuvalu,Fiji,81,46,35
1995,100,Bulgaria,Fiji,1,1,0
1995,203,Czechia,Fiji,3,2,1
1995,208,Denmark,Fiji,17,5,12
1995,246,Finland,Fiji,6,3,3
1995,372,Ireland,Fiji,8,3,5
1995,578,Norway,Fiji,17,10,7
1995,752,Sweden,Fiji,33,8,25
1995,826,United Kingdom,Fiji,1900,995,905
1995,300,Greece,Fiji,10,6,4
1995,380,Italy,Fiji,10,1,9
1995,724,Spain,Fiji,6,3,3
1995,40,Austria,Fiji,11,4,7
1995,56,Belgium,Fiji,15,3,12
1995,250,France,Fiji,96,40,56
1995,528,Netherlands,Fiji,8,8,0
1995,756,Switzerland,Fiji,90,49,41
1995,124,Canada,Fiji,18730,9068,9662
1995,840,United States of America,Fiji,23725,11296,12429
2000,710,South Africa,Fiji,20,12,8
2000,196,Cyprus,Fiji,2,0,2
2000,356,India,Fiji,210,91,119
2000,188,Costa Rica,Fiji,1,0,1
2000,32,Argentina,Fiji,1,0,1
2000,68,Bolivia (Plurinational State of),Fiji,2,0,2
2000,152,Chile,Fiji,9,5,4
2000,36,Australia,Fiji,46700,22031,24669
2000,554,New Zealand,Fiji,25029,12165,12864
2000,598,Papua New Guinea,Fiji,98,61,37
2000,90,Solomon Islands,Fiji,208,101,107
2000,548,Vanuatu,Fiji,129,65,64
2000,296,Kiribati,Fiji,275,152,123
2000,584,Marshall Islands,Fiji,67,44,23
2000,520,Nauru,Fiji,188,112,76
2000,16,American Samoa,Fiji,152,78,74
2000,184,Cook Islands,Fiji,84,46,38
2000,258,French Polynesia,Fiji,32,15,17
2000,570,Niue,Fiji,41,20,21
2000,882,Samoa,Fiji,173,77,96
2000,776,Tonga,Fiji,466,255,211
2000,798,Tuvalu,Fiji,60,36,24
2000,100,Bulgaria,Fiji,1,1,0
2000,203,Czechia,Fiji,4,3,1
2000,208,Denmark,Fiji,21,6,15
2000,246,Finland,Fiji,6,4,2
2000,372,Ireland,Fiji,17,7,10
2000,578,Norway,Fiji,24,13,11
2000,752,Sweden,Fiji,36,9,27
2000,826,United Kingdom,Fiji,3349,1700,1649
2000,300,Greece,Fiji,9,6,3
2000,380,Italy,Fiji,17,2,15
2000,724,Spain,Fiji,72,38,34
2000,40,Austria,Fiji,12,4,8
2000,56,Belgium,Fiji,15,3,12
2000,250,France,Fiji,99,41,58
2000,528,Netherlands,Fiji,12,10,2
2000,756,Switzerland,Fiji,49,24,25
2000,124,Canada,Fiji,22553,10880,11673
2000,840,United States of America,Fiji,31674,15196,16478
2005,710,South Africa,Fiji,25,14,11
2005,196,Cyprus,Fiji,3,0,3
2005,356,India,Fiji,194,84,110
2005,188,Costa Rica,Fiji,1,0,1
2005,32,Argentina,Fiji,1,0,1
2005,68,Bolivia (Plurinational State of),Fiji,1,0,1
2005,152,Chile,Fiji,13,8,5
2005,36,Australia,Fiji,54770,25822,28948
2005,554,New Zealand,Fiji,36097,17521,18576
2005,598,Papua New Guinea,Fiji,98,63,35
2005,90,Solomon Islands,Fiji,154,79,75
2005,548,Vanuatu,Fiji,176,86,90
2005,296,Kiribati,Fiji,382,206,176
2005,584,Marshall Islands,Fiji,86,56,30
2005,520,Nauru,Fiji,176,105,71
2005,16,American Samoa,Fiji,243,123,120
2005,184,Cook Islands,Fiji,111,49,62
2005,258,French Polynesia,Fiji,33,16,17
2005,570,Niue,Fiji,43,21,22
2005,882,Samoa,Fiji,162,71,91
2005,776,Tonga,Fiji,544,300,244
2005,798,Tuvalu,Fiji,54,33,21
2005,100,Bulgaria,Fiji,2,1,1
2005,203,Czechia,Fiji,4,2,2
2005,208,Denmark,Fiji,23,6,17
2005,246,Finland,Fiji,7,4,3
2005,352,Iceland,Fiji,1,0,1
2005,372,Ireland,Fiji,17,7,10
2005,578,Norway,Fiji,27,14,13
2005,752,Sweden,Fiji,44,13,31
2005,826,United Kingdom,Fiji,4497,2314,2183
2005,300,Greece,Fiji,5,3,2
2005,380,Italy,Fiji,31,7,24
2005,724,Spain,Fiji,35,18,17
2005,40,Austria,Fiji,14,5,9
2005,56,Belgium,Fiji,18,3,15
2005,250,France,Fiji,44,12,32
2005,528,Netherlands,Fiji,73,28,45
2005,756,Switzerland,Fiji,53,26,27
2005,124,Canada,Fiji,22701,10796,11905
2005,840,United States of America,Fiji,35708,17234,18474
2010,710,South Africa,Fiji,39,22,17
2010,196,Cyprus,Fiji,4,0,4
2010,356,India,Fiji,178,77,101
2010,188,Costa Rica,Fiji,1,0,1
2010,32,Argentina,Fiji,1,0,1
2010,152,Chile,Fiji,18,11,7
2010,36,Australia,Fiji,63960,30011,33949
2010,554,New Zealand,Fiji,45823,22198,23625
2010,598,Papua New Guinea,Fiji,83,54,29
2010,90,Solomon Islands,Fiji,110,62,48
2010,548,Vanuatu,Fiji,216,108,108
2010,296,Kiribati,Fiji,489,259,230
2010,584,Marshall Islands,Fiji,111,69,42
2010,520,Nauru,Fiji,58,35,23
2010,16,American Samoa,Fiji,333,168,165
2010,184,Cook Islands,Fiji,138,52,86
2010,258,French Polynesia,Fiji,32,16,16
2010,570,Niue,Fiji,41,21,20
2010,882,Samoa,Fiji,142,61,81
2010,776,Tonga,Fiji,582,323,259
2010,798,Tuvalu,Fiji,48,30,18
2010,100,Bulgaria,Fiji,2,1,1
2010,203,Czechia,Fiji,3,1,2
2010,208,Denmark,Fiji,24,7,17
2010,246,Finland,Fiji,9,7,2
2010,352,Iceland,Fiji,1,0,1
2010,372,Ireland,Fiji,14,5,9
2010,578,Norway,Fiji,40,20,20
2010,752,Sweden,Fiji,56,23,33
2010,826,United Kingdom,Fiji,4737,2485,2252
2010,300,Greece,Fiji,1,0,1
2010,380,Italy,Fiji,39,11,28
2010,724,Spain,Fiji,31,15,16
2010,40,Austria,Fiji,15,5,10
2010,56,Belgium,Fiji,25,7,18
2010,250,France,Fiji,147,59,88
2010,528,Netherlands,Fiji,61,21,40
2010,756,Switzerland,Fiji,66,28,38
2010,124,Canada,Fiji,24290,11429,12861
2010,840,United States of America,Fiji,40945,19470,21475
2015,710,South Africa,Fiji,69,38,31
2015,324,Guinea,Fiji,3,2,1
2015,196,Cyprus,Fiji,3,0,3
2015,356,India,Fiji,171,75,96
2015,188,Costa Rica,Fiji,1,0,1
2015,32,Argentina,Fiji,1,0,1
2015,152,Chile,Fiji,27,17,10
2015,36,Australia,Fiji,72600,34451,38149
2015,554,New Zealand,Fiji,54815,26507,28308
2015,598,Papua New Guinea,Fiji,84,56,28
2015,90,Solomon Islands,Fiji,103,59,44
2015,548,Vanuatu,Fiji,225,112,113
2015,296,Kiribati,Fiji,497,263,234
2015,584,Marshall Islands,Fiji,118,74,44
2015,520,Nauru,Fiji,91,56,35
2015,16,American Samoa,Fiji,332,167,165
2015,184,Cook Islands,Fiji,127,48,79
2015,258,French Polynesia,Fiji,30,15,15
2015,570,Niue,Fiji,40,21,19
2015,882,Samoa,Fiji,118,51,67
2015,776,Tonga,Fiji,499,278,221
2015,798,Tuvalu,Fiji,51,31,20
2015,100,Bulgaria,Fiji,1,1,0
2015,203,Czechia,Fiji,5,4,1
2015,208,Denmark,Fiji,22,6,16
2015,246,Finland,Fiji,11,8,3
2015,352,Iceland,Fiji,1,0,1
2015,372,Ireland,Fiji,14,5,9
2015,578,Norway,Fiji,41,23,18
2015,752,Sweden,Fiji,63,27,36
2015,826,United Kingdom,Fiji,6057,3092,2965
2015,380,Italy,Fiji,38,12,26
2015,724,Spain,Fiji,32,15,17
2015,40,Austria,Fiji,18,7,11
2015,56,Belgium,Fiji,26,12,14
2015,250,France,Fiji,162,62,100
2015,528,Netherlands,Fiji,69,28,41
2015,756,Switzerland,Fiji,87,37,50
2015,124,Canada,Fiji,24513,11279,13234
2015,840,United States of America,Fiji,46821,22140,24681
2019,710,South Africa,Fiji,76,42,34
2019,324,Guinea,Fiji,2,2,0
2019,196,Cyprus,Fiji,2,0,2
2019,356,India,Fiji,168,73,95
2019,188,Costa Rica,Fiji,1,0,1
2019,32,Argentina,Fiji,1,0,1
2019,152,Chile,Fiji,36,22,14
2019,36,Australia,Fiji,79424,37445,41979
2019,554,New Zealand,Fiji,56344,27247,29097
2019,598,Papua New Guinea,Fiji,84,56,28
2019,90,Solomon Islands,Fiji,100,57,43
2019,548,Vanuatu,Fiji,229,114,115
2019,296,Kiribati,Fiji,514,272,242
2019,584,Marshall Islands,Fiji,118,74,44
2019,520,Nauru,Fiji,101,63,38
2019,16,American Samoa,Fiji,332,167,165
2019,184,Cook Islands,Fiji,127,48,79
2019,258,French Polynesia,Fiji,31,16,15
2019,570,Niue,Fiji,40,21,19
2019,882,Samoa,Fiji,111,48,63
2019,776,Tonga,Fiji,473,264,209
2019,798,Tuvalu,Fiji,54,33,21
2019,100,Bulgaria,Fiji,1,1,0
2019,203,Czechia,Fiji,7,6,1
2019,208,Denmark,Fiji,31,11,20
2019,246,Finland,Fiji,13,9,4
2019,352,Iceland,Fiji,1,0,1
2019,372,Ireland,Fiji,15,6,9
2019,578,Norway,Fiji,46,26,20
2019,752,Sweden,Fiji,74,28,46
2019,826,United Kingdom,Fiji,6878,3520,3358
2019,380,Italy,Fiji,42,12,30
2019,724,Spain,Fiji,33,15,18
2019,40,Austria,Fiji,21,9,12
2019,56,Belgium,Fiji,27,13,14
2019,250,France,Fiji,171,65,106
2019,528,Netherlands,Fiji,72,32,40
2019,756,Switzerland,Fiji,99,45,54
2019,124,Canada,Fiji,26268,12087,14181
2019,840,United States of America,Fiji,50561,23621,26940
1990,516,Namibia,Finland,116,32,84
1990,710,South Africa,Finland,576,154,422
1990,818,Egypt,Finland,189,72,117
1990,434,Libya,Finland,538,207,331
1990,196,Cyprus,Finland,123,35,88
1990,376,Israel,Finland,529,149,380
1990,792,Turkey,Finland,404,198,206
1990,417,Kyrgyzstan,Finland,361,219,142
1990,392,Japan,Finland,432,220,212
1990,496,Mongolia,Finland,20,6,14
1990,608,Philippines,Finland,9,7,2
1990,136,Cayman Islands,Finland,2,1,1
1990,214,Dominican Republic,Finland,45,31,14
1990,188,Costa Rica,Finland,18,8,10
1990,484,Mexico,Finland,35,12,23
1990,591,Panama,Finland,7,4,3
1990,32,Argentina,Finland,156,44,112
1990,68,Bolivia (Plurinational State of),Finland,75,41,34
1990,76,Brazil,Finland,169,84,85
1990,152,Chile,Finland,99,49,50
1990,170,Colombia,Finland,56,33,23
1990,218,Ecuador,Finland,43,16,27
1990,604,Peru,Finland,43,21,22
1990,862,Venezuela (Bolivarian Republic of),Finland,64,27,37
1990,36,Australia,Finland,9718,4790,4928
1990,112,Belarus,Finland,1185,710,475
1990,100,Bulgaria,Finland,10,4,6
1990,203,Czechia,Finland,82,41,41
1990,348,Hungary,Finland,92,41,51
1990,616,Poland,Finland,272,126,146
1990,642,Romania,Finland,116,52,64
1990,643,Russian Federation,Finland,1737,852,885
1990,703,Slovakia,Finland,4,2,2
1990,208,Denmark,Finland,3180,1101,2079
1990,233,Estonia,Finland,651,347,304
1990,352,Iceland,Finland,75,22,53
1990,372,Ireland,Finland,75,37,38
1990,428,Latvia,Finland,1199,790,409
1990,440,Lithuania,Finland,74,44,30
1990,578,Norway,Finland,4257,1812,2445
1990,752,Sweden,Finland,153578,65280,88298
1990,826,United Kingdom,Finland,5179,1088,4091
1990,300,Greece,Finland,1528,536,992
1990,380,Italy,Finland,462,161,301
1990,470,Malta,Finland,8,1,7
1990,620,Portugal,Finland,91,38,53
1990,688,Serbia,Finland,3,1,2
1990,705,Slovenia,Finland,2,1,1
1990,724,Spain,Finland,2803,1110,1693
1990,40,Austria,Finland,880,242,638
1990,56,Belgium,Finland,473,217,256
1990,250,France,Finland,4412,1204,3208
1990,276,Germany,Finland,11251,2914,8337
1990,438,Liechtenstein,Finland,1,1,0
1990,442,Luxembourg,Finland,243,103,140
1990,528,Netherlands,Finland,1130,358,772
1990,756,Switzerland,Finland,3408,877,2531
1990,124,Canada,Finland,16148,7861,8287
1990,304,Greenland,Finland,16,10,6
1990,840,United States of America,Finland,22313,7471,14842
1995,516,Namibia,Finland,110,31,79
1995,710,South Africa,Finland,370,109,261
1995,818,Egypt,Finland,178,68,110
1995,434,Libya,Finland,569,266,303
1995,196,Cyprus,Finland,174,44,130
1995,376,Israel,Finland,516,140,376
1995,792,Turkey,Finland,978,459,519
1995,417,Kyrgyzstan,Finland,303,182,121
1995,144,Sri Lanka,Finland,6,5,1
1995,392,Japan,Finland,442,212,230
1995,496,Mongolia,Finland,21,8,13
1995,608,Philippines,Finland,12,10,2
1995,136,Cayman Islands,Finland,6,3,3
1995,214,Dominican Republic,Finland,50,34,16
1995,188,Costa Rica,Finland,14,6,8
1995,484,Mexico,Finland,78,29,49
1995,591,Panama,Finland,8,5,3
1995,32,Argentina,Finland,152,44,108
1995,68,Bolivia (Plurinational State of),Finland,59,31,28
1995,76,Brazil,Finland,167,79,88
1995,152,Chile,Finland,115,62,53
1995,170,Colombia,Finland,51,29,22
1995,218,Ecuador,Finland,48,18,30
1995,604,Peru,Finland,44,21,23
1995,862,Venezuela (Bolivarian Republic of),Finland,63,27,36
1995,36,Australia,Finland,9656,4718,4938
1995,112,Belarus,Finland,1688,863,825
1995,100,Bulgaria,Finland,19,9,10
1995,203,Czechia,Finland,123,63,60
1995,348,Hungary,Finland,284,133,151
1995,616,Poland,Finland,232,106,126
1995,642,Romania,Finland,108,44,64
1995,643,Russian Federation,Finland,1899,894,1005
1995,703,Slovakia,Finland,44,23,21
1995,208,Denmark,Finland,3503,1194,2309
1995,233,Estonia,Finland,1010,542,468
1995,352,Iceland,Finland,97,29,68
1995,372,Ireland,Finland,266,127,139
1995,428,Latvia,Finland,684,445,239
1995,440,Lithuania,Finland,83,49,34
1995,578,Norway,Finland,4533,1900,2633
1995,752,Sweden,Finland,182250,76671,105579
1995,826,United Kingdom,Finland,7993,1989,6004
1995,191,Croatia,Finland,13,4,9
1995,300,Greece,Finland,1175,338,837
1995,380,Italy,Finland,1336,201,1135
1995,470,Malta,Finland,10,1,9
1995,620,Portugal,Finland,196,82,114
1995,688,Serbia,Finland,25,11,14
1995,705,Slovenia,Finland,4,3,1
1995,724,Spain,Finland,3868,1639,2229
1995,40,Austria,Finland,993,285,708
1995,56,Belgium,Finland,1541,622,919
1995,250,France,Finland,4555,1187,3368
1995,276,Germany,Finland,13312,3580,9732
1995,438,Liechtenstein,Finland,1,1,0
1995,442,Luxembourg,Finland,445,183,262
1995,528,Netherlands,Finland,1655,499,1156
1995,756,Switzerland,Finland,3555,1086,2469
1995,124,Canada,Finland,14970,7256,7714
1995,304,Greenland,Finland,9,5,4
1995,840,United States of America,Finland,22152,7536,14616
2000,516,Namibia,Finland,104,29,75
2000,710,South Africa,Finland,273,85,188
2000,818,Egypt,Finland,182,72,110
2000,434,Libya,Finland,611,338,273
2000,196,Cyprus,Finland,225,54,171
2000,268,Georgia,Finland,12,3,9
2000,376,Israel,Finland,474,127,347
2000,792,Turkey,Finland,1557,722,835
2000,417,Kyrgyzstan,Finland,237,140,97
2000,144,Sri Lanka,Finland,14,8,6
2000,392,Japan,Finland,613,283,330
2000,496,Mongolia,Finland,24,10,14
2000,608,Philippines,Finland,430,247,183
2000,136,Cayman Islands,Finland,11,5,6
2000,214,Dominican Republic,Finland,55,37,18
2000,188,Costa Rica,Finland,17,6,11
2000,484,Mexico,Finland,125,47,78
2000,591,Panama,Finland,11,7,4
2000,32,Argentina,Finland,148,44,104
2000,68,Bolivia (Plurinational State of),Finland,43,21,22
2000,76,Brazil,Finland,165,75,90
2000,152,Chile,Finland,132,70,62
2000,170,Colombia,Finland,46,25,21
2000,218,Ecuador,Finland,53,20,33
2000,604,Peru,Finland,52,25,27
2000,862,Venezuela (Bolivarian Republic of),Finland,62,26,36
2000,36,Australia,Finland,9420,4380,5040
2000,112,Belarus,Finland,2190,1016,1174
2000,100,Bulgaria,Finland,28,14,14
2000,203,Czechia,Finland,164,85,79
2000,348,Hungary,Finland,476,226,250
2000,616,Poland,Finland,199,89,110
2000,642,Romania,Finland,102,36,66
2000,643,Russian Federation,Finland,1994,904,1090
2000,703,Slovakia,Finland,98,50,48
2000,208,Denmark,Finland,3826,1287,2539
2000,233,Estonia,Finland,1369,737,632
2000,352,Iceland,Finland,119,37,82
2000,372,Ireland,Finland,603,298,305
2000,428,Latvia,Finland,170,101,69
2000,440,Lithuania,Finland,65,39,26
2000,578,Norway,Finland,6635,2755,3880
2000,752,Sweden,Finland,195447,81486,113961
2000,826,United Kingdom,Finland,10943,2908,8035
2000,191,Croatia,Finland,24,8,16
2000,300,Greece,Finland,841,130,711
2000,380,Italy,Finland,2210,241,1969
2000,470,Malta,Finland,25,3,22
2000,620,Portugal,Finland,310,129,181
2000,688,Serbia,Finland,35,15,20
2000,705,Slovenia,Finland,11,4,7
2000,724,Spain,Finland,6598,2933,3665
2000,40,Austria,Finland,1106,329,777
2000,56,Belgium,Finland,2565,1014,1551
2000,250,France,Finland,4698,1171,3527
2000,276,Germany,Finland,15373,4247,11126
2000,438,Liechtenstein,Finland,1,1,0
2000,442,Luxembourg,Finland,653,266,387
2000,528,Netherlands,Finland,2237,655,1582
2000,756,Switzerland,Finland,3716,1306,2410
2000,124,Canada,Finland,14148,6825,7323
2000,304,Greenland,Finland,13,5,8
2000,840,United States of America,Finland,21951,7607,14344
2005,516,Namibia,Finland,82,23,59
2005,710,South Africa,Finland,358,98,260
2005,818,Egypt,Finland,217,95,122
2005,434,Libya,Finland,673,427,246
2005,196,Cyprus,Finland,329,77,252
2005,268,Georgia,Finland,11,3,8
2005,376,Israel,Finland,384,102,282
2005,792,Turkey,Finland,1604,725,879
2005,417,Kyrgyzstan,Finland,185,108,77
2005,144,Sri Lanka,Finland,29,9,20
2005,392,Japan,Finland,565,257,308
2005,496,Mongolia,Finland,12,5,7
2005,608,Philippines,Finland,348,203,145
2005,136,Cayman Islands,Finland,10,5,5
2005,214,Dominican Republic,Finland,41,24,17
2005,188,Costa Rica,Finland,11,4,7
2005,484,Mexico,Finland,128,49,79
2005,591,Panama,Finland,24,13,11
2005,32,Argentina,Finland,109,33,76
2005,68,Bolivia (Plurinational State of),Finland,39,19,20
2005,76,Brazil,Finland,341,175,166
2005,152,Chile,Finland,198,107,91
2005,170,Colombia,Finland,41,22,19
2005,218,Ecuador,Finland,62,24,38
2005,604,Peru,Finland,61,29,32
2005,862,Venezuela (Bolivarian Republic of),Finland,64,27,37
2005,36,Australia,Finland,9490,4270,5220
2005,112,Belarus,Finland,2104,976,1128
2005,100,Bulgaria,Finland,41,22,19
2005,203,Czechia,Finland,200,109,91
2005,348,Hungary,Finland,589,286,303
2005,616,Poland,Finland,225,98,127
2005,642,Romania,Finland,74,27,47
2005,643,Russian Federation,Finland,2103,962,1141
2005,703,Slovakia,Finland,111,58,53
2005,208,Denmark,Finland,3802,1241,2561
2005,233,Estonia,Finland,1891,1082,809
2005,352,Iceland,Finland,153,48,105
2005,372,Ireland,Finland,844,320,524
2005,428,Latvia,Finland,226,136,90
2005,440,Lithuania,Finland,89,58,31
2005,578,Norway,Finland,6538,2659,3879
2005,752,Sweden,Finland,183685,75565,108120
2005,826,United Kingdom,Finland,11384,3007,8377
2005,191,Croatia,Finland,32,11,21
2005,300,Greece,Finland,815,128,687
2005,380,Italy,Finland,2519,424,2095
2005,470,Malta,Finland,41,5,36
2005,620,Portugal,Finland,329,134,195
2005,688,Serbia,Finland,35,15,20
2005,705,Slovenia,Finland,12,6,6
2005,724,Spain,Finland,8459,3762,4697
2005,40,Austria,Finland,1236,346,890
2005,56,Belgium,Finland,2682,1037,1645
2005,250,France,Finland,3613,983,2630
2005,276,Germany,Finland,14205,3989,10216
2005,438,Liechtenstein,Finland,4,2,2
2005,442,Luxembourg,Finland,749,305,444
2005,528,Netherlands,Finland,2447,695,1752
2005,756,Switzerland,Finland,4186,1358,2828
2005,124,Canada,Finland,11631,5348,6283
2005,304,Greenland,Finland,8,5,3
2005,840,United States of America,Finland,20430,10234,10196
2010,516,Namibia,Finland,79,23,56
2010,710,South Africa,Finland,560,152,408
2010,818,Egypt,Finland,234,97,137
2010,434,Libya,Finland,737,471,266
2010,196,Cyprus,Finland,538,131,407
2010,268,Georgia,Finland,11,3,8
2010,376,Israel,Finland,299,79,220
2010,792,Turkey,Finland,1652,726,926
2010,417,Kyrgyzstan,Finland,132,75,57
2010,144,Sri Lanka,Finland,61,21,40
2010,392,Japan,Finland,599,269,330
2010,496,Mongolia,Finland,3,2,1
2010,608,Philippines,Finland,110,63,47
2010,136,Cayman Islands,Finland,10,4,6
2010,214,Dominican Republic,Finland,26,10,16
2010,188,Costa Rica,Finland,22,7,15
2010,484,Mexico,Finland,147,57,90
2010,591,Panama,Finland,39,19,20
2010,32,Argentina,Finland,70,22,48
2010,68,Bolivia (Plurinational State of),Finland,34,17,17
2010,76,Brazil,Finland,512,272,240
2010,152,Chile,Finland,264,143,121
2010,170,Colombia,Finland,44,23,21
2010,218,Ecuador,Finland,87,33,54
2010,604,Peru,Finland,68,33,35
2010,862,Venezuela (Bolivarian Republic of),Finland,68,29,39
2010,36,Australia,Finland,9520,4068,5452
2010,112,Belarus,Finland,2017,935,1082
2010,100,Bulgaria,Finland,53,29,24
2010,203,Czechia,Finland,218,127,91
2010,348,Hungary,Finland,701,346,355
2010,616,Poland,Finland,260,110,150
2010,642,Romania,Finland,58,23,35
2010,643,Russian Federation,Finland,2169,1000,1169
2010,703,Slovakia,Finland,124,65,59
2010,208,Denmark,Finland,3710,1174,2536
2010,233,Estonia,Finland,2398,1415,983
2010,352,Iceland,Finland,185,58,127
2010,372,Ireland,Finland,946,222,724
2010,428,Latvia,Finland,277,166,111
2010,440,Lithuania,Finland,101,66,35
2010,578,Norway,Finland,6611,2682,3929
2010,752,Sweden,Finland,169521,68565,100956
2010,826,United Kingdom,Finland,11992,3349,8643
2010,191,Croatia,Finland,39,14,25
2010,300,Greece,Finland,819,131,688
2010,380,Italy,Finland,2995,644,2351
2010,470,Malta,Finland,65,23,42
2010,620,Portugal,Finland,295,118,177
2010,688,Serbia,Finland,35,15,20
2010,705,Slovenia,Finland,29,9,20
2010,724,Spain,Finland,10378,4606,5772
2010,40,Austria,Finland,1366,363,1003
2010,56,Belgium,Finland,2817,994,1823
2010,250,France,Finland,3595,836,2759
2010,276,Germany,Finland,13179,3695,9484
2010,438,Liechtenstein,Finland,9,4,5
2010,442,Luxembourg,Finland,854,348,506
2010,528,Netherlands,Finland,2554,697,1857
2010,756,Switzerland,Finland,4910,1372,3538
2010,124,Canada,Finland,9695,4158,5537
2010,304,Greenland,Finland,11,6,5
2010,840,United States of America,Finland,19499,9635,9864
2015,516,Namibia,Finland,77,23,54
2015,710,South Africa,Finland,1009,236,773
2015,324,Guinea,Finland,6,4,2
2015,818,Egypt,Finland,173,85,88
2015,434,Libya,Finland,830,526,304
2015,196,Cyprus,Finland,516,128,388
2015,268,Georgia,Finland,11,3,8
2015,376,Israel,Finland,308,80,228
2015,792,Turkey,Finland,1677,716,961
2015,417,Kyrgyzstan,Finland,116,66,50
2015,144,Sri Lanka,Finland,61,20,41
2015,392,Japan,Finland,678,303,375
2015,496,Mongolia,Finland,3,2,1
2015,608,Philippines,Finland,112,64,48
2015,136,Cayman Islands,Finland,9,4,5
2015,214,Dominican Republic,Finland,27,11,16
2015,188,Costa Rica,Finland,22,7,15
2015,484,Mexico,Finland,155,59,96
2015,591,Panama,Finland,46,23,23
2015,32,Argentina,Finland,70,22,48
2015,68,Bolivia (Plurinational State of),Finland,40,20,20
2015,76,Brazil,Finland,617,328,289
2015,152,Chile,Finland,399,213,186
2015,170,Colombia,Finland,49,26,23
2015,218,Ecuador,Finland,126,47,79
2015,604,Peru,Finland,72,36,36
2015,862,Venezuela (Bolivarian Republic of),Finland,72,30,42
2015,36,Australia,Finland,9210,3793,5417
2015,112,Belarus,Finland,2111,979,1132
2015,100,Bulgaria,Finland,147,77,70
2015,203,Czechia,Finland,298,172,126
2015,348,Hungary,Finland,771,375,396
2015,616,Poland,Finland,250,109,141
2015,642,Romania,Finland,24,14,10
2015,643,Russian Federation,Finland,2210,1012,1198
2015,703,Slovakia,Finland,154,86,68
2015,208,Denmark,Finland,3977,1263,2714
2015,233,Estonia,Finland,3870,2425,1445
2015,352,Iceland,Finland,178,59,119
2015,372,Ireland,Finland,966,217,749
2015,428,Latvia,Finland,170,95,75
2015,440,Lithuania,Finland,108,67,41
2015,578,Norway,Finland,6854,2758,4096
2015,752,Sweden,Finland,156045,61968,94077
2015,826,United Kingdom,Finland,15335,3955,11380
2015,191,Croatia,Finland,39,14,25
2015,300,Greece,Finland,768,95,673
2015,380,Italy,Finland,2685,547,2138
2015,470,Malta,Finland,109,43,66
2015,620,Portugal,Finland,334,123,211
2015,688,Serbia,Finland,34,15,19
2015,705,Slovenia,Finland,33,12,21
2015,724,Spain,Finland,12359,5539,6820
2015,40,Austria,Finland,1598,432,1166
2015,56,Belgium,Finland,2560,888,1672
2015,250,France,Finland,3814,1065,2749
2015,276,Germany,Finland,13732,3827,9905
2015,438,Liechtenstein,Finland,8,3,5
2015,442,Luxembourg,Finland,1302,542,760
2015,528,Netherlands,Finland,2896,862,2034
2015,756,Switzerland,Finland,5327,1558,3769
2015,124,Canada,Finland,9466,3849,5617
2015,304,Greenland,Finland,12,4,8
2015,840,United States of America,Finland,21879,10754,11125
2019,516,Namibia,Finland,81,24,57
2019,710,South Africa,Finland,1130,266,864
2019,324,Guinea,Finland,5,4,1
2019,818,Egypt,Finland,246,106,140
2019,434,Libya,Finland,880,558,322
2019,196,Cyprus,Finland,515,132,383
2019,268,Georgia,Finland,11,3,8
2019,376,Israel,Finland,299,78,221
2019,792,Turkey,Finland,2267,981,1286
2019,417,Kyrgyzstan,Finland,113,65,48
2019,144,Sri Lanka,Finland,61,20,41
2019,392,Japan,Finland,758,339,419
2019,496,Mongolia,Finland,3,2,1
2019,608,Philippines,Finland,115,66,49
2019,136,Cayman Islands,Finland,10,5,5
2019,214,Dominican Republic,Finland,27,11,16
2019,188,Costa Rica,Finland,22,7,15
2019,484,Mexico,Finland,159,61,98
2019,591,Panama,Finland,48,25,23
2019,32,Argentina,Finland,71,23,48
2019,68,Bolivia (Plurinational State of),Finland,43,22,21
2019,76,Brazil,Finland,694,369,325
2019,152,Chile,Finland,533,271,262
2019,170,Colombia,Finland,50,27,23
2019,218,Ecuador,Finland,124,47,77
2019,604,Peru,Finland,85,45,40
2019,862,Venezuela (Bolivarian Republic of),Finland,70,29,41
2019,36,Australia,Finland,9606,3892,5714
2019,112,Belarus,Finland,2084,967,1117
2019,100,Bulgaria,Finland,195,100,95
2019,203,Czechia,Finland,339,195,144
2019,348,Hungary,Finland,867,407,460
2019,616,Poland,Finland,264,121,143
2019,642,Romania,Finland,203,103,100
2019,643,Russian Federation,Finland,2209,1012,1197
2019,703,Slovakia,Finland,179,98,81
2019,208,Denmark,Finland,4300,1348,2952
2019,233,Estonia,Finland,4603,2904,1699
2019,352,Iceland,Finland,239,87,152
2019,372,Ireland,Finland,1060,241,819
2019,428,Latvia,Finland,117,78,39
2019,440,Lithuania,Finland,119,72,47
2019,578,Norway,Finland,7438,2959,4479
2019,752,Sweden,Finland,145544,56762,88782
2019,826,United Kingdom,Finland,17414,4524,12890
2019,191,Croatia,Finland,36,13,23
2019,300,Greece,Finland,750,118,632
2019,380,Italy,Finland,2816,613,2203
2019,470,Malta,Finland,175,70,105
2019,620,Portugal,Finland,339,125,214
2019,688,Serbia,Finland,34,15,19
2019,705,Slovenia,Finland,38,15,23
2019,724,Spain,Finland,12749,5523,7226
2019,40,Austria,Finland,1886,534,1352
2019,56,Belgium,Finland,2705,950,1755
2019,250,France,Finland,4037,1121,2916
2019,276,Germany,Finland,15063,4857,10206
2019,438,Liechtenstein,Finland,8,3,5
2019,442,Luxembourg,Finland,1232,546,686
2019,528,Netherlands,Finland,3634,1148,2486
2019,756,Switzerland,Finland,5560,1656,3904
2019,124,Canada,Finland,10143,4124,6019
2019,304,Greenland,Finland,11,4,7
2019,840,United States of America,Finland,23626,11484,12142
1990,108,Burundi,France,321,157,164
1990,174,Comoros,France,543,310,233
1990,232,Eritrea,France,108,52,56
1990,450,Madagascar,France,6672,3725,2947
1990,480,Mauritius,France,788,374,414
1990,175,Mayotte,France,1359,859,500
1990,638,Réunion,France,37516,20563,16953
1990,690,Seychelles,France,180,69,111
1990,800,Uganda,France,241,158,83
1990,894,Zambia,France,65,41,24
1990,120,Cameroon,France,11808,6377,5431
1990,140,Central African Republic,France,10537,5416,5121
1990,148,Chad,France,886,478,408
1990,178,Congo,France,8574,4496,4078
1990,226,Equatorial Guinea,France,1154,511,643
1990,266,Gabon,France,4969,2806,2163
1990,516,Namibia,France,793,354,439
1990,710,South Africa,France,5608,2219,3389
1990,204,Benin,France,370,190,180
1990,132,Cabo Verde,France,102,50,52
1990,288,Ghana,France,117,62,55
1990,324,Guinea,France,1642,959,683
1990,624,Guinea-Bissau,France,71,49,22
1990,430,Liberia,France,296,157,139
1990,466,Mali,France,2689,1443,1246
1990,686,Senegal,France,11453,5507,5946
1990,768,Togo,France,1816,961,855
1990,12,Algeria,France,2086,1162,924
1990,818,Egypt,France,3089,1664,1425
1990,434,Libya,France,8821,4774,4047
1990,504,Morocco,France,15056,7961,7095
1990,788,Tunisia,France,3870,1926,1944
1990,732,Western Sahara,France,140,63,77
1990,48,Bahrain,France,57,29,28
1990,196,Cyprus,France,228,97,131
1990,376,Israel,France,17904,8311,9593
1990,400,Jordan,France,295,169,126
1990,414,Kuwait,France,355,119,236
1990,422,Lebanon,France,135,77,58
1990,512,Oman,France,200,132,68
1990,634,Qatar,France,102,56,46
1990,792,Turkey,France,10280,5235,5045
1990,784,United Arab Emirates,France,434,223,211
1990,64,Bhutan,France,14,7,7
1990,356,India,France,5858,2694,3164
1990,462,Maldives,France,51,28,23
1990,144,Sri Lanka,France,50,31,19
1990,344,"China, Hong Kong SAR",France,1470,998,472
1990,392,Japan,France,3167,1613,1554
1990,496,Mongolia,France,11,8,3
1990,410,Republic of Korea,France,507,277,230
1990,116,Cambodia,France,128,83,45
1990,608,Philippines,France,197,121,76
1990,764,Thailand,France,1349,1009,340
1990,704,Viet Nam,France,21,14,7
1990,28,Antigua and Barbuda,France,32,15,17
1990,44,Bahamas,France,38,25,13
1990,92,British Virgin Islands,France,12,7,5
1990,535,"Bonaire, Sint Eustatius and Saba",France,58,31,27
1990,136,Cayman Islands,France,11,7,4
1990,192,Cuba,France,328,169,159
1990,212,Dominica,France,29,19,10
1990,214,Dominican Republic,France,2524,1571,953
1990,312,Guadeloupe,France,31775,15930,15845
1990,332,Haiti,France,445,272,173
1990,474,Martinique,France,29695,15034,14661
1990,630,Puerto Rico,France,278,132,146
1990,662,Saint Lucia,France,31,21,10
1990,188,Costa Rica,France,539,303,236
1990,222,El Salvador,France,200,91,109
1990,320,Guatemala,France,294,119,175
1990,340,Honduras,France,109,64,45
1990,484,Mexico,France,4190,2100,2090
1990,558,Nicaragua,France,139,79,60
1990,591,Panama,France,260,144,116
1990,32,Argentina,France,6463,2979,3484
1990,68,Bolivia (Plurinational State of),France,491,268,223
1990,76,Brazil,France,8096,4706,3390
1990,152,Chile,France,2147,1075,1072
1990,170,Colombia,France,1905,1030,875
1990,218,Ecuador,France,686,352,334
1990,254,French Guiana,France,15361,9083,6278
1990,600,Paraguay,France,491,286,205
1990,604,Peru,France,1439,777,662
1990,858,Uruguay,France,865,412,453
1990,862,Venezuela (Bolivarian Republic of),France,4664,2390,2274
1990,36,Australia,France,15533,8048,7485
1990,554,New Zealand,France,881,482,399
1990,540,New Caledonia,France,19351,11159,8192
1990,548,Vanuatu,France,244,150,94
1990,258,French Polynesia,France,17851,11075,6776
1990,882,Samoa,France,8,6,2
1990,876,Wallis and Futuna Islands,France,327,170,157
1990,100,Bulgaria,France,63,40,23
1990,203,Czechia,France,891,453,438
1990,348,Hungary,France,1793,797,996
1990,616,Poland,France,49150,22761,26389
1990,642,Romania,France,427,195,232
1990,643,Russian Federation,France,1474,723,751
1990,703,Slovakia,France,484,206,278
1990,830,Channel Islands,France,840,396,444
1990,208,Denmark,France,2451,1228,1223
1990,233,Estonia,France,42,19,23
1990,246,Finland,France,538,317,221
1990,352,Iceland,France,135,64,71
1990,372,Ireland,France,1917,747,1170
1990,428,Latvia,France,26,11,15
1990,440,Lithuania,France,215,96,119
1990,578,Norway,France,2433,1236,1197
1990,752,Sweden,France,4401,2594,1807
1990,826,United Kingdom,France,52367,19131,33236
1990,20,Andorra,France,4135,2212,1923
1990,70,Bosnia and Herzegovina,France,259,116,143
1990,191,Croatia,France,831,332,499
1990,300,Greece,France,10626,4282,6344
1990,380,Italy,France,66902,16136,50766
1990,470,Malta,France,97,43,54
1990,620,Portugal,France,58434,28258,30176
1990,674,San Marino,France,32,13,19
1990,688,Serbia,France,10,5,5
1990,705,Slovenia,France,1408,652,756
1990,724,Spain,France,100111,45428,54683
1990,40,Austria,France,4939,2236,2703
1990,56,Belgium,France,109361,51521,57840
1990,276,Germany,France,89386,43534,45852
1990,438,Liechtenstein,France,66,34,32
1990,442,Luxembourg,France,14367,6384,7983
1990,492,Monaco,France,7679,3189,4490
1990,528,Netherlands,France,13064,5983,7081
1990,756,Switzerland,France,87249,38781,48468
1990,60,Bermuda,France,106,70,36
1990,124,Canada,France,52932,25769,27163
1990,304,Greenland,France,10,5,5
1990,666,Saint Pierre and Miquelon,France,668,388,280
1990,840,United States of America,France,119233,58322,60911
1995,108,Burundi,France,310,151,159
1995,174,Comoros,France,538,306,232
1995,232,Eritrea,France,159,75,84
1995,450,Madagascar,France,5908,3321,2587
1995,480,Mauritius,France,696,367,329
1995,175,Mayotte,France,2791,1712,1079
1995,638,Réunion,France,50738,27680,23058
1995,690,Seychelles,France,167,80,87
1995,800,Uganda,France,228,147,81
1995,894,Zambia,France,59,38,21
1995,120,Cameroon,France,10986,5919,5067
1995,140,Central African Republic,France,13090,6743,6347
1995,148,Chad,France,963,519,444
1995,178,Congo,France,6041,3121,2920
1995,226,Equatorial Guinea,France,1529,672,857
1995,266,Gabon,France,6645,3749,2896
1995,516,Namibia,France,758,341,417
1995,710,South Africa,France,3828,1728,2100
1995,204,Benin,France,510,265,245
1995,132,Cabo Verde,France,137,69,68
1995,288,Ghana,France,116,66,50
1995,324,Guinea,France,1893,1192,701
1995,624,Guinea-Bissau,France,91,63,28
1995,430,Liberia,France,289,150,139
1995,466,Mali,France,2679,1409,1270
1995,686,Senegal,France,11977,5721,6256
1995,768,Togo,France,1523,806,717
1995,12,Algeria,France,1321,707,614
1995,818,Egypt,France,2490,1317,1173
1995,434,Libya,France,6208,3395,2813
1995,504,Morocco,France,13813,7204,6609
1995,788,Tunisia,France,3841,1931,1910
1995,732,Western Sahara,France,155,71,84
1995,48,Bahrain,France,118,64,54
1995,196,Cyprus,France,323,130,193
1995,376,Israel,France,23373,10650,12723
1995,400,Jordan,France,388,207,181
1995,414,Kuwait,France,505,236,269
1995,422,Lebanon,France,177,89,88
1995,512,Oman,France,663,437,226
1995,634,Qatar,France,202,127,75
1995,792,Turkey,France,12558,6264,6294
1995,784,United Arab Emirates,France,1118,643,475
1995,64,Bhutan,France,17,9,8
1995,356,India,France,3628,1679,1949
1995,462,Maldives,France,70,35,35
1995,144,Sri Lanka,France,78,52,26
1995,344,"China, Hong Kong SAR",France,1641,1110,531
1995,392,Japan,France,3824,1835,1989
1995,496,Mongolia,France,12,10,2
1995,410,Republic of Korea,France,929,567,362
1995,116,Cambodia,France,336,217,119
1995,608,Philippines,France,265,161,104
1995,764,Thailand,France,1220,916,304
1995,704,Viet Nam,France,53,37,16
1995,28,Antigua and Barbuda,France,33,15,18
1995,44,Bahamas,France,89,52,37
1995,92,British Virgin Islands,France,14,8,6
1995,535,"Bonaire, Sint Eustatius and Saba",France,121,65,56
1995,136,Cayman Islands,France,22,14,8
1995,192,Cuba,France,249,123,126
1995,212,Dominica,France,38,25,13
1995,214,Dominican Republic,France,2804,1720,1084
1995,312,Guadeloupe,France,40430,20010,20420
1995,332,Haiti,France,422,258,164
1995,474,Martinique,France,35638,17511,18127
1995,630,Puerto Rico,France,294,140,154
1995,662,Saint Lucia,France,41,28,13
1995,188,Costa Rica,France,482,274,208
1995,222,El Salvador,France,175,86,89
1995,320,Guatemala,France,229,109,120
1995,340,Honduras,France,108,62,46
1995,484,Mexico,France,4851,2445,2406
1995,558,Nicaragua,France,111,63,48
1995,591,Panama,France,282,157,125
1995,32,Argentina,France,6229,2959,3270
1995,68,Bolivia (Plurinational State of),France,597,342,255
1995,76,Brazil,France,8249,4810,3439
1995,152,Chile,France,2625,1357,1268
1995,170,Colombia,France,1851,996,855
1995,218,Ecuador,France,813,414,399
1995,254,French Guiana,France,18094,10192,7902
1995,600,Paraguay,France,594,355,239
1995,604,Peru,France,1441,770,671
1995,858,Uruguay,France,840,403,437
1995,862,Venezuela (Bolivarian Republic of),France,4149,2163,1986
1995,36,Australia,France,16385,8472,7913
1995,554,New Zealand,France,1085,570,515
1995,540,New Caledonia,France,22427,12788,9639
1995,548,Vanuatu,France,242,128,114
1995,258,French Polynesia,France,19606,11974,7632
1995,882,Samoa,France,10,8,2
1995,876,Wallis and Futuna Islands,France,461,236,225
1995,100,Bulgaria,France,165,99,66
1995,203,Czechia,France,1336,697,639
1995,348,Hungary,France,2203,1076,1127
1995,616,Poland,France,42043,19126,22917
1995,642,Romania,France,677,373,304
1995,643,Russian Federation,France,1481,758,723
1995,703,Slovakia,France,1071,496,575
1995,830,Channel Islands,France,824,388,436
1995,208,Denmark,France,3345,1803,1542
1995,233,Estonia,France,65,29,36
1995,246,Finland,France,727,448,279
1995,352,Iceland,France,196,95,101
1995,372,Ireland,France,3104,1153,1951
1995,428,Latvia,France,77,39,38
1995,440,Lithuania,France,241,108,133
1995,578,Norway,France,2459,1259,1200
1995,752,Sweden,France,5223,3062,2161
1995,826,United Kingdom,France,71537,27992,43545
1995,20,Andorra,France,4216,2232,1984
1995,70,Bosnia and Herzegovina,France,238,108,130
1995,191,Croatia,France,651,261,390
1995,300,Greece,France,8518,3382,5136
1995,380,Italy,France,56690,14691,41999
1995,470,Malta,France,114,52,62
1995,620,Portugal,France,75053,35425,39628
1995,674,San Marino,France,28,12,16
1995,688,Serbia,France,168,83,85
1995,705,Slovenia,France,1262,575,687
1995,724,Spain,France,113860,53134,60726
1995,40,Austria,France,5572,2572,3000
1995,56,Belgium,France,123438,59024,64414
1995,276,Germany,France,97944,45208,52736
1995,438,Liechtenstein,France,70,36,34
1995,442,Luxembourg,France,15658,7172,8486
1995,492,Monaco,France,7401,3069,4332
1995,528,Netherlands,France,15164,6786,8378
1995,756,Switzerland,France,93526,45313,48213
1995,60,Bermuda,France,114,70,44
1995,124,Canada,France,62998,30503,32495
1995,304,Greenland,France,8,5,3
1995,666,Saint Pierre and Miquelon,France,845,475,370
1995,840,United States of America,France,137002,67657,69345
2000,108,Burundi,France,237,116,121
2000,174,Comoros,France,532,301,231
2000,232,Eritrea,France,211,99,112
2000,450,Madagascar,France,6567,3705,2862
2000,480,Mauritius,France,993,504,489
2000,175,Mayotte,France,5080,2948,2132
2000,638,Réunion,France,66309,35879,30430
2000,690,Seychelles,France,154,90,64
2000,800,Uganda,France,228,142,86
2000,894,Zambia,France,55,35,20
2000,120,Cameroon,France,10163,5460,4703
2000,140,Central African Republic,France,14506,7482,7024
2000,148,Chad,France,1039,560,479
2000,178,Congo,France,5127,2575,2552
2000,226,Equatorial Guinea,France,1903,833,1070
2000,266,Gabon,France,8312,4716,3596
2000,516,Namibia,France,705,318,387
2000,710,South Africa,France,3182,1664,1518
2000,204,Benin,France,650,340,310
2000,132,Cabo Verde,France,172,88,84
2000,288,Ghana,France,130,69,61
2000,324,Guinea,France,1325,835,490
2000,624,Guinea-Bissau,France,111,78,33
2000,430,Liberia,France,284,143,141
2000,466,Mali,France,2347,1217,1130
2000,686,Senegal,France,10825,5303,5522
2000,768,Togo,France,1277,670,607
2000,12,Algeria,France,556,252,304
2000,818,Egypt,France,2089,1075,1014
2000,434,Libya,France,3699,2139,1560
2000,504,Morocco,France,14547,7470,7077
2000,788,Tunisia,France,4789,2435,2354
2000,732,Western Sahara,France,171,80,91
2000,48,Bahrain,France,180,98,82
2000,196,Cyprus,France,417,163,254
2000,268,Georgia,France,41,14,27
2000,376,Israel,France,27534,12530,15004
2000,400,Jordan,France,480,245,235
2000,414,Kuwait,France,853,449,404
2000,422,Lebanon,France,218,101,117
2000,512,Oman,France,940,644,296
2000,634,Qatar,France,272,178,94
2000,792,Turkey,France,14882,7304,7578
2000,784,United Arab Emirates,France,1868,1095,773
2000,64,Bhutan,France,19,10,9
2000,356,India,France,1397,664,733
2000,462,Maldives,France,86,47,39
2000,144,Sri Lanka,France,107,69,38
2000,344,"China, Hong Kong SAR",France,1811,1222,589
2000,392,Japan,France,5371,2481,2890
2000,496,Mongolia,France,14,11,3
2000,410,Republic of Korea,France,1647,1060,587
2000,116,Cambodia,France,543,351,192
2000,608,Philippines,France,365,197,168
2000,764,Thailand,France,1343,1003,340
2000,704,Viet Nam,France,127,90,37
2000,28,Antigua and Barbuda,France,34,16,18
2000,44,Bahamas,France,141,80,61
2000,92,British Virgin Islands,France,16,10,6
2000,535,"Bonaire, Sint Eustatius and Saba",France,184,99,85
2000,136,Cayman Islands,France,40,25,15
2000,192,Cuba,France,169,77,92
2000,212,Dominica,France,45,30,15
2000,214,Dominican Republic,France,3083,1868,1215
2000,312,Guadeloupe,France,49084,24090,24994
2000,332,Haiti,France,400,245,155
2000,474,Martinique,France,41569,19986,21583
2000,630,Puerto Rico,France,311,148,163
2000,662,Saint Lucia,France,57,39,18
2000,188,Costa Rica,France,666,373,293
2000,222,El Salvador,France,150,82,68
2000,320,Guatemala,France,163,98,65
2000,340,Honduras,France,107,60,47
2000,484,Mexico,France,5723,2910,2813
2000,558,Nicaragua,France,119,70,49
2000,591,Panama,France,322,179,143
2000,32,Argentina,France,5996,2940,3056
2000,68,Bolivia (Plurinational State of),France,696,411,285
2000,76,Brazil,France,8402,4915,3487
2000,152,Chile,France,3101,1595,1506
2000,170,Colombia,France,1797,963,834
2000,218,Ecuador,France,939,475,464
2000,254,French Guiana,France,20826,11300,9526
2000,600,Paraguay,France,695,421,274
2000,604,Peru,France,1685,904,781
2000,858,Uruguay,France,816,393,423
2000,862,Venezuela (Bolivarian Republic of),France,3657,1935,1722
2000,36,Australia,France,18110,9154,8956
2000,554,New Zealand,France,1573,766,807
2000,540,New Caledonia,France,25504,14418,11086
2000,548,Vanuatu,France,240,121,119
2000,258,French Polynesia,France,20959,12633,8326
2000,882,Samoa,France,13,10,3
2000,876,Wallis and Futuna Islands,France,545,275,270
2000,100,Bulgaria,France,267,159,108
2000,203,Czechia,France,1781,941,840
2000,348,Hungary,France,2613,1356,1257
2000,616,Poland,France,35964,16061,19903
2000,642,Romania,France,942,558,384
2000,643,Russian Federation,France,1436,766,670
2000,703,Slovakia,France,1952,922,1030
2000,830,Channel Islands,France,875,412,463
2000,208,Denmark,France,4238,2377,1861
2000,233,Estonia,France,88,40,48
2000,246,Finland,France,916,579,337
2000,352,Iceland,France,257,126,131
2000,372,Ireland,France,5996,2346,3650
2000,428,Latvia,France,128,67,61
2000,440,Lithuania,France,188,84,104
2000,578,Norway,France,2934,1561,1373
2000,752,Sweden,France,5602,3269,2333
2000,826,United Kingdom,France,91911,37212,54699
2000,20,Andorra,France,4298,2253,2045
2000,70,Bosnia and Herzegovina,France,217,100,117
2000,191,Croatia,France,401,166,235
2000,300,Greece,France,6549,2443,4106
2000,380,Italy,France,46478,13247,33231
2000,470,Malta,France,161,63,98
2000,620,Portugal,France,94718,44182,50536
2000,674,San Marino,France,25,10,15
2000,688,Serbia,France,2287,1104,1183
2000,705,Slovenia,France,1698,780,918
2000,724,Spain,France,174641,83388,91253
2000,40,Austria,France,6205,2909,3296
2000,56,Belgium,France,133707,63845,69862
2000,276,Germany,France,106502,46882,59620
2000,438,Liechtenstein,France,73,36,37
2000,442,Luxembourg,France,17116,8050,9066
2000,492,Monaco,France,7134,2956,4178
2000,528,Netherlands,France,17789,7802,9987
2000,756,Switzerland,France,100144,52151,47993
2000,60,Bermuda,France,122,70,52
2000,124,Canada,France,74561,35968,38593
2000,304,Greenland,France,7,6,1
2000,666,Saint Pierre and Miquelon,France,970,534,436
2000,840,United States of America,France,154992,77205,77787
2005,108,Burundi,France,232,112,120
2005,174,Comoros,France,509,289,220
2005,232,Eritrea,France,320,161,159
2005,450,Madagascar,France,7269,4115,3154
2005,480,Mauritius,France,1119,604,515
2005,175,Mayotte,France,7789,4023,3766
2005,638,Réunion,France,75927,41517,34410
2005,690,Seychelles,France,184,97,87
2005,800,Uganda,France,220,136,84
2005,894,Zambia,France,62,40,22
2005,120,Cameroon,France,4643,2459,2184
2005,140,Central African Republic,France,11091,5727,5364
2005,148,Chad,France,719,326,393
2005,178,Congo,France,3260,2020,1240
2005,226,Equatorial Guinea,France,2776,1252,1524
2005,266,Gabon,France,9063,5181,3882
2005,516,Namibia,France,557,250,307
2005,710,South Africa,France,4186,2101,2085
2005,204,Benin,France,909,458,451
2005,132,Cabo Verde,France,183,89,94
2005,288,Ghana,France,183,102,81
2005,324,Guinea,France,927,649,278
2005,624,Guinea-Bissau,France,108,76,32
2005,430,Liberia,France,128,83,45
2005,466,Mali,France,9575,4815,4760
2005,686,Senegal,France,11647,5694,5953
2005,768,Togo,France,1071,567,504
2005,12,Algeria,France,438,199,239
2005,818,Egypt,France,2487,1354,1133
2005,434,Libya,France,4075,2663,1412
2005,504,Morocco,France,14916,7546,7370
2005,788,Tunisia,France,4577,2348,2229
2005,732,Western Sahara,France,202,98,104
2005,48,Bahrain,France,693,420,273
2005,196,Cyprus,France,610,236,374
2005,268,Georgia,France,38,13,25
2005,376,Israel,France,33850,15388,18462
2005,400,Jordan,France,693,396,297
2005,414,Kuwait,France,1425,811,614
2005,422,Lebanon,France,171,83,88
2005,512,Oman,France,972,670,302
2005,634,Qatar,France,585,402,183
2005,792,Turkey,France,15335,7350,7985
2005,784,United Arab Emirates,France,5745,3578,2167
2005,64,Bhutan,France,24,12,12
2005,356,India,France,1291,612,679
2005,462,Maldives,France,81,47,34
2005,144,Sri Lanka,France,168,90,78
2005,344,"China, Hong Kong SAR",France,1978,1303,675
2005,392,Japan,France,8545,3892,4653
2005,496,Mongolia,France,37,30,7
2005,410,Republic of Korea,France,1467,980,487
2005,116,Cambodia,France,424,278,146
2005,608,Philippines,France,295,162,133
2005,764,Thailand,France,1237,905,332
2005,704,Viet Nam,France,145,105,40
2005,28,Antigua and Barbuda,France,37,17,20
2005,44,Bahamas,France,137,83,54
2005,92,British Virgin Islands,France,19,12,7
2005,535,"Bonaire, Sint Eustatius and Saba",France,196,106,90
2005,136,Cayman Islands,France,36,22,14
2005,192,Cuba,France,113,52,61
2005,212,Dominica,France,56,38,18
2005,214,Dominican Republic,France,2518,1526,992
2005,312,Guadeloupe,France,51403,24284,27119
2005,332,Haiti,France,379,232,147
2005,474,Martinique,France,43513,20365,23148
2005,630,Puerto Rico,France,243,115,128
2005,662,Saint Lucia,France,59,41,18
2005,534,Sint Maarten (Dutch part),France,44,24,20
2005,188,Costa Rica,France,436,242,194
2005,222,El Salvador,France,178,103,75
2005,320,Guatemala,France,194,128,66
2005,340,Honduras,France,105,59,46
2005,484,Mexico,France,6737,3316,3421
2005,558,Nicaragua,France,130,78,52
2005,591,Panama,France,560,327,233
2005,32,Argentina,France,6534,3255,3279
2005,68,Bolivia (Plurinational State of),France,880,515,365
2005,76,Brazil,France,9004,5492,3512
2005,152,Chile,France,4655,2431,2224
2005,170,Colombia,France,1712,921,791
2005,218,Ecuador,France,1108,572,536
2005,254,French Guiana,France,20818,11190,9628
2005,600,Paraguay,France,662,401,261
2005,604,Peru,France,1979,1067,912
2005,858,Uruguay,France,493,238,255
2005,862,Venezuela (Bolivarian Republic of),France,3657,1907,1750
2005,36,Australia,France,21120,10686,10434
2005,554,New Zealand,France,2364,1148,1216
2005,540,New Caledonia,France,30810,17091,13719
2005,548,Vanuatu,France,379,190,189
2005,258,French Polynesia,France,22395,13083,9312
2005,882,Samoa,France,12,10,2
2005,876,Wallis and Futuna Islands,France,646,326,320
2005,100,Bulgaria,France,411,248,163
2005,203,Czechia,France,1978,1216,762
2005,348,Hungary,France,3227,1702,1525
2005,616,Poland,France,31040,13530,17510
2005,642,Romania,France,1319,773,546
2005,643,Russian Federation,France,1997,1097,900
2005,703,Slovakia,France,2189,1053,1136
2005,830,Channel Islands,France,1371,652,719
2005,208,Denmark,France,5231,2920,2311
2005,233,Estonia,France,151,87,64
2005,246,Finland,France,1471,924,547
2005,352,Iceland,France,355,182,173
2005,372,Ireland,France,9213,4139,5074
2005,428,Latvia,France,232,131,101
2005,440,Lithuania,France,280,149,131
2005,578,Norway,France,3189,1727,1462
2005,752,Sweden,France,6530,3857,2673
2005,826,United Kingdom,France,108252,46250,62002
2005,20,Andorra,France,4875,2574,2301
2005,70,Bosnia and Herzegovina,France,152,70,82
2005,191,Croatia,France,1075,502,573
2005,300,Greece,France,6696,2561,4135
2005,380,Italy,France,90429,33459,56970
2005,470,Malta,France,203,73,130
2005,620,Portugal,France,95316,44553,50763
2005,674,San Marino,France,24,10,14
2005,688,Serbia,France,5640,2690,2950
2005,705,Slovenia,France,1549,691,858
2005,724,Spain,France,177040,84133,92907
2005,40,Austria,France,6935,3163,3772
2005,56,Belgium,France,145202,69085,76117
2005,276,Germany,France,112952,51236,61716
2005,438,Liechtenstein,France,93,47,46
2005,442,Luxembourg,France,20304,9544,10760
2005,492,Monaco,France,6719,2819,3900
2005,528,Netherlands,France,19469,8715,10754
2005,756,Switzerland,France,113664,56703,56961
2005,60,Bermuda,France,133,78,55
2005,124,Canada,France,89277,45226,44051
2005,304,Greenland,France,10,6,4
2005,666,Saint Pierre and Miquelon,France,841,461,380
2005,840,United States of America,France,155257,77768,77489
2010,108,Burundi,France,248,119,129
2010,174,Comoros,France,486,278,208
2010,232,Eritrea,France,429,223,206
2010,450,Madagascar,France,8066,4583,3483
2010,480,Mauritius,France,1308,763,545
2010,175,Mayotte,France,9498,4504,4994
2010,638,Réunion,France,81294,44766,36528
2010,690,Seychelles,France,214,103,111
2010,800,Uganda,France,221,136,85
2010,894,Zambia,France,70,29,41
2010,120,Cameroon,France,3695,2035,1660
2010,140,Central African Republic,France,10976,5672,5304
2010,148,Chad,France,852,382,470
2010,178,Congo,France,7765,4390,3375
2010,226,Equatorial Guinea,France,3649,1672,1977
2010,266,Gabon,France,10497,6087,4410
2010,516,Namibia,France,536,241,295
2010,710,South Africa,France,6557,3280,3277
2010,204,Benin,France,1161,574,587
2010,132,Cabo Verde,France,194,91,103
2010,288,Ghana,France,182,104,78
2010,324,Guinea,France,648,453,195
2010,624,Guinea-Bissau,France,104,73,31
2010,430,Liberia,France,59,27,32
2010,466,Mali,France,4397,2334,2063
2010,686,Senegal,France,13027,6447,6580
2010,768,Togo,France,945,522,423
2010,12,Algeria,France,481,207,274
2010,818,Egypt,France,2684,1415,1269
2010,434,Libya,France,4459,2932,1527
2010,504,Morocco,France,26733,13465,13268
2010,788,Tunisia,France,6669,3433,3236
2010,732,Western Sahara,France,233,115,118
2010,48,Bahrain,France,1361,836,525
2010,196,Cyprus,France,998,394,604
2010,268,Georgia,France,38,13,25
2010,376,Israel,France,40576,18395,22181
2010,400,Jordan,France,890,530,360
2010,414,Kuwait,France,2353,1383,970
2010,422,Lebanon,France,123,64,59
2010,512,Oman,France,1162,817,345
2010,634,Qatar,France,1374,1052,322
2010,792,Turkey,France,15802,7388,8414
2010,784,United Arab Emirates,France,15230,9829,5401
2010,64,Bhutan,France,29,14,15
2010,356,India,France,1184,559,625
2010,462,Maldives,France,98,74,24
2010,144,Sri Lanka,France,294,157,137
2010,344,"China, Hong Kong SAR",France,2149,1386,763
2010,392,Japan,France,9060,4075,4985
2010,496,Mongolia,France,66,53,13
2010,410,Republic of Korea,France,1869,1258,611
2010,116,Cambodia,France,305,205,100
2010,608,Philippines,France,1186,632,554
2010,764,Thailand,France,1220,879,341
2010,704,Viet Nam,France,170,121,49
2010,28,Antigua and Barbuda,France,39,18,21
2010,44,Bahamas,France,132,85,47
2010,92,British Virgin Islands,France,21,13,8
2010,535,"Bonaire, Sint Eustatius and Saba",France,28,12,16
2010,136,Cayman Islands,France,36,22,14
2010,192,Cuba,France,62,28,34
2010,212,Dominica,France,69,46,23
2010,214,Dominican Republic,France,1936,1174,762
2010,312,Guadeloupe,France,53722,24478,29244
2010,332,Haiti,France,397,243,154
2010,474,Martinique,France,45448,20742,24706
2010,630,Puerto Rico,France,146,68,78
2010,662,Saint Lucia,France,57,39,18
2010,534,Sint Maarten (Dutch part),France,85,44,41
2010,188,Costa Rica,France,860,478,382
2010,222,El Salvador,France,205,123,82
2010,320,Guatemala,France,224,157,67
2010,340,Honduras,France,103,59,44
2010,484,Mexico,France,8533,4112,4421
2010,558,Nicaragua,France,138,83,55
2010,591,Panama,France,825,494,331
2010,32,Argentina,France,7071,3570,3501
2010,68,Bolivia (Plurinational State of),France,1063,618,445
2010,76,Brazil,France,9476,5985,3491
2010,152,Chile,France,6207,3266,2941
2010,170,Colombia,France,1924,1050,874
2010,218,Ecuador,France,1557,785,772
2010,254,French Guiana,France,20809,11080,9729
2010,600,Paraguay,France,630,381,249
2010,604,Peru,France,2743,1490,1253
2010,858,Uruguay,France,456,218,238
2010,862,Venezuela (Bolivarian Republic of),France,3695,1899,1796
2010,36,Australia,France,28120,14503,13617
2010,554,New Zealand,France,3159,1531,1628
2010,540,New Caledonia,France,36117,19765,16352
2010,548,Vanuatu,France,510,254,256
2010,258,French Polynesia,France,22012,12688,9324
2010,882,Samoa,France,11,9,2
2010,876,Wallis and Futuna Islands,France,721,364,357
2010,100,Bulgaria,France,538,326,212
2010,203,Czechia,France,1993,1411,582
2010,348,Hungary,France,3841,2048,1793
2010,616,Poland,France,27091,11308,15783
2010,642,Romania,France,1880,1093,787
2010,643,Russian Federation,France,2518,1406,1112
2010,703,Slovakia,France,2454,1198,1256
2010,830,Channel Islands,France,1866,891,975
2010,208,Denmark,France,6114,3405,2709
2010,233,Estonia,France,212,132,80
2010,246,Finland,France,2405,1442,963
2010,352,Iceland,France,452,238,214
2010,372,Ireland,France,10912,4606,6306
2010,428,Latvia,France,331,190,141
2010,440,Lithuania,France,335,187,148
2010,578,Norway,France,4635,2604,2031
2010,752,Sweden,France,7944,4695,3249
2010,826,United Kingdom,France,134393,62302,72091
2010,20,Andorra,France,4796,2533,2263
2010,70,Bosnia and Herzegovina,France,175,82,93
2010,191,Croatia,France,1749,839,910
2010,300,Greece,France,7118,2789,4329
2010,380,Italy,France,137725,54477,83248
2010,470,Malta,France,352,173,179
2010,499,Montenegro,France,397,120,277
2010,620,Portugal,France,80086,37638,42448
2010,674,San Marino,France,24,9,15
2010,688,Serbia,France,5513,2627,2886
2010,705,Slovenia,France,1636,735,901
2010,724,Spain,France,210047,102092,107955
2010,40,Austria,France,7665,3418,4247
2010,56,Belgium,France,171307,75980,95327
2010,276,Germany,France,117963,54528,63435
2010,438,Liechtenstein,France,115,59,56
2010,442,Luxembourg,France,23716,11140,12576
2010,492,Monaco,France,6399,2720,3679
2010,528,Netherlands,France,22101,10043,12058
2010,756,Switzerland,France,132304,61864,70440
2010,60,Bermuda,France,144,86,58
2010,124,Canada,France,90445,47407,43038
2010,304,Greenland,France,12,9,3
2010,666,Saint Pierre and Miquelon,France,745,410,335
2010,840,United States of America,France,160300,79193,81107
2015,108,Burundi,France,302,145,157
2015,174,Comoros,France,482,277,205
2015,232,Eritrea,France,436,229,207
2015,450,Madagascar,France,8950,5102,3848
2015,480,Mauritius,France,1505,909,596
2015,175,Mayotte,France,9659,4470,5189
2015,638,Réunion,France,84056,46102,37954
2015,690,Seychelles,France,239,122,117
2015,800,Uganda,France,222,136,86
2015,894,Zambia,France,61,25,36
2015,120,Cameroon,France,4720,2314,2406
2015,140,Central African Republic,France,9583,4920,4663
2015,148,Chad,France,1056,486,570
2015,178,Congo,France,10320,5643,4677
2015,226,Equatorial Guinea,France,4561,2121,2440
2015,266,Gabon,France,14678,9373,5305
2015,516,Namibia,France,524,237,287
2015,710,South Africa,France,11827,5615,6212
2015,204,Benin,France,1304,659,645
2015,132,Cabo Verde,France,201,94,107
2015,288,Ghana,France,223,127,96
2015,324,Guinea,France,248,173,75
2015,624,Guinea-Bissau,France,110,77,33
2015,430,Liberia,France,67,30,37
2015,466,Mali,France,5448,2893,2555
2015,686,Senegal,France,13909,6881,7028
2015,768,Togo,France,792,438,354
2015,12,Algeria,France,530,228,302
2015,818,Egypt,France,1990,1171,819
2015,434,Libya,France,5027,3282,1745
2015,504,Morocco,France,34844,17477,17367
2015,788,Tunisia,France,8612,4447,4165
2015,732,Western Sahara,France,268,136,132
2015,48,Bahrain,France,2027,1234,793
2015,196,Cyprus,France,958,382,576
2015,268,Georgia,France,39,13,26
2015,376,Israel,France,41847,18859,22988
2015,400,Jordan,France,383,193,190
2015,414,Kuwait,France,4810,2554,2256
2015,422,Lebanon,France,104,50,54
2015,512,Oman,France,2642,1976,666
2015,634,Qatar,France,1061,829,232
2015,792,Turkey,France,16041,7307,8734
2015,784,United Arab Emirates,France,16642,10508,6134
2015,64,Bhutan,France,30,15,15
2015,356,India,France,1140,539,601
2015,462,Maldives,France,115,101,14
2015,144,Sri Lanka,France,299,158,141
2015,344,"China, Hong Kong SAR",France,2194,1384,810
2015,392,Japan,France,10672,4761,5911
2015,496,Mongolia,France,81,61,20
2015,410,Republic of Korea,France,2322,1546,776
2015,116,Cambodia,France,275,187,88
2015,608,Philippines,France,1204,643,561
2015,764,Thailand,France,1319,950,369
2015,704,Viet Nam,France,205,146,59
2015,28,Antigua and Barbuda,France,41,19,22
2015,44,Bahamas,France,143,92,51
2015,92,British Virgin Islands,France,23,15,8
2015,535,"Bonaire, Sint Eustatius and Saba",France,31,13,18
2015,136,Cayman Islands,France,38,24,14
2015,192,Cuba,France,49,22,27
2015,212,Dominica,France,80,53,27
2015,214,Dominican Republic,France,3731,2622,1109
2015,312,Guadeloupe,France,55739,25106,30633
2015,332,Haiti,France,416,255,161
2015,474,Martinique,France,47103,21277,25826
2015,630,Puerto Rico,France,143,67,76
2015,662,Saint Lucia,France,54,37,17
2015,534,Sint Maarten (Dutch part),France,89,47,42
2015,188,Costa Rica,France,873,483,390
2015,222,El Salvador,France,214,129,85
2015,320,Guatemala,France,258,182,76
2015,340,Honduras,France,144,83,61
2015,484,Mexico,France,9778,5310,4468
2015,558,Nicaragua,France,148,89,59
2015,591,Panama,France,969,579,390
2015,32,Argentina,France,8160,4118,4042
2015,68,Bolivia (Plurinational State of),France,1237,719,518
2015,76,Brazil,France,11411,7207,4204
2015,152,Chile,France,9403,4852,4551
2015,170,Colombia,France,2154,1185,969
2015,218,Ecuador,France,2264,1134,1130
2015,254,French Guiana,France,20934,11029,9905
2015,600,Paraguay,France,614,371,243
2015,604,Peru,France,3952,2204,1748
2015,858,Uruguay,France,470,225,245
2015,862,Venezuela (Bolivarian Republic of),France,3777,1916,1861
2015,36,Australia,France,36670,19318,17352
2015,554,New Zealand,France,3905,1889,2016
2015,540,New Caledonia,France,43901,24043,19858
2015,548,Vanuatu,France,540,269,271
2015,258,French Polynesia,France,20918,12055,8863
2015,882,Samoa,France,8,7,1
2015,876,Wallis and Futuna Islands,France,817,412,405
2015,100,Bulgaria,France,1781,986,795
2015,203,Czechia,France,2791,1977,814
2015,348,Hungary,France,4166,2210,1956
2015,616,Poland,France,26120,11190,14930
2015,642,Romania,France,6471,3594,2877
2015,643,Russian Federation,France,2567,1428,1139
2015,703,Slovakia,France,2938,1562,1376
2015,830,Channel Islands,France,1980,948,1032
2015,208,Denmark,France,7406,4114,3292
2015,233,Estonia,France,536,322,214
2015,246,Finland,France,2932,1796,1136
2015,352,Iceland,France,538,286,252
2015,372,Ireland,France,11147,4626,6521
2015,428,Latvia,France,181,106,75
2015,440,Lithuania,France,334,178,156
2015,578,Norway,France,6375,3605,2770
2015,752,Sweden,France,9525,5541,3984
2015,826,United Kingdom,France,149825,68244,81581
2015,20,Andorra,France,3890,2116,1774
2015,70,Bosnia and Herzegovina,France,174,82,92
2015,191,Croatia,France,1760,842,918
2015,300,Greece,France,6680,2444,4236
2015,380,Italy,France,127941,50210,77731
2015,470,Malta,France,596,313,283
2015,499,Montenegro,France,446,137,309
2015,620,Portugal,France,90792,40194,50598
2015,674,San Marino,France,29,10,19
2015,688,Serbia,France,5388,2560,2828
2015,705,Slovenia,France,1167,558,609
2015,724,Spain,France,203692,98858,104834
2015,40,Austria,France,8964,4024,4940
2015,56,Belgium,France,182214,82542,99672
2015,276,Germany,France,122911,56659,66252
2015,438,Liechtenstein,France,125,65,60
2015,442,Luxembourg,France,36180,17289,18891
2015,492,Monaco,France,7611,3285,4326
2015,528,Netherlands,France,24712,11307,13405
2015,756,Switzerland,France,158819,77004,81815
2015,60,Bermuda,France,145,86,59
2015,124,Canada,France,104922,55037,49885
2015,304,Greenland,France,13,9,4
2015,666,Saint Pierre and Miquelon,France,723,400,323
2015,840,United States of America,France,173561,85076,88485
2019,108,Burundi,France,334,161,173
2019,174,Comoros,France,480,276,204
2019,232,Eritrea,France,440,231,209
2019,450,Madagascar,France,9747,5556,4191
2019,480,Mauritius,France,1518,917,601
2019,175,Mayotte,France,9743,4509,5234
2019,638,Réunion,France,85340,46807,38533
2019,690,Seychelles,France,241,123,118
2019,800,Uganda,France,222,136,86
2019,894,Zambia,France,78,32,46
2019,120,Cameroon,France,4695,2304,2391
2019,140,Central African Republic,France,10645,5472,5173
2019,148,Chad,France,1158,533,625
2019,178,Congo,France,10637,5814,4823
2019,226,Equatorial Guinea,France,5017,2333,2684
2019,266,Gabon,France,15947,10179,5768
2019,516,Namibia,France,554,251,303
2019,710,South Africa,France,13255,6299,6956
2019,204,Benin,France,1388,703,685
2019,132,Cabo Verde,France,210,98,112
2019,288,Ghana,France,250,143,107
2019,324,Guinea,France,236,165,71
2019,624,Guinea-Bissau,France,120,84,36
2019,430,Liberia,France,55,25,30
2019,466,Mali,France,6066,3222,2844
2019,686,Senegal,France,14367,7104,7263
2019,768,Togo,France,797,443,354
2019,12,Algeria,France,551,237,314
2019,818,Egypt,France,2836,1531,1305
2019,434,Libya,France,5333,3482,1851
2019,504,Morocco,France,37173,18642,18531
2019,788,Tunisia,France,8753,4523,4230
2019,732,Western Sahara,France,278,141,137
2019,48,Bahrain,France,2133,1299,834
2019,196,Cyprus,France,957,388,569
2019,268,Georgia,France,40,14,26
2019,376,Israel,France,40694,18339,22355
2019,400,Jordan,France,411,207,204
2019,414,Kuwait,France,5093,2705,2388
2019,422,Lebanon,France,98,47,51
2019,512,Oman,France,3254,2434,820
2019,634,Qatar,France,1082,829,253
2019,792,Turkey,France,21690,9998,11692
2019,784,United Arab Emirates,France,17874,11285,6589
2019,64,Bhutan,France,31,16,15
2019,356,India,France,1121,530,591
2019,462,Maldives,France,123,108,15
2019,144,Sri Lanka,France,301,159,142
2019,344,"China, Hong Kong SAR",France,2842,1762,1080
2019,392,Japan,France,12206,5446,6760
2019,496,Mongolia,France,86,65,21
2019,410,Republic of Korea,France,2363,1573,790
2019,116,Cambodia,France,292,199,93
2019,608,Philippines,France,1241,663,578
2019,764,Thailand,France,1375,991,384
2019,704,Viet Nam,France,214,153,61
2019,28,Antigua and Barbuda,France,42,20,22
2019,44,Bahamas,France,151,97,54
2019,92,British Virgin Islands,France,24,16,8
2019,535,"Bonaire, Sint Eustatius and Saba",France,36,15,21
2019,136,Cayman Islands,France,41,26,15
2019,192,Cuba,France,45,21,24
2019,212,Dominica,France,81,54,27
2019,214,Dominican Republic,France,3855,2709,1146
2019,312,Guadeloupe,France,56600,25494,31106
2019,332,Haiti,France,432,265,167
2019,474,Martinique,France,47049,21248,25801
2019,630,Puerto Rico,France,136,64,72
2019,662,Saint Lucia,France,52,36,16
2019,534,Sint Maarten (Dutch part),France,92,49,43
2019,188,Costa Rica,France,885,492,393
2019,222,El Salvador,France,216,130,86
2019,320,Guatemala,France,264,186,78
2019,340,Honduras,France,146,85,61
2019,484,Mexico,France,10081,5475,4606
2019,558,Nicaragua,France,155,94,61
2019,591,Panama,France,1030,617,413
2019,32,Argentina,France,8303,4184,4119
2019,68,Bolivia (Plurinational State of),France,1350,785,565
2019,76,Brazil,France,12851,8117,4734
2019,152,Chile,France,12562,6143,6419
2019,170,Colombia,France,2203,1212,991
2019,218,Ecuador,France,2228,1116,1112
2019,254,French Guiana,France,23156,12200,10956
2019,600,Paraguay,France,629,380,249
2019,604,Peru,France,4710,2711,1999
2019,858,Uruguay,France,486,234,252
2019,862,Venezuela (Bolivarian Republic of),France,3699,1868,1831
2019,36,Australia,France,40733,21225,19508
2019,554,New Zealand,France,4013,1941,2072
2019,540,New Caledonia,France,46240,25250,20990
2019,548,Vanuatu,France,549,274,275
2019,258,French Polynesia,France,21726,12517,9209
2019,882,Samoa,France,7,7,0
2019,876,Wallis and Futuna Islands,France,791,399,392
2019,100,Bulgaria,France,2614,1435,1179
2019,203,Czechia,France,3219,2276,943
2019,348,Hungary,France,4404,2379,2025
2019,616,Poland,France,27662,12458,15204
2019,642,Romania,France,13805,7644,6161
2019,643,Russian Federation,France,2566,1428,1138
2019,703,Slovakia,France,3024,1666,1358
2019,830,Channel Islands,France,2016,965,1051
2019,208,Denmark,France,8214,4407,3807
2019,233,Estonia,France,645,392,253
2019,246,Finland,France,3370,2021,1349
2019,352,Iceland,France,715,384,331
2019,372,Ireland,France,12237,5100,7137
2019,428,Latvia,France,209,128,81
2019,440,Lithuania,France,373,222,151
2019,578,Norway,France,6941,3905,3036
2019,752,Sweden,France,11879,6848,5031
2019,826,United Kingdom,France,170142,77733,92409
2019,20,Andorra,France,4151,2272,1879
2019,70,Bosnia and Herzegovina,France,161,76,85
2019,191,Croatia,France,1625,775,850
2019,300,Greece,France,6523,2543,3980
2019,380,Italy,France,132810,53087,79723
2019,470,Malta,France,961,508,453
2019,499,Montenegro,France,447,139,308
2019,620,Portugal,France,92335,40988,51347
2019,674,San Marino,France,30,9,21
2019,688,Serbia,France,5473,2603,2870
2019,705,Slovenia,France,1131,551,580
2019,724,Spain,France,209344,100363,108981
2019,40,Austria,France,10581,4850,5731
2019,56,Belgium,France,194862,89723,105139
2019,276,Germany,France,134829,66064,68765
2019,438,Liechtenstein,France,129,66,63
2019,442,Luxembourg,France,45063,23895,21168
2019,492,Monaco,France,7765,3350,4415
2019,528,Netherlands,France,29455,13704,15751
2019,756,Switzerland,France,170887,84251,86636
2019,60,Bermuda,France,146,87,59
2019,124,Canada,France,112435,58978,53457
2019,304,Greenland,France,12,9,3
2019,666,Saint Pierre and Miquelon,France,725,402,323
2019,840,United States of America,France,189395,92655,96740
1990,28,Antigua and Barbuda,French Guiana,4,2,2
1990,535,"Bonaire, Sint Eustatius and Saba",French Guiana,2,1,1
1990,212,Dominica,French Guiana,8,1,7
1990,312,Guadeloupe,French Guiana,732,352,380
1990,474,Martinique,French Guiana,1101,409,692
1990,662,Saint Lucia,French Guiana,127,46,81
1990,188,Costa Rica,French Guiana,6,3,3
1990,320,Guatemala,French Guiana,13,4,9
1990,76,Brazil,French Guiana,742,384,358
1990,152,Chile,French Guiana,2,0,2
1990,604,Peru,French Guiana,20,9,11
1990,862,Venezuela (Bolivarian Republic of),French Guiana,26,11,15
1990,36,Australia,French Guiana,6,0,6
1990,208,Denmark,French Guiana,5,3,2
1990,300,Greece,French Guiana,2,2,0
1990,124,Canada,French Guiana,48,24,24
1995,28,Antigua and Barbuda,French Guiana,4,2,2
1995,535,"Bonaire, Sint Eustatius and Saba",French Guiana,4,3,1
1995,212,Dominica,French Guiana,11,2,9
1995,312,Guadeloupe,French Guiana,881,399,482
1995,474,Martinique,French Guiana,1348,498,850
1995,662,Saint Lucia,French Guiana,171,63,108
1995,188,Costa Rica,French Guiana,6,3,3
1995,320,Guatemala,French Guiana,13,5,8
1995,68,Bolivia (Plurinational State of),French Guiana,1,0,1
1995,76,Brazil,French Guiana,683,371,312
1995,152,Chile,French Guiana,2,2,0
1995,604,Peru,French Guiana,21,9,12
1995,862,Venezuela (Bolivarian Republic of),French Guiana,25,11,14
1995,36,Australia,French Guiana,3,0,3
1995,208,Denmark,French Guiana,3,2,1
1995,300,Greece,French Guiana,3,2,1
1995,124,Canada,French Guiana,48,23,25
2000,28,Antigua and Barbuda,French Guiana,4,2,2
2000,535,"Bonaire, Sint Eustatius and Saba",French Guiana,6,4,2
2000,212,Dominica,French Guiana,13,2,11
2000,312,Guadeloupe,French Guiana,1030,447,583
2000,474,Martinique,French Guiana,1596,587,1009
2000,662,Saint Lucia,French Guiana,235,87,148
2000,188,Costa Rica,French Guiana,9,4,5
2000,320,Guatemala,French Guiana,13,6,7
2000,68,Bolivia (Plurinational State of),French Guiana,2,1,1
2000,76,Brazil,French Guiana,624,359,265
2000,152,Chile,French Guiana,2,2,0
2000,604,Peru,French Guiana,25,11,14
2000,862,Venezuela (Bolivarian Republic of),French Guiana,25,11,14
2000,36,Australia,French Guiana,10,5,5
2000,300,Greece,French Guiana,4,2,2
2000,124,Canada,French Guiana,50,24,26
2005,28,Antigua and Barbuda,French Guiana,5,3,2
2005,535,"Bonaire, Sint Eustatius and Saba",French Guiana,6,4,2
2005,212,Dominica,French Guiana,16,3,13
2005,312,Guadeloupe,French Guiana,1089,482,607
2005,474,Martinique,French Guiana,1670,588,1082
2005,662,Saint Lucia,French Guiana,199,72,127
2005,188,Costa Rica,French Guiana,6,3,3
2005,320,Guatemala,French Guiana,15,7,8
2005,68,Bolivia (Plurinational State of),French Guiana,2,1,1
2005,76,Brazil,French Guiana,667,389,278
2005,152,Chile,French Guiana,3,3,0
2005,604,Peru,French Guiana,30,13,17
2005,862,Venezuela (Bolivarian Republic of),French Guiana,26,12,14
2005,36,Australia,French Guiana,10,5,5
2005,300,Greece,French Guiana,2,1,1
2005,124,Canada,French Guiana,62,33,29
2010,28,Antigua and Barbuda,French Guiana,5,3,2
2010,212,Dominica,French Guiana,20,5,15
2010,312,Guadeloupe,French Guiana,1148,518,630
2010,474,Martinique,French Guiana,1744,588,1156
2010,662,Saint Lucia,French Guiana,149,52,97
2010,188,Costa Rica,French Guiana,12,5,7
2010,320,Guatemala,French Guiana,17,9,8
2010,68,Bolivia (Plurinational State of),French Guiana,1,1,0
2010,76,Brazil,French Guiana,701,413,288
2010,152,Chile,French Guiana,4,4,0
2010,604,Peru,French Guiana,33,15,18
2010,862,Venezuela (Bolivarian Republic of),French Guiana,28,12,16
2010,36,Australia,French Guiana,10,5,5
2010,124,Canada,French Guiana,70,40,30
2015,28,Antigua and Barbuda,French Guiana,5,3,2
2015,212,Dominica,French Guiana,23,6,17
2015,312,Guadeloupe,French Guiana,1191,531,660
2015,474,Martinique,French Guiana,1807,599,1208
2015,662,Saint Lucia,French Guiana,142,50,92
2015,188,Costa Rica,French Guiana,12,5,7
2015,320,Guatemala,French Guiana,20,11,9
2015,68,Bolivia (Plurinational State of),French Guiana,1,1,0
2015,76,Brazil,French Guiana,844,497,347
2015,152,Chile,French Guiana,6,6,0
2015,604,Peru,French Guiana,34,15,19
2015,862,Venezuela (Bolivarian Republic of),French Guiana,30,13,17
2015,36,Australia,French Guiana,20,12,8
2015,124,Canada,French Guiana,278,134,144
2019,28,Antigua and Barbuda,French Guiana,5,3,2
2019,212,Dominica,French Guiana,23,6,17
2019,312,Guadeloupe,French Guiana,1209,539,670
2019,474,Martinique,French Guiana,1804,598,1206
2019,662,Saint Lucia,French Guiana,137,48,89
2019,188,Costa Rica,French Guiana,12,5,7
2019,320,Guatemala,French Guiana,20,11,9
2019,68,Bolivia (Plurinational State of),French Guiana,1,1,0
2019,76,Brazil,French Guiana,950,560,390
2019,152,Chile,French Guiana,8,8,0
2019,604,Peru,French Guiana,40,19,21
2019,862,Venezuela (Bolivarian Republic of),French Guiana,29,13,16
2019,36,Australia,French Guiana,21,12,9
2019,124,Canada,French Guiana,297,143,154
1990,152,Chile,French Polynesia,18,12,6
1990,36,Australia,French Polynesia,236,91,145
1990,540,New Caledonia,French Polynesia,2726,1404,1322
1990,184,Cook Islands,French Polynesia,63,32,31
1990,876,Wallis and Futuna Islands,French Polynesia,18,10,8
1990,208,Denmark,French Polynesia,5,3,2
1990,826,United Kingdom,French Polynesia,13,8,5
1990,300,Greece,French Polynesia,17,9,8
1990,124,Canada,French Polynesia,53,26,27
1995,152,Chile,French Polynesia,12,3,9
1995,36,Australia,French Polynesia,317,134,183
1995,540,New Caledonia,French Polynesia,3159,1604,1555
1995,184,Cook Islands,French Polynesia,66,34,32
1995,876,Wallis and Futuna Islands,French Polynesia,23,12,11
1995,208,Denmark,French Polynesia,3,2,1
1995,372,Ireland,French Polynesia,1,1,0
1995,826,United Kingdom,French Polynesia,55,26,29
1995,300,Greece,French Polynesia,16,8,8
1995,124,Canada,French Polynesia,97,47,50
2000,152,Chile,French Polynesia,6,1,5
2000,36,Australia,French Polynesia,350,149,201
2000,540,New Caledonia,French Polynesia,3593,1804,1789
2000,184,Cook Islands,French Polynesia,68,35,33
2000,876,Wallis and Futuna Islands,French Polynesia,28,15,13
2000,372,Ireland,French Polynesia,2,1,1
2000,826,United Kingdom,French Polynesia,98,44,54
2000,300,Greece,French Polynesia,16,7,9
2000,124,Canada,French Polynesia,144,70,74
2005,152,Chile,French Polynesia,9,2,7
2005,36,Australia,French Polynesia,390,151,239
2005,540,New Caledonia,French Polynesia,1974,1046,928
2005,184,Cook Islands,French Polynesia,90,35,55
2005,876,Wallis and Futuna Islands,French Polynesia,32,16,16
2005,372,Ireland,French Polynesia,2,1,1
2005,826,United Kingdom,French Polynesia,84,39,45
2005,300,Greece,French Polynesia,13,6,7
2005,124,Canada,French Polynesia,131,76,55
2010,466,Mali,French Polynesia,280,140,140
2010,152,Chile,French Polynesia,12,3,9
2010,36,Australia,French Polynesia,470,186,284
2010,540,New Caledonia,French Polynesia,355,287,68
2010,184,Cook Islands,French Polynesia,112,36,76
2010,876,Wallis and Futuna Islands,French Polynesia,16,8,8
2010,372,Ireland,French Polynesia,1,0,1
2010,826,United Kingdom,French Polynesia,88,42,46
2010,300,Greece,French Polynesia,10,5,5
2010,124,Canada,French Polynesia,115,80,35
2015,466,Mali,French Polynesia,346,173,173
2015,152,Chile,French Polynesia,18,5,13
2015,36,Australia,French Polynesia,530,231,299
2015,540,New Caledonia,French Polynesia,532,423,109
2015,184,Cook Islands,French Polynesia,103,33,70
2015,876,Wallis and Futuna Islands,French Polynesia,4,2,2
2015,372,Ireland,French Polynesia,1,0,1
2015,826,United Kingdom,French Polynesia,112,52,60
2015,300,Greece,French Polynesia,9,5,4
2015,124,Canada,French Polynesia,178,89,89
2019,466,Mali,French Polynesia,385,193,192
2019,152,Chile,French Polynesia,24,6,18
2019,36,Australia,French Polynesia,581,264,317
2019,540,New Caledonia,French Polynesia,560,445,115
2019,184,Cook Islands,French Polynesia,103,33,70
2019,876,Wallis and Futuna Islands,French Polynesia,3,2,1
2019,372,Ireland,French Polynesia,1,0,1
2019,826,United Kingdom,French Polynesia,127,60,67
2019,300,Greece,French Polynesia,8,5,3
2019,124,Canada,French Polynesia,190,95,95
1990,148,Chad,Gabon,292,158,134
1990,178,Congo,Gabon,970,465,505
1990,226,Equatorial Guinea,Gabon,65,36,29
1990,678,Sao Tome and Principe,Gabon,11,9,2
1990,710,South Africa,Gabon,306,145,161
1990,132,Cabo Verde,Gabon,11,6,5
1990,466,Mali,Gabon,4463,2384,2079
1990,478,Mauritania,Gabon,77,35,42
1990,768,Togo,Gabon,430,229,201
1990,188,Costa Rica,Gabon,1,0,1
1990,68,Bolivia (Plurinational State of),Gabon,4,3,1
1990,152,Chile,Gabon,5,4,1
1990,36,Australia,Gabon,20,14,6
1990,100,Bulgaria,Gabon,3,1,2
1990,208,Denmark,Gabon,5,3,2
1990,372,Ireland,Gabon,1,1,0
1990,752,Sweden,Gabon,3,3,0
1990,826,United Kingdom,Gabon,17,11,6
1990,300,Greece,Gabon,18,9,9
1990,380,Italy,Gabon,14,5,9
1990,620,Portugal,Gabon,21,10,11
1990,724,Spain,Gabon,22,10,12
1990,40,Austria,Gabon,14,9,5
1990,56,Belgium,Gabon,308,160,148
1990,250,France,Gabon,7939,3837,4102
1990,276,Germany,Gabon,123,96,27
1990,528,Netherlands,Gabon,35,18,17
1990,756,Switzerland,Gabon,136,56,80
1990,124,Canada,Gabon,38,19,19
1995,148,Chad,Gabon,318,172,146
1995,178,Congo,Gabon,1121,510,611
1995,226,Equatorial Guinea,Gabon,86,47,39
1995,678,Sao Tome and Principe,Gabon,221,157,64
1995,710,South Africa,Gabon,190,98,92
1995,132,Cabo Verde,Gabon,14,8,6
1995,466,Mali,Gabon,4670,2495,2175
1995,478,Mauritania,Gabon,82,42,40
1995,768,Togo,Gabon,484,258,226
1995,188,Costa Rica,Gabon,1,0,1
1995,68,Bolivia (Plurinational State of),Gabon,2,1,1
1995,152,Chile,Gabon,5,3,2
1995,36,Australia,Gabon,10,7,3
1995,100,Bulgaria,Gabon,5,2,3
1995,348,Hungary,Gabon,2,1,1
1995,208,Denmark,Gabon,5,3,2
1995,246,Finland,Gabon,1,0,1
1995,372,Ireland,Gabon,3,2,1
1995,752,Sweden,Gabon,3,3,0
1995,826,United Kingdom,Gabon,70,34,36
1995,300,Greece,Gabon,31,17,14
1995,380,Italy,Gabon,75,37,38
1995,620,Portugal,Gabon,45,21,24
1995,724,Spain,Gabon,34,16,18
1995,40,Austria,Gabon,16,10,6
1995,56,Belgium,Gabon,306,158,148
1995,250,France,Gabon,8196,3890,4306
1995,276,Germany,Gabon,182,133,49
1995,528,Netherlands,Gabon,51,25,26
1995,756,Switzerland,Gabon,157,66,91
1995,124,Canada,Gabon,229,110,119
2000,148,Chad,Gabon,343,185,158
2000,178,Congo,Gabon,1572,689,883
2000,226,Equatorial Guinea,Gabon,107,59,48
2000,678,Sao Tome and Principe,Gabon,436,309,127
2000,710,South Africa,Gabon,131,77,54
2000,132,Cabo Verde,Gabon,17,10,7
2000,466,Mali,Gabon,4279,2297,1982
2000,478,Mauritania,Gabon,84,47,37
2000,768,Togo,Gabon,545,291,254
2000,188,Costa Rica,Gabon,1,0,1
2000,152,Chile,Gabon,5,2,3
2000,36,Australia,Gabon,20,10,10
2000,100,Bulgaria,Gabon,6,2,4
2000,348,Hungary,Gabon,4,2,2
2000,208,Denmark,Gabon,5,3,2
2000,246,Finland,Gabon,1,0,1
2000,372,Ireland,Gabon,6,3,3
2000,752,Sweden,Gabon,4,4,0
2000,826,United Kingdom,Gabon,126,58,68
2000,300,Greece,Gabon,45,25,20
2000,380,Italy,Gabon,136,70,66
2000,620,Portugal,Gabon,71,33,38
2000,705,Slovenia,Gabon,2,2,0
2000,724,Spain,Gabon,415,213,202
2000,40,Austria,Gabon,18,12,6
2000,56,Belgium,Gabon,296,154,142
2000,250,France,Gabon,8453,3944,4509
2000,276,Germany,Gabon,241,171,70
2000,528,Netherlands,Gabon,71,33,38
2000,756,Switzerland,Gabon,180,77,103
2000,124,Canada,Gabon,426,205,221
2005,120,Cameroon,Gabon,1061,535,526
2005,148,Chad,Gabon,237,107,130
2005,178,Congo,Gabon,1000,571,429
2005,226,Equatorial Guinea,Gabon,156,87,69
2005,678,Sao Tome and Principe,Gabon,342,242,100
2005,710,South Africa,Gabon,172,97,75
2005,132,Cabo Verde,Gabon,13,8,5
2005,466,Mali,Gabon,17459,9108,8351
2005,478,Mauritania,Gabon,84,49,35
2005,768,Togo,Gabon,613,327,286
2005,188,Costa Rica,Gabon,1,0,1
2005,76,Brazil,Gabon,15,15,0
2005,152,Chile,Gabon,7,3,4
2005,36,Australia,Gabon,30,15,15
2005,100,Bulgaria,Gabon,9,3,6
2005,203,Czechia,Gabon,1,1,0
2005,348,Hungary,Gabon,5,3,2
2005,208,Denmark,Gabon,6,3,3
2005,246,Finland,Gabon,4,1,3
2005,372,Ireland,Gabon,5,2,3
2005,752,Sweden,Gabon,3,3,0
2005,826,United Kingdom,Gabon,229,98,131
2005,300,Greece,Gabon,27,14,13
2005,380,Italy,Gabon,260,133,127
2005,620,Portugal,Gabon,310,282,28
2005,705,Slovenia,Gabon,1,1,0
2005,724,Spain,Gabon,200,101,99
2005,40,Austria,Gabon,20,13,7
2005,56,Belgium,Gabon,452,231,221
2005,250,France,Gabon,17241,7700,9541
2005,276,Germany,Gabon,340,214,126
2005,528,Netherlands,Gabon,100,50,50
2005,756,Switzerland,Gabon,206,87,119
2005,124,Canada,Gabon,681,323,358
2010,120,Cameroon,Gabon,845,445,400
2010,148,Chad,Gabon,281,126,155
2010,178,Congo,Gabon,2380,1212,1168
2010,226,Equatorial Guinea,Gabon,205,116,89
2010,678,Sao Tome and Principe,Gabon,268,189,79
2010,710,South Africa,Gabon,269,152,117
2010,132,Cabo Verde,Gabon,8,5,3
2010,466,Mali,Gabon,9692,4895,4797
2010,478,Mauritania,Gabon,84,50,34
2010,768,Togo,Gabon,796,443,353
2010,188,Costa Rica,Gabon,1,0,1
2010,76,Brazil,Gabon,30,30,0
2010,152,Chile,Gabon,10,5,5
2010,36,Australia,Gabon,30,15,15
2010,100,Bulgaria,Gabon,11,4,7
2010,203,Czechia,Gabon,1,1,0
2010,348,Hungary,Gabon,5,4,1
2010,208,Denmark,Gabon,6,3,3
2010,246,Finland,Gabon,9,4,5
2010,372,Ireland,Gabon,4,2,2
2010,752,Sweden,Gabon,12,7,5
2010,826,United Kingdom,Gabon,241,106,135
2010,300,Greece,Gabon,8,2,6
2010,380,Italy,Gabon,383,212,171
2010,620,Portugal,Gabon,499,485,14
2010,705,Slovenia,Gabon,2,2,0
2010,724,Spain,Gabon,271,135,136
2010,40,Austria,Gabon,21,13,8
2010,56,Belgium,Gabon,545,268,277
2010,250,France,Gabon,18574,8443,10131
2010,276,Germany,Gabon,422,252,170
2010,528,Netherlands,Gabon,87,39,48
2010,756,Switzerland,Gabon,238,86,152
2010,124,Canada,Gabon,830,393,437
2015,120,Cameroon,Gabon,1079,499,580
2015,148,Chad,Gabon,349,161,188
2015,178,Congo,Gabon,3163,1544,1619
2015,226,Equatorial Guinea,Gabon,256,146,110
2015,678,Sao Tome and Principe,Gabon,237,167,70
2015,710,South Africa,Gabon,484,263,221
2015,132,Cabo Verde,Gabon,8,5,3
2015,324,Guinea,Gabon,74,47,27
2015,466,Mali,Gabon,12008,6065,5943
2015,478,Mauritania,Gabon,84,51,33
2015,768,Togo,Gabon,896,499,397
2015,188,Costa Rica,Gabon,1,0,1
2015,76,Brazil,Gabon,36,36,0
2015,152,Chile,Gabon,15,8,7
2015,36,Australia,Gabon,50,29,21
2015,100,Bulgaria,Gabon,11,4,7
2015,203,Czechia,Gabon,3,3,0
2015,348,Hungary,Gabon,7,4,3
2015,208,Denmark,Gabon,6,4,2
2015,246,Finland,Gabon,12,5,7
2015,372,Ireland,Gabon,4,2,2
2015,752,Sweden,Gabon,25,15,10
2015,826,United Kingdom,Gabon,308,131,177
2015,300,Greece,Gabon,7,2,5
2015,380,Italy,Gabon,372,194,178
2015,620,Portugal,Gabon,566,549,17
2015,705,Slovenia,Gabon,1,1,0
2015,724,Spain,Gabon,278,135,143
2015,40,Austria,Gabon,24,15,9
2015,56,Belgium,Gabon,614,284,330
2015,250,France,Gabon,20576,9045,11531
2015,276,Germany,Gabon,440,263,177
2015,528,Netherlands,Gabon,96,50,46
2015,756,Switzerland,Gabon,297,115,182
2015,124,Canada,Gabon,1068,497,571
2019,120,Cameroon,Gabon,1073,497,576
2019,148,Chad,Gabon,382,176,206
2019,178,Congo,Gabon,3260,1591,1669
2019,226,Equatorial Guinea,Gabon,281,160,121
2019,678,Sao Tome and Principe,Gabon,215,152,63
2019,710,South Africa,Gabon,541,294,247
2019,132,Cabo Verde,Gabon,8,5,3
2019,324,Guinea,Gabon,70,45,25
2019,466,Mali,Gabon,13370,6753,6617
2019,478,Mauritania,Gabon,87,53,34
2019,768,Togo,Gabon,901,504,397
2019,188,Costa Rica,Gabon,1,0,1
2019,76,Brazil,Gabon,40,40,0
2019,152,Chile,Gabon,20,11,9
2019,36,Australia,Gabon,63,33,30
2019,100,Bulgaria,Gabon,10,5,5
2019,203,Czechia,Gabon,7,6,1
2019,348,Hungary,Gabon,15,8,7
2019,208,Denmark,Gabon,11,5,6
2019,246,Finland,Gabon,17,8,9
2019,372,Ireland,Gabon,4,2,2
2019,752,Sweden,Gabon,39,20,19
2019,826,United Kingdom,Gabon,349,149,200
2019,300,Greece,Gabon,6,2,4
2019,380,Italy,Gabon,459,235,224
2019,620,Portugal,Gabon,575,558,17
2019,705,Slovenia,Gabon,1,1,0
2019,724,Spain,Gabon,288,137,151
2019,40,Austria,Gabon,28,18,10
2019,56,Belgium,Gabon,735,332,403
2019,250,France,Gabon,21779,9546,12233
2019,276,Germany,Gabon,482,294,188
2019,528,Netherlands,Gabon,107,53,54
2019,756,Switzerland,Gabon,320,125,195
2019,124,Canada,Gabon,1144,533,611
1990,800,Uganda,Gambia,29,29,0
1990,516,Namibia,Gambia,128,57,71
1990,132,Cabo Verde,Gambia,7,3,4
1990,384,Côte d'Ivoire,Gambia,10359,5445,4914
1990,288,Ghana,Gambia,19,12,7
1990,324,Guinea,Gambia,811,490,321
1990,624,Guinea-Bissau,Gambia,960,461,499
1990,430,Liberia,Gambia,656,383,273
1990,466,Mali,Gambia,595,323,272
1990,686,Senegal,Gambia,4263,1858,2405
1990,694,Sierra Leone,Gambia,5240,2856,2384
1990,768,Togo,Gambia,510,276,234
1990,818,Egypt,Gambia,36,29,7
1990,218,Ecuador,Gambia,11,9,2
1990,36,Australia,Gambia,18,11,7
1990,100,Bulgaria,Gambia,2,1,1
1990,203,Czechia,Gambia,2,1,1
1990,208,Denmark,Gambia,236,171,65
1990,246,Finland,Gambia,22,20,2
1990,352,Iceland,Gambia,2,1,1
1990,372,Ireland,Gambia,11,6,5
1990,578,Norway,Gambia,570,447,123
1990,752,Sweden,Gambia,1965,1176,789
1990,826,United Kingdom,Gambia,1354,755,599
1990,300,Greece,Gambia,59,32,27
1990,380,Italy,Gambia,84,29,55
1990,620,Portugal,Gambia,7,7,0
1990,724,Spain,Gambia,2779,2013,766
1990,40,Austria,Gambia,346,310,36
1990,56,Belgium,Gambia,194,125,69
1990,250,France,Gambia,1329,700,629
1990,276,Germany,Gambia,1908,1809,99
1990,528,Netherlands,Gambia,112,87,25
1990,756,Switzerland,Gambia,157,143,14
1990,124,Canada,Gambia,14,6,8
1990,840,United States of America,Gambia,1485,727,758
1995,800,Uganda,Gambia,27,27,0
1995,516,Namibia,Gambia,122,55,67
1995,132,Cabo Verde,Gambia,10,4,6
1995,384,Côte d'Ivoire,Gambia,6022,3156,2866
1995,288,Ghana,Gambia,19,13,6
1995,324,Guinea,Gambia,935,606,329
1995,624,Guinea-Bissau,Gambia,1247,619,628
1995,430,Liberia,Gambia,650,378,272
1995,466,Mali,Gambia,621,337,284
1995,686,Senegal,Gambia,4458,1928,2530
1995,694,Sierra Leone,Gambia,5110,2718,2392
1995,768,Togo,Gambia,574,311,263
1995,818,Egypt,Gambia,28,22,6
1995,152,Chile,Gambia,1,1,0
1995,218,Ecuador,Gambia,13,10,3
1995,36,Australia,Gambia,9,6,3
1995,100,Bulgaria,Gambia,4,2,2
1995,203,Czechia,Gambia,3,1,2
1995,348,Hungary,Gambia,4,2,2
1995,208,Denmark,Gambia,360,231,129
1995,246,Finland,Gambia,96,88,8
1995,352,Iceland,Gambia,4,2,2
1995,372,Ireland,Gambia,30,15,15
1995,578,Norway,Gambia,676,492,184
1995,752,Sweden,Gambia,2332,1388,944
1995,826,United Kingdom,Gambia,2553,1402,1151
1995,300,Greece,Gambia,51,26,25
1995,380,Italy,Gambia,363,234,129
1995,620,Portugal,Gambia,15,15,0
1995,724,Spain,Gambia,3557,2553,1004
1995,40,Austria,Gambia,391,351,40
1995,56,Belgium,Gambia,194,125,69
1995,250,France,Gambia,1372,712,660
1995,276,Germany,Gambia,2261,2028,233
1995,528,Netherlands,Gambia,164,127,37
1995,756,Switzerland,Gambia,314,282,32
1995,124,Canada,Gambia,122,58,64
1995,840,United States of America,Gambia,3673,1823,1850
2000,516,Namibia,Gambia,114,50,64
2000,132,Cabo Verde,Gambia,12,5,7
2000,384,Côte d'Ivoire,Gambia,6275,3287,2988
2000,288,Ghana,Gambia,21,13,8
2000,324,Guinea,Gambia,654,424,230
2000,624,Guinea-Bissau,Gambia,1534,778,756
2000,430,Liberia,Gambia,630,355,275
2000,466,Mali,Gambia,570,310,260
2000,686,Senegal,Gambia,4029,1635,2394
2000,694,Sierra Leone,Gambia,4984,2584,2400
2000,768,Togo,Gambia,646,350,296
2000,818,Egypt,Gambia,22,16,6
2000,152,Chile,Gambia,2,2,0
2000,218,Ecuador,Gambia,14,11,3
2000,36,Australia,Gambia,30,15,15
2000,100,Bulgaria,Gambia,5,2,3
2000,203,Czechia,Gambia,4,1,3
2000,348,Hungary,Gambia,7,4,3
2000,208,Denmark,Gambia,483,291,192
2000,246,Finland,Gambia,169,155,14
2000,352,Iceland,Gambia,5,3,2
2000,372,Ireland,Gambia,66,35,31
2000,578,Norway,Gambia,789,526,263
2000,752,Sweden,Gambia,2501,1482,1019
2000,826,United Kingdom,Gambia,3796,2070,1726
2000,300,Greece,Gambia,44,21,23
2000,380,Italy,Gambia,641,439,202
2000,620,Portugal,Gambia,24,23,1
2000,705,Slovenia,Gambia,1,1,0
2000,724,Spain,Gambia,5866,4218,1648
2000,40,Austria,Gambia,435,391,44
2000,56,Belgium,Gambia,187,120,67
2000,250,France,Gambia,1415,724,691
2000,276,Germany,Gambia,2614,2248,366
2000,528,Netherlands,Gambia,223,170,53
2000,756,Switzerland,Gambia,473,421,52
2000,124,Canada,Gambia,233,112,121
2000,840,United States of America,Gambia,5911,2947,2964
2005,516,Namibia,Gambia,90,40,50
2005,132,Cabo Verde,Gambia,9,4,5
2005,384,Côte d'Ivoire,Gambia,6569,3441,3128
2005,288,Ghana,Gambia,30,19,11
2005,324,Guinea,Gambia,457,277,180
2005,624,Guinea-Bissau,Gambia,1472,744,728
2005,430,Liberia,Gambia,504,349,155
2005,466,Mali,Gambia,2323,1230,1093
2005,686,Senegal,Gambia,4335,1849,2486
2005,694,Sierra Leone,Gambia,2274,1495,779
2005,768,Togo,Gambia,727,394,333
2005,818,Egypt,Gambia,26,19,7
2005,152,Chile,Gambia,3,3,0
2005,218,Ecuador,Gambia,16,13,3
2005,36,Australia,Gambia,80,40,40
2005,100,Bulgaria,Gambia,8,4,4
2005,203,Czechia,Gambia,8,6,2
2005,348,Hungary,Gambia,9,5,4
2005,208,Denmark,Gambia,548,319,229
2005,246,Finland,Gambia,309,255,54
2005,352,Iceland,Gambia,6,3,3
2005,372,Ireland,Gambia,66,37,29
2005,578,Norway,Gambia,887,560,327
2005,752,Sweden,Gambia,2931,1696,1235
2005,826,United Kingdom,Gambia,7039,3805,3234
2005,300,Greece,Gambia,48,32,16
2005,380,Italy,Gambia,1078,850,228
2005,620,Portugal,Gambia,68,59,9
2005,724,Spain,Gambia,11215,8822,2393
2005,40,Austria,Gambia,487,437,50
2005,56,Belgium,Gambia,291,186,105
2005,250,France,Gambia,1546,876,670
2005,276,Germany,Gambia,3143,2477,666
2005,528,Netherlands,Gambia,401,278,123
2005,756,Switzerland,Gambia,539,476,63
2005,124,Canada,Gambia,368,205,163
2005,840,United States of America,Gambia,11356,5694,5662
2010,516,Namibia,Gambia,86,38,48
2010,132,Cabo Verde,Gambia,5,2,3
2010,384,Côte d'Ivoire,Gambia,6863,3594,3269
2010,288,Ghana,Gambia,1337,713,624
2010,324,Guinea,Gambia,319,193,126
2010,624,Guinea-Bissau,Gambia,1410,710,700
2010,430,Liberia,Gambia,711,396,315
2010,466,Mali,Gambia,1015,497,518
2010,686,Senegal,Gambia,4849,2189,2660
2010,694,Sierra Leone,Gambia,1316,830,486
2010,768,Togo,Gambia,944,535,409
2010,818,Egypt,Gambia,28,20,8
2010,152,Chile,Gambia,4,4,0
2010,218,Ecuador,Gambia,23,19,4
2010,36,Australia,Gambia,100,59,41
2010,100,Bulgaria,Gambia,10,5,5
2010,203,Czechia,Gambia,11,10,1
2010,348,Hungary,Gambia,11,6,5
2010,208,Denmark,Gambia,602,341,261
2010,246,Finland,Gambia,500,381,119
2010,352,Iceland,Gambia,10,9,1
2010,372,Ireland,Gambia,56,30,26
2010,578,Norway,Gambia,1015,608,407
2010,752,Sweden,Gambia,3886,2259,1627
2010,826,United Kingdom,Gambia,7415,4079,3336
2010,300,Greece,Gambia,53,45,8
2010,380,Italy,Gambia,1253,1016,237
2010,620,Portugal,Gambia,101,84,17
2010,705,Slovenia,Gambia,4,3,1
2010,724,Spain,Gambia,18687,15422,3265
2010,40,Austria,Gambia,538,482,56
2010,56,Belgium,Gambia,435,259,176
2010,250,France,Gambia,1790,896,894
2010,276,Germany,Gambia,3575,2666,909
2010,528,Netherlands,Gambia,529,356,173
2010,756,Switzerland,Gambia,625,548,77
2010,124,Canada,Gambia,490,291,199
2010,840,United States of America,Gambia,17293,8553,8740
2015,516,Namibia,Gambia,84,38,46
2015,132,Cabo Verde,Gambia,5,2,3
2015,384,Côte d'Ivoire,Gambia,7157,3748,3409
2015,288,Ghana,Gambia,1645,877,768
2015,324,Guinea,Gambia,281,170,111
2015,624,Guinea-Bissau,Gambia,1495,746,749
2015,430,Liberia,Gambia,816,452,364
2015,466,Mali,Gambia,1257,616,641
2015,686,Senegal,Gambia,5386,2442,2944
2015,694,Sierra Leone,Gambia,705,432,273
2015,768,Togo,Gambia,1063,603,460
2015,818,Egypt,Gambia,20,15,5
2015,152,Chile,Gambia,6,6,0
2015,218,Ecuador,Gambia,33,28,5
2015,36,Australia,Gambia,130,77,53
2015,100,Bulgaria,Gambia,9,4,5
2015,203,Czechia,Gambia,16,14,2
2015,348,Hungary,Gambia,11,8,3
2015,208,Denmark,Gambia,676,377,299
2015,246,Finland,Gambia,836,659,177
2015,352,Iceland,Gambia,11,9,2
2015,372,Ireland,Gambia,57,30,27
2015,578,Norway,Gambia,1163,679,484
2015,752,Sweden,Gambia,4884,2844,2040
2015,826,United Kingdom,Gambia,9482,5090,4392
2015,300,Greece,Gambia,27,14,13
2015,380,Italy,Gambia,3322,3048,274
2015,620,Portugal,Gambia,114,94,20
2015,705,Slovenia,Gambia,16,14,2
2015,724,Spain,Gambia,17017,13320,3697
2015,40,Austria,Gambia,628,562,66
2015,56,Belgium,Gambia,711,446,265
2015,250,France,Gambia,1982,965,1017
2015,276,Germany,Gambia,3725,2775,950
2015,528,Netherlands,Gambia,672,435,237
2015,756,Switzerland,Gambia,990,852,138
2015,124,Canada,Gambia,665,372,293
2015,840,United States of America,Gambia,23157,11393,11764
2019,516,Namibia,Gambia,88,40,48
2019,132,Cabo Verde,Gambia,5,2,3
2019,384,Côte d'Ivoire,Gambia,7392,3871,3521
2019,288,Ghana,Gambia,1851,989,862
2019,324,Guinea,Gambia,268,163,105
2019,624,Guinea-Bissau,Gambia,1638,817,821
2019,430,Liberia,Gambia,677,375,302
2019,466,Mali,Gambia,1399,686,713
2019,686,Senegal,Gambia,5630,2556,3074
2019,694,Sierra Leone,Gambia,557,336,221
2019,768,Togo,Gambia,1069,609,460
2019,818,Egypt,Gambia,28,21,7
2019,152,Chile,Gambia,8,8,0
2019,218,Ecuador,Gambia,32,28,4
2019,36,Australia,Gambia,137,89,48
2019,100,Bulgaria,Gambia,10,5,5
2019,203,Czechia,Gambia,18,16,2
2019,348,Hungary,Gambia,11,6,5
2019,208,Denmark,Gambia,715,396,319
2019,246,Finland,Gambia,1045,837,208
2019,352,Iceland,Gambia,16,13,3
2019,372,Ireland,Gambia,62,33,29
2019,578,Norway,Gambia,1316,769,547
2019,752,Sweden,Gambia,5561,3303,2258
2019,826,United Kingdom,Gambia,10767,5793,4974
2019,300,Greece,Gambia,47,23,24
2019,380,Italy,Gambia,14556,14142,414
2019,620,Portugal,Gambia,115,95,20
2019,705,Slovenia,Gambia,18,17,1
2019,724,Spain,Gambia,17836,13734,4102
2019,40,Austria,Gambia,741,665,76
2019,56,Belgium,Gambia,874,551,323
2019,250,France,Gambia,2097,1019,1078
2019,276,Germany,Gambia,14336,12043,2293
2019,528,Netherlands,Gambia,909,585,324
2019,756,Switzerland,Gambia,937,778,159
2019,124,Canada,Gambia,712,399,313
2019,840,United States of America,Gambia,25007,12167,12840
1990,51,Armenia,Georgia,1646,564,1082
1990,31,Azerbaijan,Georgia,69766,30871,38895
1990,196,Cyprus,Georgia,3802,2082,1720
1990,376,Israel,Georgia,25921,12697,13224
1990,792,Turkey,Georgia,1575,715,860
1990,398,Kazakhstan,Georgia,3773,2333,1440
1990,417,Kyrgyzstan,Georgia,10351,4548,5803
1990,762,Tajikistan,Georgia,872,384,488
1990,188,Costa Rica,Georgia,10,4,6
1990,152,Chile,Georgia,16,9,7
1990,862,Venezuela (Bolivarian Republic of),Georgia,12,4,8
1990,36,Australia,Georgia,17,6,11
1990,112,Belarus,Georgia,9868,5654,4214
1990,100,Bulgaria,Georgia,77,39,38
1990,203,Czechia,Georgia,88,50,38
1990,348,Hungary,Georgia,186,102,84
1990,616,Poland,Georgia,460,221,239
1990,498,Republic of Moldova,Georgia,3550,2008,1542
1990,643,Russian Federation,Georgia,656888,322343,334545
1990,703,Slovakia,Georgia,11,5,6
1990,804,Ukraine,Georgia,76612,32828,43784
1990,208,Denmark,Georgia,72,35,37
1990,233,Estonia,Georgia,2196,1132,1064
1990,352,Iceland,Georgia,2,1,1
1990,372,Ireland,Georgia,49,27,22
1990,428,Latvia,Georgia,697,427,270
1990,440,Lithuania,Georgia,2036,1213,823
1990,752,Sweden,Georgia,103,43,60
1990,826,United Kingdom,Georgia,76,46,30
1990,300,Greece,Georgia,36031,19955,16076
1990,380,Italy,Georgia,11,4,7
1990,470,Malta,Georgia,12,6,6
1990,620,Portugal,Georgia,40,36,4
1990,688,Serbia,Georgia,5,2,3
1990,724,Spain,Georgia,102,50,52
1990,40,Austria,Georgia,1827,949,878
1990,56,Belgium,Georgia,184,91,93
1990,250,France,Georgia,1337,659,678
1990,276,Germany,Georgia,1410,553,857
1990,528,Netherlands,Georgia,32,18,14
1990,756,Switzerland,Georgia,293,158,135
1990,124,Canada,Georgia,749,365,384
1990,840,United States of America,Georgia,6689,3272,3417
1995,51,Armenia,Georgia,27684,9488,18196
1995,31,Azerbaijan,Georgia,61233,29158,32075
1995,196,Cyprus,Georgia,5376,2846,2530
1995,376,Israel,Georgia,24200,11667,12533
1995,792,Turkey,Georgia,3813,1645,2168
1995,398,Kazakhstan,Georgia,3089,1888,1201
1995,417,Kyrgyzstan,Georgia,8367,3842,4525
1995,762,Tajikistan,Georgia,753,385,368
1995,188,Costa Rica,Georgia,8,4,4
1995,68,Bolivia (Plurinational State of),Georgia,1,1,0
1995,152,Chile,Georgia,9,9,0
1995,862,Venezuela (Bolivarian Republic of),Georgia,11,3,8
1995,36,Australia,Georgia,168,85,83
1995,112,Belarus,Georgia,9348,5375,3973
1995,100,Bulgaria,Georgia,117,53,64
1995,203,Czechia,Georgia,132,77,55
1995,348,Hungary,Georgia,165,89,76
1995,616,Poland,Georgia,393,186,207
1995,498,Republic of Moldova,Georgia,2396,1328,1068
1995,643,Russian Federation,Georgia,653159,337869,315290
1995,703,Slovakia,Georgia,27,16,11
1995,804,Ukraine,Georgia,74660,36124,38536
1995,208,Denmark,Georgia,78,38,40
1995,233,Estonia,Georgia,1884,964,920
1995,246,Finland,Georgia,5,2,3
1995,352,Iceland,Georgia,3,1,2
1995,372,Ireland,Georgia,136,73,63
1995,428,Latvia,Georgia,1368,790,578
1995,440,Lithuania,Georgia,1144,683,461
1995,578,Norway,Georgia,11,5,6
1995,752,Sweden,Georgia,123,51,72
1995,826,United Kingdom,Georgia,303,151,152
1995,300,Greece,Georgia,53103,26400,26703
1995,380,Italy,Georgia,164,54,110
1995,470,Malta,Georgia,15,8,7
1995,620,Portugal,Georgia,88,79,9
1995,688,Serbia,Georgia,37,12,25
1995,724,Spain,Georgia,257,135,122
1995,40,Austria,Georgia,2061,1087,974
1995,56,Belgium,Georgia,183,90,93
1995,250,France,Georgia,1381,669,712
1995,276,Germany,Georgia,5946,2521,3425
1995,528,Netherlands,Georgia,46,25,21
1995,756,Switzerland,Georgia,369,185,184
1995,124,Canada,Georgia,752,365,387
1995,840,United States of America,Georgia,8723,4313,4410
2000,51,Armenia,Georgia,46779,16040,30739
2000,31,Azerbaijan,Georgia,61708,28924,32784
2000,196,Cyprus,Georgia,6950,3610,3340
2000,376,Israel,Georgia,21123,10117,11006
2000,792,Turkey,Georgia,6065,2577,3488
2000,398,Kazakhstan,Georgia,2405,1443,962
2000,417,Kyrgyzstan,Georgia,6156,3021,3135
2000,762,Tajikistan,Georgia,703,365,338
2000,188,Costa Rica,Georgia,9,4,5
2000,68,Bolivia (Plurinational State of),Georgia,1,1,0
2000,152,Chile,Georgia,2,2,0
2000,862,Venezuela (Bolivarian Republic of),Georgia,11,3,8
2000,36,Australia,Georgia,290,150,140
2000,112,Belarus,Georgia,8827,5096,3731
2000,100,Bulgaria,Georgia,157,67,90
2000,203,Czechia,Georgia,176,104,72
2000,348,Hungary,Georgia,144,77,67
2000,616,Poland,Georgia,336,156,180
2000,498,Republic of Moldova,Georgia,1617,877,740
2000,643,Russian Federation,Georgia,625743,341259,284484
2000,703,Slovakia,Georgia,51,30,21
2000,804,Ukraine,Georgia,73621,39862,33759
2000,208,Denmark,Georgia,83,41,42
2000,233,Estonia,Georgia,1572,796,776
2000,246,Finland,Georgia,9,3,6
2000,352,Iceland,Georgia,4,2,2
2000,372,Ireland,Georgia,298,165,133
2000,428,Latvia,Georgia,2039,1153,886
2000,440,Lithuania,Georgia,896,535,361
2000,578,Norway,Georgia,16,8,8
2000,752,Sweden,Georgia,132,54,78
2000,826,United Kingdom,Georgia,537,259,278
2000,300,Greece,Georgia,71047,32796,38251
2000,380,Italy,Georgia,317,105,212
2000,470,Malta,Georgia,19,11,8
2000,620,Portugal,Georgia,140,124,16
2000,688,Serbia,Georgia,51,15,36
2000,705,Slovenia,Georgia,11,8,3
2000,724,Spain,Georgia,523,281,242
2000,40,Austria,Georgia,2295,1225,1070
2000,56,Belgium,Georgia,176,87,89
2000,250,France,Georgia,1424,679,745
2000,276,Germany,Georgia,10482,4489,5993
2000,528,Netherlands,Georgia,63,33,30
2000,756,Switzerland,Georgia,448,213,235
2000,124,Canada,Georgia,773,373,400
2000,840,United States of America,Georgia,10795,5379,5416
2005,51,Armenia,Georgia,30942,11273,19669
2005,31,Azerbaijan,Georgia,58561,26490,32071
2005,196,Cyprus,Georgia,10173,5254,4919
2005,376,Israel,Georgia,14988,7128,7860
2005,792,Turkey,Georgia,6249,2574,3675
2005,398,Kazakhstan,Georgia,2742,1674,1068
2005,417,Kyrgyzstan,Georgia,4973,2429,2544
2005,762,Tajikistan,Georgia,678,353,325
2005,188,Costa Rica,Georgia,6,3,3
2005,591,Panama,Georgia,23,21,2
2005,68,Bolivia (Plurinational State of),Georgia,2,1,1
2005,76,Brazil,Georgia,31,10,21
2005,152,Chile,Georgia,3358,1679,1679
2005,862,Venezuela (Bolivarian Republic of),Georgia,11,3,8
2005,36,Australia,Georgia,400,190,210
2005,112,Belarus,Georgia,8705,5025,3680
2005,100,Bulgaria,Georgia,223,96,127
2005,203,Czechia,Georgia,607,351,256
2005,348,Hungary,Georgia,178,97,81
2005,616,Poland,Georgia,331,149,182
2005,498,Republic of Moldova,Georgia,1117,596,521
2005,643,Russian Federation,Georgia,539318,292371,246947
2005,703,Slovakia,Georgia,120,68,52
2005,804,Ukraine,Georgia,67270,36466,30804
2005,208,Denmark,Georgia,143,64,79
2005,233,Estonia,Georgia,1592,794,798
2005,246,Finland,Georgia,23,10,13
2005,352,Iceland,Georgia,12,5,7
2005,372,Ireland,Georgia,299,174,125
2005,428,Latvia,Georgia,1850,1044,806
2005,440,Lithuania,Georgia,868,523,345
2005,578,Norway,Georgia,125,59,66
2005,752,Sweden,Georgia,365,167,198
2005,826,United Kingdom,Georgia,1707,815,892
2005,300,Greece,Georgia,78132,34054,44078
2005,380,Italy,Georgia,6271,929,5342
2005,470,Malta,Georgia,23,12,11
2005,620,Portugal,Georgia,590,454,136
2005,688,Serbia,Georgia,51,15,36
2005,705,Slovenia,Georgia,8,5,3
2005,724,Spain,Georgia,4926,3132,1794
2005,40,Austria,Georgia,2565,1340,1225
2005,56,Belgium,Georgia,128,63,65
2005,250,France,Georgia,5304,2591,2713
2005,276,Germany,Georgia,14882,6065,8817
2005,528,Netherlands,Georgia,150,75,75
2005,756,Switzerland,Georgia,513,225,288
2005,124,Canada,Georgia,1205,595,610
2005,840,United States of America,Georgia,15875,7954,7921
2010,51,Armenia,Georgia,25767,9939,15828
2010,31,Azerbaijan,Georgia,53614,25318,28296
2010,196,Cyprus,Georgia,16659,8705,7954
2010,376,Israel,Georgia,9034,4209,4825
2010,792,Turkey,Georgia,6439,2567,3872
2010,398,Kazakhstan,Georgia,3079,1906,1173
2010,417,Kyrgyzstan,Georgia,3712,1790,1922
2010,762,Tajikistan,Georgia,676,349,327
2010,188,Costa Rica,Georgia,12,5,7
2010,591,Panama,Georgia,49,44,5
2010,68,Bolivia (Plurinational State of),Georgia,2,1,1
2010,76,Brazil,Georgia,63,21,42
2010,152,Chile,Georgia,6714,3357,3357
2010,862,Venezuela (Bolivarian Republic of),Georgia,12,3,9
2010,36,Australia,Georgia,490,233,257
2010,112,Belarus,Georgia,8583,4954,3629
2010,100,Bulgaria,Georgia,279,120,159
2010,203,Czechia,Georgia,979,575,404
2010,348,Hungary,Georgia,212,117,95
2010,616,Poland,Georgia,638,247,391
2010,498,Republic of Moldova,Georgia,804,433,371
2010,642,Romania,Georgia,2,2,0
2010,643,Russian Federation,Georgia,441793,237616,204177
2010,703,Slovakia,Georgia,65,39,26
2010,804,Ukraine,Georgia,64185,34834,29351
2010,208,Denmark,Georgia,199,86,113
2010,233,Estonia,Georgia,1599,782,817
2010,246,Finland,Georgia,35,14,21
2010,352,Iceland,Georgia,20,8,12
2010,372,Ireland,Georgia,250,137,113
2010,428,Latvia,Georgia,1614,896,718
2010,440,Lithuania,Georgia,723,422,301
2010,578,Norway,Georgia,208,96,112
2010,752,Sweden,Georgia,859,422,437
2010,826,United Kingdom,Georgia,1798,878,920
2010,300,Greece,Georgia,88665,36760,51905
2010,380,Italy,Georgia,10030,1351,8679
2010,470,Malta,Georgia,33,16,17
2010,620,Portugal,Georgia,943,709,234
2010,688,Serbia,Georgia,50,14,36
2010,705,Slovenia,Georgia,15,6,9
2010,724,Spain,Georgia,9792,5490,4302
2010,40,Austria,Georgia,2835,1455,1380
2010,56,Belgium,Georgia,262,133,129
2010,250,France,Georgia,7121,3313,3808
2010,276,Germany,Georgia,18514,7411,11103
2010,528,Netherlands,Georgia,202,109,93
2010,756,Switzerland,Georgia,593,248,345
2010,124,Canada,Georgia,1655,828,827
2010,840,United States of America,Georgia,21577,10664,10913
2015,51,Armenia,Georgia,38094,14694,23400
2015,31,Azerbaijan,Georgia,51141,24733,26408
2015,196,Cyprus,Georgia,16005,8414,7591
2015,376,Israel,Georgia,9317,4317,5000
2015,792,Turkey,Georgia,6536,2517,4019
2015,398,Kazakhstan,Georgia,3275,2048,1227
2015,417,Kyrgyzstan,Georgia,3270,1568,1702
2015,762,Tajikistan,Georgia,664,341,323
2015,188,Costa Rica,Georgia,12,5,7
2015,591,Panama,Georgia,58,53,5
2015,68,Bolivia (Plurinational State of),Georgia,2,1,1
2015,76,Brazil,Georgia,76,25,51
2015,152,Chile,Georgia,10171,4976,5195
2015,862,Venezuela (Bolivarian Republic of),Georgia,13,3,10
2015,36,Australia,Georgia,620,296,324
2015,112,Belarus,Georgia,8507,4911,3596
2015,100,Bulgaria,Georgia,404,179,225
2015,203,Czechia,Georgia,1070,616,454
2015,348,Hungary,Georgia,204,99,105
2015,616,Poland,Georgia,325,145,180
2015,498,Republic of Moldova,Georgia,607,330,277
2015,642,Romania,Georgia,57,20,37
2015,643,Russian Federation,Georgia,450221,241107,209114
2015,703,Slovakia,Georgia,78,47,31
2015,804,Ukraine,Georgia,64399,34991,29408
2015,208,Denmark,Georgia,230,101,129
2015,233,Estonia,Georgia,1642,828,814
2015,246,Finland,Georgia,85,41,44
2015,352,Iceland,Georgia,22,8,14
2015,372,Ireland,Georgia,255,138,117
2015,428,Latvia,Georgia,1317,720,597
2015,440,Lithuania,Georgia,656,389,267
2015,578,Norway,Georgia,315,141,174
2015,752,Sweden,Georgia,1325,645,680
2015,826,United Kingdom,Georgia,2299,1088,1211
2015,300,Greece,Georgia,83218,32424,50794
2015,380,Italy,Georgia,13386,1830,11556
2015,470,Malta,Georgia,55,28,27
2015,620,Portugal,Georgia,1070,792,278
2015,688,Serbia,Georgia,48,13,35
2015,705,Slovenia,Georgia,18,9,9
2015,724,Spain,Georgia,8760,4016,4744
2015,40,Austria,Georgia,3316,1711,1605
2015,56,Belgium,Georgia,499,251,248
2015,250,France,Georgia,7888,3553,4335
2015,276,Germany,Georgia,19290,7694,11596
2015,528,Netherlands,Georgia,296,153,143
2015,756,Switzerland,Georgia,948,401,547
2015,124,Canada,Georgia,2554,1192,1362
2015,840,United States of America,Georgia,27126,13337,13789
2019,51,Armenia,Georgia,37886,14817,23069
2019,31,Azerbaijan,Georgia,49137,23764,25373
2019,196,Cyprus,Georgia,15996,8487,7509
2019,376,Israel,Georgia,9060,4198,4862
2019,792,Turkey,Georgia,8837,3457,5380
2019,398,Kazakhstan,Georgia,3422,2140,1282
2019,417,Kyrgyzstan,Georgia,3204,1537,1667
2019,762,Tajikistan,Georgia,661,340,321
2019,188,Costa Rica,Georgia,12,5,7
2019,591,Panama,Georgia,60,56,4
2019,68,Bolivia (Plurinational State of),Georgia,2,1,1
2019,76,Brazil,Georgia,85,28,57
2019,152,Chile,Georgia,13589,6262,7327
2019,862,Venezuela (Bolivarian Republic of),Georgia,12,3,9
2019,36,Australia,Georgia,708,328,380
2019,112,Belarus,Georgia,8400,4849,3551
2019,100,Bulgaria,Georgia,510,230,280
2019,203,Czechia,Georgia,1181,675,506
2019,348,Hungary,Georgia,300,140,160
2019,616,Poland,Georgia,344,161,183
2019,498,Republic of Moldova,Georgia,597,325,272
2019,642,Romania,Georgia,165,86,79
2019,643,Russian Federation,Georgia,450115,241050,209065
2019,703,Slovakia,Georgia,85,53,32
2019,804,Ukraine,Georgia,65042,35340,29702
2019,208,Denmark,Georgia,261,105,156
2019,233,Estonia,Georgia,1663,839,824
2019,246,Finland,Georgia,122,63,59
2019,352,Iceland,Georgia,28,13,15
2019,372,Ireland,Georgia,279,151,128
2019,428,Latvia,Georgia,1216,667,549
2019,440,Lithuania,Georgia,443,208,235
2019,578,Norway,Georgia,352,167,185
2019,752,Sweden,Georgia,2099,1024,1075
2019,826,United Kingdom,Georgia,2610,1239,1371
2019,300,Greece,Georgia,81272,33546,47726
2019,380,Italy,Georgia,15124,2463,12661
2019,470,Malta,Georgia,88,45,43
2019,620,Portugal,Georgia,1088,806,282
2019,688,Serbia,Georgia,48,13,35
2019,705,Slovenia,Georgia,27,14,13
2019,724,Spain,Georgia,9076,4043,5033
2019,40,Austria,Georgia,3914,2052,1862
2019,56,Belgium,Georgia,554,283,271
2019,250,France,Georgia,8349,3750,4599
2019,276,Germany,Georgia,21160,9051,12109
2019,528,Netherlands,Georgia,397,194,203
2019,756,Switzerland,Georgia,1217,543,674
2019,124,Canada,Georgia,2736,1277,1459
2019,840,United States of America,Georgia,29293,14243,15050
1990,480,Mauritius,Germany,57,33,24
1990,690,Seychelles,Germany,40,16,24
1990,800,Uganda,Germany,226,128,98
1990,834,United Republic of Tanzania,Germany,605,348,257
1990,894,Zambia,Germany,311,173,138
1990,178,Congo,Germany,178,81,97
1990,266,Gabon,Germany,27,15,12
1990,72,Botswana,Germany,332,184,148
1990,516,Namibia,Germany,13401,5620,7781
1990,710,South Africa,Germany,33946,15243,18703
1990,132,Cabo Verde,Germany,25,13,12
1990,324,Guinea,Germany,849,421,428
1990,430,Liberia,Germany,928,478,450
1990,686,Senegal,Germany,721,359,362
1990,694,Sierra Leone,Germany,135,74,61
1990,768,Togo,Germany,75,32,43
1990,12,Algeria,Germany,6544,3694,2850
1990,818,Egypt,Germany,9692,5298,4394
1990,434,Libya,Germany,27674,15197,12477
1990,504,Morocco,Germany,984,521,463
1990,788,Tunisia,Germany,903,449,454
1990,51,Armenia,Germany,660,281,379
1990,31,Azerbaijan,Germany,389,155,234
1990,196,Cyprus,Germany,646,294,352
1990,268,Georgia,Germany,8348,3717,4631
1990,376,Israel,Germany,26628,11817,14811
1990,400,Jordan,Germany,413,206,207
1990,422,Lebanon,Germany,189,94,95
1990,792,Turkey,Germany,176820,88533,88287
1990,417,Kyrgyzstan,Germany,15254,6486,8768
1990,762,Tajikistan,Germany,205,91,114
1990,795,Turkmenistan,Germany,1567,587,980
1990,860,Uzbekistan,Germany,19362,8643,10719
1990,64,Bhutan,Germany,12,7,5
1990,356,India,Germany,5654,2682,2972
1990,462,Maldives,Germany,251,138,113
1990,144,Sri Lanka,Germany,21,14,7
1990,344,"China, Hong Kong SAR",Germany,1323,990,333
1990,392,Japan,Germany,3607,1838,1769
1990,496,Mongolia,Germany,50,28,22
1990,410,Republic of Korea,Germany,645,409,236
1990,116,Cambodia,Germany,18,11,7
1990,608,Philippines,Germany,704,509,195
1990,764,Thailand,Germany,2551,2159,392
1990,28,Antigua and Barbuda,Germany,45,22,23
1990,44,Bahamas,Germany,161,80,81
1990,92,British Virgin Islands,Germany,29,13,16
1990,136,Cayman Islands,Germany,42,29,13
1990,192,Cuba,Germany,752,388,364
1990,212,Dominica,Germany,11,4,7
1990,214,Dominican Republic,Germany,5084,3081,2003
1990,312,Guadeloupe,Germany,125,60,65
1990,332,Haiti,Germany,896,533,363
1990,630,Puerto Rico,Germany,2231,1057,1174
1990,662,Saint Lucia,Germany,31,12,19
1990,780,Trinidad and Tobago,Germany,137,66,71
1990,84,Belize,Germany,45,29,16
1990,188,Costa Rica,Germany,1268,746,522
1990,222,El Salvador,Germany,464,279,185
1990,320,Guatemala,Germany,476,155,321
1990,340,Honduras,Germany,223,149,74
1990,484,Mexico,Germany,4560,2321,2239
1990,558,Nicaragua,Germany,374,209,165
1990,591,Panama,Germany,284,175,109
1990,32,Argentina,Germany,15674,7342,8332
1990,68,Bolivia (Plurinational State of),Germany,1351,726,625
1990,76,Brazil,Germany,25679,13074,12605
1990,152,Chile,Germany,5379,2656,2723
1990,170,Colombia,Germany,2679,1472,1207
1990,218,Ecuador,Germany,1397,743,654
1990,600,Paraguay,Germany,2108,1210,898
1990,604,Peru,Germany,1823,932,891
1990,858,Uruguay,Germany,2573,1232,1341
1990,862,Venezuela (Bolivarian Republic of),Germany,4895,2619,2276
1990,36,Australia,Germany,126452,62326,64126
1990,554,New Zealand,Germany,5298,2537,2761
1990,258,French Polynesia,Germany,319,224,95
1990,882,Samoa,Germany,35,21,14
1990,112,Belarus,Germany,32,21,11
1990,100,Bulgaria,Germany,252,114,138
1990,203,Czechia,Germany,2375,1189,1186
1990,348,Hungary,Germany,18409,8179,10230
1990,616,Poland,Germany,144229,64066,80163
1990,498,Republic of Moldova,Germany,3419,1778,1641
1990,642,Romania,Germany,1783,731,1052
1990,643,Russian Federation,Germany,144895,71102,73793
1990,703,Slovakia,Germany,255,123,132
1990,804,Ukraine,Germany,1308,665,643
1990,208,Denmark,Germany,22533,9734,12799
1990,233,Estonia,Germany,461,230,231
1990,234,Faroe Islands,Germany,27,13,14
1990,246,Finland,Germany,2586,1535,1051
1990,352,Iceland,Germany,803,251,552
1990,372,Ireland,Germany,3341,1653,1688
1990,428,Latvia,Germany,1913,832,1081
1990,440,Lithuania,Germany,1833,975,858
1990,578,Norway,Germany,8821,3895,4926
1990,752,Sweden,Germany,29981,13563,16418
1990,826,United Kingdom,Germany,213058,87109,125949
1990,20,Andorra,Germany,347,185,162
1990,70,Bosnia and Herzegovina,Germany,816,375,441
1990,191,Croatia,Germany,5148,2143,3005
1990,300,Greece,Germany,26527,11636,14891
1990,380,Italy,Germany,96165,26844,69321
1990,470,Malta,Germany,323,128,195
1990,807,North Macedonia,Germany,43,18,25
1990,620,Portugal,Germany,16069,7873,8196
1990,688,Serbia,Germany,31,17,14
1990,705,Slovenia,Germany,8402,3990,4412
1990,724,Spain,Germany,80772,38178,42594
1990,40,Austria,Germany,100832,40249,60583
1990,56,Belgium,Germany,55851,28588,27263
1990,250,France,Germany,171594,67085,104509
1990,438,Liechtenstein,Germany,978,523,455
1990,442,Luxembourg,Germany,12616,4746,7870
1990,528,Netherlands,Germany,127898,53350,74548
1990,756,Switzerland,Germany,161440,70101,91339
1990,60,Bermuda,Germany,228,119,109
1990,124,Canada,Germany,173222,84328,88894
1990,304,Greenland,Germany,33,28,5
1990,840,United States of America,Germany,711929,348233,363696
1995,480,Mauritius,Germany,70,39,31
1995,690,Seychelles,Germany,48,23,25
1995,800,Uganda,Germany,214,118,96
1995,834,United Republic of Tanzania,Germany,769,442,327
1995,894,Zambia,Germany,220,123,97
1995,178,Congo,Germany,205,87,118
1995,266,Gabon,Germany,36,20,16
1995,72,Botswana,Germany,320,177,143
1995,516,Namibia,Germany,12815,5422,7393
1995,710,South Africa,Germany,25144,12166,12978
1995,132,Cabo Verde,Germany,33,18,15
1995,430,Liberia,Germany,906,457,449
1995,686,Senegal,Germany,754,374,380
1995,694,Sierra Leone,Germany,131,70,61
1995,768,Togo,Germany,87,37,50
1995,12,Algeria,Germany,3661,1987,1674
1995,818,Egypt,Germany,7378,3965,3413
1995,434,Libya,Germany,16289,8749,7540
1995,504,Morocco,Germany,903,471,432
1995,788,Tunisia,Germany,896,450,446
1995,51,Armenia,Germany,700,314,386
1995,31,Azerbaijan,Germany,341,148,193
1995,196,Cyprus,Germany,914,396,518
1995,268,Georgia,Germany,1214,546,668
1995,376,Israel,Germany,27508,11996,15512
1995,400,Jordan,Germany,642,331,311
1995,422,Lebanon,Germany,292,141,151
1995,792,Turkey,Germany,215428,106300,109128
1995,417,Kyrgyzstan,Germany,10548,4494,6054
1995,762,Tajikistan,Germany,166,89,77
1995,795,Turkmenistan,Germany,1280,552,728
1995,860,Uzbekistan,Germany,14711,6469,8242
1995,64,Bhutan,Germany,15,9,6
1995,356,India,Germany,4140,1810,2330
1995,462,Maldives,Germany,213,106,107
1995,144,Sri Lanka,Germany,83,64,19
1995,344,"China, Hong Kong SAR",Germany,1476,1102,374
1995,392,Japan,Germany,4017,1928,2089
1995,496,Mongolia,Germany,54,32,22
1995,410,Republic of Korea,Germany,799,523,276
1995,116,Cambodia,Germany,47,28,19
1995,608,Philippines,Germany,947,680,267
1995,764,Thailand,Germany,2303,1948,355
1995,28,Antigua and Barbuda,Germany,57,28,29
1995,44,Bahamas,Germany,190,100,90
1995,92,British Virgin Islands,Germany,35,16,19
1995,136,Cayman Islands,Germany,81,55,26
1995,192,Cuba,Germany,570,282,288
1995,212,Dominica,Germany,14,5,9
1995,214,Dominican Republic,Germany,5647,3368,2279
1995,312,Guadeloupe,Germany,167,81,86
1995,332,Haiti,Germany,851,507,344
1995,630,Puerto Rico,Germany,1662,789,873
1995,662,Saint Lucia,Germany,41,16,25
1995,780,Trinidad and Tobago,Germany,124,60,64
1995,84,Belize,Germany,47,30,17
1995,188,Costa Rica,Germany,1077,637,440
1995,222,El Salvador,Germany,347,207,140
1995,320,Guatemala,Germany,440,185,255
1995,340,Honduras,Germany,221,145,76
1995,484,Mexico,Germany,4988,2667,2321
1995,558,Nicaragua,Germany,297,165,132
1995,591,Panama,Germany,344,213,131
1995,32,Argentina,Germany,12672,5865,6807
1995,68,Bolivia (Plurinational State of),Germany,1524,813,711
1995,76,Brazil,Germany,22641,11628,11013
1995,152,Chile,Germany,5371,2656,2715
1995,170,Colombia,Germany,2455,1359,1096
1995,218,Ecuador,Germany,1612,827,785
1995,600,Paraguay,Germany,1994,1152,842
1995,604,Peru,Germany,1826,923,903
1995,858,Uruguay,Germany,2205,1001,1204
1995,862,Venezuela (Bolivarian Republic of),Germany,4432,2393,2039
1995,36,Australia,Germany,125092,61259,63833
1995,554,New Zealand,Germany,6879,3271,3608
1995,258,French Polynesia,Germany,350,243,107
1995,882,Samoa,Germany,45,27,18
1995,112,Belarus,Germany,50,29,21
1995,100,Bulgaria,Germany,625,318,307
1995,203,Czechia,Germany,3563,1833,1730
1995,348,Hungary,Germany,19850,9154,10696
1995,616,Poland,Germany,123377,53759,69618
1995,498,Republic of Moldova,Germany,2308,1171,1137
1995,642,Romania,Germany,2033,956,1077
1995,643,Russian Federation,Germany,149872,74550,75322
1995,703,Slovakia,Germany,1460,906,554
1995,804,Ukraine,Germany,1265,661,604
1995,208,Denmark,Germany,25297,11440,13857
1995,233,Estonia,Germany,716,360,356
1995,234,Faroe Islands,Germany,17,8,9
1995,246,Finland,Germany,2800,1714,1086
1995,352,Iceland,Germany,922,301,621
1995,372,Ireland,Germany,4291,2057,2234
1995,428,Latvia,Germany,3084,1855,1229
1995,440,Lithuania,Germany,2049,1094,955
1995,578,Norway,Germany,9318,4178,5140
1995,752,Sweden,Germany,35578,15947,19631
1995,826,United Kingdom,Germany,233229,96500,136729
1995,20,Andorra,Germany,351,186,165
1995,70,Bosnia and Herzegovina,Germany,812,374,438
1995,191,Croatia,Germany,6825,2800,4025
1995,300,Greece,Germany,63007,29130,33877
1995,380,Italy,Germany,75903,22011,53892
1995,470,Malta,Germany,378,153,225
1995,807,North Macedonia,Germany,40,17,23
1995,620,Portugal,Germany,19705,9622,10083
1995,688,Serbia,Germany,502,260,242
1995,705,Slovenia,Germany,6970,3352,3618
1995,724,Spain,Germany,100172,48525,51647
1995,40,Austria,Germany,113756,46527,67229
1995,56,Belgium,Germany,65226,34230,30996
1995,250,France,Germany,177141,67438,109703
1995,438,Liechtenstein,Germany,1244,643,601
1995,442,Luxembourg,Germany,10558,4290,6268
1995,528,Netherlands,Germany,123377,50299,73078
1995,756,Switzerland,Germany,201043,99941,101102
1995,60,Bermuda,Germany,231,125,106
1995,124,Canada,Germany,172549,83607,88942
1995,304,Greenland,Germany,34,28,6
1995,840,United States of America,Germany,718811,352821,365990
2000,480,Mauritius,Germany,124,61,63
2000,690,Seychelles,Germany,57,30,27
2000,800,Uganda,Germany,214,112,102
2000,834,United Republic of Tanzania,Germany,810,466,344
2000,894,Zambia,Germany,157,88,69
2000,178,Congo,Germany,288,118,170
2000,266,Gabon,Germany,46,26,20
2000,72,Botswana,Germany,341,187,154
2000,516,Namibia,Germany,11896,5066,6830
2000,710,South Africa,Germany,23826,12163,11663
2000,132,Cabo Verde,Germany,41,23,18
2000,430,Liberia,Germany,890,437,453
2000,686,Senegal,Germany,682,322,360
2000,694,Sierra Leone,Germany,127,66,61
2000,768,Togo,Germany,101,43,58
2000,12,Algeria,Germany,778,281,497
2000,818,Egypt,Germany,5649,2946,2703
2000,434,Libya,Germany,5172,2623,2549
2000,504,Morocco,Germany,952,489,463
2000,788,Tunisia,Germany,1038,528,510
2000,51,Armenia,Germany,766,353,413
2000,31,Azerbaijan,Germany,344,147,197
2000,196,Cyprus,Germany,1181,497,684
2000,268,Georgia,Germany,607,273,334
2000,376,Israel,Germany,26847,11670,15177
2000,400,Jordan,Germany,869,457,412
2000,422,Lebanon,Germany,395,189,206
2000,792,Turkey,Germany,254815,124254,130561
2000,417,Kyrgyzstan,Germany,5589,2387,3202
2000,762,Tajikistan,Germany,143,79,64
2000,795,Turkmenistan,Germany,1037,429,608
2000,860,Uzbekistan,Germany,9353,4071,5282
2000,64,Bhutan,Germany,17,10,7
2000,356,India,Germany,2626,938,1688
2000,462,Maldives,Germany,162,89,73
2000,144,Sri Lanka,Germany,147,103,44
2000,344,"China, Hong Kong SAR",Germany,1629,1214,415
2000,392,Japan,Germany,4295,1984,2311
2000,496,Mongolia,Germany,60,36,24
2000,410,Republic of Korea,Germany,1208,820,388
2000,116,Cambodia,Germany,76,46,30
2000,608,Philippines,Germany,1638,1017,621
2000,764,Thailand,Germany,2531,2130,401
2000,28,Antigua and Barbuda,Germany,68,33,35
2000,44,Bahamas,Germany,220,122,98
2000,92,British Virgin Islands,Germany,40,18,22
2000,136,Cayman Islands,Germany,140,94,46
2000,192,Cuba,Germany,388,177,211
2000,212,Dominica,Germany,17,6,11
2000,214,Dominican Republic,Germany,6209,3655,2554
2000,312,Guadeloupe,Germany,209,103,106
2000,332,Haiti,Germany,808,482,326
2000,630,Puerto Rico,Germany,1097,521,576
2000,662,Saint Lucia,Germany,57,22,35
2000,780,Trinidad and Tobago,Germany,135,65,70
2000,84,Belize,Germany,48,30,18
2000,188,Costa Rica,Germany,1424,827,597
2000,222,El Salvador,Germany,229,134,95
2000,320,Guatemala,Germany,404,215,189
2000,340,Honduras,Germany,218,141,77
2000,484,Mexico,Germany,5632,3142,2490
2000,558,Nicaragua,Germany,275,163,112
2000,591,Panama,Germany,426,263,163
2000,32,Argentina,Germany,9671,4390,5281
2000,68,Bolivia (Plurinational State of),Germany,1682,891,791
2000,76,Brazil,Germany,19603,10182,9421
2000,152,Chile,Germany,5359,2635,2724
2000,170,Colombia,Germany,2230,1245,985
2000,218,Ecuador,Germany,1827,911,916
2000,600,Paraguay,Germany,1874,1084,790
2000,604,Peru,Germany,2134,1066,1068
2000,858,Uruguay,Germany,1563,718,845
2000,862,Venezuela (Bolivarian Republic of),Germany,3977,2164,1813
2000,36,Australia,Germany,119040,58057,60983
2000,554,New Zealand,Germany,8152,3963,4189
2000,258,French Polynesia,Germany,375,258,117
2000,882,Samoa,Germany,55,33,22
2000,112,Belarus,Germany,68,37,31
2000,100,Bulgaria,Germany,998,523,475
2000,203,Czechia,Germany,4750,2476,2274
2000,348,Hungary,Germany,21290,10129,11161
2000,616,Poland,Germany,105540,45078,60462
2000,498,Republic of Moldova,Germany,1558,770,788
2000,642,Romania,Germany,2299,1187,1112
2000,643,Russian Federation,Germany,149414,75322,74092
2000,703,Slovakia,Germany,3067,1938,1129
2000,804,Ukraine,Germany,1239,665,574
2000,208,Denmark,Germany,28060,13145,14915
2000,233,Estonia,Germany,970,489,481
2000,234,Faroe Islands,Germany,16,9,7
2000,246,Finland,Germany,3013,1893,1120
2000,352,Iceland,Germany,1040,350,690
2000,372,Ireland,Germany,7601,3771,3830
2000,428,Latvia,Germany,4256,2879,1377
2000,440,Lithuania,Germany,1605,856,749
2000,578,Norway,Germany,11445,5394,6051
2000,752,Sweden,Germany,38155,16965,21190
2000,826,United Kingdom,Germany,257322,107160,150162
2000,20,Andorra,Germany,355,186,169
2000,70,Bosnia and Herzegovina,Germany,807,372,435
2000,191,Croatia,Germany,7773,3212,4561
2000,300,Greece,Germany,100521,46488,54033
2000,380,Italy,Germany,55640,17177,38463
2000,470,Malta,Germany,578,247,331
2000,807,North Macedonia,Germany,38,16,22
2000,620,Portugal,Germany,24141,11799,12342
2000,688,Serbia,Germany,6826,3454,3372
2000,705,Slovenia,Germany,12368,6025,6343
2000,724,Spain,Germany,160472,79608,80864
2000,40,Austria,Germany,126680,52805,73875
2000,56,Belgium,Germany,72016,36970,35046
2000,250,France,Germany,182688,67791,114897
2000,438,Liechtenstein,Germany,1489,744,745
2000,442,Luxembourg,Germany,8612,3890,4722
2000,528,Netherlands,Germany,123252,48843,74409
2000,756,Switzerland,Germany,241379,130442,110937
2000,60,Bermuda,Germany,234,132,102
2000,124,Canada,Germany,175979,84894,91085
2000,304,Greenland,Germany,41,30,11
2000,840,United States of America,Germany,724649,357323,367326
2005,480,Mauritius,Germany,118,57,61
2005,690,Seychelles,Germany,66,30,36
2005,800,Uganda,Germany,207,107,100
2005,834,United Republic of Tanzania,Germany,901,519,382
2005,894,Zambia,Germany,209,118,91
2005,120,Cameroon,Germany,296,150,146
2005,178,Congo,Germany,183,100,83
2005,266,Gabon,Germany,50,29,21
2005,72,Botswana,Germany,653,354,299
2005,516,Namibia,Germany,9406,3973,5433
2005,710,South Africa,Germany,31347,15330,16017
2005,132,Cabo Verde,Germany,53,29,24
2005,430,Liberia,Germany,404,258,146
2005,686,Senegal,Germany,733,361,372
2005,694,Sierra Leone,Germany,46,34,12
2005,768,Togo,Germany,117,50,67
2005,12,Algeria,Germany,614,222,392
2005,818,Egypt,Germany,6725,3706,3019
2005,434,Libya,Germany,5699,3392,2307
2005,504,Morocco,Germany,977,495,482
2005,788,Tunisia,Germany,992,509,483
2005,51,Armenia,Germany,507,243,264
2005,31,Azerbaijan,Germany,327,134,193
2005,196,Cyprus,Germany,1729,721,1008
2005,268,Georgia,Germany,576,259,317
2005,376,Israel,Germany,24742,10757,13985
2005,400,Jordan,Germany,1255,733,522
2005,422,Lebanon,Germany,309,154,155
2005,792,Turkey,Germany,262587,125002,137585
2005,417,Kyrgyzstan,Germany,3864,1644,2220
2005,762,Tajikistan,Germany,137,76,61
2005,795,Turkmenistan,Germany,1028,432,596
2005,860,Uzbekistan,Germany,9362,4206,5156
2005,64,Bhutan,Germany,21,12,9
2005,356,India,Germany,2427,864,1563
2005,462,Maldives,Germany,176,103,73
2005,144,Sri Lanka,Germany,278,152,126
2005,344,"China, Hong Kong SAR",Germany,1778,1302,476
2005,392,Japan,Germany,5632,2565,3067
2005,496,Mongolia,Germany,98,61,37
2005,410,Republic of Korea,Germany,1106,829,277
2005,116,Cambodia,Germany,59,36,23
2005,608,Philippines,Germany,1325,831,494
2005,764,Thailand,Germany,2247,1843,404
2005,28,Antigua and Barbuda,Germany,73,35,38
2005,44,Bahamas,Germany,244,126,118
2005,92,British Virgin Islands,Germany,46,21,25
2005,136,Cayman Islands,Germany,127,85,42
2005,192,Cuba,Germany,259,118,141
2005,212,Dominica,Germany,21,8,13
2005,214,Dominican Republic,Germany,3905,2359,1546
2005,312,Guadeloupe,Germany,256,120,136
2005,332,Haiti,Germany,767,458,309
2005,630,Puerto Rico,Germany,860,409,451
2005,662,Saint Lucia,Germany,57,22,35
2005,780,Trinidad and Tobago,Germany,144,69,75
2005,84,Belize,Germany,53,33,20
2005,188,Costa Rica,Germany,933,537,396
2005,222,El Salvador,Germany,224,129,95
2005,320,Guatemala,Germany,480,284,196
2005,340,Honduras,Germany,213,138,75
2005,484,Mexico,Germany,5985,3374,2611
2005,558,Nicaragua,Germany,261,165,96
2005,591,Panama,Germany,650,386,264
2005,32,Argentina,Germany,8840,4056,4784
2005,68,Bolivia (Plurinational State of),Germany,1711,879,832
2005,76,Brazil,Germany,17981,9862,8119
2005,152,Chile,Germany,8044,4021,4023
2005,170,Colombia,Germany,2040,1151,889
2005,218,Ecuador,Germany,2156,1098,1058
2005,600,Paraguay,Germany,1785,1033,752
2005,604,Peru,Germany,2507,1282,1225
2005,858,Uruguay,Germany,1447,665,782
2005,862,Venezuela (Bolivarian Republic of),Germany,4016,2169,1847
2005,36,Australia,Germany,123010,59472,63538
2005,554,New Zealand,Germany,10291,4995,5296
2005,258,French Polynesia,Germany,392,271,121
2005,882,Samoa,Germany,51,31,20
2005,112,Belarus,Germany,65,35,30
2005,100,Bulgaria,Germany,1529,828,701
2005,203,Czechia,Germany,8294,5890,2404
2005,348,Hungary,Germany,26297,12756,13541
2005,616,Poland,Germany,90919,39612,51307
2005,498,Republic of Moldova,Germany,1076,521,555
2005,642,Romania,Germany,2580,1350,1230
2005,643,Russian Federation,Germany,145892,72930,72962
2005,703,Slovakia,Germany,3439,2194,1245
2005,804,Ukraine,Germany,1132,609,523
2005,208,Denmark,Germany,31751,15275,16476
2005,233,Estonia,Germany,1174,618,556
2005,234,Faroe Islands,Germany,20,12,8
2005,246,Finland,Germany,4605,2721,1884
2005,352,Iceland,Germany,1387,518,869
2005,372,Ireland,Germany,11805,5449,6356
2005,428,Latvia,Germany,3723,2245,1478
2005,440,Lithuania,Germany,1819,990,829
2005,578,Norway,Germany,14134,6924,7210
2005,752,Sweden,Germany,41584,19032,22552
2005,826,United Kingdom,Germany,261429,109499,151930
2005,20,Andorra,Germany,401,212,189
2005,70,Bosnia and Herzegovina,Germany,530,246,284
2005,191,Croatia,Germany,20667,10032,10635
2005,300,Greece,Germany,108685,50099,58586
2005,380,Italy,Germany,137808,56970,80838
2005,470,Malta,Germany,756,334,422
2005,807,North Macedonia,Germany,38,16,22
2005,620,Portugal,Germany,26104,12820,13284
2005,688,Serbia,Germany,16834,8524,8310
2005,705,Slovenia,Germany,11925,5807,6118
2005,724,Spain,Germany,180349,89215,91134
2005,40,Austria,Germany,158975,69823,89152
2005,56,Belgium,Germany,75018,37535,37483
2005,250,France,Germany,222726,94115,128611
2005,438,Liechtenstein,Germany,1560,757,803
2005,442,Luxembourg,Germany,8886,4011,4875
2005,528,Netherlands,Germany,117599,47934,69665
2005,756,Switzerland,Germany,272280,141271,131009
2005,60,Bermuda,Germany,240,132,108
2005,124,Canada,Germany,166471,80120,86351
2005,304,Greenland,Germany,61,47,14
2005,840,United States of America,Germany,682498,338451,344047
2010,480,Mauritius,Germany,119,59,60
2010,690,Seychelles,Germany,76,31,45
2010,800,Uganda,Germany,208,107,101
2010,834,United Republic of Tanzania,Germany,924,532,392
2010,894,Zambia,Germany,279,151,128
2010,120,Cameroon,Germany,236,125,111
2010,178,Congo,Germany,436,212,224
2010,266,Gabon,Germany,57,33,24
2010,72,Botswana,Germany,290,130,160
2010,516,Namibia,Germany,9063,3839,5224
2010,710,South Africa,Germany,49105,23920,25185
2010,132,Cabo Verde,Germany,65,35,30
2010,430,Liberia,Germany,186,81,105
2010,686,Senegal,Germany,821,423,398
2010,694,Sierra Leone,Germany,40,28,12
2010,768,Togo,Germany,172,81,91
2010,12,Algeria,Germany,674,225,449
2010,818,Egypt,Germany,7258,3876,3382
2010,434,Libya,Germany,6235,3740,2495
2010,504,Morocco,Germany,1093,551,542
2010,788,Tunisia,Germany,1121,577,544
2010,51,Armenia,Germany,422,210,212
2010,31,Azerbaijan,Germany,299,129,170
2010,196,Cyprus,Germany,2831,1201,1630
2010,268,Georgia,Germany,581,261,320
2010,376,Israel,Germany,22937,9946,12991
2010,400,Jordan,Germany,1614,981,633
2010,422,Lebanon,Germany,223,120,103
2010,792,Turkey,Germany,270596,125609,144987
2010,417,Kyrgyzstan,Germany,2066,864,1202
2010,762,Tajikistan,Germany,136,76,60
2010,795,Turkmenistan,Germany,997,397,600
2010,860,Uzbekistan,Germany,8998,4174,4824
2010,64,Bhutan,Germany,25,14,11
2010,356,India,Germany,2227,789,1438
2010,462,Maldives,Germany,213,161,52
2010,144,Sri Lanka,Germany,547,302,245
2010,344,"China, Hong Kong SAR",Germany,1932,1394,538
2010,392,Japan,Germany,5971,2684,3287
2010,496,Mongolia,Germany,148,97,51
2010,410,Republic of Korea,Germany,1442,1148,294
2010,116,Cambodia,Germany,42,26,16
2010,608,Philippines,Germany,3727,2281,1446
2010,764,Thailand,Germany,2126,1698,428
2010,28,Antigua and Barbuda,Germany,78,38,40
2010,44,Bahamas,Germany,267,130,137
2010,92,British Virgin Islands,Germany,52,24,28
2010,136,Cayman Islands,Germany,126,85,41
2010,192,Cuba,Germany,144,66,78
2010,531,Curaçao,Germany,115,59,56
2010,212,Dominica,Germany,26,11,15
2010,214,Dominican Republic,Germany,1574,1047,527
2010,312,Guadeloupe,Germany,303,138,165
2010,332,Haiti,Germany,805,481,324
2010,630,Puerto Rico,Germany,515,242,273
2010,662,Saint Lucia,Germany,53,20,33
2010,780,Trinidad and Tobago,Germany,245,124,121
2010,84,Belize,Germany,58,37,21
2010,188,Costa Rica,Germany,1838,1059,779
2010,222,El Salvador,Germany,218,123,95
2010,320,Guatemala,Germany,556,354,202
2010,340,Honduras,Germany,208,136,72
2010,484,Mexico,Germany,7033,4001,3032
2010,558,Nicaragua,Germany,279,178,101
2010,591,Panama,Germany,906,532,374
2010,32,Argentina,Germany,8009,3723,4286
2010,68,Bolivia (Plurinational State of),Germany,1737,865,872
2010,76,Brazil,Germany,16101,9391,6710
2010,152,Chile,Germany,10727,5406,5321
2010,170,Colombia,Germany,2204,1270,934
2010,218,Ecuador,Germany,3029,1505,1524
2010,600,Paraguay,Germany,1700,982,718
2010,604,Peru,Germany,3268,1739,1529
2010,858,Uruguay,Germany,1341,610,731
2010,862,Venezuela (Bolivarian Republic of),Germany,4098,2198,1900
2010,36,Australia,Germany,126260,60397,65863
2010,554,New Zealand,Germany,11964,5797,6167
2010,258,French Polynesia,Germany,379,265,114
2010,882,Samoa,Germany,45,27,18
2010,112,Belarus,Germany,62,33,29
2010,100,Bulgaria,Germany,1996,1098,898
2010,203,Czechia,Germany,11052,8842,2210
2010,348,Hungary,Germany,31303,15383,15920
2010,616,Poland,Germany,79149,35050,44099
2010,498,Republic of Moldova,Germany,835,409,426
2010,642,Romania,Germany,3208,1692,1516
2010,643,Russian Federation,Germany,139367,69080,70287
2010,703,Slovakia,Germany,3856,2479,1377
2010,804,Ukraine,Germany,1080,582,498
2010,208,Denmark,Germany,34817,17109,17708
2010,233,Estonia,Germany,1369,740,629
2010,234,Faroe Islands,Germany,20,10,10
2010,246,Finland,Germany,7501,4095,3406
2010,352,Iceland,Germany,1731,686,1045
2010,372,Ireland,Germany,14065,5424,8641
2010,428,Latvia,Germany,3097,1533,1564
2010,440,Lithuania,Germany,1786,946,840
2010,578,Norway,Germany,24853,13251,11602
2010,752,Sweden,Germany,48158,22567,25591
2010,826,United Kingdom,Germany,298299,124672,173627
2010,20,Andorra,Germany,392,207,185
2010,70,Bosnia and Herzegovina,Germany,558,265,293
2010,191,Croatia,Germany,33561,16852,16709
2010,300,Greece,Germany,121579,55909,65670
2010,380,Italy,Germany,222661,96804,125857
2010,470,Malta,Germany,804,380,424
2010,499,Montenegro,Germany,1785,562,1223
2010,807,North Macedonia,Germany,39,16,23
2010,620,Portugal,Germany,23733,11742,11991
2010,688,Serbia,Germany,16455,8197,8258
2010,705,Slovenia,Germany,12284,6099,6185
2010,724,Spain,Germany,212883,105477,107406
2010,40,Austria,Germany,191269,86840,104429
2010,56,Belgium,Germany,84065,37749,46316
2010,250,France,Germany,219388,78312,141076
2010,438,Liechtenstein,Germany,1635,776,859
2010,442,Luxembourg,Germany,9259,4176,5083
2010,528,Netherlands,Germany,120786,49691,71095
2010,756,Switzerland,Germany,318895,156073,162822
2010,60,Bermuda,Germany,246,132,114
2010,124,Canada,Germany,152345,73354,78991
2010,304,Greenland,Germany,74,60,14
2010,840,United States of America,Germany,660214,322822,337392
2015,480,Mauritius,Germany,136,71,65
2015,690,Seychelles,Germany,85,38,47
2015,800,Uganda,Germany,209,107,102
2015,834,United Republic of Tanzania,Germany,967,473,494
2015,894,Zambia,Germany,245,132,113
2015,120,Cameroon,Germany,300,140,160
2015,178,Congo,Germany,579,269,310
2015,266,Gabon,Germany,80,51,29
2015,72,Botswana,Germany,316,142,174
2015,516,Namibia,Germany,8870,3771,5099
2015,710,South Africa,Germany,88577,40835,47742
2015,132,Cabo Verde,Germany,67,36,31
2015,324,Guinea,Germany,27,18,9
2015,430,Liberia,Germany,213,92,121
2015,686,Senegal,Germany,876,451,425
2015,694,Sierra Leone,Germany,36,23,13
2015,768,Togo,Germany,200,94,106
2015,12,Algeria,Germany,743,247,496
2015,818,Egypt,Germany,5381,3199,2182
2015,434,Libya,Germany,7029,4178,2851
2015,504,Morocco,Germany,1424,715,709
2015,788,Tunisia,Germany,1448,748,700
2015,51,Armenia,Germany,635,316,319
2015,31,Azerbaijan,Germany,285,126,159
2015,196,Cyprus,Germany,2719,1164,1555
2015,268,Georgia,Germany,610,275,335
2015,376,Israel,Germany,23656,10193,13463
2015,400,Jordan,Germany,694,361,333
2015,422,Lebanon,Germany,188,90,98
2015,792,Turkey,Germany,274691,104181,170510
2015,417,Kyrgyzstan,Germany,1820,755,1065
2015,762,Tajikistan,Germany,133,74,59
2015,795,Turkmenistan,Germany,1038,432,606
2015,860,Uzbekistan,Germany,8610,4069,4541
2015,64,Bhutan,Germany,27,15,12
2015,356,India,Germany,2145,759,1386
2015,462,Maldives,Germany,250,219,31
2015,144,Sri Lanka,Germany,557,304,253
2015,344,"China, Hong Kong SAR",Germany,1973,1402,571
2015,392,Japan,Germany,6336,2826,3510
2015,496,Mongolia,Germany,183,103,80
2015,410,Republic of Korea,Germany,1791,1418,373
2015,116,Cambodia,Germany,38,24,14
2015,608,Philippines,Germany,3786,2319,1467
2015,764,Thailand,Germany,2299,1835,464
2015,28,Antigua and Barbuda,Germany,83,40,43
2015,44,Bahamas,Germany,289,139,150
2015,92,British Virgin Islands,Germany,58,27,31
2015,136,Cayman Islands,Germany,136,92,44
2015,192,Cuba,Germany,115,52,63
2015,531,Curaçao,Germany,124,64,60
2015,212,Dominica,Germany,30,13,17
2015,214,Dominican Republic,Germany,1857,1170,687
2015,312,Guadeloupe,Germany,314,141,173
2015,332,Haiti,Germany,845,505,340
2015,630,Puerto Rico,Germany,504,236,268
2015,662,Saint Lucia,Germany,50,19,31
2015,780,Trinidad and Tobago,Germany,253,130,123
2015,84,Belize,Germany,68,44,24
2015,188,Costa Rica,Germany,1866,1071,795
2015,222,El Salvador,Germany,227,128,99
2015,320,Guatemala,Germany,640,411,229
2015,340,Honduras,Germany,292,192,100
2015,484,Mexico,Germany,6728,3524,3204
2015,558,Nicaragua,Germany,300,192,108
2015,591,Panama,Germany,1065,625,440
2015,32,Argentina,Germany,9242,4293,4949
2015,68,Bolivia (Plurinational State of),Germany,2022,1007,1015
2015,76,Brazil,Germany,19389,11246,8143
2015,152,Chile,Germany,16250,8015,8235
2015,170,Colombia,Germany,2467,1432,1035
2015,218,Ecuador,Germany,4405,2173,2232
2015,600,Paraguay,Germany,1659,958,701
2015,604,Peru,Germany,5215,2925,2290
2015,858,Uruguay,Germany,1384,629,755
2015,862,Venezuela (Bolivarian Republic of),Germany,4211,2232,1979
2015,36,Australia,Germany,119100,57076,62024
2015,554,New Zealand,Germany,13447,6503,6944
2015,258,French Polynesia,Germany,360,252,108
2015,882,Samoa,Germany,37,22,15
2015,112,Belarus,Germany,66,35,31
2015,100,Bulgaria,Germany,5533,3025,2508
2015,203,Czechia,Germany,15567,12755,2812
2015,348,Hungary,Germany,30178,15883,14295
2015,616,Poland,Germany,76313,34597,41716
2015,498,Republic of Moldova,Germany,714,353,361
2015,642,Romania,Germany,6552,3558,2994
2015,643,Russian Federation,Germany,142026,70040,71986
2015,703,Slovakia,Germany,4817,3208,1609
2015,804,Ukraine,Germany,1083,585,498
2015,208,Denmark,Germany,38443,18911,19532
2015,233,Estonia,Germany,1823,970,853
2015,234,Faroe Islands,Germany,22,13,9
2015,246,Finland,Germany,8045,4334,3711
2015,352,Iceland,Germany,1649,635,1014
2015,372,Ireland,Germany,14368,5432,8936
2015,428,Latvia,Germany,2424,1160,1264
2015,440,Lithuania,Germany,1628,842,786
2015,578,Norway,Germany,28318,15016,13302
2015,752,Sweden,Germany,49586,23412,26174
2015,826,United Kingdom,Germany,306123,137112,169011
2015,20,Andorra,Germany,339,182,157
2015,70,Bosnia and Herzegovina,Germany,554,263,291
2015,191,Croatia,Germany,33774,16910,16864
2015,300,Greece,Germany,114110,49846,64264
2015,380,Italy,Germany,214330,93095,121235
2015,470,Malta,Germany,1363,692,671
2015,499,Montenegro,Germany,1876,598,1278
2015,807,North Macedonia,Germany,42,18,24
2015,620,Portugal,Germany,26905,12612,14293
2015,688,Serbia,Germany,16083,8019,8064
2015,705,Slovenia,Germany,7586,3842,3744
2015,724,Spain,Germany,200641,98763,101878
2015,40,Austria,Germany,223705,102235,121470
2015,56,Belgium,Germany,81532,36932,44600
2015,250,France,Germany,208540,89234,119306
2015,438,Liechtenstein,Germany,1787,855,932
2015,442,Luxembourg,Germany,14125,6490,7635
2015,528,Netherlands,Germany,123273,51471,71802
2015,756,Switzerland,Germany,352966,175531,177435
2015,60,Bermuda,Germany,249,134,115
2015,124,Canada,Germany,144950,69064,75886
2015,304,Greenland,Germany,55,43,12
2015,840,United States of America,Germany,585298,283924,301374
2019,480,Mauritius,Germany,137,72,65
2019,690,Seychelles,Germany,85,38,47
2019,800,Uganda,Germany,209,107,102
2019,834,United Republic of Tanzania,Germany,867,422,445
2019,894,Zambia,Germany,315,170,145
2019,120,Cameroon,Germany,298,139,159
2019,178,Congo,Germany,596,277,319
2019,266,Gabon,Germany,86,55,31
2019,72,Botswana,Germany,338,152,186
2019,516,Namibia,Germany,9388,3991,5397
2019,710,South Africa,Germany,99284,45823,53461
2019,132,Cabo Verde,Germany,70,38,32
2019,324,Guinea,Germany,25,17,8
2019,430,Liberia,Germany,176,76,100
2019,686,Senegal,Germany,905,466,439
2019,694,Sierra Leone,Germany,34,21,13
2019,768,Togo,Germany,201,95,106
2019,12,Algeria,Germany,772,257,515
2019,818,Egypt,Germany,7669,4192,3477
2019,434,Libya,Germany,7458,4433,3025
2019,504,Morocco,Germany,1518,762,756
2019,788,Tunisia,Germany,1471,760,711
2019,51,Armenia,Germany,631,317,314
2019,31,Azerbaijan,Germany,273,121,152
2019,196,Cyprus,Germany,2717,1179,1538
2019,268,Georgia,Germany,628,283,345
2019,376,Israel,Germany,23004,9912,13092
2019,400,Jordan,Germany,746,388,358
2019,422,Lebanon,Germany,177,85,92
2019,792,Turkey,Germany,371430,143162,228268
2019,417,Kyrgyzstan,Germany,1783,740,1043
2019,762,Tajikistan,Germany,132,74,58
2019,795,Turkmenistan,Germany,1031,437,594
2019,860,Uzbekistan,Germany,8591,4064,4527
2019,64,Bhutan,Germany,28,16,12
2019,356,India,Germany,2109,746,1363
2019,462,Maldives,Germany,269,236,33
2019,144,Sri Lanka,Germany,561,307,254
2019,344,"China, Hong Kong SAR",Germany,2556,1794,762
2019,392,Japan,Germany,7102,3168,3934
2019,496,Mongolia,Germany,194,110,84
2019,410,Republic of Korea,Germany,1823,1444,379
2019,116,Cambodia,Germany,40,26,14
2019,608,Philippines,Germany,3905,2392,1513
2019,764,Thailand,Germany,2396,1913,483
2019,28,Antigua and Barbuda,Germany,86,42,44
2019,44,Bahamas,Germany,306,147,159
2019,92,British Virgin Islands,Germany,62,29,33
2019,136,Cayman Islands,Germany,151,103,48
2019,192,Cuba,Germany,105,47,58
2019,531,Curaçao,Germany,134,69,65
2019,212,Dominica,Germany,30,13,17
2019,214,Dominican Republic,Germany,1919,1210,709
2019,312,Guadeloupe,Germany,318,143,175
2019,332,Haiti,Germany,878,525,353
2019,630,Puerto Rico,Germany,479,224,255
2019,662,Saint Lucia,Germany,48,19,29
2019,780,Trinidad and Tobago,Germany,272,146,126
2019,84,Belize,Germany,74,48,26
2019,188,Costa Rica,Germany,1893,1092,801
2019,222,El Salvador,Germany,230,130,100
2019,320,Guatemala,Germany,656,421,235
2019,340,Honduras,Germany,296,195,101
2019,484,Mexico,Germany,6936,3633,3303
2019,558,Nicaragua,Germany,314,201,113
2019,591,Panama,Germany,1133,665,468
2019,32,Argentina,Germany,9404,4360,5044
2019,68,Bolivia (Plurinational State of),Germany,2207,1099,1108
2019,76,Brazil,Germany,21836,12666,9170
2019,152,Chile,Germany,21711,10096,11615
2019,170,Colombia,Germany,2523,1465,1058
2019,218,Ecuador,Germany,4336,2138,2198
2019,600,Paraguay,Germany,1702,983,719
2019,604,Peru,Germany,6216,3617,2599
2019,858,Uruguay,Germany,1431,653,778
2019,862,Venezuela (Bolivarian Republic of),Germany,4124,2177,1947
2019,36,Australia,Germany,122601,58484,64117
2019,554,New Zealand,Germany,13822,6685,7137
2019,258,French Polynesia,Germany,373,261,112
2019,882,Samoa,Germany,35,21,14
2019,112,Belarus,Germany,65,35,30
2019,100,Bulgaria,Germany,9334,5042,4292
2019,203,Czechia,Germany,16827,13780,3047
2019,348,Hungary,Germany,32278,16688,15590
2019,616,Poland,Germany,80820,38337,42483
2019,498,Republic of Moldova,Germany,702,348,354
2019,642,Romania,Germany,16581,9012,7569
2019,643,Russian Federation,Germany,141992,70023,71969
2019,703,Slovakia,Germany,5437,3614,1823
2019,804,Ukraine,Germany,1093,591,502
2019,208,Denmark,Germany,38375,18685,19690
2019,233,Estonia,Germany,1960,1034,926
2019,234,Faroe Islands,Germany,28,16,12
2019,246,Finland,Germany,8894,4791,4103
2019,352,Iceland,Germany,1979,813,1166
2019,372,Ireland,Germany,15774,5994,9780
2019,428,Latvia,Germany,1975,938,1037
2019,440,Lithuania,Germany,1606,830,776
2019,578,Norway,Germany,30341,15811,14530
2019,752,Sweden,Germany,52052,24647,27405
2019,826,United Kingdom,Germany,347634,156190,191444
2019,20,Andorra,Germany,361,195,166
2019,70,Bosnia and Herzegovina,Germany,513,244,269
2019,191,Croatia,Germany,31185,15568,15617
2019,300,Greece,Germany,111442,51059,60383
2019,380,Italy,Germany,218158,95755,122403
2019,470,Malta,Germany,2199,1124,1075
2019,499,Montenegro,Germany,1882,606,1276
2019,807,North Macedonia,Germany,42,18,24
2019,620,Portugal,Germany,27362,12858,14504
2019,688,Serbia,Germany,16339,8154,8185
2019,705,Slovenia,Germany,7361,3752,3609
2019,724,Spain,Germany,199117,96390,102727
2019,40,Austria,Germany,264081,123155,140926
2019,56,Belgium,Germany,85150,39154,45996
2019,250,France,Germany,220741,94167,126574
2019,438,Liechtenstein,Germany,1909,932,977
2019,442,Luxembourg,Germany,19057,8974,10083
2019,528,Netherlands,Germany,127373,54191,73182
2019,756,Switzerland,Germany,363037,180962,182075
2019,60,Bermuda,Germany,251,135,116
2019,124,Canada,Germany,155330,74010,81320
2019,304,Greenland,Germany,53,42,11
2019,840,United States of America,Germany,563411,272758,290653
1990,800,Uganda,Ghana,29,10,19
1990,894,Zambia,Ghana,484,340,144
1990,266,Gabon,Ghana,1968,1678,290
1990,426,Lesotho,Ghana,122,81,41
1990,516,Namibia,Ghana,212,124,88
1990,710,South Africa,Ghana,6486,3859,2627
1990,204,Benin,Ghana,2107,1097,1010
1990,854,Burkina Faso,Ghana,24542,8534,16008
1990,132,Cabo Verde,Ghana,55,26,29
1990,384,Côte d'Ivoire,Ghana,99487,39197,60290
1990,430,Liberia,Ghana,9952,5285,4667
1990,466,Mali,Ghana,1913,941,972
1990,478,Mauritania,Ghana,186,52,134
1990,562,Niger,Ghana,4184,1943,2241
1990,566,Nigeria,Ghana,75322,42256,33066
1990,686,Senegal,Ghana,1476,1144,332
1990,694,Sierra Leone,Ghana,1310,884,426
1990,768,Togo,Ghana,12685,5372,7313
1990,818,Egypt,Ghana,214,168,46
1990,434,Libya,Ghana,610,481,129
1990,196,Cyprus,Ghana,21,11,10
1990,400,Jordan,Ghana,44,29,15
1990,792,Turkey,Ghana,34,30,4
1990,392,Japan,Ghana,598,305,293
1990,608,Philippines,Ghana,8,7,1
1990,28,Antigua and Barbuda,Ghana,10,5,5
1990,44,Bahamas,Ghana,23,12,11
1990,662,Saint Lucia,Ghana,10,6,4
1990,188,Costa Rica,Ghana,1,1,0
1990,68,Bolivia (Plurinational State of),Ghana,1,1,0
1990,152,Chile,Ghana,5,3,2
1990,218,Ecuador,Ghana,13,9,4
1990,862,Venezuela (Bolivarian Republic of),Ghana,28,23,5
1990,36,Australia,Ghana,994,665,329
1990,100,Bulgaria,Ghana,4,3,1
1990,203,Czechia,Ghana,10,8,2
1990,348,Hungary,Ghana,44,37,7
1990,616,Poland,Ghana,65,46,19
1990,643,Russian Federation,Ghana,286,140,146
1990,703,Slovakia,Ghana,1,1,0
1990,208,Denmark,Ghana,391,275,116
1990,234,Faroe Islands,Ghana,1,1,0
1990,246,Finland,Ghana,74,57,17
1990,352,Iceland,Ghana,10,6,4
1990,372,Ireland,Ghana,97,45,52
1990,578,Norway,Ghana,736,554,182
1990,752,Sweden,Ghana,770,454,316
1990,826,United Kingdom,Ghana,31872,15509,16363
1990,300,Greece,Ghana,633,350,283
1990,380,Italy,Ghana,25093,14729,10364
1990,470,Malta,Ghana,6,5,1
1990,620,Portugal,Ghana,15,12,3
1990,688,Serbia,Ghana,3,2,1
1990,705,Slovenia,Ghana,5,3,2
1990,724,Spain,Ghana,436,304,132
1990,40,Austria,Ghana,1363,785,578
1990,56,Belgium,Ghana,2921,1520,1401
1990,250,France,Ghana,5576,2960,2616
1990,276,Germany,Ghana,20822,14758,6064
1990,528,Netherlands,Ghana,6020,3235,2785
1990,756,Switzerland,Ghana,1464,740,724
1990,60,Bermuda,Ghana,17,10,7
1990,124,Canada,Ghana,6404,3118,3286
1990,840,United States of America,Ghana,20889,13132,7757
1995,800,Uganda,Ghana,27,9,18
1995,894,Zambia,Ghana,283,199,84
1995,266,Gabon,Ghana,2631,2242,389
1995,426,Lesotho,Ghana,105,70,35
1995,516,Namibia,Ghana,202,119,83
1995,710,South Africa,Ghana,4046,2541,1505
1995,204,Benin,Ghana,2902,1528,1374
1995,854,Burkina Faso,Ghana,30522,10648,19874
1995,132,Cabo Verde,Ghana,74,36,38
1995,384,Côte d'Ivoire,Ghana,90436,35286,55150
1995,430,Liberia,Ghana,9723,5219,4504
1995,466,Mali,Ghana,2323,1216,1107
1995,478,Mauritania,Ghana,198,69,129
1995,562,Niger,Ghana,2881,1280,1601
1995,566,Nigeria,Ghana,81276,45306,35970
1995,686,Senegal,Ghana,1543,1194,349
1995,694,Sierra Leone,Ghana,1274,847,427
1995,768,Togo,Ghana,19575,7810,11765
1995,818,Egypt,Ghana,186,143,43
1995,434,Libya,Ghana,526,407,119
1995,196,Cyprus,Ghana,30,15,15
1995,400,Jordan,Ghana,39,26,13
1995,792,Turkey,Ghana,83,74,9
1995,392,Japan,Ghana,1187,570,617
1995,608,Philippines,Ghana,10,9,1
1995,28,Antigua and Barbuda,Ghana,18,9,9
1995,44,Bahamas,Ghana,44,24,20
1995,662,Saint Lucia,Ghana,13,8,5
1995,188,Costa Rica,Ghana,1,1,0
1995,68,Bolivia (Plurinational State of),Ghana,2,2,0
1995,152,Chile,Ghana,6,5,1
1995,218,Ecuador,Ghana,15,10,5
1995,862,Venezuela (Bolivarian Republic of),Ghana,27,22,5
1995,36,Australia,Ghana,1625,986,639
1995,100,Bulgaria,Ghana,5,3,2
1995,203,Czechia,Ghana,16,12,4
1995,348,Hungary,Ghana,65,47,18
1995,616,Poland,Ghana,55,39,16
1995,643,Russian Federation,Ghana,263,147,116
1995,703,Slovakia,Ghana,5,5,0
1995,208,Denmark,Ghana,678,429,249
1995,234,Faroe Islands,Ghana,1,1,0
1995,246,Finland,Ghana,161,125,36
1995,352,Iceland,Ghana,15,9,6
1995,372,Ireland,Ghana,268,117,151
1995,578,Norway,Ghana,1104,693,411
1995,752,Sweden,Ghana,914,537,377
1995,826,United Kingdom,Ghana,42703,20676,22027
1995,300,Greece,Ghana,514,316,198
1995,380,Italy,Ghana,29731,16817,12914
1995,470,Malta,Ghana,8,6,2
1995,620,Portugal,Ghana,33,26,7
1995,688,Serbia,Ghana,22,15,7
1995,705,Slovenia,Ghana,10,7,3
1995,724,Spain,Ghana,736,542,194
1995,40,Austria,Ghana,1538,897,641
1995,56,Belgium,Ghana,2903,1508,1395
1995,250,France,Ghana,5756,3010,2746
1995,276,Germany,Ghana,21454,13334,8120
1995,528,Netherlands,Ghana,8266,4360,3906
1995,756,Switzerland,Ghana,1683,882,801
1995,60,Bermuda,Ghana,32,18,14
1995,124,Canada,Ghana,11477,5550,5927
1995,840,United States of America,Ghana,43808,27742,16066
2000,894,Zambia,Ghana,166,117,49
2000,266,Gabon,Ghana,3291,2809,482
2000,426,Lesotho,Ghana,85,56,29
2000,516,Namibia,Ghana,189,110,79
2000,710,South Africa,Ghana,2797,1911,886
2000,204,Benin,Ghana,3698,1960,1738
2000,854,Burkina Faso,Ghana,29139,10358,18781
2000,132,Cabo Verde,Ghana,93,47,46
2000,384,Côte d'Ivoire,Ghana,94236,36735,57501
2000,430,Liberia,Ghana,9542,5161,4381
2000,466,Mali,Ghana,2388,1305,1083
2000,478,Mauritania,Ghana,204,85,119
2000,562,Niger,Ghana,1602,627,975
2000,566,Nigeria,Ghana,90479,50112,40367
2000,686,Senegal,Ghana,1395,1064,331
2000,694,Sierra Leone,Ghana,1242,814,428
2000,768,Togo,Ghana,26455,11717,14738
2000,818,Egypt,Ghana,172,128,44
2000,434,Libya,Ghana,452,343,109
2000,196,Cyprus,Ghana,38,19,19
2000,400,Jordan,Ghana,34,23,11
2000,792,Turkey,Ghana,134,118,16
2000,392,Japan,Ghana,1657,766,891
2000,608,Philippines,Ghana,11,11,0
2000,28,Antigua and Barbuda,Ghana,25,12,13
2000,44,Bahamas,Ghana,65,36,29
2000,662,Saint Lucia,Ghana,18,11,7
2000,188,Costa Rica,Ghana,1,1,0
2000,68,Bolivia (Plurinational State of),Ghana,2,2,0
2000,152,Chile,Ghana,7,5,2
2000,218,Ecuador,Ghana,16,11,5
2000,862,Venezuela (Bolivarian Republic of),Ghana,27,22,5
2000,36,Australia,Ghana,2160,1261,899
2000,100,Bulgaria,Ghana,6,3,3
2000,203,Czechia,Ghana,21,16,5
2000,348,Hungary,Ghana,85,56,29
2000,616,Poland,Ghana,48,34,14
2000,643,Russian Federation,Ghana,231,149,82
2000,703,Slovakia,Ghana,12,10,2
2000,208,Denmark,Ghana,965,584,381
2000,246,Finland,Ghana,248,193,55
2000,352,Iceland,Ghana,19,11,8
2000,372,Ireland,Ghana,587,267,320
2000,578,Norway,Ghana,1050,581,469
2000,752,Sweden,Ghana,981,573,408
2000,826,United Kingdom,Ghana,54254,26135,28119
2000,300,Greece,Ghana,403,283,120
2000,380,Italy,Ghana,34369,18906,15463
2000,470,Malta,Ghana,9,7,2
2000,620,Portugal,Ghana,53,41,12
2000,688,Serbia,Ghana,30,19,11
2000,705,Slovenia,Ghana,13,7,6
2000,724,Spain,Ghana,1354,1019,335
2000,40,Austria,Ghana,1712,1008,704
2000,56,Belgium,Ghana,2801,1458,1343
2000,250,France,Ghana,5936,3060,2876
2000,276,Germany,Ghana,22086,11911,10175
2000,528,Netherlands,Ghana,10792,5621,5171
2000,756,Switzerland,Ghana,1909,1030,879
2000,60,Bermuda,Ghana,46,26,20
2000,124,Canada,Ghana,16823,8115,8708
2000,840,United States of America,Ghana,67237,42709,24528
2005,894,Zambia,Ghana,170,120,50
2005,266,Gabon,Ghana,3589,3068,521
2005,426,Lesotho,Ghana,86,57,29
2005,516,Namibia,Ghana,149,87,62
2005,710,South Africa,Ghana,3686,2463,1223
2005,204,Benin,Ghana,7844,3507,4337
2005,854,Burkina Faso,Ghana,27293,9752,17541
2005,132,Cabo Verde,Ghana,67,33,34
2005,384,Côte d'Ivoire,Ghana,98654,38458,60196
2005,430,Liberia,Ghana,6646,4714,1932
2005,466,Mali,Ghana,9745,5185,4560
2005,478,Mauritania,Ghana,205,90,115
2005,562,Niger,Ghana,1631,638,993
2005,566,Nigeria,Ghana,179756,104666,75090
2005,686,Senegal,Ghana,1500,1157,343
2005,694,Sierra Leone,Ghana,1232,827,405
2005,768,Togo,Ghana,32848,15316,17532
2005,818,Egypt,Ghana,205,156,49
2005,434,Libya,Ghana,498,400,98
2005,196,Cyprus,Ghana,56,28,28
2005,400,Jordan,Ghana,48,35,13
2005,792,Turkey,Ghana,138,122,16
2005,392,Japan,Ghana,1776,809,967
2005,608,Philippines,Ghana,8,8,0
2005,28,Antigua and Barbuda,Ghana,27,13,14
2005,44,Bahamas,Ghana,55,36,19
2005,662,Saint Lucia,Ghana,19,12,7
2005,188,Costa Rica,Ghana,1,1,0
2005,68,Bolivia (Plurinational State of),Ghana,7,6,1
2005,76,Brazil,Ghana,30,21,9
2005,152,Chile,Ghana,10,8,2
2005,218,Ecuador,Ghana,19,13,6
2005,862,Venezuela (Bolivarian Republic of),Ghana,28,23,5
2005,36,Australia,Ghana,2820,1564,1256
2005,100,Bulgaria,Ghana,8,3,5
2005,203,Czechia,Ghana,70,57,13
2005,348,Hungary,Ghana,105,70,35
2005,616,Poland,Ghana,41,28,13
2005,643,Russian Federation,Ghana,273,200,73
2005,703,Slovakia,Ghana,14,11,3
2005,208,Denmark,Ghana,1324,764,560
2005,234,Faroe Islands,Ghana,5,1,4
2005,246,Finland,Ghana,605,438,167
2005,352,Iceland,Ghana,32,14,18
2005,372,Ireland,Ghana,588,286,302
2005,578,Norway,Ghana,1209,620,589
2005,752,Sweden,Ghana,1410,851,559
2005,826,United Kingdom,Ghana,70045,33484,36561
2005,300,Greece,Ghana,507,364,143
2005,380,Italy,Ghana,40455,23800,16655
2005,470,Malta,Ghana,13,10,3
2005,620,Portugal,Ghana,121,91,30
2005,688,Serbia,Ghana,30,19,11
2005,705,Slovenia,Ghana,17,10,7
2005,724,Spain,Ghana,9730,8504,1226
2005,40,Austria,Ghana,1914,1108,806
2005,56,Belgium,Ghana,4998,2546,2452
2005,250,France,Ghana,5389,2589,2800
2005,276,Germany,Ghana,23382,12112,11270
2005,528,Netherlands,Ghana,12168,6292,5876
2005,756,Switzerland,Ghana,2114,1091,1023
2005,60,Bermuda,Ghana,85,49,36
2005,124,Canada,Ghana,18533,9114,9419
2005,840,United States of America,Ghana,89959,57323,32636
2010,894,Zambia,Ghana,175,119,56
2010,266,Gabon,Ghana,4156,3564,592
2010,426,Lesotho,Ghana,87,58,29
2010,516,Namibia,Ghana,143,84,59
2010,710,South Africa,Ghana,5773,3851,1922
2010,204,Benin,Ghana,12065,5065,7000
2010,854,Burkina Faso,Ghana,30810,10915,19895
2010,132,Cabo Verde,Ghana,40,19,21
2010,384,Côte d'Ivoire,Ghana,103072,40155,62917
2010,430,Liberia,Ghana,7069,4109,2960
2010,466,Mali,Ghana,4095,2291,1804
2010,478,Mauritania,Ghana,206,93,113
2010,562,Niger,Ghana,1658,647,1011
2010,566,Nigeria,Ghana,183351,106759,76592
2010,686,Senegal,Ghana,1678,1310,368
2010,694,Sierra Leone,Ghana,1107,712,395
2010,768,Togo,Ghana,42991,18375,24616
2010,818,Egypt,Ghana,221,166,55
2010,434,Libya,Ghana,545,439,106
2010,196,Cyprus,Ghana,91,46,45
2010,400,Jordan,Ghana,61,45,16
2010,792,Turkey,Ghana,142,126,16
2010,392,Japan,Ghana,1883,847,1036
2010,608,Philippines,Ghana,34,34,0
2010,28,Antigua and Barbuda,Ghana,29,14,15
2010,44,Bahamas,Ghana,44,36,8
2010,662,Saint Lucia,Ghana,19,12,7
2010,188,Costa Rica,Ghana,1,1,0
2010,68,Bolivia (Plurinational State of),Ghana,12,10,2
2010,76,Brazil,Ghana,61,42,19
2010,152,Chile,Ghana,14,11,3
2010,218,Ecuador,Ghana,26,18,8
2010,862,Venezuela (Bolivarian Republic of),Ghana,31,25,6
2010,36,Australia,Ghana,4210,2274,1936
2010,100,Bulgaria,Ghana,10,4,6
2010,203,Czechia,Ghana,113,94,19
2010,348,Hungary,Ghana,124,83,41
2010,616,Poland,Ghana,37,24,13
2010,642,Romania,Ghana,2,2,0
2010,643,Russian Federation,Ghana,310,247,63
2010,703,Slovakia,Ghana,16,13,3
2010,208,Denmark,Ghana,1652,927,725
2010,233,Estonia,Ghana,6,4,2
2010,234,Faroe Islands,Ghana,16,4,12
2010,246,Finland,Ghana,1119,782,337
2010,352,Iceland,Ghana,44,17,27
2010,372,Ireland,Ghana,493,221,272
2010,578,Norway,Ghana,1539,823,716
2010,752,Sweden,Ghana,1927,1127,800
2010,826,United Kingdom,Ghana,97035,50995,46040
2010,300,Greece,Ghana,634,462,172
2010,380,Italy,Ghana,44622,27117,17505
2010,470,Malta,Ghana,55,49,6
2010,620,Portugal,Ghana,170,127,43
2010,688,Serbia,Ghana,30,19,11
2010,705,Slovenia,Ghana,19,11,8
2010,724,Spain,Ghana,14894,12520,2374
2010,40,Austria,Ghana,2115,1207,908
2010,56,Belgium,Ghana,6266,3254,3012
2010,250,France,Ghana,6287,3172,3115
2010,276,Germany,Ghana,24387,12228,12159
2010,528,Netherlands,Ghana,13222,6563,6659
2010,756,Switzerland,Ghana,2523,1232,1291
2010,60,Bermuda,Ghana,124,73,51
2010,124,Canada,Ghana,21260,10639,10621
2010,840,United States of America,Ghana,116035,69093,46942
2015,894,Zambia,Ghana,154,105,49
2015,266,Gabon,Ghana,5811,5099,712
2015,426,Lesotho,Ghana,89,60,29
2015,516,Namibia,Ghana,139,82,57
2015,710,South Africa,Ghana,10412,6769,3643
2015,204,Benin,Ghana,15076,6410,8666
2015,854,Burkina Faso,Ghana,32217,11414,20803
2015,132,Cabo Verde,Ghana,42,20,22
2015,384,Côte d'Ivoire,Ghana,107490,41876,65614
2015,324,Guinea,Ghana,588,479,109
2015,430,Liberia,Ghana,8113,4687,3426
2015,466,Mali,Ghana,5073,2838,2235
2015,478,Mauritania,Ghana,206,94,112
2015,562,Niger,Ghana,1680,654,1026
2015,566,Nigeria,Ghana,222377,122006,100371
2015,686,Senegal,Ghana,1790,1397,393
2015,694,Sierra Leone,Ghana,995,609,386
2015,768,Togo,Ghana,46794,19245,27549
2015,818,Egypt,Ghana,163,128,35
2015,434,Libya,Ghana,614,493,121
2015,196,Cyprus,Ghana,87,45,42
2015,400,Jordan,Ghana,26,18,8
2015,792,Turkey,Ghana,144,128,16
2015,392,Japan,Ghana,2005,895,1110
2015,608,Philippines,Ghana,34,34,0
2015,28,Antigua and Barbuda,Ghana,31,15,16
2015,44,Bahamas,Ghana,48,39,9
2015,662,Saint Lucia,Ghana,18,12,6
2015,188,Costa Rica,Ghana,1,1,0
2015,68,Bolivia (Plurinational State of),Ghana,14,12,2
2015,76,Brazil,Ghana,73,50,23
2015,152,Chile,Ghana,21,17,4
2015,218,Ecuador,Ghana,37,26,11
2015,862,Venezuela (Bolivarian Republic of),Ghana,33,27,6
2015,36,Australia,Ghana,5900,3264,2636
2015,100,Bulgaria,Ghana,16,8,8
2015,203,Czechia,Ghana,197,163,34
2015,348,Hungary,Ghana,124,81,43
2015,616,Poland,Ghana,35,23,12
2015,642,Romania,Ghana,57,40,17
2015,643,Russian Federation,Ghana,316,251,65
2015,703,Slovakia,Ghana,19,14,5
2015,208,Denmark,Ghana,1973,1140,833
2015,233,Estonia,Ghana,12,8,4
2015,234,Faroe Islands,Ghana,18,6,12
2015,246,Finland,Ghana,1724,1154,570
2015,352,Iceland,Ghana,62,32,30
2015,372,Ireland,Ghana,504,223,281
2015,578,Norway,Ghana,1900,1049,851
2015,752,Sweden,Ghana,2663,1541,1122
2015,826,United Kingdom,Ghana,124093,63469,60624
2015,300,Greece,Ghana,595,427,168
2015,380,Italy,Ghana,46258,28481,17777
2015,470,Malta,Ghana,93,83,10
2015,620,Portugal,Ghana,192,140,52
2015,688,Serbia,Ghana,29,19,10
2015,705,Slovenia,Ghana,38,21,17
2015,724,Spain,Ghana,12043,8985,3058
2015,40,Austria,Ghana,2474,1417,1057
2015,56,Belgium,Ghana,8956,4663,4293
2015,250,France,Ghana,6965,3420,3545
2015,276,Germany,Ghana,25409,12710,12699
2015,528,Netherlands,Ghana,14212,6915,7297
2015,756,Switzerland,Ghana,2687,1333,1354
2015,60,Bermuda,Ghana,125,74,51
2015,124,Canada,Ghana,22769,11424,11345
2015,840,United States of America,Ghana,161082,95582,65500
2019,894,Zambia,Ghana,198,136,62
2019,266,Gabon,Ghana,6314,5540,774
2019,426,Lesotho,Ghana,93,63,30
2019,516,Namibia,Ghana,147,87,60
2019,710,South Africa,Ghana,11669,7590,4079
2019,204,Benin,Ghana,16056,6842,9214
2019,854,Burkina Faso,Ghana,33225,11771,21454
2019,132,Cabo Verde,Ghana,44,21,23
2019,384,Côte d'Ivoire,Ghana,111024,43253,67771
2019,324,Guinea,Ghana,561,457,104
2019,430,Liberia,Ghana,8081,4384,3697
2019,466,Mali,Ghana,5648,3160,2488
2019,478,Mauritania,Ghana,213,97,116
2019,562,Niger,Ghana,1816,707,1109
2019,566,Nigeria,Ghana,233002,127836,105166
2019,686,Senegal,Ghana,1848,1443,405
2019,694,Sierra Leone,Ghana,952,570,382
2019,768,Togo,Ghana,47093,19542,27551
2019,818,Egypt,Ghana,232,177,55
2019,434,Libya,Ghana,651,523,128
2019,196,Cyprus,Ghana,86,45,41
2019,400,Jordan,Ghana,27,19,8
2019,792,Turkey,Ghana,194,173,21
2019,392,Japan,Ghana,2252,1006,1246
2019,608,Philippines,Ghana,35,35,0
2019,28,Antigua and Barbuda,Ghana,32,16,16
2019,44,Bahamas,Ghana,50,41,9
2019,662,Saint Lucia,Ghana,17,12,5
2019,188,Costa Rica,Ghana,1,1,0
2019,68,Bolivia (Plurinational State of),Ghana,15,13,2
2019,76,Brazil,Ghana,82,57,25
2019,152,Chile,Ghana,28,23,5
2019,218,Ecuador,Ghana,36,26,10
2019,862,Venezuela (Bolivarian Republic of),Ghana,32,27,5
2019,36,Australia,Ghana,7067,3929,3138
2019,100,Bulgaria,Ghana,26,16,10
2019,203,Czechia,Ghana,346,286,60
2019,348,Hungary,Ghana,191,137,54
2019,616,Poland,Ghana,37,25,12
2019,642,Romania,Ghana,149,122,27
2019,643,Russian Federation,Ghana,315,251,64
2019,703,Slovakia,Ghana,22,16,6
2019,208,Denmark,Ghana,2319,1323,996
2019,233,Estonia,Ghana,18,14,4
2019,234,Faroe Islands,Ghana,22,10,12
2019,246,Finland,Ghana,2167,1456,711
2019,352,Iceland,Ghana,94,48,46
2019,372,Ireland,Ghana,553,246,307
2019,578,Norway,Ghana,2118,1153,965
2019,752,Sweden,Ghana,3340,1943,1397
2019,826,United Kingdom,Ghana,140920,72249,68671
2019,300,Greece,Ghana,581,424,157
2019,380,Italy,Ghana,51364,33174,18190
2019,470,Malta,Ghana,150,134,16
2019,620,Portugal,Ghana,195,143,52
2019,688,Serbia,Ghana,29,19,10
2019,705,Slovenia,Ghana,57,33,24
2019,724,Spain,Ghana,12218,8658,3560
2019,40,Austria,Ghana,2920,1694,1226
2019,56,Belgium,Ghana,10131,5314,4817
2019,250,France,Ghana,7372,3612,3760
2019,276,Germany,Ghana,27872,14757,13115
2019,528,Netherlands,Ghana,15041,7339,7702
2019,756,Switzerland,Ghana,2849,1411,1438
2019,60,Bermuda,Ghana,126,75,51
2019,124,Canada,Ghana,24399,12242,12157
2019,840,United States of America,Ghana,173952,102458,71494
1990,710,South Africa,Gibraltar,26,21,5
1990,818,Egypt,Gibraltar,7,4,3
1990,196,Cyprus,Gibraltar,1,1,0
1990,188,Costa Rica,Gibraltar,3,0,3
1990,32,Argentina,Gibraltar,32,11,21
1990,152,Chile,Gibraltar,5,1,4
1990,36,Australia,Gibraltar,409,198,211
1990,100,Bulgaria,Gibraltar,2,1,1
1990,372,Ireland,Gibraltar,7,3,4
1990,826,United Kingdom,Gibraltar,11215,5296,5919
1990,300,Greece,Gibraltar,12,6,6
1990,250,France,Gibraltar,63,21,42
1990,528,Netherlands,Gibraltar,11,10,1
1990,124,Canada,Gibraltar,201,98,103
1995,710,South Africa,Gibraltar,21,17,4
1995,818,Egypt,Gibraltar,7,4,3
1995,196,Cyprus,Gibraltar,2,2,0
1995,188,Costa Rica,Gibraltar,2,0,2
1995,32,Argentina,Gibraltar,31,11,20
1995,68,Bolivia (Plurinational State of),Gibraltar,1,0,1
1995,152,Chile,Gibraltar,5,2,3
1995,36,Australia,Gibraltar,447,215,232
1995,100,Bulgaria,Gibraltar,3,1,2
1995,372,Ireland,Gibraltar,20,9,11
1995,826,United Kingdom,Gibraltar,9279,4481,4798
1995,300,Greece,Gibraltar,12,5,7
1995,250,France,Gibraltar,65,21,44
1995,528,Netherlands,Gibraltar,16,15,1
1995,124,Canada,Gibraltar,224,108,116
2000,710,South Africa,Gibraltar,23,17,6
2000,818,Egypt,Gibraltar,7,4,3
2000,196,Cyprus,Gibraltar,2,2,0
2000,188,Costa Rica,Gibraltar,3,0,3
2000,32,Argentina,Gibraltar,30,11,19
2000,68,Bolivia (Plurinational State of),Gibraltar,2,1,1
2000,152,Chile,Gibraltar,5,1,4
2000,36,Australia,Gibraltar,480,221,259
2000,100,Bulgaria,Gibraltar,4,1,3
2000,372,Ireland,Gibraltar,45,23,22
2000,826,United Kingdom,Gibraltar,7500,3728,3772
2000,300,Greece,Gibraltar,12,4,8
2000,250,France,Gibraltar,67,21,46
2000,528,Netherlands,Gibraltar,23,19,4
2000,124,Canada,Gibraltar,253,122,131
2005,710,South Africa,Gibraltar,30,23,7
2005,818,Egypt,Gibraltar,8,5,3
2005,196,Cyprus,Gibraltar,3,3,0
2005,188,Costa Rica,Gibraltar,2,0,2
2005,32,Argentina,Gibraltar,22,8,14
2005,68,Bolivia (Plurinational State of),Gibraltar,1,0,1
2005,152,Chile,Gibraltar,7,2,5
2005,36,Australia,Gibraltar,490,243,247
2005,100,Bulgaria,Gibraltar,6,1,5
2005,372,Ireland,Gibraltar,45,24,21
2005,752,Sweden,Gibraltar,5,3,2
2005,826,United Kingdom,Gibraltar,8716,4255,4461
2005,300,Greece,Gibraltar,9,4,5
2005,250,France,Gibraltar,20,13,7
2005,528,Netherlands,Gibraltar,34,19,15
2005,124,Canada,Gibraltar,269,151,118
2010,710,South Africa,Gibraltar,46,36,10
2010,818,Egypt,Gibraltar,9,6,3
2010,196,Cyprus,Gibraltar,4,4,0
2010,188,Costa Rica,Gibraltar,4,0,4
2010,32,Argentina,Gibraltar,14,5,9
2010,152,Chile,Gibraltar,10,3,7
2010,36,Australia,Gibraltar,480,247,233
2010,100,Bulgaria,Gibraltar,8,2,6
2010,233,Estonia,Gibraltar,1,0,1
2010,372,Ireland,Gibraltar,38,18,20
2010,752,Sweden,Gibraltar,7,4,3
2010,826,United Kingdom,Gibraltar,9181,4578,4603
2010,300,Greece,Gibraltar,5,3,2
2010,250,France,Gibraltar,66,20,46
2010,528,Netherlands,Gibraltar,31,19,12
2010,124,Canada,Gibraltar,285,179,106
2015,710,South Africa,Gibraltar,82,65,17
2015,818,Egypt,Gibraltar,6,5,1
2015,196,Cyprus,Gibraltar,3,3,0
2015,188,Costa Rica,Gibraltar,4,0,4
2015,32,Argentina,Gibraltar,14,5,9
2015,152,Chile,Gibraltar,15,5,10
2015,36,Australia,Gibraltar,490,244,246
2015,100,Bulgaria,Gibraltar,6,2,4
2015,233,Estonia,Gibraltar,1,0,1
2015,372,Ireland,Gibraltar,39,18,21
2015,752,Sweden,Gibraltar,6,2,4
2015,826,United Kingdom,Gibraltar,11741,5680,6061
2015,300,Greece,Gibraltar,4,3,1
2015,250,France,Gibraltar,72,19,53
2015,528,Netherlands,Gibraltar,33,22,11
2015,124,Canada,Gibraltar,163,74,89
2019,710,South Africa,Gibraltar,91,73,18
2019,818,Egypt,Gibraltar,8,7,1
2019,196,Cyprus,Gibraltar,2,2,0
2019,188,Costa Rica,Gibraltar,4,0,4
2019,32,Argentina,Gibraltar,14,5,9
2019,152,Chile,Gibraltar,20,6,14
2019,36,Australia,Gibraltar,507,261,246
2019,100,Bulgaria,Gibraltar,9,4,5
2019,372,Ireland,Gibraltar,42,20,22
2019,752,Sweden,Gibraltar,5,1,4
2019,826,United Kingdom,Gibraltar,13333,6468,6865
2019,300,Greece,Gibraltar,3,3,0
2019,250,France,Gibraltar,76,20,56
2019,528,Netherlands,Gibraltar,32,21,11
2019,124,Canada,Gibraltar,174,79,95
1990,800,Uganda,Greece,40,21,19
1990,710,South Africa,Greece,3191,1458,1733
1990,818,Egypt,Greece,1306,560,746
1990,434,Libya,Greece,3730,1613,2117
1990,51,Armenia,Greece,5612,2242,3370
1990,196,Cyprus,Greece,5898,3411,2487
1990,376,Israel,Greece,1320,612,708
1990,400,Jordan,Greece,117,45,72
1990,792,Turkey,Greece,101752,47783,53969
1990,144,Sri Lanka,Greece,1,1,0
1990,608,Philippines,Greece,19,12,7
1990,44,Bahamas,Greece,72,42,30
1990,214,Dominican Republic,Greece,94,62,32
1990,188,Costa Rica,Greece,28,17,11
1990,484,Mexico,Greece,255,151,104
1990,591,Panama,Greece,235,166,69
1990,32,Argentina,Greece,3197,1349,1848
1990,68,Bolivia (Plurinational State of),Greece,15,9,6
1990,76,Brazil,Greece,3523,2256,1267
1990,152,Chile,Greece,188,107,81
1990,170,Colombia,Greece,146,79,67
1990,218,Ecuador,Greece,24,19,5
1990,604,Peru,Greece,35,26,9
1990,862,Venezuela (Bolivarian Republic of),Greece,1092,698,394
1990,36,Australia,Greece,148090,76044,72046
1990,112,Belarus,Greece,164,75,89
1990,100,Bulgaria,Greece,1246,777,469
1990,203,Czechia,Greece,445,250,195
1990,348,Hungary,Greece,1601,712,889
1990,616,Poland,Greece,3964,2349,1615
1990,498,Republic of Moldova,Greece,306,187,119
1990,642,Romania,Greece,4380,1931,2449
1990,643,Russian Federation,Greece,1997,980,1017
1990,703,Slovakia,Greece,9,4,5
1990,208,Denmark,Greece,738,535,203
1990,246,Finland,Greece,320,271,49
1990,352,Iceland,Greece,5,3,2
1990,372,Ireland,Greece,104,63,41
1990,428,Latvia,Greece,326,147,179
1990,440,Lithuania,Greece,10,5,5
1990,578,Norway,Greece,475,360,115
1990,752,Sweden,Greece,8526,5146,3380
1990,826,United Kingdom,Greece,14266,7397,6869
1990,8,Albania,Greece,40087,17264,22823
1990,380,Italy,Greece,19876,11494,8382
1990,470,Malta,Greece,11,7,4
1990,807,North Macedonia,Greece,235,98,137
1990,620,Portugal,Greece,42,14,28
1990,688,Serbia,Greece,112,59,53
1990,705,Slovenia,Greece,45,24,21
1990,724,Spain,Greece,639,381,258
1990,40,Austria,Greece,2205,1411,794
1990,56,Belgium,Greece,19584,10643,8941
1990,250,France,Greece,13918,6859,7059
1990,276,Germany,Greece,337546,188622,148924
1990,438,Liechtenstein,Greece,86,44,42
1990,442,Luxembourg,Greece,636,313,323
1990,528,Netherlands,Greece,5206,3458,1748
1990,756,Switzerland,Greece,5583,3063,2520
1990,60,Bermuda,Greece,100,63,37
1990,124,Canada,Greece,80288,39086,41202
1990,840,United States of America,Greece,177398,90721,86677
1995,800,Uganda,Greece,37,19,18
1995,710,South Africa,Greece,3034,1586,1448
1995,818,Egypt,Greece,1077,451,626
1995,434,Libya,Greece,2804,1266,1538
1995,51,Armenia,Greece,3387,1361,2026
1995,196,Cyprus,Greece,8340,4682,3658
1995,376,Israel,Greece,1723,784,939
1995,400,Jordan,Greece,96,35,61
1995,792,Turkey,Greece,78316,36472,41844
1995,144,Sri Lanka,Greece,11,9,2
1995,608,Philippines,Greece,25,16,9
1995,44,Bahamas,Greece,63,38,25
1995,214,Dominican Republic,Greece,105,68,37
1995,188,Costa Rica,Greece,22,15,7
1995,484,Mexico,Greece,270,176,94
1995,591,Panama,Greece,224,159,65
1995,32,Argentina,Greece,2666,1180,1486
1995,68,Bolivia (Plurinational State of),Greece,12,7,5
1995,76,Brazil,Greece,3133,1968,1165
1995,152,Chile,Greece,189,94,95
1995,170,Colombia,Greece,131,77,54
1995,218,Ecuador,Greece,27,21,6
1995,604,Peru,Greece,36,26,10
1995,862,Venezuela (Bolivarian Republic of),Greece,922,589,333
1995,36,Australia,Greece,142981,72846,70135
1995,112,Belarus,Greece,139,56,83
1995,100,Bulgaria,Greece,1945,1075,870
1995,203,Czechia,Greece,667,383,284
1995,348,Hungary,Greece,1252,573,679
1995,616,Poland,Greece,3390,1988,1402
1995,498,Republic of Moldova,Greece,207,124,83
1995,642,Romania,Greece,4350,2094,2256
1995,643,Russian Federation,Greece,1975,1028,947
1995,703,Slovakia,Greece,119,74,45
1995,208,Denmark,Greece,916,656,260
1995,246,Finland,Greece,357,302,55
1995,352,Iceland,Greece,8,5,3
1995,372,Ireland,Greece,160,95,65
1995,428,Latvia,Greece,169,77,92
1995,440,Lithuania,Greece,12,7,5
1995,578,Norway,Greece,495,367,128
1995,752,Sweden,Greece,10118,6076,4042
1995,826,United Kingdom,Greece,23935,12918,11017
1995,8,Albania,Greece,43331,18811,24520
1995,191,Croatia,Greece,68,33,35
1995,380,Italy,Greece,14957,8215,6742
1995,470,Malta,Greece,13,8,5
1995,807,North Macedonia,Greece,220,92,128
1995,620,Portugal,Greece,81,38,43
1995,688,Serbia,Greece,713,364,349
1995,705,Slovenia,Greece,54,28,26
1995,724,Spain,Greece,806,482,324
1995,40,Austria,Greece,2488,1606,882
1995,56,Belgium,Greece,18488,9954,8534
1995,250,France,Greece,14368,6958,7410
1995,276,Germany,Greece,345405,187674,157731
1995,438,Liechtenstein,Greece,94,46,48
1995,442,Luxembourg,Greece,805,399,406
1995,528,Netherlands,Greece,6024,3962,2062
1995,756,Switzerland,Greece,5666,3201,2465
1995,60,Bermuda,Greece,101,64,37
1995,124,Canada,Greece,77124,37376,39748
1995,840,United States of America,Greece,173870,89596,84274
2000,800,Uganda,Greece,37,17,20
2000,710,South Africa,Greece,3794,2132,1662
2000,818,Egypt,Greece,934,378,556
2000,434,Libya,Greece,1925,977,948
2000,51,Armenia,Greece,2073,841,1232
2000,196,Cyprus,Greece,10781,5952,4829
2000,268,Georgia,Greece,159,83,76
2000,376,Israel,Greece,2030,923,1107
2000,400,Jordan,Greece,75,26,49
2000,792,Turkey,Greece,55164,25217,29947
2000,144,Sri Lanka,Greece,22,16,6
2000,608,Philippines,Greece,245,140,105
2000,44,Bahamas,Greece,55,36,19
2000,214,Dominican Republic,Greece,115,74,41
2000,188,Costa Rica,Greece,26,18,8
2000,484,Mexico,Greece,297,208,89
2000,591,Panama,Greece,229,162,67
2000,32,Argentina,Greece,2136,1012,1124
2000,68,Bolivia (Plurinational State of),Greece,8,5,3
2000,76,Brazil,Greece,2743,1680,1063
2000,152,Chile,Greece,191,94,97
2000,170,Colombia,Greece,115,74,41
2000,218,Ecuador,Greece,30,24,6
2000,604,Peru,Greece,43,31,12
2000,862,Venezuela (Bolivarian Republic of),Greece,772,492,280
2000,36,Australia,Greece,130780,66357,64423
2000,112,Belarus,Greece,113,37,76
2000,100,Bulgaria,Greece,2643,1373,1270
2000,203,Czechia,Greece,889,516,373
2000,348,Hungary,Greece,903,434,469
2000,616,Poland,Greece,2900,1683,1217
2000,498,Republic of Moldova,Greece,140,82,58
2000,642,Romania,Greece,4321,2256,2065
2000,643,Russian Federation,Greece,1882,1038,844
2000,703,Slovakia,Greece,262,163,99
2000,208,Denmark,Greece,1093,777,316
2000,246,Finland,Greece,394,333,61
2000,352,Iceland,Greece,10,6,4
2000,372,Ireland,Greece,304,184,120
2000,428,Latvia,Greece,12,7,5
2000,440,Lithuania,Greece,9,6,3
2000,578,Norway,Greece,575,433,142
2000,752,Sweden,Greece,10851,6488,4363
2000,826,United Kingdom,Greece,34008,18628,15380
2000,8,Albania,Greece,46575,20358,26217
2000,191,Croatia,Greece,128,63,65
2000,380,Italy,Greece,10037,4936,5101
2000,470,Malta,Greece,32,19,13
2000,807,North Macedonia,Greece,205,86,119
2000,620,Portugal,Greece,124,63,61
2000,688,Serbia,Greece,970,485,485
2000,705,Slovenia,Greece,57,30,27
2000,724,Spain,Greece,1321,800,521
2000,40,Austria,Greece,2770,1801,969
2000,56,Belgium,Greece,16857,9010,7847
2000,250,France,Greece,14818,7057,7761
2000,276,Germany,Greece,353263,186726,166537
2000,438,Liechtenstein,Greece,102,48,54
2000,442,Luxembourg,Greece,983,490,493
2000,528,Netherlands,Greece,7052,4599,2453
2000,756,Switzerland,Greece,5770,3357,2413
2000,60,Bermuda,Greece,102,66,36
2000,124,Canada,Greece,75794,36563,39231
2000,840,United States of America,Greece,169958,88375,81583
2005,800,Uganda,Greece,35,16,19
2005,120,Cameroon,Greece,193,128,65
2005,710,South Africa,Greece,4991,2708,2283
2005,818,Egypt,Greece,1112,491,621
2005,434,Libya,Greece,2121,1263,858
2005,51,Armenia,Greece,1372,584,788
2005,196,Cyprus,Greece,15780,8667,7113
2005,268,Georgia,Greece,151,79,72
2005,376,Israel,Greece,2495,1133,1362
2005,400,Jordan,Greece,109,47,62
2005,792,Turkey,Greece,56846,25288,31558
2005,144,Sri Lanka,Greece,44,25,19
2005,608,Philippines,Greece,198,115,83
2005,44,Bahamas,Greece,70,46,24
2005,214,Dominican Republic,Greece,88,59,29
2005,188,Costa Rica,Greece,17,12,5
2005,484,Mexico,Greece,258,179,79
2005,591,Panama,Greece,247,191,56
2005,32,Argentina,Greece,1575,759,816
2005,68,Bolivia (Plurinational State of),Greece,15,10,5
2005,76,Brazil,Greece,2150,1275,875
2005,152,Chile,Greece,286,143,143
2005,170,Colombia,Greece,103,70,33
2005,218,Ecuador,Greece,35,28,7
2005,604,Peru,Greece,51,36,15
2005,862,Venezuela (Bolivarian Republic of),Greece,747,477,270
2005,36,Australia,Greece,129010,64538,64472
2005,112,Belarus,Greece,109,36,73
2005,100,Bulgaria,Greece,3763,1937,1826
2005,203,Czechia,Greece,718,436,282
2005,348,Hungary,Greece,1115,545,570
2005,616,Poland,Greece,3009,1694,1315
2005,498,Republic of Moldova,Greece,97,56,41
2005,642,Romania,Greece,4708,2512,2196
2005,643,Russian Federation,Greece,1918,1078,840
2005,703,Slovakia,Greece,294,184,110
2005,208,Denmark,Greece,1274,876,398
2005,246,Finland,Greece,563,448,115
2005,352,Iceland,Greece,18,10,8
2005,372,Ireland,Greece,505,303,202
2005,428,Latvia,Greece,23,14,9
2005,440,Lithuania,Greece,35,23,12
2005,578,Norway,Greece,655,469,186
2005,752,Sweden,Greece,10749,6430,4319
2005,826,United Kingdom,Greece,33317,18017,15300
2005,8,Albania,Greece,39315,18868,20447
2005,191,Croatia,Greece,137,67,70
2005,380,Italy,Greece,13720,6764,6956
2005,470,Malta,Greece,52,31,21
2005,807,North Macedonia,Greece,210,88,122
2005,620,Portugal,Greece,157,83,74
2005,688,Serbia,Greece,957,473,484
2005,705,Slovenia,Greece,61,28,33
2005,724,Spain,Greece,2136,1311,825
2005,40,Austria,Greece,3096,1987,1109
2005,56,Belgium,Greece,14948,7752,7196
2005,250,France,Greece,11470,5583,5887
2005,276,Germany,Greece,256149,137892,118257
2005,438,Liechtenstein,Greece,75,37,38
2005,442,Luxembourg,Greece,1083,541,542
2005,528,Netherlands,Greece,7989,5128,2861
2005,756,Switzerland,Greece,6755,3788,2967
2005,60,Bermuda,Greece,104,61,43
2005,124,Canada,Greece,68502,33979,34523
2005,840,United States of America,Greece,158144,82653,75491
2010,800,Uganda,Greece,36,17,19
2010,120,Cameroon,Greece,153,104,49
2010,710,South Africa,Greece,7818,4229,3589
2010,818,Egypt,Greece,1200,504,696
2010,434,Libya,Greece,2322,1394,928
2010,51,Armenia,Greece,1143,509,634
2010,196,Cyprus,Greece,25840,14338,11502
2010,268,Georgia,Greece,152,80,72
2010,376,Israel,Greece,2991,1354,1637
2010,400,Jordan,Greece,140,64,76
2010,792,Turkey,Greece,58579,25324,33255
2010,144,Sri Lanka,Greece,89,50,39
2010,608,Philippines,Greece,150,84,66
2010,44,Bahamas,Greece,84,55,29
2010,214,Dominican Republic,Greece,60,43,17
2010,188,Costa Rica,Greece,33,22,11
2010,484,Mexico,Greece,249,169,80
2010,591,Panama,Greece,277,229,48
2010,32,Argentina,Greece,1014,506,508
2010,68,Bolivia (Plurinational State of),Greece,22,16,6
2010,76,Brazil,Greece,1527,851,676
2010,152,Chile,Greece,382,193,189
2010,170,Colombia,Greece,109,79,30
2010,218,Ecuador,Greece,49,40,9
2010,604,Peru,Greece,57,41,16
2010,862,Venezuela (Bolivarian Republic of),Greece,731,469,262
2010,36,Australia,Greece,122520,60391,62129
2010,112,Belarus,Greece,104,34,70
2010,100,Bulgaria,Greece,4724,2418,2306
2010,203,Czechia,Greece,483,329,154
2010,348,Hungary,Greece,1327,657,670
2010,616,Poland,Greece,3214,1750,1464
2010,498,Republic of Moldova,Greece,256,150,106
2010,642,Romania,Greece,5657,3065,2592
2010,643,Russian Federation,Greece,1916,1097,819
2010,703,Slovakia,Greece,330,208,122
2010,208,Denmark,Greece,1429,959,470
2010,233,Estonia,Greece,25,13,12
2010,246,Finland,Greece,855,645,210
2010,352,Iceland,Greece,25,14,11
2010,372,Ireland,Greece,623,347,276
2010,428,Latvia,Greece,34,21,13
2010,440,Lithuania,Greece,57,37,20
2010,578,Norway,Greece,855,590,265
2010,752,Sweden,Greece,11381,6753,4628
2010,826,United Kingdom,Greece,35098,19311,15787
2010,8,Albania,Greece,32054,15383,16671
2010,191,Croatia,Greece,146,71,75
2010,380,Italy,Greece,20212,10521,9691
2010,470,Malta,Greece,63,45,18
2010,499,Montenegro,Greece,50,40,10
2010,807,North Macedonia,Greece,216,91,125
2010,620,Portugal,Greece,165,89,76
2010,688,Serbia,Greece,936,462,474
2010,705,Slovenia,Greece,79,37,42
2010,724,Spain,Greece,3625,2258,1367
2010,40,Austria,Greece,3422,2173,1249
2010,56,Belgium,Greece,14226,7083,7143
2010,250,France,Greece,12103,5621,6482
2010,276,Germany,Greece,173992,94718,79274
2010,438,Liechtenstein,Greece,49,26,23
2010,442,Luxembourg,Greece,1195,596,599
2010,528,Netherlands,Greece,9137,5597,3540
2010,756,Switzerland,Greece,7623,4080,3543
2010,60,Bermuda,Greece,105,56,49
2010,124,Canada,Greece,66475,34121,32354
2010,840,United States of America,Greece,150879,77865,73014
2015,800,Uganda,Greece,35,16,19
2015,120,Cameroon,Greece,195,124,71
2015,710,South Africa,Greece,14101,7298,6803
2015,818,Egypt,Greece,889,440,449
2015,434,Libya,Greece,2617,1557,1060
2015,51,Armenia,Greece,1021,455,566
2015,196,Cyprus,Greece,24826,13849,10977
2015,268,Georgia,Greece,159,84,75
2015,376,Israel,Greece,3085,1388,1697
2015,400,Jordan,Greece,59,20,39
2015,792,Turkey,Greece,59465,24944,34521
2015,144,Sri Lanka,Greece,90,50,40
2015,608,Philippines,Greece,153,87,66
2015,44,Bahamas,Greece,91,59,32
2015,214,Dominican Republic,Greece,63,46,17
2015,188,Costa Rica,Greece,33,22,11
2015,484,Mexico,Greece,264,179,85
2015,591,Panama,Greece,325,268,57
2015,32,Argentina,Greece,1017,507,510
2015,68,Bolivia (Plurinational State of),Greece,26,19,7
2015,76,Brazil,Greece,1839,1025,814
2015,152,Chile,Greece,578,286,292
2015,170,Colombia,Greece,122,89,33
2015,218,Ecuador,Greece,71,58,13
2015,604,Peru,Greece,60,43,17
2015,862,Venezuela (Bolivarian Republic of),Greece,735,468,267
2015,36,Australia,Greece,115820,57050,58770
2015,112,Belarus,Greece,108,35,73
2015,100,Bulgaria,Greece,7166,3992,3174
2015,203,Czechia,Greece,724,512,212
2015,348,Hungary,Greece,1219,611,608
2015,616,Poland,Greece,3098,1714,1384
2015,498,Republic of Moldova,Greece,452,265,187
2015,642,Romania,Greece,4653,2616,2037
2015,643,Russian Federation,Greece,1952,1113,839
2015,703,Slovakia,Greece,431,284,147
2015,208,Denmark,Greece,2242,1443,799
2015,233,Estonia,Greece,77,50,27
2015,246,Finland,Greece,1434,969,465
2015,352,Iceland,Greece,45,30,15
2015,372,Ireland,Greece,636,351,285
2015,428,Latvia,Greece,42,24,18
2015,440,Lithuania,Greece,55,37,18
2015,578,Norway,Greece,2304,1410,894
2015,752,Sweden,Greece,16025,9281,6744
2015,826,United Kingdom,Greece,44885,24098,20787
2015,8,Albania,Greece,31596,15163,16433
2015,191,Croatia,Greece,147,71,76
2015,380,Italy,Greece,17023,8098,8925
2015,470,Malta,Greece,106,77,29
2015,499,Montenegro,Greece,56,45,11
2015,807,North Macedonia,Greece,233,98,135
2015,620,Portugal,Greece,186,97,89
2015,688,Serbia,Greece,914,450,464
2015,705,Slovenia,Greece,91,47,44
2015,724,Spain,Greece,3982,2308,1674
2015,40,Austria,Greece,4003,2549,1454
2015,56,Belgium,Greece,16193,8045,8148
2015,250,France,Greece,13210,6452,6758
2015,276,Germany,Greece,181290,98496,82794
2015,438,Liechtenstein,Greece,46,26,20
2015,442,Luxembourg,Greece,1823,924,899
2015,528,Netherlands,Greece,13959,8222,5737
2015,756,Switzerland,Greece,12254,6483,5771
2015,60,Bermuda,Greece,106,57,49
2015,124,Canada,Greece,62330,31372,30958
2015,840,United States of America,Greece,151699,77913,73786
2019,800,Uganda,Greece,35,16,19
2019,120,Cameroon,Greece,193,123,70
2019,710,South Africa,Greece,15804,8187,7617
2019,818,Egypt,Greece,1267,552,715
2019,434,Libya,Greece,2776,1652,1124
2019,51,Armenia,Greece,1015,457,558
2019,196,Cyprus,Greece,24813,13954,10859
2019,268,Georgia,Greece,163,86,77
2019,376,Israel,Greece,3000,1350,1650
2019,400,Jordan,Greece,63,22,41
2019,792,Turkey,Greece,80407,34193,46214
2019,144,Sri Lanka,Greece,90,50,40
2019,608,Philippines,Greece,157,89,68
2019,44,Bahamas,Greece,96,63,33
2019,214,Dominican Republic,Greece,65,48,17
2019,188,Costa Rica,Greece,33,22,11
2019,484,Mexico,Greece,272,185,87
2019,591,Panama,Greece,344,285,59
2019,32,Argentina,Greece,1034,515,519
2019,68,Bolivia (Plurinational State of),Greece,28,21,7
2019,76,Brazil,Greece,2071,1155,916
2019,152,Chile,Greece,772,361,411
2019,170,Colombia,Greece,124,91,33
2019,218,Ecuador,Greece,69,57,12
2019,604,Peru,Greece,71,52,19
2019,862,Venezuela (Bolivarian Republic of),Greece,719,457,262
2019,36,Australia,Greece,117702,57359,60343
2019,112,Belarus,Greece,106,34,72
2019,100,Bulgaria,Greece,8563,4816,3747
2019,203,Czechia,Greece,898,639,259
2019,348,Hungary,Greece,1304,644,660
2019,616,Poland,Greece,3280,1871,1409
2019,498,Republic of Moldova,Greece,445,262,183
2019,642,Romania,Greece,7121,4123,2998
2019,643,Russian Federation,Greece,1951,1113,838
2019,703,Slovakia,Greece,562,376,186
2019,208,Denmark,Greece,3606,2165,1441
2019,233,Estonia,Greece,96,65,31
2019,246,Finland,Greece,1975,1339,636
2019,352,Iceland,Greece,75,52,23
2019,372,Ireland,Greece,698,387,311
2019,428,Latvia,Greece,48,33,15
2019,440,Lithuania,Greece,60,43,17
2019,578,Norway,Greece,3052,1828,1224
2019,752,Sweden,Greece,20490,11463,9027
2019,826,United Kingdom,Greece,50971,27425,23546
2019,8,Albania,Greece,29852,14326,15526
2019,191,Croatia,Greece,135,65,70
2019,380,Italy,Greece,17120,8312,8808
2019,470,Malta,Greece,171,125,46
2019,499,Montenegro,Greece,56,46,10
2019,807,North Macedonia,Greece,233,98,135
2019,620,Portugal,Greece,189,99,90
2019,688,Serbia,Greece,928,457,471
2019,705,Slovenia,Greece,109,62,47
2019,724,Spain,Greece,4125,2349,1776
2019,40,Austria,Greece,4725,3039,1686
2019,56,Belgium,Greece,17832,8935,8897
2019,250,France,Greece,13982,6813,7169
2019,276,Germany,Greece,326297,182293,144004
2019,438,Liechtenstein,Greece,49,28,21
2019,442,Luxembourg,Greece,2871,1471,1400
2019,528,Netherlands,Greece,17287,10099,7188
2019,756,Switzerland,Greece,14337,7658,6679
2019,60,Bermuda,Greece,107,58,49
2019,124,Canada,Greece,66793,33618,33175
2019,840,United States of America,Greece,163819,83281,80538
1990,192,Cuba,Greenland,195,88,107
1990,188,Costa Rica,Greenland,7,5,2
1990,320,Guatemala,Greenland,269,85,184
1990,32,Argentina,Greenland,36,6,30
1990,152,Chile,Greenland,6,3,3
1990,100,Bulgaria,Greenland,1,1,0
1990,208,Denmark,Greenland,8672,3456,5216
1990,234,Faroe Islands,Greenland,137,55,82
1990,352,Iceland,Greenland,35,16,19
1990,578,Norway,Greenland,123,45,78
1990,826,United Kingdom,Greenland,9,6,3
1990,300,Greece,Greenland,8,5,3
1990,250,France,Greenland,12,3,9
1995,192,Cuba,Greenland,148,63,85
1995,188,Costa Rica,Greenland,5,3,2
1995,320,Guatemala,Greenland,261,101,160
1995,32,Argentina,Greenland,35,6,29
1995,152,Chile,Greenland,5,3,2
1995,100,Bulgaria,Greenland,2,2,0
1995,208,Denmark,Greenland,10581,4249,6332
1995,234,Faroe Islands,Greenland,92,36,56
1995,352,Iceland,Greenland,38,17,21
1995,372,Ireland,Greenland,1,1,0
1995,578,Norway,Greenland,155,56,99
1995,826,United Kingdom,Greenland,22,10,12
1995,300,Greece,Greenland,8,5,3
1995,250,France,Greenland,13,3,10
2000,192,Cuba,Greenland,101,39,62
2000,188,Costa Rica,Greenland,6,4,2
2000,320,Guatemala,Greenland,252,117,135
2000,32,Argentina,Greenland,34,6,28
2000,152,Chile,Greenland,5,2,3
2000,100,Bulgaria,Greenland,2,2,0
2000,208,Denmark,Greenland,12489,5042,7447
2000,234,Faroe Islands,Greenland,102,44,58
2000,352,Iceland,Greenland,40,18,22
2000,372,Ireland,Greenland,2,2,0
2000,578,Norway,Greenland,184,71,113
2000,826,United Kingdom,Greenland,36,13,23
2000,300,Greece,Greenland,8,4,4
2000,250,France,Greenland,13,3,10
2005,192,Cuba,Greenland,67,26,41
2005,188,Costa Rica,Greenland,4,3,1
2005,320,Guatemala,Greenland,299,150,149
2005,32,Argentina,Greenland,25,5,20
2005,152,Chile,Greenland,7,3,4
2005,100,Bulgaria,Greenland,3,3,0
2005,208,Denmark,Greenland,13871,5719,8152
2005,234,Faroe Islands,Greenland,134,53,81
2005,352,Iceland,Greenland,53,25,28
2005,372,Ireland,Greenland,2,2,0
2005,578,Norway,Greenland,214,84,130
2005,826,United Kingdom,Greenland,42,14,28
2005,300,Greece,Greenland,6,3,3
2005,250,France,Greenland,8,0,8
2010,192,Cuba,Greenland,37,15,22
2010,188,Costa Rica,Greenland,8,5,3
2010,320,Guatemala,Greenland,346,184,162
2010,32,Argentina,Greenland,15,3,12
2010,152,Chile,Greenland,10,5,5
2010,100,Bulgaria,Greenland,3,3,0
2010,208,Denmark,Greenland,14984,6288,8696
2010,234,Faroe Islands,Greenland,143,52,91
2010,352,Iceland,Greenland,65,32,33
2010,372,Ireland,Greenland,1,1,0
2010,428,Latvia,Greenland,1,1,0
2010,578,Norway,Greenland,256,107,149
2010,826,United Kingdom,Greenland,44,16,28
2010,300,Greece,Greenland,3,1,2
2010,250,France,Greenland,12,2,10
2015,192,Cuba,Greenland,29,12,17
2015,188,Costa Rica,Greenland,8,5,3
2015,320,Guatemala,Greenland,398,214,184
2015,32,Argentina,Greenland,15,3,12
2015,152,Chile,Greenland,15,8,7
2015,100,Bulgaria,Greenland,2,2,0
2015,208,Denmark,Greenland,17107,7363,9744
2015,234,Faroe Islands,Greenland,150,54,96
2015,352,Iceland,Greenland,65,28,37
2015,372,Ireland,Greenland,1,1,0
2015,428,Latvia,Greenland,1,0,1
2015,578,Norway,Greenland,299,128,171
2015,826,United Kingdom,Greenland,56,20,36
2015,300,Greece,Greenland,2,1,1
2015,250,France,Greenland,13,2,11
2019,192,Cuba,Greenland,26,11,15
2019,188,Costa Rica,Greenland,8,5,3
2019,320,Guatemala,Greenland,408,220,188
2019,32,Argentina,Greenland,15,3,12
2019,152,Chile,Greenland,20,11,9
2019,100,Bulgaria,Greenland,2,2,0
2019,208,Denmark,Greenland,17566,7475,10091
2019,234,Faroe Islands,Greenland,172,64,108
2019,352,Iceland,Greenland,79,37,42
2019,372,Ireland,Greenland,1,1,0
2019,578,Norway,Greenland,310,127,183
2019,826,United Kingdom,Greenland,63,23,40
2019,300,Greece,Greenland,1,1,0
2019,250,France,Greenland,13,2,11
1990,28,Antigua and Barbuda,Grenada,115,55,60
1990,533,Aruba,Grenada,294,53,241
1990,44,Bahamas,Grenada,28,15,13
1990,52,Barbados,Grenada,565,191,374
1990,535,"Bonaire, Sint Eustatius and Saba",Grenada,5,2,3
1990,136,Cayman Islands,Grenada,4,3,1
1990,192,Cuba,Grenada,180,96,84
1990,388,Jamaica,Grenada,161,79,82
1990,659,Saint Kitts and Nevis,Grenada,24,13,11
1990,662,Saint Lucia,Grenada,67,40,27
1990,670,Saint Vincent and the Grenadines,Grenada,377,155,222
1990,780,Trinidad and Tobago,Grenada,16589,7704,8885
1990,850,United States Virgin Islands,Grenada,463,220,243
1990,188,Costa Rica,Grenada,7,5,2
1990,591,Panama,Grenada,21,6,15
1990,32,Argentina,Grenada,25,0,25
1990,68,Bolivia (Plurinational State of),Grenada,1,1,0
1990,152,Chile,Grenada,7,3,4
1990,328,Guyana,Grenada,54,29,25
1990,862,Venezuela (Bolivarian Republic of),Grenada,436,141,295
1990,36,Australia,Grenada,89,46,43
1990,348,Hungary,Grenada,1,1,0
1990,208,Denmark,Grenada,3,0,3
1990,372,Ireland,Grenada,3,2,1
1990,752,Sweden,Grenada,31,27,4
1990,826,United Kingdom,Grenada,1366,811,555
1990,300,Greece,Grenada,2,2,0
1990,380,Italy,Grenada,1,0,1
1990,40,Austria,Grenada,8,3,5
1990,528,Netherlands,Grenada,14,9,5
1990,756,Switzerland,Grenada,35,16,19
1990,124,Canada,Grenada,4543,2212,2331
1990,840,United States of America,Grenada,17730,7664,10066
1995,28,Antigua and Barbuda,Grenada,137,72,65
1995,533,Aruba,Grenada,285,58,227
1995,44,Bahamas,Grenada,27,14,13
1995,52,Barbados,Grenada,616,215,401
1995,535,"Bonaire, Sint Eustatius and Saba",Grenada,10,3,7
1995,136,Cayman Islands,Grenada,9,5,4
1995,192,Cuba,Grenada,137,70,67
1995,388,Jamaica,Grenada,192,94,98
1995,659,Saint Kitts and Nevis,Grenada,34,19,15
1995,662,Saint Lucia,Grenada,90,54,36
1995,670,Saint Vincent and the Grenadines,Grenada,392,162,230
1995,780,Trinidad and Tobago,Grenada,15066,6972,8094
1995,850,United States Virgin Islands,Grenada,520,247,273
1995,188,Costa Rica,Grenada,5,3,2
1995,591,Panama,Grenada,11,3,8
1995,32,Argentina,Grenada,24,0,24
1995,68,Bolivia (Plurinational State of),Grenada,2,2,0
1995,152,Chile,Grenada,6,2,4
1995,328,Guyana,Grenada,81,43,38
1995,862,Venezuela (Bolivarian Republic of),Grenada,321,99,222
1995,36,Australia,Grenada,92,44,48
1995,348,Hungary,Grenada,3,2,1
1995,208,Denmark,Grenada,5,2,3
1995,372,Ireland,Grenada,8,5,3
1995,752,Sweden,Grenada,37,32,5
1995,826,United Kingdom,Grenada,5367,2585,2782
1995,300,Greece,Grenada,4,2,2
1995,380,Italy,Grenada,5,2,3
1995,724,Spain,Grenada,90,44,46
1995,40,Austria,Grenada,9,3,6
1995,528,Netherlands,Grenada,20,12,8
1995,756,Switzerland,Grenada,33,16,17
1995,124,Canada,Grenada,6638,3212,3426
1995,840,United States of America,Grenada,23815,10433,13382
2000,28,Antigua and Barbuda,Grenada,158,88,70
2000,533,Aruba,Grenada,276,63,213
2000,44,Bahamas,Grenada,26,14,12
2000,52,Barbados,Grenada,668,239,429
2000,535,"Bonaire, Sint Eustatius and Saba",Grenada,15,4,11
2000,136,Cayman Islands,Grenada,17,10,7
2000,192,Cuba,Grenada,93,44,49
2000,388,Jamaica,Grenada,222,108,114
2000,659,Saint Kitts and Nevis,Grenada,46,26,20
2000,662,Saint Lucia,Grenada,124,75,49
2000,670,Saint Vincent and the Grenadines,Grenada,408,169,239
2000,780,Trinidad and Tobago,Grenada,11148,4994,6154
2000,850,United States Virgin Islands,Grenada,578,274,304
2000,188,Costa Rica,Grenada,6,4,2
2000,591,Panama,Grenada,2,0,2
2000,32,Argentina,Grenada,23,0,23
2000,68,Bolivia (Plurinational State of),Grenada,2,2,0
2000,152,Chile,Grenada,5,1,4
2000,328,Guyana,Grenada,108,58,50
2000,862,Venezuela (Bolivarian Republic of),Grenada,235,68,167
2000,36,Australia,Grenada,130,60,70
2000,348,Hungary,Grenada,4,2,2
2000,208,Denmark,Grenada,7,5,2
2000,372,Ireland,Grenada,17,10,7
2000,752,Sweden,Grenada,40,34,6
2000,826,United Kingdom,Grenada,9460,4397,5063
2000,300,Greece,Grenada,6,1,5
2000,380,Italy,Grenada,8,3,5
2000,724,Spain,Grenada,1095,581,514
2000,40,Austria,Grenada,10,4,6
2000,528,Netherlands,Grenada,29,15,14
2000,756,Switzerland,Grenada,33,16,17
2000,124,Canada,Grenada,8890,4289,4601
2000,840,United States of America,Grenada,30015,13274,16741
2005,28,Antigua and Barbuda,Grenada,170,95,75
2005,533,Aruba,Grenada,263,63,200
2005,44,Bahamas,Grenada,28,13,15
2005,52,Barbados,Grenada,518,186,332
2005,535,"Bonaire, Sint Eustatius and Saba",Grenada,15,4,11
2005,136,Cayman Islands,Grenada,16,10,6
2005,192,Cuba,Grenada,62,30,32
2005,388,Jamaica,Grenada,216,105,111
2005,659,Saint Kitts and Nevis,Grenada,52,27,25
2005,662,Saint Lucia,Grenada,156,93,63
2005,670,Saint Vincent and the Grenadines,Grenada,422,179,243
2005,780,Trinidad and Tobago,Grenada,11973,5345,6628
2005,850,United States Virgin Islands,Grenada,583,278,305
2005,188,Costa Rica,Grenada,4,3,1
2005,591,Panama,Grenada,11,6,5
2005,32,Argentina,Grenada,17,0,17
2005,68,Bolivia (Plurinational State of),Grenada,1,1,0
2005,76,Brazil,Grenada,13,11,2
2005,152,Chile,Grenada,7,2,5
2005,328,Guyana,Grenada,137,74,63
2005,862,Venezuela (Bolivarian Republic of),Grenada,202,63,139
2005,36,Australia,Grenada,130,67,63
2005,203,Czechia,Grenada,1,1,0
2005,348,Hungary,Grenada,5,3,2
2005,208,Denmark,Grenada,9,6,3
2005,372,Ireland,Grenada,17,10,7
2005,752,Sweden,Grenada,42,35,7
2005,826,United Kingdom,Grenada,8825,4062,4763
2005,300,Greece,Grenada,4,1,3
2005,380,Italy,Grenada,12,3,9
2005,724,Spain,Grenada,527,276,251
2005,40,Austria,Grenada,12,5,7
2005,528,Netherlands,Grenada,40,16,24
2005,756,Switzerland,Grenada,36,17,19
2005,124,Canada,Grenada,9321,4051,5270
2005,840,United States of America,Grenada,30901,13762,17139
2010,466,Mali,Grenada,302,130,172
2010,28,Antigua and Barbuda,Grenada,181,101,80
2010,533,Aruba,Grenada,245,62,183
2010,44,Bahamas,Grenada,30,13,17
2010,52,Barbados,Grenada,371,133,238
2010,136,Cayman Islands,Grenada,16,9,7
2010,192,Cuba,Grenada,34,17,17
2010,531,Curaçao,Grenada,2,1,1
2010,388,Jamaica,Grenada,210,103,107
2010,659,Saint Kitts and Nevis,Grenada,56,30,26
2010,662,Saint Lucia,Grenada,176,104,72
2010,670,Saint Vincent and the Grenadines,Grenada,431,188,243
2010,780,Trinidad and Tobago,Grenada,7748,3358,4390
2010,850,United States Virgin Islands,Grenada,590,283,307
2010,188,Costa Rica,Grenada,8,5,3
2010,591,Panama,Grenada,22,13,9
2010,32,Argentina,Grenada,11,1,10
2010,76,Brazil,Grenada,26,22,4
2010,152,Chile,Grenada,10,3,7
2010,328,Guyana,Grenada,165,90,75
2010,862,Venezuela (Bolivarian Republic of),Grenada,176,58,118
2010,36,Australia,Grenada,130,75,55
2010,203,Czechia,Grenada,1,1,0
2010,348,Hungary,Grenada,5,4,1
2010,208,Denmark,Grenada,9,6,3
2010,372,Ireland,Grenada,14,7,7
2010,752,Sweden,Grenada,45,33,12
2010,826,United Kingdom,Grenada,9296,4382,4914
2010,300,Greece,Grenada,2,1,1
2010,380,Italy,Grenada,19,6,13
2010,724,Spain,Grenada,513,262,251
2010,40,Austria,Grenada,13,5,8
2010,528,Netherlands,Grenada,45,16,29
2010,756,Switzerland,Grenada,44,18,26
2010,124,Canada,Grenada,10325,4077,6248
2010,840,United States of America,Grenada,32759,14340,18419
2015,466,Mali,Grenada,374,161,213
2015,28,Antigua and Barbuda,Grenada,192,107,85
2015,533,Aruba,Grenada,258,65,193
2015,44,Bahamas,Grenada,33,14,19
2015,52,Barbados,Grenada,389,139,250
2015,136,Cayman Islands,Grenada,16,10,6
2015,192,Cuba,Grenada,27,14,13
2015,531,Curaçao,Grenada,2,1,1
2015,388,Jamaica,Grenada,205,100,105
2015,659,Saint Kitts and Nevis,Grenada,57,31,26
2015,662,Saint Lucia,Grenada,168,100,68
2015,670,Saint Vincent and the Grenadines,Grenada,439,192,247
2015,780,Trinidad and Tobago,Grenada,8026,3551,4475
2015,850,United States Virgin Islands,Grenada,590,283,307
2015,188,Costa Rica,Grenada,8,5,3
2015,591,Panama,Grenada,27,17,10
2015,32,Argentina,Grenada,11,1,10
2015,76,Brazil,Grenada,31,26,5
2015,152,Chile,Grenada,15,5,10
2015,328,Guyana,Grenada,193,105,88
2015,862,Venezuela (Bolivarian Republic of),Grenada,163,53,110
2015,36,Australia,Grenada,140,75,65
2015,203,Czechia,Grenada,1,1,0
2015,348,Hungary,Grenada,3,2,1
2015,208,Denmark,Grenada,10,7,3
2015,372,Ireland,Grenada,14,7,7
2015,752,Sweden,Grenada,40,29,11
2015,826,United Kingdom,Grenada,11888,5418,6470
2015,300,Greece,Grenada,1,1,0
2015,380,Italy,Grenada,15,3,12
2015,724,Spain,Grenada,622,309,313
2015,40,Austria,Grenada,15,6,9
2015,528,Netherlands,Grenada,47,16,31
2015,756,Switzerland,Grenada,46,20,26
2015,124,Canada,Grenada,10202,4043,6159
2015,840,United States of America,Grenada,35652,15505,20147
2019,466,Mali,Grenada,416,179,237
2019,28,Antigua and Barbuda,Grenada,199,111,88
2019,533,Aruba,Grenada,260,65,195
2019,44,Bahamas,Grenada,35,15,20
2019,52,Barbados,Grenada,392,140,252
2019,136,Cayman Islands,Grenada,17,10,7
2019,192,Cuba,Grenada,24,12,12
2019,531,Curaçao,Grenada,2,1,1
2019,388,Jamaica,Grenada,207,101,106
2019,659,Saint Kitts and Nevis,Grenada,58,32,26
2019,662,Saint Lucia,Grenada,162,97,65
2019,670,Saint Vincent and the Grenadines,Grenada,443,195,248
2019,780,Trinidad and Tobago,Grenada,8640,4045,4595
2019,850,United States Virgin Islands,Grenada,590,283,307
2019,188,Costa Rica,Grenada,8,5,3
2019,591,Panama,Grenada,27,18,9
2019,32,Argentina,Grenada,11,1,10
2019,76,Brazil,Grenada,34,29,5
2019,152,Chile,Grenada,20,6,14
2019,328,Guyana,Grenada,196,107,89
2019,862,Venezuela (Bolivarian Republic of),Grenada,159,51,108
2019,36,Australia,Grenada,148,79,69
2019,203,Czechia,Grenada,1,1,0
2019,348,Hungary,Grenada,2,1,1
2019,208,Denmark,Grenada,15,8,7
2019,372,Ireland,Grenada,15,8,7
2019,752,Sweden,Grenada,41,30,11
2019,826,United Kingdom,Grenada,13500,6172,7328
2019,380,Italy,Grenada,16,4,12
2019,724,Spain,Grenada,644,312,332
2019,40,Austria,Grenada,17,7,10
2019,528,Netherlands,Grenada,49,19,30
2019,756,Switzerland,Grenada,44,20,24
2019,124,Canada,Grenada,10932,4332,6600
2019,840,United States of America,Grenada,38501,16512,21989
1990,792,Turkey,Guadeloupe,11,6,5
1990,28,Antigua and Barbuda,Guadeloupe,46,22,24
1990,535,"Bonaire, Sint Eustatius and Saba",Guadeloupe,61,31,30
1990,212,Dominica,Guadeloupe,14,5,9
1990,214,Dominican Republic,Guadeloupe,97,68,29
1990,474,Martinique,Guadeloupe,3327,1192,2135
1990,662,Saint Lucia,Guadeloupe,19,5,14
1990,152,Chile,Guadeloupe,2,1,1
1990,254,French Guiana,Guadeloupe,2089,1179,910
1990,36,Australia,Guadeloupe,9,3,6
1990,208,Denmark,Guadeloupe,8,6,2
1990,300,Greece,Guadeloupe,20,11,9
1990,124,Canada,Guadeloupe,125,61,64
1995,792,Turkey,Guadeloupe,27,14,13
1995,28,Antigua and Barbuda,Guadeloupe,54,26,28
1995,535,"Bonaire, Sint Eustatius and Saba",Guadeloupe,127,64,63
1995,212,Dominica,Guadeloupe,19,7,12
1995,214,Dominican Republic,Guadeloupe,108,75,33
1995,474,Martinique,Guadeloupe,4074,1449,2625
1995,662,Saint Lucia,Guadeloupe,25,6,19
1995,152,Chile,Guadeloupe,4,2,2
1995,254,French Guiana,Guadeloupe,2180,1188,992
1995,36,Australia,Guadeloupe,4,1,3
1995,208,Denmark,Guadeloupe,4,3,1
1995,300,Greece,Guadeloupe,20,11,9
1995,124,Canada,Guadeloupe,233,113,120
2000,792,Turkey,Guadeloupe,44,21,23
2000,28,Antigua and Barbuda,Guadeloupe,62,30,32
2000,535,"Bonaire, Sint Eustatius and Saba",Guadeloupe,193,96,97
2000,212,Dominica,Guadeloupe,23,9,14
2000,214,Dominican Republic,Guadeloupe,118,81,37
2000,474,Martinique,Guadeloupe,4821,1705,3116
2000,662,Saint Lucia,Guadeloupe,34,8,26
2000,152,Chile,Guadeloupe,7,2,5
2000,254,French Guiana,Guadeloupe,2271,1198,1073
2000,36,Australia,Guadeloupe,10,5,5
2000,300,Greece,Guadeloupe,20,10,10
2000,124,Canada,Guadeloupe,347,168,179
2005,792,Turkey,Guadeloupe,45,21,24
2005,28,Antigua and Barbuda,Guadeloupe,67,32,35
2005,535,"Bonaire, Sint Eustatius and Saba",Guadeloupe,205,102,103
2005,212,Dominica,Guadeloupe,27,10,17
2005,214,Dominican Republic,Guadeloupe,86,56,30
2005,474,Martinique,Guadeloupe,5045,1703,3342
2005,662,Saint Lucia,Guadeloupe,32,7,25
2005,534,Sint Maarten (Dutch part),Guadeloupe,984,460,524
2005,152,Chile,Guadeloupe,10,3,7
2005,254,French Guiana,Guadeloupe,2140,1121,1019
2005,36,Australia,Guadeloupe,20,10,10
2005,300,Greece,Guadeloupe,10,5,5
2005,124,Canada,Guadeloupe,454,237,217
2010,466,Mali,Guadeloupe,767,346,421
2010,792,Turkey,Guadeloupe,46,21,25
2010,28,Antigua and Barbuda,Guadeloupe,71,34,37
2010,535,"Bonaire, Sint Eustatius and Saba",Guadeloupe,24,21,3
2010,531,Curaçao,Guadeloupe,87,38,49
2010,212,Dominica,Guadeloupe,33,11,22
2010,214,Dominican Republic,Guadeloupe,53,31,22
2010,474,Martinique,Guadeloupe,5270,1702,3568
2010,662,Saint Lucia,Guadeloupe,29,6,23
2010,534,Sint Maarten (Dutch part),Guadeloupe,1968,919,1049
2010,152,Chile,Guadeloupe,14,5,9
2010,254,French Guiana,Guadeloupe,2009,1044,965
2010,36,Australia,Guadeloupe,20,10,10
2010,124,Canada,Guadeloupe,430,235,195
2015,466,Mali,Guadeloupe,950,429,521
2015,792,Turkey,Guadeloupe,46,21,25
2015,28,Antigua and Barbuda,Guadeloupe,76,37,39
2015,535,"Bonaire, Sint Eustatius and Saba",Guadeloupe,27,24,3
2015,531,Curaçao,Guadeloupe,94,41,53
2015,212,Dominica,Guadeloupe,38,12,26
2015,214,Dominican Republic,Guadeloupe,55,32,23
2015,474,Martinique,Guadeloupe,5460,1732,3728
2015,662,Saint Lucia,Guadeloupe,27,6,21
2015,534,Sint Maarten (Dutch part),Guadeloupe,2051,956,1095
2015,152,Chile,Guadeloupe,21,8,13
2015,254,French Guiana,Guadeloupe,2021,1039,982
2015,36,Australia,Guadeloupe,20,12,8
2015,124,Canada,Guadeloupe,511,243,268
2019,466,Mali,Guadeloupe,1057,477,580
2019,792,Turkey,Guadeloupe,62,29,33
2019,28,Antigua and Barbuda,Guadeloupe,79,39,40
2019,535,"Bonaire, Sint Eustatius and Saba",Guadeloupe,32,29,3
2019,531,Curaçao,Guadeloupe,102,45,57
2019,212,Dominica,Guadeloupe,38,12,26
2019,214,Dominican Republic,Guadeloupe,56,33,23
2019,474,Martinique,Guadeloupe,5452,1730,3722
2019,662,Saint Lucia,Guadeloupe,26,6,20
2019,534,Sint Maarten (Dutch part),Guadeloupe,2123,990,1133
2019,152,Chile,Guadeloupe,28,10,18
2019,254,French Guiana,Guadeloupe,2235,1149,1086
2019,36,Australia,Guadeloupe,21,12,9
2019,124,Canada,Guadeloupe,547,260,287
1990,608,Philippines,Guam,58,38,20
1990,188,Costa Rica,Guam,5,3,2
1990,152,Chile,Guam,1,1,0
1990,36,Australia,Guam,40,19,21
1990,583,Micronesia (Fed. States of),Guam,55,32,23
1990,580,Northern Mariana Islands,Guam,1062,508,554
1990,585,Palau,Guam,152,90,62
1990,300,Greece,Guam,2,2,0
1990,40,Austria,Guam,1,1,0
1995,608,Philippines,Guam,78,51,27
1995,188,Costa Rica,Guam,4,2,2
1995,152,Chile,Guam,2,2,0
1995,36,Australia,Guam,36,15,21
1995,583,Micronesia (Fed. States of),Guam,49,32,17
1995,580,Northern Mariana Islands,Guam,1186,612,574
1995,585,Palau,Guam,258,136,122
1995,300,Greece,Guam,2,2,0
1995,40,Austria,Guam,1,1,0
2000,608,Philippines,Guam,1056,483,573
2000,188,Costa Rica,Guam,4,2,2
2000,152,Chile,Guam,4,2,2
2000,36,Australia,Guam,50,25,25
2000,583,Micronesia (Fed. States of),Guam,45,26,19
2000,580,Northern Mariana Islands,Guam,1382,718,664
2000,585,Palau,Guam,256,130,126
2000,300,Greece,Guam,3,2,1
2000,40,Austria,Guam,1,1,0
2005,608,Philippines,Guam,854,398,456
2005,188,Costa Rica,Guam,3,2,1
2005,152,Chile,Guam,6,4,2
2005,36,Australia,Guam,80,40,40
2005,583,Micronesia (Fed. States of),Guam,41,23,18
2005,580,Northern Mariana Islands,Guam,1280,624,656
2005,585,Palau,Guam,274,140,134
2005,300,Greece,Guam,2,1,1
2005,40,Austria,Guam,1,1,0
2010,608,Philippines,Guam,992,442,550
2010,188,Costa Rica,Guam,5,2,3
2010,152,Chile,Guam,8,5,3
2010,36,Australia,Guam,100,50,50
2010,583,Micronesia (Fed. States of),Guam,39,22,17
2010,580,Northern Mariana Islands,Guam,810,358,452
2010,585,Palau,Guam,262,128,134
2010,40,Austria,Guam,1,1,0
2015,608,Philippines,Guam,1008,451,557
2015,188,Costa Rica,Guam,5,2,3
2015,152,Chile,Guam,12,8,4
2015,36,Australia,Guam,120,66,54
2015,583,Micronesia (Fed. States of),Guam,38,22,16
2015,580,Northern Mariana Islands,Guam,726,319,407
2015,585,Palau,Guam,235,121,114
2015,40,Austria,Guam,1,1,0
2019,608,Philippines,Guam,1039,465,574
2019,188,Costa Rica,Guam,5,2,3
2019,152,Chile,Guam,16,11,5
2019,36,Australia,Guam,126,64,62
2019,583,Micronesia (Fed. States of),Guam,38,22,16
2019,580,Northern Mariana Islands,Guam,731,321,410
2019,585,Palau,Guam,241,113,128
2019,40,Austria,Guam,1,1,0
1990,710,South Africa,Guatemala,90,54,36
1990,818,Egypt,Guatemala,7,2,5
1990,608,Philippines,Guatemala,9,4,5
1990,44,Bahamas,Guatemala,7,1,6
1990,192,Cuba,Guatemala,153,75,78
1990,214,Dominican Republic,Guatemala,475,337,138
1990,388,Jamaica,Guatemala,295,123,172
1990,630,Puerto Rico,Guatemala,487,231,256
1990,662,Saint Lucia,Guatemala,2,1,1
1990,84,Belize,Guatemala,12650,6504,6146
1990,188,Costa Rica,Guatemala,1977,1026,951
1990,222,El Salvador,Guatemala,8235,3739,4496
1990,340,Honduras,Guatemala,3250,1713,1537
1990,484,Mexico,Guatemala,72343,36574,35769
1990,558,Nicaragua,Guatemala,1134,583,551
1990,591,Panama,Guatemala,376,191,185
1990,32,Argentina,Guatemala,116,93,23
1990,68,Bolivia (Plurinational State of),Guatemala,146,69,77
1990,76,Brazil,Guatemala,53,15,38
1990,152,Chile,Guatemala,143,88,55
1990,170,Colombia,Guatemala,264,105,159
1990,218,Ecuador,Guatemala,144,70,74
1990,604,Peru,Guatemala,100,50,50
1990,862,Venezuela (Bolivarian Republic of),Guatemala,579,268,311
1990,36,Australia,Guatemala,217,108,109
1990,100,Bulgaria,Guatemala,1,0,1
1990,203,Czechia,Guatemala,2,1,1
1990,348,Hungary,Guatemala,6,2,4
1990,208,Denmark,Guatemala,22,11,11
1990,246,Finland,Guatemala,16,12,4
1990,352,Iceland,Guatemala,14,8,6
1990,372,Ireland,Guatemala,24,12,12
1990,578,Norway,Guatemala,208,108,100
1990,752,Sweden,Guatemala,517,277,240
1990,826,United Kingdom,Guatemala,69,38,31
1990,300,Greece,Guatemala,41,23,18
1990,380,Italy,Guatemala,108,38,70
1990,620,Portugal,Guatemala,7,2,5
1990,724,Spain,Guatemala,975,344,631
1990,40,Austria,Guatemala,206,105,101
1990,56,Belgium,Guatemala,5732,3384,2348
1990,250,France,Guatemala,1614,797,817
1990,276,Germany,Guatemala,583,277,306
1990,528,Netherlands,Guatemala,165,83,82
1990,756,Switzerland,Guatemala,472,195,277
1990,124,Canada,Guatemala,8559,4167,4392
1990,840,United States of America,Guatemala,225739,113994,111745
1995,710,South Africa,Guatemala,56,36,20
1995,818,Egypt,Guatemala,7,3,4
1995,608,Philippines,Guatemala,12,6,6
1995,44,Bahamas,Guatemala,8,2,6
1995,192,Cuba,Guatemala,116,54,62
1995,214,Dominican Republic,Guatemala,528,371,157
1995,388,Jamaica,Guatemala,311,132,179
1995,630,Puerto Rico,Guatemala,515,244,271
1995,662,Saint Lucia,Guatemala,2,2,0
1995,84,Belize,Guatemala,14350,7178,7172
1995,188,Costa Rica,Guatemala,1602,842,760
1995,222,El Salvador,Guatemala,7224,3298,3926
1995,340,Honduras,Guatemala,3336,1705,1631
1995,484,Mexico,Guatemala,49676,26336,23340
1995,558,Nicaragua,Guatemala,900,459,441
1995,591,Panama,Guatemala,473,242,231
1995,32,Argentina,Guatemala,158,93,65
1995,68,Bolivia (Plurinational State of),Guatemala,144,68,76
1995,76,Brazil,Guatemala,106,66,40
1995,152,Chile,Guatemala,181,87,94
1995,170,Colombia,Guatemala,305,131,174
1995,218,Ecuador,Guatemala,162,79,83
1995,604,Peru,Guatemala,101,49,52
1995,862,Venezuela (Bolivarian Republic of),Guatemala,501,236,265
1995,36,Australia,Guatemala,276,138,138
1995,100,Bulgaria,Guatemala,2,0,2
1995,203,Czechia,Guatemala,3,2,1
1995,348,Hungary,Guatemala,9,3,6
1995,208,Denmark,Guatemala,78,37,41
1995,246,Finland,Guatemala,21,16,5
1995,352,Iceland,Guatemala,21,12,9
1995,372,Ireland,Guatemala,66,30,36
1995,578,Norway,Guatemala,234,124,110
1995,752,Sweden,Guatemala,613,325,288
1995,826,United Kingdom,Guatemala,272,114,158
1995,300,Greece,Guatemala,37,15,22
1995,380,Italy,Guatemala,353,79,274
1995,620,Portugal,Guatemala,15,4,11
1995,724,Spain,Guatemala,1214,432,782
1995,40,Austria,Guatemala,232,120,112
1995,56,Belgium,Guatemala,5692,3355,2337
1995,250,France,Guatemala,1667,809,858
1995,276,Germany,Guatemala,618,264,354
1995,528,Netherlands,Guatemala,242,118,124
1995,756,Switzerland,Guatemala,577,260,317
1995,124,Canada,Guatemala,11127,5386,5741
1995,840,United States of America,Guatemala,357929,181531,176398
2000,710,South Africa,Guatemala,38,26,12
2000,818,Egypt,Guatemala,7,3,4
2000,608,Philippines,Guatemala,276,111,165
2000,44,Bahamas,Guatemala,9,3,6
2000,192,Cuba,Guatemala,79,34,45
2000,214,Dominican Republic,Guatemala,580,404,176
2000,388,Jamaica,Guatemala,326,141,185
2000,630,Puerto Rico,Guatemala,546,259,287
2000,662,Saint Lucia,Guatemala,4,3,1
2000,84,Belize,Guatemala,16058,7853,8205
2000,188,Costa Rica,Guatemala,2029,1050,979
2000,222,El Salvador,Guatemala,6212,2857,3355
2000,340,Honduras,Guatemala,3421,1697,1724
2000,484,Mexico,Guatemala,29156,17372,11784
2000,558,Nicaragua,Guatemala,1199,624,575
2000,591,Panama,Guatemala,600,307,293
2000,32,Argentina,Guatemala,201,94,107
2000,68,Bolivia (Plurinational State of),Guatemala,141,67,74
2000,76,Brazil,Guatemala,158,116,42
2000,152,Chile,Guatemala,220,105,115
2000,170,Colombia,Guatemala,346,157,189
2000,218,Ecuador,Guatemala,179,87,92
2000,604,Peru,Guatemala,119,58,61
2000,862,Venezuela (Bolivarian Republic of),Guatemala,433,208,225
2000,36,Australia,Guatemala,310,154,156
2000,100,Bulgaria,Guatemala,3,0,3
2000,203,Czechia,Guatemala,4,3,1
2000,348,Hungary,Guatemala,12,5,7
2000,208,Denmark,Guatemala,133,62,71
2000,246,Finland,Guatemala,25,19,6
2000,352,Iceland,Guatemala,27,16,11
2000,372,Ireland,Guatemala,145,69,76
2000,578,Norway,Guatemala,285,145,140
2000,752,Sweden,Guatemala,658,347,311
2000,826,United Kingdom,Guatemala,481,192,289
2000,300,Greece,Guatemala,33,7,26
2000,380,Italy,Guatemala,598,120,478
2000,620,Portugal,Guatemala,25,7,18
2000,724,Spain,Guatemala,1977,728,1249
2000,40,Austria,Guatemala,258,135,123
2000,56,Belgium,Guatemala,5493,3247,2246
2000,250,France,Guatemala,1719,820,899
2000,276,Germany,Guatemala,653,251,402
2000,528,Netherlands,Guatemala,328,157,171
2000,756,Switzerland,Guatemala,686,327,359
2000,124,Canada,Guatemala,13960,6734,7226
2000,840,United States of America,Guatemala,492870,250780,242090
2005,710,South Africa,Guatemala,50,35,15
2005,818,Egypt,Guatemala,8,4,4
2005,608,Philippines,Guatemala,223,92,131
2005,44,Bahamas,Guatemala,21,9,12
2005,192,Cuba,Guatemala,52,22,30
2005,214,Dominican Republic,Guatemala,495,313,182
2005,388,Jamaica,Guatemala,318,139,179
2005,630,Puerto Rico,Guatemala,563,267,296
2005,662,Saint Lucia,Guatemala,4,3,1
2005,84,Belize,Guatemala,18022,8763,9259
2005,188,Costa Rica,Guatemala,1329,679,650
2005,222,El Salvador,Guatemala,7367,3417,3950
2005,340,Honduras,Guatemala,3351,1682,1669
2005,484,Mexico,Guatemala,29322,15299,14023
2005,558,Nicaragua,Guatemala,1529,802,727
2005,591,Panama,Guatemala,960,523,437
2005,32,Argentina,Guatemala,149,71,78
2005,68,Bolivia (Plurinational State of),Guatemala,132,68,64
2005,76,Brazil,Guatemala,225,135,90
2005,152,Chile,Guatemala,330,161,169
2005,170,Colombia,Guatemala,357,167,190
2005,218,Ecuador,Guatemala,211,105,106
2005,604,Peru,Guatemala,140,68,72
2005,862,Venezuela (Bolivarian Republic of),Guatemala,425,201,224
2005,36,Australia,Guatemala,350,162,188
2005,100,Bulgaria,Guatemala,5,1,4
2005,203,Czechia,Guatemala,18,8,10
2005,348,Hungary,Guatemala,15,7,8
2005,208,Denmark,Guatemala,182,86,96
2005,246,Finland,Guatemala,46,30,16
2005,352,Iceland,Guatemala,30,17,13
2005,372,Ireland,Guatemala,145,74,71
2005,578,Norway,Guatemala,355,183,172
2005,752,Sweden,Guatemala,695,367,328
2005,826,United Kingdom,Guatemala,679,269,410
2005,300,Greece,Guatemala,32,6,26
2005,380,Italy,Guatemala,1367,476,891
2005,620,Portugal,Guatemala,28,11,17
2005,724,Spain,Guatemala,3643,1439,2204
2005,40,Austria,Guatemala,289,148,141
2005,56,Belgium,Guatemala,540,245,295
2005,250,France,Guatemala,2817,1472,1345
2005,276,Germany,Guatemala,1221,534,687
2005,528,Netherlands,Guatemala,547,281,266
2005,756,Switzerland,Guatemala,769,346,423
2005,124,Canada,Guatemala,14401,7168,7233
2005,840,United States of America,Guatemala,643349,329093,314256
2010,710,South Africa,Guatemala,78,55,23
2010,818,Egypt,Guatemala,9,5,4
2010,608,Philippines,Guatemala,34,14,20
2010,44,Bahamas,Guatemala,32,15,17
2010,192,Cuba,Guatemala,28,12,16
2010,214,Dominican Republic,Guatemala,406,219,187
2010,388,Jamaica,Guatemala,309,136,173
2010,630,Puerto Rico,Guatemala,511,240,271
2010,662,Saint Lucia,Guatemala,4,3,1
2010,84,Belize,Guatemala,19995,9723,10272
2010,188,Costa Rica,Guatemala,2620,1343,1277
2010,222,El Salvador,Guatemala,8521,3977,4544
2010,340,Honduras,Guatemala,3280,1667,1613
2010,484,Mexico,Guatemala,32888,15022,17866
2010,558,Nicaragua,Guatemala,1634,863,771
2010,591,Panama,Guatemala,1367,771,596
2010,32,Argentina,Guatemala,96,48,48
2010,68,Bolivia (Plurinational State of),Guatemala,122,68,54
2010,76,Brazil,Guatemala,289,153,136
2010,152,Chile,Guatemala,440,216,224
2010,170,Colombia,Guatemala,429,209,220
2010,218,Ecuador,Guatemala,296,143,153
2010,604,Peru,Guatemala,156,76,80
2010,862,Venezuela (Bolivarian Republic of),Guatemala,422,197,225
2010,36,Australia,Guatemala,410,192,218
2010,100,Bulgaria,Guatemala,6,1,5
2010,203,Czechia,Guatemala,30,13,17
2010,348,Hungary,Guatemala,18,9,9
2010,208,Denmark,Guatemala,226,108,118
2010,233,Estonia,Guatemala,7,4,3
2010,246,Finland,Guatemala,76,46,30
2010,352,Iceland,Guatemala,32,17,15
2010,372,Ireland,Guatemala,122,58,64
2010,578,Norway,Guatemala,390,201,189
2010,752,Sweden,Guatemala,760,396,364
2010,826,United Kingdom,Guatemala,715,292,423
2010,300,Greece,Guatemala,32,6,26
2010,380,Italy,Guatemala,2107,805,1302
2010,620,Portugal,Guatemala,27,13,14
2010,705,Slovenia,Guatemala,1,0,1
2010,724,Spain,Guatemala,6440,2649,3791
2010,40,Austria,Guatemala,319,160,159
2010,56,Belgium,Guatemala,745,353,392
2010,250,France,Guatemala,2811,1308,1503
2010,276,Germany,Guatemala,1693,776,917
2010,528,Netherlands,Guatemala,632,314,318
2010,756,Switzerland,Guatemala,907,379,528
2010,124,Canada,Guatemala,15285,7838,7447
2010,840,United States of America,Guatemala,817495,412680,404815
2015,710,South Africa,Guatemala,139,97,42
2015,818,Egypt,Guatemala,6,4,2
2015,608,Philippines,Guatemala,34,13,21
2015,44,Bahamas,Guatemala,35,16,19
2015,192,Cuba,Guatemala,22,10,12
2015,214,Dominican Republic,Guatemala,428,231,197
2015,388,Jamaica,Guatemala,302,133,169
2015,630,Puerto Rico,Guatemala,381,178,203
2015,662,Saint Lucia,Guatemala,3,3,0
2015,84,Belize,Guatemala,23580,11393,12187
2015,188,Costa Rica,Guatemala,2660,1356,1304
2015,222,El Salvador,Guatemala,8885,4153,4732
2015,340,Honduras,Guatemala,4607,2347,2260
2015,484,Mexico,Guatemala,42850,19934,22916
2015,558,Nicaragua,Guatemala,1762,935,827
2015,591,Panama,Guatemala,1606,904,702
2015,32,Argentina,Guatemala,96,48,48
2015,68,Bolivia (Plurinational State of),Guatemala,142,79,63
2015,76,Brazil,Guatemala,348,184,164
2015,152,Chile,Guatemala,666,320,346
2015,170,Colombia,Guatemala,480,237,243
2015,218,Ecuador,Guatemala,430,206,224
2015,604,Peru,Guatemala,166,84,82
2015,862,Venezuela (Bolivarian Republic of),Guatemala,428,197,231
2015,36,Australia,Guatemala,540,258,282
2015,100,Bulgaria,Guatemala,4,2,2
2015,203,Czechia,Guatemala,35,18,17
2015,348,Hungary,Guatemala,17,10,7
2015,208,Denmark,Guatemala,250,125,125
2015,233,Estonia,Guatemala,10,6,4
2015,246,Finland,Guatemala,90,55,35
2015,352,Iceland,Guatemala,37,20,17
2015,372,Ireland,Guatemala,125,59,66
2015,428,Latvia,Guatemala,1,1,0
2015,578,Norway,Guatemala,449,224,225
2015,752,Sweden,Guatemala,809,427,382
2015,826,United Kingdom,Guatemala,914,358,556
2015,300,Greece,Guatemala,30,5,25
2015,380,Italy,Guatemala,2121,797,1324
2015,620,Portugal,Guatemala,30,13,17
2015,705,Slovenia,Guatemala,1,0,1
2015,724,Spain,Guatemala,7411,2832,4579
2015,40,Austria,Guatemala,372,188,184
2015,56,Belgium,Guatemala,832,400,432
2015,250,France,Guatemala,3114,1403,1711
2015,276,Germany,Guatemala,1764,806,958
2015,528,Netherlands,Guatemala,756,381,375
2015,756,Switzerland,Guatemala,1027,427,600
2015,124,Canada,Guatemala,17169,8603,8566
2015,840,United States of America,Guatemala,991516,498006,493510
2019,710,South Africa,Guatemala,154,108,46
2019,818,Egypt,Guatemala,8,5,3
2019,608,Philippines,Guatemala,35,14,21
2019,44,Bahamas,Guatemala,37,17,20
2019,192,Cuba,Guatemala,20,9,11
2019,214,Dominican Republic,Guatemala,442,239,203
2019,388,Jamaica,Guatemala,305,134,171
2019,630,Puerto Rico,Guatemala,357,167,190
2019,662,Saint Lucia,Guatemala,2,2,0
2019,84,Belize,Guatemala,25876,12503,13373
2019,188,Costa Rica,Guatemala,2699,1385,1314
2019,222,El Salvador,Guatemala,9005,4209,4796
2019,340,Honduras,Guatemala,4681,2385,2296
2019,484,Mexico,Guatemala,44178,20552,23626
2019,558,Nicaragua,Guatemala,1845,979,866
2019,591,Panama,Guatemala,1705,961,744
2019,32,Argentina,Guatemala,97,49,48
2019,68,Bolivia (Plurinational State of),Guatemala,155,87,68
2019,76,Brazil,Guatemala,391,207,184
2019,152,Chile,Guatemala,889,401,488
2019,170,Colombia,Guatemala,490,242,248
2019,218,Ecuador,Guatemala,423,203,220
2019,604,Peru,Guatemala,197,104,93
2019,862,Venezuela (Bolivarian Republic of),Guatemala,419,192,227
2019,36,Australia,Guatemala,603,291,312
2019,100,Bulgaria,Guatemala,4,2,2
2019,203,Czechia,Guatemala,43,25,18
2019,348,Hungary,Guatemala,26,13,13
2019,208,Denmark,Guatemala,261,130,131
2019,233,Estonia,Guatemala,11,9,2
2019,246,Finland,Guatemala,103,61,42
2019,352,Iceland,Guatemala,45,26,19
2019,372,Ireland,Guatemala,137,65,72
2019,578,Norway,Guatemala,491,243,248
2019,752,Sweden,Guatemala,851,439,412
2019,826,United Kingdom,Guatemala,1037,408,629
2019,300,Greece,Guatemala,29,6,23
2019,380,Italy,Guatemala,2299,880,1419
2019,620,Portugal,Guatemala,30,13,17
2019,705,Slovenia,Guatemala,1,0,1
2019,724,Spain,Guatemala,7678,2820,4858
2019,40,Austria,Guatemala,439,226,213
2019,56,Belgium,Guatemala,875,416,459
2019,250,France,Guatemala,3296,1481,1815
2019,276,Germany,Guatemala,1935,975,960
2019,528,Netherlands,Guatemala,835,418,417
2019,756,Switzerland,Guatemala,1131,468,663
2019,124,Canada,Guatemala,18398,9219,9179
2019,840,United States of America,Guatemala,1070743,532063,538680
1990,24,Angola,Guinea,131,63,68
1990,266,Gabon,Guinea,1539,1136,403
1990,516,Namibia,Guinea,79,48,31
1990,710,South Africa,Guinea,78,42,36
1990,132,Cabo Verde,Guinea,60,30,30
1990,384,Côte d'Ivoire,Guinea,133914,72699,61215
1990,270,Gambia,Guinea,24859,15134,9725
1990,288,Ghana,Guinea,74,44,30
1990,624,Guinea-Bissau,Guinea,3170,1692,1478
1990,430,Liberia,Guinea,32485,19453,13032
1990,466,Mali,Guinea,19164,9484,9680
1990,478,Mauritania,Guinea,2748,851,1897
1990,686,Senegal,Guinea,42570,26752,15818
1990,694,Sierra Leone,Guinea,74272,43901,30371
1990,768,Togo,Guinea,1553,814,739
1990,818,Egypt,Guinea,182,172,10
1990,504,Morocco,Guinea,673,356,317
1990,732,Western Sahara,Guinea,495,301,194
1990,32,Argentina,Guinea,1,0,1
1990,68,Bolivia (Plurinational State of),Guinea,4,0,4
1990,36,Australia,Guinea,33,16,17
1990,100,Bulgaria,Guinea,4,3,1
1990,203,Czechia,Guinea,6,5,1
1990,348,Hungary,Guinea,15,15,0
1990,616,Poland,Guinea,17,12,5
1990,642,Romania,Guinea,1,1,0
1990,643,Russian Federation,Guinea,429,211,218
1990,208,Denmark,Guinea,21,16,5
1990,246,Finland,Guinea,6,5,1
1990,352,Iceland,Guinea,3,2,1
1990,372,Ireland,Guinea,10,6,4
1990,578,Norway,Guinea,29,20,9
1990,752,Sweden,Guinea,88,54,34
1990,826,United Kingdom,Guinea,36,25,11
1990,300,Greece,Guinea,11,6,5
1990,380,Italy,Guinea,103,36,67
1990,620,Portugal,Guinea,86,71,15
1990,724,Spain,Guinea,2316,1167,1149
1990,40,Austria,Guinea,166,131,35
1990,56,Belgium,Guinea,795,547,248
1990,250,France,Guinea,7816,4414,3402
1990,276,Germany,Guinea,697,561,136
1990,528,Netherlands,Guinea,392,326,66
1990,756,Switzerland,Guinea,375,293,82
1990,124,Canada,Guinea,225,110,115
1990,840,United States of America,Guinea,1032,505,527
1995,24,Angola,Guinea,152,69,83
1995,266,Gabon,Guinea,2058,1518,540
1995,516,Namibia,Guinea,75,46,29
1995,710,South Africa,Guinea,48,28,20
1995,132,Cabo Verde,Guinea,80,41,39
1995,384,Côte d'Ivoire,Guinea,135616,73199,62417
1995,270,Gambia,Guinea,30668,18191,12477
1995,288,Ghana,Guinea,74,47,27
1995,624,Guinea-Bissau,Guinea,4069,2238,1831
1995,430,Liberia,Guinea,32238,19217,13021
1995,466,Mali,Guinea,17896,8858,9038
1995,478,Mauritania,Guinea,2936,1098,1838
1995,686,Senegal,Guinea,44519,27867,16652
1995,694,Sierra Leone,Guinea,72442,41993,30449
1995,768,Togo,Guinea,1749,917,832
1995,818,Egypt,Guinea,138,128,10
1995,504,Morocco,Guinea,618,323,295
1995,732,Western Sahara,Guinea,550,338,212
1995,32,Argentina,Guinea,1,0,1
1995,68,Bolivia (Plurinational State of),Guinea,3,0,3
1995,152,Chile,Guinea,2,1,1
1995,36,Australia,Guinea,17,9,8
1995,100,Bulgaria,Guinea,5,4,1
1995,203,Czechia,Guinea,9,8,1
1995,348,Hungary,Guinea,22,19,3
1995,616,Poland,Guinea,14,10,4
1995,642,Romania,Guinea,1,1,0
1995,643,Russian Federation,Guinea,397,221,176
1995,208,Denmark,Guinea,38,22,16
1995,246,Finland,Guinea,7,6,1
1995,352,Iceland,Guinea,5,3,2
1995,372,Ireland,Guinea,27,15,12
1995,578,Norway,Guinea,27,16,11
1995,752,Sweden,Guinea,104,64,40
1995,826,United Kingdom,Guinea,144,84,60
1995,300,Greece,Guinea,17,11,6
1995,380,Italy,Guinea,690,421,269
1995,620,Portugal,Guinea,186,153,33
1995,724,Spain,Guinea,2825,1472,1353
1995,40,Austria,Guinea,188,149,39
1995,56,Belgium,Guinea,793,545,248
1995,250,France,Guinea,8069,4498,3571
1995,276,Germany,Guinea,1345,1086,259
1995,528,Netherlands,Guinea,577,478,99
1995,756,Switzerland,Guinea,575,431,144
1995,124,Canada,Guinea,764,369,395
1995,840,United States of America,Guinea,3086,1532,1554
2000,24,Angola,Guinea,173,76,97
2000,266,Gabon,Guinea,2574,1904,670
2000,516,Namibia,Guinea,71,43,28
2000,710,South Africa,Guinea,33,21,12
2000,132,Cabo Verde,Guinea,99,51,48
2000,384,Côte d'Ivoire,Guinea,141314,76237,65077
2000,270,Gambia,Guinea,38423,22393,16030
2000,288,Ghana,Guinea,82,49,33
2000,624,Guinea-Bissau,Guinea,4968,2785,2183
2000,430,Liberia,Guinea,31145,18020,13125
2000,466,Mali,Guinea,14659,7307,7352
2000,478,Mauritania,Guinea,3042,1332,1710
2000,686,Senegal,Guinea,40236,24685,15551
2000,694,Sierra Leone,Guinea,70385,39660,30725
2000,768,Togo,Guinea,1970,1033,937
2000,818,Egypt,Guinea,105,95,10
2000,504,Morocco,Guinea,651,335,316
2000,732,Western Sahara,Guinea,606,376,230
2000,32,Argentina,Guinea,1,0,1
2000,68,Bolivia (Plurinational State of),Guinea,1,0,1
2000,152,Chile,Guinea,4,1,3
2000,36,Australia,Guinea,30,15,15
2000,100,Bulgaria,Guinea,6,5,1
2000,203,Czechia,Guinea,11,10,1
2000,348,Hungary,Guinea,29,24,5
2000,616,Poland,Guinea,12,8,4
2000,642,Romania,Guinea,1,1,0
2000,643,Russian Federation,Guinea,351,222,129
2000,208,Denmark,Guinea,54,28,26
2000,246,Finland,Guinea,8,7,1
2000,352,Iceland,Guinea,7,5,2
2000,372,Ireland,Guinea,59,34,25
2000,578,Norway,Guinea,30,15,15
2000,752,Sweden,Guinea,112,68,44
2000,826,United Kingdom,Guinea,255,143,112
2000,300,Greece,Guinea,24,16,8
2000,380,Italy,Guinea,1276,805,471
2000,620,Portugal,Guinea,295,241,54
2000,705,Slovenia,Guinea,6,6,0
2000,724,Spain,Guinea,4551,2448,2103
2000,40,Austria,Guinea,209,166,43
2000,56,Belgium,Guinea,767,528,239
2000,250,France,Guinea,8321,4581,3740
2000,276,Germany,Guinea,1993,1612,381
2000,528,Netherlands,Guinea,784,647,137
2000,756,Switzerland,Guinea,778,570,208
2000,124,Canada,Guinea,1322,638,684
2000,840,United States of America,Guinea,5190,2587,2603
2005,24,Angola,Guinea,224,95,129
2005,120,Cameroon,Guinea,4605,2222,2383
2005,266,Gabon,Guinea,2807,2084,723
2005,516,Namibia,Guinea,56,34,22
2005,710,South Africa,Guinea,43,28,15
2005,132,Cabo Verde,Guinea,249,121,128
2005,384,Côte d'Ivoire,Guinea,147939,79811,68128
2005,270,Gambia,Guinea,38128,22113,16015
2005,288,Ghana,Guinea,115,71,44
2005,624,Guinea-Bissau,Guinea,4813,2580,2233
2005,430,Liberia,Guinea,25289,15913,9376
2005,466,Mali,Guinea,16303,8075,8228
2005,478,Mauritania,Guinea,3068,1412,1656
2005,686,Senegal,Guinea,43297,27027,16270
2005,694,Sierra Leone,Guinea,56539,31348,25191
2005,768,Togo,Guinea,2219,1164,1055
2005,818,Egypt,Guinea,125,114,11
2005,504,Morocco,Guinea,668,339,329
2005,732,Western Sahara,Guinea,717,453,264
2005,32,Argentina,Guinea,1,0,1
2005,68,Bolivia (Plurinational State of),Guinea,5,3,2
2005,76,Brazil,Guinea,28,16,12
2005,152,Chile,Guinea,6,2,4
2005,36,Australia,Guinea,220,126,94
2005,100,Bulgaria,Guinea,8,6,2
2005,203,Czechia,Guinea,43,33,10
2005,348,Hungary,Guinea,36,30,6
2005,616,Poland,Guinea,34,28,6
2005,642,Romania,Guinea,1,1,0
2005,643,Russian Federation,Guinea,278,192,86
2005,208,Denmark,Guinea,73,39,34
2005,246,Finland,Guinea,32,26,6
2005,352,Iceland,Guinea,11,6,5
2005,372,Ireland,Guinea,59,35,24
2005,578,Norway,Guinea,77,44,33
2005,752,Sweden,Guinea,170,109,61
2005,826,United Kingdom,Guinea,1204,653,551
2005,300,Greece,Guinea,105,92,13
2005,380,Italy,Guinea,2587,1756,831
2005,620,Portugal,Guinea,2325,1289,1036
2005,705,Slovenia,Guinea,7,5,2
2005,724,Spain,Guinea,8269,5618,2651
2005,40,Austria,Guinea,234,185,49
2005,56,Belgium,Guinea,1927,1162,765
2005,250,France,Guinea,21387,11600,9787
2005,276,Germany,Guinea,2777,2041,736
2005,528,Netherlands,Guinea,2802,2158,644
2005,756,Switzerland,Guinea,904,647,257
2005,124,Canada,Guinea,2636,1362,1274
2005,840,United States of America,Guinea,9971,4999,4972
2010,24,Angola,Guinea,274,114,160
2010,120,Cameroon,Guinea,3665,1854,1811
2010,266,Gabon,Guinea,3251,2430,821
2010,516,Namibia,Guinea,53,32,21
2010,710,South Africa,Guinea,67,44,23
2010,132,Cabo Verde,Guinea,398,190,208
2010,384,Côte d'Ivoire,Guinea,154564,83357,71207
2010,270,Gambia,Guinea,38965,22564,16401
2010,288,Ghana,Guinea,114,72,42
2010,624,Guinea-Bissau,Guinea,4657,2375,2282
2010,430,Liberia,Guinea,35375,19647,15728
2010,466,Mali,Guinea,29324,15138,14186
2010,478,Mauritania,Guinea,3100,1460,1640
2010,686,Senegal,Guinea,48426,30918,17508
2010,694,Sierra Leone,Guinea,47462,26388,21074
2010,768,Togo,Guinea,2964,1623,1341
2010,818,Egypt,Guinea,135,123,12
2010,504,Morocco,Guinea,747,377,370
2010,732,Western Sahara,Guinea,828,530,298
2010,32,Argentina,Guinea,1,0,1
2010,68,Bolivia (Plurinational State of),Guinea,8,6,2
2010,76,Brazil,Guinea,57,32,25
2010,152,Chile,Guinea,8,3,5
2010,36,Australia,Guinea,660,325,335
2010,100,Bulgaria,Guinea,10,8,2
2010,203,Czechia,Guinea,70,52,18
2010,348,Hungary,Guinea,43,37,6
2010,616,Poland,Guinea,58,48,10
2010,642,Romania,Guinea,2,2,0
2010,643,Russian Federation,Guinea,200,157,43
2010,208,Denmark,Guinea,89,49,40
2010,246,Finland,Guinea,58,51,7
2010,352,Iceland,Guinea,14,6,8
2010,372,Ireland,Guinea,49,27,22
2010,578,Norway,Guinea,164,86,78
2010,752,Sweden,Guinea,339,225,114
2010,826,United Kingdom,Guinea,1268,700,568
2010,300,Greece,Guinea,193,176,17
2010,380,Italy,Guinea,3646,2500,1146
2010,620,Portugal,Guinea,3970,2126,1844
2010,705,Slovenia,Guinea,8,5,3
2010,724,Spain,Guinea,12192,8539,3653
2010,40,Austria,Guinea,258,203,55
2010,56,Belgium,Guinea,5150,2936,2214
2010,250,France,Guinea,28367,15155,13212
2010,276,Germany,Guinea,3423,2400,1023
2010,528,Netherlands,Guinea,2464,1731,733
2010,756,Switzerland,Guinea,1029,723,306
2010,124,Canada,Guinea,3795,2006,1789
2010,840,United States of America,Guinea,15184,7508,7676
2015,24,Angola,Guinea,324,133,191
2015,120,Cameroon,Guinea,4681,2056,2625
2015,266,Gabon,Guinea,4546,3558,988
2015,516,Namibia,Guinea,51,31,20
2015,710,South Africa,Guinea,119,77,42
2015,132,Cabo Verde,Guinea,413,196,217
2015,384,Côte d'Ivoire,Guinea,161189,86930,74259
2015,270,Gambia,Guinea,40369,23347,17022
2015,288,Ghana,Guinea,140,89,51
2015,624,Guinea-Bissau,Guinea,4938,2496,2442
2015,430,Liberia,Guinea,32482,17918,14564
2015,466,Mali,Guinea,36334,18759,17575
2015,478,Mauritania,Guinea,3105,1477,1628
2015,686,Senegal,Guinea,51711,32997,18714
2015,694,Sierra Leone,Guinea,39375,22078,17297
2015,768,Togo,Guinea,3338,1828,1510
2015,818,Egypt,Guinea,100,93,7
2015,504,Morocco,Guinea,973,489,484
2015,732,Western Sahara,Guinea,954,619,335
2015,32,Argentina,Guinea,1,0,1
2015,68,Bolivia (Plurinational State of),Guinea,9,7,2
2015,76,Brazil,Guinea,69,39,30
2015,152,Chile,Guinea,12,5,7
2015,36,Australia,Guinea,940,487,453
2015,100,Bulgaria,Guinea,10,9,1
2015,203,Czechia,Guinea,78,58,20
2015,348,Hungary,Guinea,40,34,6
2015,616,Poland,Guinea,55,46,9
2015,642,Romania,Guinea,49,35,14
2015,643,Russian Federation,Guinea,204,159,45
2015,208,Denmark,Guinea,119,72,47
2015,246,Finland,Guinea,109,87,22
2015,352,Iceland,Guinea,18,10,8
2015,372,Ireland,Guinea,50,27,23
2015,578,Norway,Guinea,276,141,135
2015,752,Sweden,Guinea,528,339,189
2015,826,United Kingdom,Guinea,1621,874,747
2015,300,Greece,Guinea,54,27,27
2015,380,Italy,Guinea,4074,2829,1245
2015,620,Portugal,Guinea,4500,2303,2197
2015,705,Slovenia,Guinea,5,3,2
2015,724,Spain,Guinea,9689,6209,3480
2015,40,Austria,Guinea,303,238,65
2015,56,Belgium,Guinea,12984,6758,6226
2015,250,France,Guinea,31424,16385,15039
2015,276,Germany,Guinea,3566,2497,1069
2015,528,Netherlands,Guinea,2619,1594,1025
2015,756,Switzerland,Guinea,1558,1080,478
2015,124,Canada,Guinea,5158,2598,2560
2015,840,United States of America,Guinea,20333,10002,10331
2019,24,Angola,Guinea,18504,11103,7401
2019,120,Cameroon,Guinea,4656,2047,2609
2019,266,Gabon,Guinea,4938,3864,1074
2019,516,Namibia,Guinea,53,32,21
2019,710,South Africa,Guinea,132,86,46
2019,132,Cabo Verde,Guinea,433,206,227
2019,384,Côte d'Ivoire,Guinea,166489,89789,76700
2019,270,Gambia,Guinea,45163,26119,19044
2019,288,Ghana,Guinea,157,100,57
2019,624,Guinea-Bissau,Guinea,5419,2740,2679
2019,430,Liberia,Guinea,28963,15874,13089
2019,466,Mali,Guinea,40457,20889,19568
2019,478,Mauritania,Guinea,3224,1535,1689
2019,686,Senegal,Guinea,53438,34089,19349
2019,694,Sierra Leone,Guinea,36325,20531,15794
2019,768,Togo,Guinea,3359,1849,1510
2019,818,Egypt,Guinea,142,131,11
2019,504,Morocco,Guinea,1037,521,516
2019,732,Western Sahara,Guinea,991,643,348
2019,32,Argentina,Guinea,1,0,1
2019,68,Bolivia (Plurinational State of),Guinea,9,7,2
2019,76,Brazil,Guinea,77,44,33
2019,152,Chile,Guinea,16,7,9
2019,36,Australia,Guinea,1110,536,574
2019,100,Bulgaria,Guinea,12,11,1
2019,203,Czechia,Guinea,76,60,16
2019,348,Hungary,Guinea,50,39,11
2019,616,Poland,Guinea,58,49,9
2019,642,Romania,Guinea,100,78,22
2019,643,Russian Federation,Guinea,203,159,44
2019,208,Denmark,Guinea,126,73,53
2019,246,Finland,Guinea,133,105,28
2019,352,Iceland,Guinea,20,12,8
2019,372,Ireland,Guinea,54,29,25
2019,578,Norway,Guinea,307,154,153
2019,752,Sweden,Guinea,666,403,263
2019,826,United Kingdom,Guinea,1840,994,846
2019,300,Greece,Guinea,169,83,86
2019,380,Italy,Guinea,7227,5835,1392
2019,620,Portugal,Guinea,4576,2347,2229
2019,705,Slovenia,Guinea,6,4,2
2019,724,Spain,Guinea,10141,6425,3716
2019,40,Austria,Guinea,357,282,75
2019,56,Belgium,Guinea,15273,7765,7508
2019,250,France,Guinea,33262,17307,15955
2019,276,Germany,Guinea,9312,7119,2193
2019,528,Netherlands,Guinea,2652,1577,1075
2019,756,Switzerland,Guinea,1787,1230,557
2019,124,Canada,Guinea,5527,2784,2743
2019,840,United States of America,Guinea,21956,10681,11275
1990,710,South Africa,Guinea-Bissau,30,3,27
1990,132,Cabo Verde,Guinea-Bissau,539,310,229
1990,384,Côte d'Ivoire,Guinea-Bissau,308,171,137
1990,270,Gambia,Guinea-Bissau,7591,3952,3639
1990,324,Guinea,Guinea-Bissau,2798,1483,1315
1990,430,Liberia,Guinea-Bissau,2263,1143,1120
1990,478,Mauritania,Guinea-Bissau,1067,301,766
1990,686,Senegal,Guinea-Bissau,23825,10012,13813
1990,694,Sierra Leone,Guinea-Bissau,24,16,8
1990,768,Togo,Guinea-Bissau,62,26,36
1990,818,Egypt,Guinea-Bissau,70,68,2
1990,434,Libya,Guinea-Bissau,200,195,5
1990,732,Western Sahara,Guinea-Bissau,523,205,318
1990,152,Chile,Guinea-Bissau,3,3,0
1990,36,Australia,Guinea-Bissau,13,10,3
1990,100,Bulgaria,Guinea-Bissau,1,1,0
1990,203,Czechia,Guinea-Bissau,2,2,0
1990,348,Hungary,Guinea-Bissau,5,5,0
1990,643,Russian Federation,Guinea-Bissau,342,168,174
1990,208,Denmark,Guinea-Bissau,9,9,0
1990,578,Norway,Guinea-Bissau,9,6,3
1990,752,Sweden,Guinea-Bissau,61,38,23
1990,826,United Kingdom,Guinea-Bissau,53,34,19
1990,300,Greece,Guinea-Bissau,3,1,2
1990,380,Italy,Guinea-Bissau,35,12,23
1990,620,Portugal,Guinea-Bissau,6588,3759,2829
1990,724,Spain,Guinea-Bissau,539,471,68
1990,40,Austria,Guinea-Bissau,38,34,4
1990,56,Belgium,Guinea-Bissau,124,57,67
1990,250,France,Guinea-Bissau,8060,4789,3271
1990,528,Netherlands,Guinea-Bissau,74,46,28
1990,756,Switzerland,Guinea-Bissau,126,91,35
1990,124,Canada,Guinea-Bissau,24,11,13
1995,710,South Africa,Guinea-Bissau,18,3,15
1995,132,Cabo Verde,Guinea-Bissau,839,493,346
1995,384,Côte d'Ivoire,Guinea-Bissau,344,190,154
1995,270,Gambia,Guinea-Bissau,9365,4696,4669
1995,324,Guinea,Guinea-Bissau,3226,1875,1351
1995,430,Liberia,Guinea-Bissau,2211,1092,1119
1995,478,Mauritania,Guinea-Bissau,1140,398,742
1995,686,Senegal,Guinea-Bissau,24916,10390,14526
1995,694,Sierra Leone,Guinea-Bissau,23,15,8
1995,768,Togo,Guinea-Bissau,69,29,40
1995,818,Egypt,Guinea-Bissau,66,65,1
1995,434,Libya,Guinea-Bissau,213,209,4
1995,732,Western Sahara,Guinea-Bissau,581,233,348
1995,152,Chile,Guinea-Bissau,2,2,0
1995,36,Australia,Guinea-Bissau,11,10,1
1995,100,Bulgaria,Guinea-Bissau,2,1,1
1995,203,Czechia,Guinea-Bissau,3,3,0
1995,348,Hungary,Guinea-Bissau,6,6,0
1995,643,Russian Federation,Guinea-Bissau,308,176,132
1995,208,Denmark,Guinea-Bissau,20,17,3
1995,246,Finland,Guinea-Bissau,2,2,0
1995,372,Ireland,Guinea-Bissau,1,1,0
1995,578,Norway,Guinea-Bissau,10,7,3
1995,752,Sweden,Guinea-Bissau,72,45,27
1995,826,United Kingdom,Guinea-Bissau,211,112,99
1995,300,Greece,Guinea-Bissau,5,1,4
1995,380,Italy,Guinea-Bissau,152,84,68
1995,620,Portugal,Guinea-Bissau,13671,8076,5595
1995,724,Spain,Guinea-Bissau,869,727,142
1995,40,Austria,Guinea-Bissau,43,38,5
1995,56,Belgium,Guinea-Bissau,121,54,67
1995,250,France,Guinea-Bissau,8321,4887,3434
1995,528,Netherlands,Guinea-Bissau,108,66,42
1995,756,Switzerland,Guinea-Bissau,165,119,46
1995,124,Canada,Guinea-Bissau,37,18,19
2000,710,South Africa,Guinea-Bissau,13,5,8
2000,132,Cabo Verde,Guinea-Bissau,1138,676,462
2000,384,Côte d'Ivoire,Guinea-Bissau,358,198,160
2000,270,Gambia,Guinea-Bissau,11733,5735,5998
2000,324,Guinea,Guinea-Bissau,3495,2002,1493
2000,430,Liberia,Guinea-Bissau,2171,1043,1128
2000,478,Mauritania,Guinea-Bissau,1178,490,688
2000,686,Senegal,Guinea-Bissau,23437,11710,11727
2000,694,Sierra Leone,Guinea-Bissau,22,14,8
2000,768,Togo,Guinea-Bissau,77,32,45
2000,818,Egypt,Guinea-Bissau,68,67,1
2000,434,Libya,Guinea-Bissau,230,227,3
2000,732,Western Sahara,Guinea-Bissau,640,262,378
2000,152,Chile,Guinea-Bissau,2,2,0
2000,36,Australia,Guinea-Bissau,20,10,10
2000,100,Bulgaria,Guinea-Bissau,3,2,1
2000,203,Czechia,Guinea-Bissau,4,4,0
2000,348,Hungary,Guinea-Bissau,6,6,0
2000,643,Russian Federation,Guinea-Bissau,264,178,86
2000,208,Denmark,Guinea-Bissau,31,26,5
2000,246,Finland,Guinea-Bissau,3,3,0
2000,372,Ireland,Guinea-Bissau,2,1,1
2000,578,Norway,Guinea-Bissau,13,9,4
2000,752,Sweden,Guinea-Bissau,78,48,30
2000,826,United Kingdom,Guinea-Bissau,373,191,182
2000,300,Greece,Guinea-Bissau,7,1,6
2000,380,Italy,Guinea-Bissau,268,156,112
2000,620,Portugal,Guinea-Bissau,21309,12741,8568
2000,705,Slovenia,Guinea-Bissau,1,1,0
2000,724,Spain,Guinea-Bissau,1574,1300,274
2000,40,Austria,Guinea-Bissau,47,42,5
2000,56,Belgium,Guinea-Bissau,117,53,64
2000,250,France,Guinea-Bissau,8581,4985,3596
2000,528,Netherlands,Guinea-Bissau,148,89,59
2000,756,Switzerland,Guinea-Bissau,205,146,59
2000,124,Canada,Guinea-Bissau,50,24,26
2005,710,South Africa,Guinea-Bissau,16,6,10
2005,132,Cabo Verde,Guinea-Bissau,2984,1680,1304
2005,384,Côte d'Ivoire,Guinea-Bissau,374,207,167
2005,270,Gambia,Guinea-Bissau,11643,5650,5993
2005,324,Guinea,Guinea-Bissau,4194,2395,1799
2005,430,Liberia,Guinea-Bissau,987,622,365
2005,478,Mauritania,Guinea-Bissau,1188,521,667
2005,686,Senegal,Guinea-Bissau,24985,11703,13282
2005,694,Sierra Leone,Guinea-Bissau,6,3,3
2005,768,Togo,Guinea-Bissau,86,36,50
2005,818,Egypt,Guinea-Bissau,81,80,1
2005,434,Libya,Guinea-Bissau,252,251,1
2005,732,Western Sahara,Guinea-Bissau,757,323,434
2005,76,Brazil,Guinea-Bissau,468,311,157
2005,152,Chile,Guinea-Bissau,3,3,0
2005,36,Australia,Guinea-Bissau,20,10,10
2005,100,Bulgaria,Guinea-Bissau,4,2,2
2005,203,Czechia,Guinea-Bissau,13,11,2
2005,348,Hungary,Guinea-Bissau,7,7,0
2005,643,Russian Federation,Guinea-Bissau,198,136,62
2005,208,Denmark,Guinea-Bissau,39,31,8
2005,246,Finland,Guinea-Bissau,5,4,1
2005,372,Ireland,Guinea-Bissau,2,1,1
2005,578,Norway,Guinea-Bissau,13,8,5
2005,752,Sweden,Guinea-Bissau,94,60,34
2005,826,United Kingdom,Guinea-Bissau,1279,624,655
2005,300,Greece,Guinea-Bissau,4,1,3
2005,380,Italy,Guinea-Bissau,525,338,187
2005,620,Portugal,Guinea-Bissau,25289,14706,10583
2005,705,Slovenia,Guinea-Bissau,1,1,0
2005,724,Spain,Guinea-Bissau,4351,3641,710
2005,40,Austria,Guinea-Bissau,53,47,6
2005,56,Belgium,Guinea-Bissau,171,72,99
2005,250,France,Guinea-Bissau,2476,1616,860
2005,528,Netherlands,Guinea-Bissau,217,138,79
2005,756,Switzerland,Guinea-Bissau,246,171,75
2005,124,Canada,Guinea-Bissau,67,38,29
2010,710,South Africa,Guinea-Bissau,25,10,15
2010,132,Cabo Verde,Guinea-Bissau,4829,2684,2145
2010,384,Côte d'Ivoire,Guinea-Bissau,390,216,174
2010,270,Gambia,Guinea-Bissau,11899,5762,6137
2010,324,Guinea,Guinea-Bissau,5032,2873,2159
2010,430,Liberia,Guinea-Bissau,454,192,262
2010,466,Mali,Guinea-Bissau,291,97,194
2010,478,Mauritania,Guinea-Bissau,1198,539,659
2010,686,Senegal,Guinea-Bissau,27726,12453,15273
2010,694,Sierra Leone,Guinea-Bissau,47,27,20
2010,768,Togo,Guinea-Bissau,116,51,65
2010,818,Egypt,Guinea-Bissau,87,86,1
2010,434,Libya,Guinea-Bissau,275,274,1
2010,732,Western Sahara,Guinea-Bissau,874,384,490
2010,76,Brazil,Guinea-Bissau,937,623,314
2010,152,Chile,Guinea-Bissau,4,4,0
2010,36,Australia,Guinea-Bissau,20,10,10
2010,100,Bulgaria,Guinea-Bissau,5,3,2
2010,203,Czechia,Guinea-Bissau,20,17,3
2010,348,Hungary,Guinea-Bissau,8,8,0
2010,643,Russian Federation,Guinea-Bissau,128,91,37
2010,208,Denmark,Guinea-Bissau,46,37,9
2010,246,Finland,Guinea-Bissau,5,5,0
2010,372,Ireland,Guinea-Bissau,1,0,1
2010,578,Norway,Guinea-Bissau,22,13,9
2010,752,Sweden,Guinea-Bissau,120,76,44
2010,826,United Kingdom,Guinea-Bissau,1347,672,675
2010,380,Italy,Guinea-Bissau,695,444,251
2010,620,Portugal,Guinea-Bissau,25070,14253,10817
2010,705,Slovenia,Guinea-Bissau,2,2,0
2010,724,Spain,Guinea-Bissau,6554,5287,1267
2010,40,Austria,Guinea-Bissau,58,51,7
2010,56,Belgium,Guinea-Bissau,171,95,76
2010,250,France,Guinea-Bissau,2878,1646,1232
2010,528,Netherlands,Guinea-Bissau,230,141,89
2010,756,Switzerland,Guinea-Bissau,272,185,87
2010,124,Canada,Guinea-Bissau,85,52,33
2015,710,South Africa,Guinea-Bissau,44,17,27
2015,132,Cabo Verde,Guinea-Bissau,5015,2780,2235
2015,384,Côte d'Ivoire,Guinea-Bissau,406,225,181
2015,270,Gambia,Guinea-Bissau,12328,5958,6370
2015,324,Guinea,Guinea-Bissau,4540,2592,1948
2015,430,Liberia,Guinea-Bissau,521,218,303
2015,466,Mali,Guinea-Bissau,360,120,240
2015,478,Mauritania,Guinea-Bissau,1203,548,655
2015,686,Senegal,Guinea-Bissau,29591,13281,16310
2015,694,Sierra Leone,Guinea-Bissau,377,231,146
2015,768,Togo,Guinea-Bissau,130,57,73
2015,818,Egypt,Guinea-Bissau,64,64,0
2015,434,Libya,Guinea-Bissau,310,309,1
2015,732,Western Sahara,Guinea-Bissau,1007,455,552
2015,76,Brazil,Guinea-Bissau,1128,750,378
2015,152,Chile,Guinea-Bissau,6,6,0
2015,36,Australia,Guinea-Bissau,20,12,8
2015,100,Bulgaria,Guinea-Bissau,4,2,2
2015,203,Czechia,Guinea-Bissau,21,18,3
2015,348,Hungary,Guinea-Bissau,3,3,0
2015,643,Russian Federation,Guinea-Bissau,131,93,38
2015,208,Denmark,Guinea-Bissau,63,46,17
2015,246,Finland,Guinea-Bissau,8,7,1
2015,372,Ireland,Guinea-Bissau,1,0,1
2015,578,Norway,Guinea-Bissau,64,43,21
2015,752,Sweden,Guinea-Bissau,142,85,57
2015,826,United Kingdom,Guinea-Bissau,1722,834,888
2015,300,Greece,Guinea-Bissau,2,1,1
2015,380,Italy,Guinea-Bissau,865,602,263
2015,620,Portugal,Guinea-Bissau,28422,15528,12894
2015,705,Slovenia,Guinea-Bissau,18,10,8
2015,724,Spain,Guinea-Bissau,5369,4151,1218
2015,40,Austria,Guinea-Bissau,68,60,8
2015,56,Belgium,Guinea-Bissau,276,162,114
2015,250,France,Guinea-Bissau,3188,1786,1402
2015,528,Netherlands,Guinea-Bissau,247,145,102
2015,756,Switzerland,Guinea-Bissau,646,455,191
2015,124,Canada,Guinea-Bissau,109,70,39
2019,710,South Africa,Guinea-Bissau,48,19,29
2019,132,Cabo Verde,Guinea-Bissau,5263,2918,2345
2019,384,Côte d'Ivoire,Guinea-Bissau,419,233,186
2019,270,Gambia,Guinea-Bissau,13792,6666,7126
2019,324,Guinea,Guinea-Bissau,4333,2474,1859
2019,430,Liberia,Guinea-Bissau,432,156,276
2019,466,Mali,Guinea-Bissau,400,133,267
2019,478,Mauritania,Guinea-Bissau,1249,570,679
2019,686,Senegal,Guinea-Bissau,30570,13713,16857
2019,694,Sierra Leone,Guinea-Bissau,652,395,257
2019,768,Togo,Guinea-Bissau,130,57,73
2019,818,Egypt,Guinea-Bissau,91,91,0
2019,434,Libya,Guinea-Bissau,328,327,1
2019,732,Western Sahara,Guinea-Bissau,1046,473,573
2019,76,Brazil,Guinea-Bissau,1270,845,425
2019,152,Chile,Guinea-Bissau,8,8,0
2019,36,Australia,Guinea-Bissau,21,12,9
2019,100,Bulgaria,Guinea-Bissau,4,2,2
2019,203,Czechia,Guinea-Bissau,22,19,3
2019,348,Hungary,Guinea-Bissau,3,2,1
2019,643,Russian Federation,Guinea-Bissau,130,93,37
2019,208,Denmark,Guinea-Bissau,111,76,35
2019,246,Finland,Guinea-Bissau,9,8,1
2019,372,Ireland,Guinea-Bissau,1,0,1
2019,578,Norway,Guinea-Bissau,65,45,20
2019,752,Sweden,Guinea-Bissau,149,92,57
2019,826,United Kingdom,Guinea-Bissau,1955,950,1005
2019,300,Greece,Guinea-Bissau,1,1,0
2019,380,Italy,Guinea-Bissau,1704,1410,294
2019,620,Portugal,Guinea-Bissau,28905,15820,13085
2019,705,Slovenia,Guinea-Bissau,22,12,10
2019,724,Spain,Guinea-Bissau,5563,4271,1292
2019,40,Austria,Guinea-Bissau,80,71,9
2019,56,Belgium,Guinea-Bissau,315,183,132
2019,250,France,Guinea-Bissau,3374,1887,1487
2019,528,Netherlands,Guinea-Bissau,258,147,111
2019,756,Switzerland,Guinea-Bissau,749,522,227
2019,124,Canada,Guinea-Bissau,116,75,41
1990,710,South Africa,Guyana,54,16,38
1990,660,Anguilla,Guyana,181,108,73
1990,28,Antigua and Barbuda,Guyana,1660,798,862
1990,533,Aruba,Guyana,107,52,55
1990,44,Bahamas,Guyana,419,213,206
1990,52,Barbados,Guyana,2557,1004,1553
1990,92,British Virgin Islands,Guyana,841,444,397
1990,535,"Bonaire, Sint Eustatius and Saba",Guyana,389,189,200
1990,136,Cayman Islands,Guyana,60,30,30
1990,212,Dominica,Guyana,69,38,31
1990,214,Dominican Republic,Guyana,45,31,14
1990,308,Grenada,Guyana,324,160,164
1990,312,Guadeloupe,Guyana,56,31,25
1990,500,Montserrat,Guyana,359,209,150
1990,630,Puerto Rico,Guyana,99,47,52
1990,659,Saint Kitts and Nevis,Guyana,335,172,163
1990,662,Saint Lucia,Guyana,821,342,479
1990,670,Saint Vincent and the Grenadines,Guyana,209,89,120
1990,780,Trinidad and Tobago,Guyana,5140,2110,3030
1990,188,Costa Rica,Guyana,20,11,9
1990,591,Panama,Guyana,46,32,14
1990,68,Bolivia (Plurinational State of),Guyana,1,0,1
1990,76,Brazil,Guyana,1093,481,612
1990,152,Chile,Guyana,7,4,3
1990,170,Colombia,Guyana,17,10,7
1990,254,French Guiana,Guyana,2242,1197,1045
1990,740,Suriname,Guyana,5114,2760,2354
1990,862,Venezuela (Bolivarian Republic of),Guyana,4601,2280,2321
1990,36,Australia,Guyana,426,202,224
1990,100,Bulgaria,Guyana,1,1,0
1990,203,Czechia,Guyana,1,1,0
1990,348,Hungary,Guyana,5,4,1
1990,616,Poland,Guyana,18,15,3
1990,208,Denmark,Guyana,73,23,50
1990,246,Finland,Guyana,8,6,2
1990,352,Iceland,Guyana,7,3,4
1990,372,Ireland,Guyana,6,3,3
1990,578,Norway,Guyana,67,28,39
1990,752,Sweden,Guyana,83,32,51
1990,826,United Kingdom,Guyana,19978,8960,11018
1990,300,Greece,Guyana,14,8,6
1990,380,Italy,Guyana,9,3,6
1990,724,Spain,Guyana,8,3,5
1990,40,Austria,Guyana,10,2,8
1990,56,Belgium,Guyana,92,23,69
1990,250,France,Guyana,30,12,18
1990,528,Netherlands,Guyana,1803,678,1125
1990,756,Switzerland,Guyana,96,33,63
1990,60,Bermuda,Guyana,51,28,23
1990,124,Canada,Guyana,63381,30855,32526
1990,840,United States of America,Guyana,120698,57013,63685
1995,710,South Africa,Guyana,34,13,21
1995,660,Anguilla,Guyana,233,137,96
1995,28,Antigua and Barbuda,Guyana,3489,1591,1898
1995,533,Aruba,Guyana,202,104,98
1995,44,Bahamas,Guyana,550,267,283
1995,52,Barbados,Guyana,2792,1124,1668
1995,92,British Virgin Islands,Guyana,989,511,478
1995,535,"Bonaire, Sint Eustatius and Saba",Guyana,812,393,419
1995,136,Cayman Islands,Guyana,114,56,58
1995,212,Dominica,Guyana,91,50,41
1995,214,Dominican Republic,Guyana,50,34,16
1995,308,Grenada,Guyana,316,104,212
1995,312,Guadeloupe,Guyana,91,49,42
1995,500,Montserrat,Guyana,288,168,120
1995,630,Puerto Rico,Guyana,104,50,54
1995,659,Saint Kitts and Nevis,Guyana,443,230,213
1995,662,Saint Lucia,Guyana,1108,465,643
1995,670,Saint Vincent and the Grenadines,Guyana,217,93,124
1995,780,Trinidad and Tobago,Guyana,4666,1910,2756
1995,188,Costa Rica,Guyana,16,9,7
1995,591,Panama,Guyana,38,28,10
1995,68,Bolivia (Plurinational State of),Guyana,4,2,2
1995,76,Brazil,Guyana,1350,648,702
1995,152,Chile,Guyana,11,7,4
1995,170,Colombia,Guyana,17,10,7
1995,254,French Guiana,Guyana,2469,1265,1204
1995,740,Suriname,Guyana,6317,3420,2897
1995,862,Venezuela (Bolivarian Republic of),Guyana,5577,2693,2884
1995,36,Australia,Guyana,492,227,265
1995,100,Bulgaria,Guyana,2,2,0
1995,203,Czechia,Guyana,1,1,0
1995,348,Hungary,Guyana,4,3,1
1995,616,Poland,Guyana,15,13,2
1995,208,Denmark,Guyana,86,25,61
1995,246,Finland,Guyana,8,4,4
1995,352,Iceland,Guyana,10,4,6
1995,372,Ireland,Guyana,16,6,10
1995,578,Norway,Guyana,69,28,41
1995,752,Sweden,Guyana,98,37,61
1995,826,United Kingdom,Guyana,19912,8699,11213
1995,300,Greece,Guyana,13,7,6
1995,380,Italy,Guyana,21,2,19
1995,724,Spain,Guyana,13,5,8
1995,40,Austria,Guyana,12,3,9
1995,56,Belgium,Guyana,92,23,69
1995,250,France,Guyana,31,12,19
1995,528,Netherlands,Guyana,2020,735,1285
1995,756,Switzerland,Guyana,97,36,61
1995,60,Bermuda,Guyana,61,31,30
1995,124,Canada,Guyana,72507,35112,37395
1995,840,United States of America,Guyana,168164,79804,88360
2000,710,South Africa,Guyana,24,12,12
2000,660,Anguilla,Guyana,285,166,119
2000,28,Antigua and Barbuda,Guyana,5317,2383,2934
2000,533,Aruba,Guyana,297,157,140
2000,44,Bahamas,Guyana,682,322,360
2000,52,Barbados,Guyana,3026,1244,1782
2000,92,British Virgin Islands,Guyana,1136,577,559
2000,535,"Bonaire, Sint Eustatius and Saba",Guyana,1235,597,638
2000,136,Cayman Islands,Guyana,198,97,101
2000,212,Dominica,Guyana,108,60,48
2000,214,Dominican Republic,Guyana,55,37,18
2000,308,Grenada,Guyana,308,47,261
2000,312,Guadeloupe,Guyana,125,66,59
2000,500,Montserrat,Guyana,218,127,91
2000,630,Puerto Rico,Guyana,110,52,58
2000,659,Saint Kitts and Nevis,Guyana,612,322,290
2000,662,Saint Lucia,Guyana,1522,647,875
2000,670,Saint Vincent and the Grenadines,Guyana,226,98,128
2000,780,Trinidad and Tobago,Guyana,5264,2142,3122
2000,188,Costa Rica,Guyana,21,12,9
2000,591,Panama,Guyana,33,25,8
2000,68,Bolivia (Plurinational State of),Guyana,7,4,3
2000,76,Brazil,Guyana,1607,816,791
2000,152,Chile,Guyana,15,9,6
2000,170,Colombia,Guyana,16,9,7
2000,254,French Guiana,Guyana,2696,1333,1363
2000,740,Suriname,Guyana,7802,4224,3578
2000,862,Venezuela (Bolivarian Republic of),Guyana,6698,3141,3557
2000,36,Australia,Guyana,520,233,287
2000,100,Bulgaria,Guyana,2,2,0
2000,203,Czechia,Guyana,1,1,0
2000,348,Hungary,Guyana,3,2,1
2000,616,Poland,Guyana,13,11,2
2000,208,Denmark,Guyana,99,28,71
2000,246,Finland,Guyana,8,3,5
2000,352,Iceland,Guyana,13,5,8
2000,372,Ireland,Guyana,34,13,21
2000,578,Norway,Guyana,78,29,49
2000,752,Sweden,Guyana,106,40,66
2000,826,United Kingdom,Guyana,20182,8555,11627
2000,300,Greece,Guyana,12,5,7
2000,380,Italy,Guyana,32,1,31
2000,724,Spain,Guyana,168,72,96
2000,40,Austria,Guyana,13,3,10
2000,56,Belgium,Guyana,88,23,65
2000,250,France,Guyana,32,13,19
2000,528,Netherlands,Guyana,2309,815,1494
2000,756,Switzerland,Guyana,99,39,60
2000,60,Bermuda,Guyana,71,34,37
2000,124,Canada,Guyana,83357,40212,43145
2000,840,United States of America,Guyana,216551,103175,113376
2005,710,South Africa,Guyana,31,14,17
2005,660,Anguilla,Guyana,328,192,136
2005,28,Antigua and Barbuda,Guyana,5702,2552,3150
2005,533,Aruba,Guyana,289,145,144
2005,44,Bahamas,Guyana,957,431,526
2005,52,Barbados,Guyana,4640,2089,2551
2005,92,British Virgin Islands,Guyana,1301,661,640
2005,535,"Bonaire, Sint Eustatius and Saba",Guyana,1316,636,680
2005,136,Cayman Islands,Guyana,241,133,108
2005,212,Dominica,Guyana,133,73,60
2005,214,Dominican Republic,Guyana,39,27,12
2005,308,Grenada,Guyana,322,49,273
2005,312,Guadeloupe,Guyana,153,74,79
2005,500,Montserrat,Guyana,224,130,94
2005,630,Puerto Rico,Guyana,86,41,45
2005,659,Saint Kitts and Nevis,Guyana,697,368,329
2005,662,Saint Lucia,Guyana,1994,873,1121
2005,670,Saint Vincent and the Grenadines,Guyana,236,107,129
2005,534,Sint Maarten (Dutch part),Guyana,867,423,444
2005,780,Trinidad and Tobago,Guyana,5649,2291,3358
2005,188,Costa Rica,Guyana,14,8,6
2005,591,Panama,Guyana,36,22,14
2005,68,Bolivia (Plurinational State of),Guyana,6,4,2
2005,76,Brazil,Guyana,1756,867,889
2005,152,Chile,Guyana,22,14,8
2005,170,Colombia,Guyana,16,10,6
2005,254,French Guiana,Guyana,2870,1366,1504
2005,740,Suriname,Guyana,9548,5201,4347
2005,862,Venezuela (Bolivarian Republic of),Guyana,7511,3627,3884
2005,36,Australia,Guyana,560,267,293
2005,100,Bulgaria,Guyana,3,2,1
2005,203,Czechia,Guyana,4,3,1
2005,348,Hungary,Guyana,4,3,1
2005,616,Poland,Guyana,19,13,6
2005,208,Denmark,Guyana,100,30,70
2005,246,Finland,Guyana,14,7,7
2005,352,Iceland,Guyana,17,6,11
2005,372,Ireland,Guyana,34,15,19
2005,578,Norway,Guyana,82,30,52
2005,752,Sweden,Guyana,119,42,77
2005,826,United Kingdom,Guyana,19728,8173,11555
2005,300,Greece,Guyana,12,4,8
2005,380,Italy,Guyana,53,8,45
2005,724,Spain,Guyana,81,34,47
2005,40,Austria,Guyana,15,3,12
2005,56,Belgium,Guyana,102,23,79
2005,250,France,Guyana,4226,2074,2152
2005,528,Netherlands,Guyana,2400,841,1559
2005,756,Switzerland,Guyana,106,39,67
2005,60,Bermuda,Guyana,86,44,42
2005,124,Canada,Guyana,82392,38135,44257
2005,840,United States of America,Guyana,236839,113527,123312
2010,710,South Africa,Guyana,48,22,26
2010,660,Anguilla,Guyana,357,210,147
2010,28,Antigua and Barbuda,Guyana,6086,2721,3365
2010,533,Aruba,Guyana,275,130,145
2010,44,Bahamas,Guyana,1232,541,691
2010,52,Barbados,Guyana,6277,2945,3332
2010,92,British Virgin Islands,Guyana,2023,1029,994
2010,535,"Bonaire, Sint Eustatius and Saba",Guyana,145,64,81
2010,136,Cayman Islands,Guyana,308,182,126
2010,531,Curaçao,Guyana,422,178,244
2010,212,Dominica,Guyana,163,90,73
2010,214,Dominican Republic,Guyana,22,16,6
2010,308,Grenada,Guyana,337,52,285
2010,312,Guadeloupe,Guyana,181,82,99
2010,500,Montserrat,Guyana,230,133,97
2010,630,Puerto Rico,Guyana,52,25,27
2010,659,Saint Kitts and Nevis,Guyana,756,401,355
2010,662,Saint Lucia,Guyana,2274,1018,1256
2010,670,Saint Vincent and the Grenadines,Guyana,242,112,130
2010,534,Sint Maarten (Dutch part),Guyana,1735,846,889
2010,780,Trinidad and Tobago,Guyana,9490,4397,5093
2010,188,Costa Rica,Guyana,28,16,12
2010,591,Panama,Guyana,41,19,22
2010,68,Bolivia (Plurinational State of),Guyana,4,3,1
2010,76,Brazil,Guyana,1880,905,975
2010,152,Chile,Guyana,30,19,11
2010,170,Colombia,Guyana,18,11,7
2010,254,French Guiana,Guyana,3044,1400,1644
2010,740,Suriname,Guyana,11264,6143,5121
2010,862,Venezuela (Bolivarian Republic of),Guyana,8510,4230,4280
2010,36,Australia,Guyana,600,279,321
2010,100,Bulgaria,Guyana,4,3,1
2010,203,Czechia,Guyana,7,6,1
2010,348,Hungary,Guyana,5,4,1
2010,616,Poland,Guyana,27,15,12
2010,208,Denmark,Guyana,98,32,66
2010,233,Estonia,Guyana,2,0,2
2010,246,Finland,Guyana,18,7,11
2010,352,Iceland,Guyana,20,7,13
2010,372,Ireland,Guyana,28,11,17
2010,578,Norway,Guyana,86,32,54
2010,752,Sweden,Guyana,127,46,81
2010,826,United Kingdom,Guyana,20782,8860,11922
2010,300,Greece,Guyana,11,3,8
2010,380,Italy,Guyana,79,20,59
2010,724,Spain,Guyana,108,58,50
2010,40,Austria,Guyana,16,3,13
2010,56,Belgium,Guyana,79,32,47
2010,250,France,Guyana,4432,1742,2690
2010,528,Netherlands,Guyana,2342,808,1534
2010,756,Switzerland,Guyana,132,43,89
2010,60,Bermuda,Guyana,101,54,47
2010,124,Canada,Guyana,87945,39166,48779
2010,840,United States of America,Guyana,264928,125093,139835
2015,710,South Africa,Guyana,85,37,48
2015,660,Anguilla,Guyana,382,225,157
2015,28,Antigua and Barbuda,Guyana,6472,2891,3581
2015,533,Aruba,Guyana,289,136,153
2015,44,Bahamas,Guyana,1335,581,754
2015,52,Barbados,Guyana,6594,3093,3501
2015,92,British Virgin Islands,Guyana,2266,1153,1113
2015,535,"Bonaire, Sint Eustatius and Saba",Guyana,164,72,92
2015,136,Cayman Islands,Guyana,335,199,136
2015,531,Curaçao,Guyana,458,194,264
2015,212,Dominica,Guyana,190,105,85
2015,214,Dominican Republic,Guyana,23,17,6
2015,308,Grenada,Guyana,341,53,288
2015,312,Guadeloupe,Guyana,188,84,104
2015,500,Montserrat,Guyana,240,139,101
2015,630,Puerto Rico,Guyana,50,23,27
2015,659,Saint Kitts and Nevis,Guyana,777,413,364
2015,662,Saint Lucia,Guyana,2185,965,1220
2015,670,Saint Vincent and the Grenadines,Guyana,246,115,131
2015,534,Sint Maarten (Dutch part),Guyana,1807,879,928
2015,780,Trinidad and Tobago,Guyana,9830,4640,5190
2015,188,Costa Rica,Guyana,28,16,12
2015,591,Panama,Guyana,48,23,25
2015,68,Bolivia (Plurinational State of),Guyana,5,4,1
2015,76,Brazil,Guyana,2264,1090,1174
2015,152,Chile,Guyana,45,29,16
2015,170,Colombia,Guyana,20,13,7
2015,254,French Guiana,Guyana,3675,1666,2009
2015,740,Suriname,Guyana,12232,6678,5554
2015,862,Venezuela (Bolivarian Republic of),Guyana,9149,4483,4666
2015,36,Australia,Guyana,660,312,348
2015,100,Bulgaria,Guyana,4,3,1
2015,203,Czechia,Guyana,5,5,0
2015,348,Hungary,Guyana,8,6,2
2015,616,Poland,Guyana,26,15,11
2015,208,Denmark,Guyana,106,30,76
2015,233,Estonia,Guyana,2,0,2
2015,246,Finland,Guyana,23,12,11
2015,352,Iceland,Guyana,20,6,14
2015,372,Ireland,Guyana,29,11,18
2015,578,Norway,Guyana,88,32,56
2015,752,Sweden,Guyana,120,41,79
2015,826,United Kingdom,Guyana,26577,10879,15698
2015,300,Greece,Guyana,10,3,7
2015,380,Italy,Guyana,73,17,56
2015,724,Spain,Guyana,111,52,59
2015,40,Austria,Guyana,19,4,15
2015,56,Belgium,Guyana,92,37,55
2015,250,France,Guyana,4910,1848,3062
2015,528,Netherlands,Guyana,2356,816,1540
2015,756,Switzerland,Guyana,137,42,95
2015,60,Bermuda,Guyana,102,55,47
2015,124,Canada,Guyana,87142,38674,48468
2015,840,United States of America,Guyana,299148,140441,158707
2019,710,South Africa,Guyana,95,42,53
2019,660,Anguilla,Guyana,396,234,162
2019,28,Antigua and Barbuda,Guyana,6731,3007,3724
2019,533,Aruba,Guyana,292,138,154
2019,44,Bahamas,Guyana,1417,617,800
2019,52,Barbados,Guyana,6657,3123,3534
2019,92,British Virgin Islands,Guyana,2460,1252,1208
2019,535,"Bonaire, Sint Eustatius and Saba",Guyana,195,86,109
2019,136,Cayman Islands,Guyana,371,220,151
2019,531,Curaçao,Guyana,497,211,286
2019,212,Dominica,Guyana,194,108,86
2019,214,Dominican Republic,Guyana,23,17,6
2019,308,Grenada,Guyana,344,54,290
2019,312,Guadeloupe,Guyana,190,85,105
2019,500,Montserrat,Guyana,244,142,102
2019,630,Puerto Rico,Guyana,47,22,25
2019,659,Saint Kitts and Nevis,Guyana,792,421,371
2019,662,Saint Lucia,Guyana,2111,929,1182
2019,670,Saint Vincent and the Grenadines,Guyana,247,116,131
2019,534,Sint Maarten (Dutch part),Guyana,1870,910,960
2019,780,Trinidad and Tobago,Guyana,10582,5253,5329
2019,188,Costa Rica,Guyana,28,16,12
2019,591,Panama,Guyana,50,25,25
2019,68,Bolivia (Plurinational State of),Guyana,5,4,1
2019,76,Brazil,Guyana,2549,1227,1322
2019,152,Chile,Guyana,60,38,22
2019,170,Colombia,Guyana,20,13,7
2019,254,French Guiana,Guyana,4065,1843,2222
2019,740,Suriname,Guyana,13091,7155,5936
2019,862,Venezuela (Bolivarian Republic of),Guyana,8961,4371,4590
2019,36,Australia,Guyana,698,340,358
2019,100,Bulgaria,Guyana,4,3,1
2019,203,Czechia,Guyana,5,5,0
2019,348,Hungary,Guyana,6,3,3
2019,616,Poland,Guyana,27,16,11
2019,208,Denmark,Guyana,110,37,73
2019,233,Estonia,Guyana,1,0,1
2019,246,Finland,Guyana,24,13,11
2019,352,Iceland,Guyana,22,8,14
2019,372,Ireland,Guyana,31,12,19
2019,578,Norway,Guyana,97,34,63
2019,752,Sweden,Guyana,127,46,81
2019,826,United Kingdom,Guyana,30180,12399,17781
2019,300,Greece,Guyana,9,3,6
2019,380,Italy,Guyana,73,18,55
2019,724,Spain,Guyana,115,53,62
2019,40,Austria,Guyana,22,5,17
2019,56,Belgium,Guyana,93,37,56
2019,250,France,Guyana,5197,1949,3248
2019,528,Netherlands,Guyana,2427,850,1577
2019,756,Switzerland,Guyana,149,51,98
2019,60,Bermuda,Guyana,103,56,47
2019,124,Canada,Guyana,93382,41443,51939
2019,840,United States of America,Guyana,323052,149820,173232
1990,196,Cyprus,Haiti,1,0,1
1990,28,Antigua and Barbuda,Haiti,11,5,6
1990,533,Aruba,Haiti,320,38,282
1990,44,Bahamas,Haiti,10894,6814,4080
1990,535,"Bonaire, Sint Eustatius and Saba",Haiti,4062,2415,1647
1990,136,Cayman Islands,Haiti,5,4,1
1990,192,Cuba,Haiti,2063,1478,585
1990,212,Dominica,Haiti,561,274,287
1990,214,Dominican Republic,Haiti,187210,122793,64417
1990,312,Guadeloupe,Haiti,12028,6776,5252
1990,474,Martinique,Haiti,1109,631,478
1990,630,Puerto Rico,Haiti,295,140,155
1990,662,Saint Lucia,Haiti,15,8,7
1990,796,Turks and Caicos Islands,Haiti,2430,1258,1172
1990,850,United States Virgin Islands,Haiti,188,90,98
1990,84,Belize,Haiti,35,19,16
1990,188,Costa Rica,Haiti,48,32,16
1990,320,Guatemala,Haiti,26,7,19
1990,340,Honduras,Haiti,34,29,5
1990,484,Mexico,Haiti,475,383,92
1990,558,Nicaragua,Haiti,25,19,6
1990,591,Panama,Haiti,122,60,62
1990,32,Argentina,Haiti,75,66,9
1990,68,Bolivia (Plurinational State of),Haiti,6,5,1
1990,76,Brazil,Haiti,254,119,135
1990,152,Chile,Haiti,36,24,12
1990,170,Colombia,Haiti,100,77,23
1990,218,Ecuador,Haiti,32,22,10
1990,254,French Guiana,Haiti,9605,5126,4479
1990,604,Peru,Haiti,29,12,17
1990,862,Venezuela (Bolivarian Republic of),Haiti,2013,1135,878
1990,36,Australia,Haiti,43,22,21
1990,100,Bulgaria,Haiti,1,1,0
1990,203,Czechia,Haiti,5,2,3
1990,208,Denmark,Haiti,50,28,22
1990,352,Iceland,Haiti,1,0,1
1990,372,Ireland,Haiti,1,0,1
1990,578,Norway,Haiti,6,3,3
1990,752,Sweden,Haiti,84,48,36
1990,826,United Kingdom,Haiti,21,11,10
1990,300,Greece,Haiti,143,80,63
1990,380,Italy,Haiti,38,13,25
1990,724,Spain,Haiti,38,19,19
1990,40,Austria,Haiti,35,15,20
1990,56,Belgium,Haiti,1799,937,862
1990,250,France,Haiti,26253,11872,14381
1990,276,Germany,Haiti,292,173,119
1990,528,Netherlands,Haiti,271,140,131
1990,756,Switzerland,Haiti,993,329,664
1990,60,Bermuda,Haiti,1028,666,362
1990,124,Canada,Haiti,38271,18631,19640
1990,840,United States of America,Haiti,225393,112330,113063
1995,196,Cyprus,Haiti,2,0,2
1995,144,Sri Lanka,Haiti,3,3,0
1995,28,Antigua and Barbuda,Haiti,19,9,10
1995,533,Aruba,Haiti,660,178,482
1995,44,Bahamas,Haiti,15759,9370,6389
1995,535,"Bonaire, Sint Eustatius and Saba",Haiti,3574,2084,1490
1995,136,Cayman Islands,Haiti,11,7,4
1995,192,Cuba,Haiti,1564,1102,462
1995,212,Dominica,Haiti,732,357,375
1995,214,Dominican Republic,Haiti,207931,134652,73279
1995,312,Guadeloupe,Haiti,10272,5528,4744
1995,474,Martinique,Haiti,1335,805,530
1995,630,Puerto Rico,Haiti,310,147,163
1995,662,Saint Lucia,Haiti,15,8,7
1995,796,Turks and Caicos Islands,Haiti,3567,1813,1754
1995,850,United States Virgin Islands,Haiti,346,164,182
1995,84,Belize,Haiti,37,20,17
1995,188,Costa Rica,Haiti,41,26,15
1995,320,Guatemala,Haiti,18,6,12
1995,340,Honduras,Haiti,34,29,5
1995,484,Mexico,Haiti,395,297,98
1995,558,Nicaragua,Haiti,20,15,5
1995,591,Panama,Haiti,204,101,103
1995,32,Argentina,Haiti,80,62,18
1995,68,Bolivia (Plurinational State of),Haiti,7,4,3
1995,76,Brazil,Haiti,135,64,71
1995,152,Chile,Haiti,40,23,17
1995,170,Colombia,Haiti,100,74,26
1995,218,Ecuador,Haiti,36,25,11
1995,254,French Guiana,Haiti,11381,5815,5566
1995,604,Peru,Haiti,30,12,18
1995,862,Venezuela (Bolivarian Republic of),Haiti,1824,1035,789
1995,36,Australia,Haiti,53,27,26
1995,100,Bulgaria,Haiti,2,2,0
1995,203,Czechia,Haiti,8,4,4
1995,208,Denmark,Haiti,90,54,36
1995,246,Finland,Haiti,1,1,0
1995,352,Iceland,Haiti,1,0,1
1995,372,Ireland,Haiti,3,1,2
1995,578,Norway,Haiti,10,5,5
1995,752,Sweden,Haiti,99,56,43
1995,826,United Kingdom,Haiti,86,32,54
1995,300,Greece,Haiti,87,47,40
1995,380,Italy,Haiti,133,34,99
1995,724,Spain,Haiti,58,30,28
1995,40,Austria,Haiti,39,17,22
1995,56,Belgium,Haiti,1784,929,855
1995,250,France,Haiti,27102,12006,15096
1995,276,Germany,Haiti,350,170,180
1995,528,Netherlands,Haiti,399,201,198
1995,756,Switzerland,Haiti,1120,416,704
1995,60,Bermuda,Haiti,1160,710,450
1995,124,Canada,Haiti,45292,21930,23362
1995,840,United States of America,Haiti,326669,163499,163170
2000,196,Cyprus,Haiti,2,0,2
2000,144,Sri Lanka,Haiti,8,5,3
2000,28,Antigua and Barbuda,Haiti,27,13,14
2000,533,Aruba,Haiti,1000,319,681
2000,44,Bahamas,Haiti,20628,11930,8698
2000,535,"Bonaire, Sint Eustatius and Saba",Haiti,3086,1752,1334
2000,136,Cayman Islands,Haiti,19,12,7
2000,192,Cuba,Haiti,1065,726,339
2000,212,Dominica,Haiti,873,432,441
2000,214,Dominican Republic,Haiti,228652,146511,82141
2000,312,Guadeloupe,Haiti,8515,4280,4235
2000,474,Martinique,Haiti,1562,979,583
2000,630,Puerto Rico,Haiti,327,155,172
2000,662,Saint Lucia,Haiti,28,15,13
2000,796,Turks and Caicos Islands,Haiti,5127,2564,2563
2000,850,United States Virgin Islands,Haiti,506,239,267
2000,84,Belize,Haiti,38,20,18
2000,188,Costa Rica,Haiti,54,32,22
2000,320,Guatemala,Haiti,10,5,5
2000,340,Honduras,Haiti,33,28,5
2000,484,Mexico,Haiti,334,225,109
2000,558,Nicaragua,Haiti,20,13,7
2000,591,Panama,Haiti,300,148,152
2000,32,Argentina,Haiti,86,60,26
2000,68,Bolivia (Plurinational State of),Haiti,7,2,5
2000,76,Brazil,Haiti,15,8,7
2000,152,Chile,Haiti,45,25,20
2000,170,Colombia,Haiti,99,71,28
2000,218,Ecuador,Haiti,40,28,12
2000,254,French Guiana,Haiti,13157,6505,6652
2000,604,Peru,Haiti,36,14,22
2000,862,Venezuela (Bolivarian Republic of),Haiti,1689,963,726
2000,36,Australia,Haiti,90,45,45
2000,100,Bulgaria,Haiti,3,3,0
2000,203,Czechia,Haiti,11,6,5
2000,208,Denmark,Haiti,130,81,49
2000,246,Finland,Haiti,1,1,0
2000,352,Iceland,Haiti,1,0,1
2000,372,Ireland,Haiti,6,3,3
2000,578,Norway,Haiti,11,8,3
2000,752,Sweden,Haiti,107,60,47
2000,826,United Kingdom,Haiti,154,54,100
2000,300,Greece,Haiti,32,14,18
2000,380,Italy,Haiti,228,55,173
2000,724,Spain,Haiti,704,391,313
2000,40,Austria,Haiti,43,19,24
2000,56,Belgium,Haiti,1725,900,825
2000,250,France,Haiti,27950,12140,15810
2000,276,Germany,Haiti,408,168,240
2000,528,Netherlands,Haiti,541,268,273
2000,756,Switzerland,Haiti,1252,506,746
2000,60,Bermuda,Haiti,1291,754,537
2000,124,Canada,Haiti,53390,25756,27634
2000,840,United States of America,Haiti,429964,215954,214010
2005,196,Cyprus,Haiti,3,0,3
2005,144,Sri Lanka,Haiti,18,8,10
2005,28,Antigua and Barbuda,Haiti,29,14,15
2005,533,Aruba,Haiti,1288,446,842
2005,44,Bahamas,Haiti,23047,13224,9823
2005,52,Barbados,Haiti,24,8,16
2005,535,"Bonaire, Sint Eustatius and Saba",Haiti,3288,1866,1422
2005,136,Cayman Islands,Haiti,18,12,6
2005,192,Cuba,Haiti,713,486,227
2005,212,Dominica,Haiti,1071,525,546
2005,214,Dominican Republic,Haiti,271273,170525,100748
2005,312,Guadeloupe,Haiti,11623,5600,6023
2005,474,Martinique,Haiti,1634,1009,625
2005,630,Puerto Rico,Haiti,299,142,157
2005,662,Saint Lucia,Haiti,28,15,13
2005,534,Sint Maarten (Dutch part),Haiti,1317,759,558
2005,796,Turks and Caicos Islands,Haiti,5652,2817,2835
2005,850,United States Virgin Islands,Haiti,574,273,301
2005,84,Belize,Haiti,42,22,20
2005,188,Costa Rica,Haiti,35,20,15
2005,320,Guatemala,Haiti,11,6,5
2005,340,Honduras,Haiti,32,27,5
2005,484,Mexico,Haiti,602,384,218
2005,558,Nicaragua,Haiti,21,10,11
2005,591,Panama,Haiti,371,174,197
2005,32,Argentina,Haiti,64,45,19
2005,68,Bolivia (Plurinational State of),Haiti,10,5,5
2005,76,Brazil,Haiti,35,13,22
2005,152,Chile,Haiti,67,38,29
2005,170,Colombia,Haiti,95,67,28
2005,218,Ecuador,Haiti,47,34,13
2005,254,French Guiana,Haiti,14450,6582,7868
2005,604,Peru,Haiti,43,17,26
2005,862,Venezuela (Bolivarian Republic of),Haiti,1750,996,754
2005,36,Australia,Haiti,90,45,45
2005,100,Bulgaria,Haiti,4,3,1
2005,203,Czechia,Haiti,8,4,4
2005,208,Denmark,Haiti,140,86,54
2005,246,Finland,Haiti,7,5,2
2005,352,Iceland,Haiti,4,1,3
2005,372,Ireland,Haiti,5,2,3
2005,578,Norway,Haiti,22,15,7
2005,752,Sweden,Haiti,116,64,52
2005,826,United Kingdom,Haiti,220,95,125
2005,300,Greece,Haiti,36,15,21
2005,380,Italy,Haiti,466,159,307
2005,724,Spain,Haiti,339,186,153
2005,40,Austria,Haiti,49,21,28
2005,56,Belgium,Haiti,1554,811,743
2005,250,France,Haiti,67078,30040,37038
2005,276,Germany,Haiti,884,396,488
2005,528,Netherlands,Haiti,972,492,480
2005,756,Switzerland,Haiti,1398,525,873
2005,60,Bermuda,Haiti,1475,780,695
2005,124,Canada,Haiti,66504,30199,36305
2005,840,United States of America,Haiti,491772,248351,243421
2010,196,Cyprus,Haiti,4,0,4
2010,144,Sri Lanka,Haiti,38,17,21
2010,28,Antigua and Barbuda,Haiti,31,15,16
2010,533,Aruba,Haiti,1551,565,986
2010,44,Bahamas,Haiti,25465,14517,10948
2010,52,Barbados,Haiti,32,10,22
2010,535,"Bonaire, Sint Eustatius and Saba",Haiti,88,40,48
2010,136,Cayman Islands,Haiti,18,11,7
2010,192,Cuba,Haiti,396,270,126
2010,531,Curaçao,Haiti,1811,992,819
2010,212,Dominica,Haiti,3071,1536,1535
2010,214,Dominican Republic,Haiti,311969,193328,118641
2010,312,Guadeloupe,Haiti,14731,6920,7811
2010,474,Martinique,Haiti,1707,1039,668
2010,630,Puerto Rico,Haiti,235,110,125
2010,662,Saint Lucia,Haiti,26,14,12
2010,534,Sint Maarten (Dutch part),Haiti,2635,1518,1117
2010,796,Turks and Caicos Islands,Haiti,9756,4878,4878
2010,850,United States Virgin Islands,Haiti,644,308,336
2010,84,Belize,Haiti,46,25,21
2010,188,Costa Rica,Haiti,70,41,29
2010,320,Guatemala,Haiti,12,8,4
2010,340,Honduras,Haiti,31,27,4
2010,484,Mexico,Haiti,940,586,354
2010,558,Nicaragua,Haiti,22,11,11
2010,591,Panama,Haiti,461,212,249
2010,32,Argentina,Haiti,41,30,11
2010,68,Bolivia (Plurinational State of),Haiti,13,9,4
2010,76,Brazil,Haiti,54,18,36
2010,152,Chile,Haiti,90,51,39
2010,170,Colombia,Haiti,108,75,33
2010,218,Ecuador,Haiti,66,47,19
2010,254,French Guiana,Haiti,15743,6660,9083
2010,604,Peru,Haiti,47,18,29
2010,862,Venezuela (Bolivarian Republic of),Haiti,1831,1041,790
2010,36,Australia,Haiti,100,43,57
2010,100,Bulgaria,Haiti,5,4,1
2010,203,Czechia,Haiti,4,2,2
2010,208,Denmark,Haiti,147,90,57
2010,246,Finland,Haiti,15,10,5
2010,352,Iceland,Haiti,7,2,5
2010,372,Ireland,Haiti,4,1,3
2010,578,Norway,Haiti,30,19,11
2010,752,Sweden,Haiti,135,68,67
2010,826,United Kingdom,Haiti,231,103,128
2010,300,Greece,Haiti,40,17,23
2010,380,Italy,Haiti,738,268,470
2010,705,Slovenia,Haiti,1,0,1
2010,724,Spain,Haiti,610,342,268
2010,40,Austria,Haiti,54,23,31
2010,56,Belgium,Haiti,1822,797,1025
2010,250,France,Haiti,69806,29433,40373
2010,276,Germany,Haiti,1279,592,687
2010,528,Netherlands,Haiti,1245,642,603
2010,756,Switzerland,Haiti,1655,559,1096
2010,60,Bermuda,Haiti,1658,806,852
2010,124,Canada,Haiti,80100,35019,45081
2010,840,United States of America,Haiti,570290,284120,286170
2015,324,Guinea,Haiti,25,13,12
2015,196,Cyprus,Haiti,3,0,3
2015,144,Sri Lanka,Haiti,37,16,21
2015,28,Antigua and Barbuda,Haiti,33,16,17
2015,533,Aruba,Haiti,1632,595,1037
2015,44,Bahamas,Haiti,27591,15643,11948
2015,52,Barbados,Haiti,33,10,23
2015,535,"Bonaire, Sint Eustatius and Saba",Haiti,100,46,54
2015,136,Cayman Islands,Haiti,18,12,6
2015,192,Cuba,Haiti,316,215,101
2015,531,Curaçao,Haiti,1968,1080,888
2015,212,Dominica,Haiti,2453,1227,1226
2015,214,Dominican Republic,Haiti,475084,310466,164618
2015,312,Guadeloupe,Haiti,15284,7102,8182
2015,474,Martinique,Haiti,1768,1070,698
2015,630,Puerto Rico,Haiti,160,74,86
2015,662,Saint Lucia,Haiti,24,13,11
2015,534,Sint Maarten (Dutch part),Haiti,2746,1581,1165
2015,796,Turks and Caicos Islands,Haiti,13928,6965,6963
2015,850,United States Virgin Islands,Haiti,644,308,336
2015,84,Belize,Haiti,54,30,24
2015,188,Costa Rica,Haiti,71,42,29
2015,320,Guatemala,Haiti,14,9,5
2015,340,Honduras,Haiti,43,38,5
2015,484,Mexico,Haiti,578,300,278
2015,558,Nicaragua,Haiti,23,12,11
2015,591,Panama,Haiti,542,248,294
2015,32,Argentina,Haiti,41,30,11
2015,68,Bolivia (Plurinational State of),Haiti,15,10,5
2015,76,Brazil,Haiti,65,22,43
2015,152,Chile,Haiti,39825,22194,17631
2015,170,Colombia,Haiti,120,84,36
2015,218,Ecuador,Haiti,96,69,27
2015,254,French Guiana,Haiti,19005,7908,11097
2015,604,Peru,Haiti,49,19,30
2015,862,Venezuela (Bolivarian Republic of),Haiti,1900,1069,831
2015,36,Australia,Haiti,120,64,56
2015,100,Bulgaria,Haiti,5,4,1
2015,203,Czechia,Haiti,7,4,3
2015,208,Denmark,Haiti,164,98,66
2015,246,Finland,Haiti,12,9,3
2015,352,Iceland,Haiti,12,3,9
2015,372,Ireland,Haiti,4,1,3
2015,578,Norway,Haiti,40,24,16
2015,752,Sweden,Haiti,144,74,70
2015,826,United Kingdom,Haiti,295,127,168
2015,300,Greece,Haiti,37,15,22
2015,380,Italy,Haiti,714,268,446
2015,705,Slovenia,Haiti,10,6,4
2015,724,Spain,Haiti,723,396,327
2015,40,Austria,Haiti,63,28,35
2015,56,Belgium,Haiti,1925,853,1072
2015,250,France,Haiti,77330,31375,45955
2015,276,Germany,Haiti,1333,615,718
2015,528,Netherlands,Haiti,1411,734,677
2015,756,Switzerland,Haiti,1723,591,1132
2015,60,Bermuda,Haiti,1680,818,862
2015,124,Canada,Haiti,92911,40685,52226
2015,840,United States of America,Haiti,682521,338275,344246
2019,324,Guinea,Haiti,23,12,11
2019,196,Cyprus,Haiti,2,0,2
2019,144,Sri Lanka,Haiti,37,16,21
2019,28,Antigua and Barbuda,Haiti,34,17,17
2019,533,Aruba,Haiti,1650,602,1048
2019,44,Bahamas,Haiti,29291,16607,12684
2019,52,Barbados,Haiti,33,10,23
2019,535,"Bonaire, Sint Eustatius and Saba",Haiti,119,55,64
2019,136,Cayman Islands,Haiti,20,13,7
2019,192,Cuba,Haiti,290,197,93
2019,531,Curaçao,Haiti,2139,1174,965
2019,212,Dominica,Haiti,2504,1252,1252
2019,214,Dominican Republic,Haiti,491013,320849,170164
2019,312,Guadeloupe,Haiti,15520,7212,8308
2019,474,Martinique,Haiti,1765,1068,697
2019,630,Puerto Rico,Haiti,139,64,75
2019,662,Saint Lucia,Haiti,23,13,10
2019,534,Sint Maarten (Dutch part),Haiti,2843,1637,1206
2019,796,Turks and Caicos Islands,Haiti,15040,7522,7518
2019,850,United States Virgin Islands,Haiti,644,308,336
2019,84,Belize,Haiti,59,33,26
2019,188,Costa Rica,Haiti,72,43,29
2019,320,Guatemala,Haiti,14,9,5
2019,340,Honduras,Haiti,43,38,5
2019,484,Mexico,Haiti,595,309,286
2019,558,Nicaragua,Haiti,24,13,11
2019,591,Panama,Haiti,576,264,312
2019,32,Argentina,Haiti,41,30,11
2019,68,Bolivia (Plurinational State of),Haiti,16,11,5
2019,76,Brazil,Haiti,73,25,48
2019,152,Chile,Haiti,68643,43775,24868
2019,170,Colombia,Haiti,122,86,36
2019,218,Ecuador,Haiti,94,68,26
2019,254,French Guiana,Haiti,21022,8748,12274
2019,604,Peru,Haiti,58,24,34
2019,862,Venezuela (Bolivarian Republic of),Haiti,1861,1044,817
2019,36,Australia,Haiti,137,73,64
2019,100,Bulgaria,Haiti,5,4,1
2019,203,Czechia,Haiti,10,5,5
2019,208,Denmark,Haiti,167,97,70
2019,246,Finland,Haiti,14,9,5
2019,352,Iceland,Haiti,15,5,10
2019,372,Ireland,Haiti,4,1,3
2019,578,Norway,Haiti,53,29,24
2019,752,Sweden,Haiti,153,79,74
2019,826,United Kingdom,Haiti,335,145,190
2019,300,Greece,Haiti,36,16,20
2019,380,Italy,Haiti,792,309,483
2019,705,Slovenia,Haiti,2,1,1
2019,724,Spain,Haiti,749,403,346
2019,40,Austria,Haiti,74,34,40
2019,56,Belgium,Haiti,2069,935,1134
2019,250,France,Haiti,81854,33100,48754
2019,276,Germany,Haiti,1462,682,780
2019,528,Netherlands,Haiti,1547,810,737
2019,756,Switzerland,Haiti,1804,636,1168
2019,60,Bermuda,Haiti,1698,827,871
2019,124,Canada,Haiti,99564,43598,55966
2019,840,United States of America,Haiti,737058,361304,375754
1990,152,Chile,Holy See,21,8,13
1990,300,Greece,Holy See,2,2,0
1990,380,Italy,Holy See,8,3,5
1995,152,Chile,Holy See,11,1,10
1995,300,Greece,Holy See,5,3,2
1995,380,Italy,Holy See,21,14,7
2000,152,Chile,Holy See,2,0,2
2000,300,Greece,Holy See,8,3,5
2000,380,Italy,Holy See,33,25,8
2005,152,Chile,Holy See,3,1,2
2005,300,Greece,Holy See,4,1,3
2005,380,Italy,Holy See,106,53,53
2010,152,Chile,Holy See,4,1,3
2010,233,Estonia,Holy See,1,0,1
2010,380,Italy,Holy See,173,75,98
2015,152,Chile,Holy See,6,2,4
2015,233,Estonia,Holy See,1,0,1
2015,380,Italy,Holy See,299,107,192
2019,152,Chile,Holy See,8,3,5
2019,380,Italy,Holy See,209,92,117
1990,196,Cyprus,Honduras,1,1,0
1990,28,Antigua and Barbuda,Honduras,3,1,2
1990,44,Bahamas,Honduras,7,5,2
1990,136,Cayman Islands,Honduras,747,357,390
1990,214,Dominican Republic,Honduras,433,226,207
1990,388,Jamaica,Honduras,157,66,91
1990,630,Puerto Rico,Honduras,435,206,229
1990,84,Belize,Honduras,2764,1521,1243
1990,188,Costa Rica,Honduras,2608,1156,1452
1990,222,El Salvador,Honduras,15774,6905,8869
1990,320,Guatemala,Honduras,4768,990,3778
1990,484,Mexico,Honduras,1990,955,1035
1990,558,Nicaragua,Honduras,10105,4953,5152
1990,591,Panama,Honduras,638,292,346
1990,32,Argentina,Honduras,141,68,73
1990,68,Bolivia (Plurinational State of),Honduras,232,110,122
1990,76,Brazil,Honduras,280,208,72
1990,152,Chile,Honduras,215,106,109
1990,170,Colombia,Honduras,265,126,139
1990,218,Ecuador,Honduras,157,71,86
1990,604,Peru,Honduras,102,40,62
1990,862,Venezuela (Bolivarian Republic of),Honduras,437,193,244
1990,36,Australia,Honduras,124,68,56
1990,203,Czechia,Honduras,1,1,0
1990,348,Hungary,Honduras,2,2,0
1990,208,Denmark,Honduras,34,11,23
1990,246,Finland,Honduras,5,2,3
1990,352,Iceland,Honduras,7,6,1
1990,372,Ireland,Honduras,2,1,1
1990,578,Norway,Honduras,57,29,28
1990,752,Sweden,Honduras,165,83,82
1990,826,United Kingdom,Honduras,59,32,27
1990,300,Greece,Honduras,62,35,27
1990,380,Italy,Honduras,78,27,51
1990,724,Spain,Honduras,1169,354,815
1990,40,Austria,Honduras,54,22,32
1990,56,Belgium,Honduras,96,32,64
1990,250,France,Honduras,482,204,278
1990,276,Germany,Honduras,438,165,273
1990,528,Netherlands,Honduras,125,48,77
1990,756,Switzerland,Honduras,250,90,160
1990,124,Canada,Honduras,2202,1072,1130
1990,840,United States of America,Honduras,108923,46067,62856
1995,196,Cyprus,Honduras,2,2,0
1995,28,Antigua and Barbuda,Honduras,5,2,3
1995,44,Bahamas,Honduras,10,5,5
1995,136,Cayman Islands,Honduras,678,325,353
1995,214,Dominican Republic,Honduras,481,245,236
1995,388,Jamaica,Honduras,165,70,95
1995,630,Puerto Rico,Honduras,446,212,234
1995,84,Belize,Honduras,4100,2140,1960
1995,188,Costa Rica,Honduras,2241,1005,1236
1995,222,El Salvador,Honduras,12650,5450,7200
1995,320,Guatemala,Honduras,5032,1492,3540
1995,484,Mexico,Honduras,3031,1290,1741
1995,558,Nicaragua,Honduras,9473,4607,4866
1995,591,Panama,Honduras,715,331,384
1995,32,Argentina,Honduras,140,66,74
1995,68,Bolivia (Plurinational State of),Honduras,216,102,114
1995,76,Brazil,Honduras,208,156,52
1995,152,Chile,Honduras,224,96,128
1995,170,Colombia,Honduras,276,134,142
1995,218,Ecuador,Honduras,176,79,97
1995,604,Peru,Honduras,103,39,64
1995,862,Venezuela (Bolivarian Republic of),Honduras,369,153,216
1995,36,Australia,Honduras,146,71,75
1995,100,Bulgaria,Honduras,1,1,0
1995,203,Czechia,Honduras,1,0,1
1995,348,Hungary,Honduras,5,3,2
1995,208,Denmark,Honduras,52,18,34
1995,246,Finland,Honduras,10,3,7
1995,352,Iceland,Honduras,11,9,2
1995,372,Ireland,Honduras,6,2,4
1995,578,Norway,Honduras,63,30,33
1995,752,Sweden,Honduras,195,97,98
1995,826,United Kingdom,Honduras,233,96,137
1995,300,Greece,Honduras,47,22,25
1995,380,Italy,Honduras,319,67,252
1995,724,Spain,Honduras,1515,472,1043
1995,40,Austria,Honduras,61,25,36
1995,56,Belgium,Honduras,96,32,64
1995,250,France,Honduras,498,206,292
1995,276,Germany,Honduras,498,168,330
1995,528,Netherlands,Honduras,184,68,116
1995,756,Switzerland,Honduras,315,120,195
1995,124,Canada,Honduras,3293,1593,1700
1995,840,United States of America,Honduras,198509,85305,113204
2000,196,Cyprus,Honduras,2,2,0
2000,28,Antigua and Barbuda,Honduras,6,3,3
2000,44,Bahamas,Honduras,13,6,7
2000,136,Cayman Islands,Honduras,777,373,404
2000,214,Dominican Republic,Honduras,529,265,264
2000,388,Jamaica,Honduras,173,74,99
2000,630,Puerto Rico,Honduras,460,219,241
2000,84,Belize,Honduras,5436,2760,2676
2000,188,Costa Rica,Honduras,2994,1306,1688
2000,222,El Salvador,Honduras,9525,3994,5531
2000,320,Guatemala,Honduras,5295,1993,3302
2000,484,Mexico,Honduras,4203,1689,2514
2000,558,Nicaragua,Honduras,10017,4840,5177
2000,591,Panama,Honduras,838,388,450
2000,32,Argentina,Honduras,139,65,74
2000,68,Bolivia (Plurinational State of),Honduras,197,92,105
2000,76,Brazil,Honduras,136,105,31
2000,152,Chile,Honduras,234,99,135
2000,170,Colombia,Honduras,286,141,145
2000,218,Ecuador,Honduras,195,88,107
2000,604,Peru,Honduras,121,46,75
2000,862,Venezuela (Bolivarian Republic of),Honduras,309,118,191
2000,36,Australia,Honduras,180,94,86
2000,100,Bulgaria,Honduras,1,1,0
2000,203,Czechia,Honduras,1,0,1
2000,348,Hungary,Honduras,7,4,3
2000,208,Denmark,Honduras,69,25,44
2000,246,Finland,Honduras,14,4,10
2000,352,Iceland,Honduras,14,11,3
2000,372,Ireland,Honduras,14,5,9
2000,578,Norway,Honduras,61,31,30
2000,752,Sweden,Honduras,210,104,106
2000,826,United Kingdom,Honduras,412,162,250
2000,300,Greece,Honduras,33,10,23
2000,380,Italy,Honduras,560,108,452
2000,705,Slovenia,Honduras,1,0,1
2000,724,Spain,Honduras,2515,823,1692
2000,40,Austria,Honduras,68,29,39
2000,56,Belgium,Honduras,93,32,61
2000,250,France,Honduras,514,209,305
2000,276,Germany,Honduras,557,170,387
2000,528,Netherlands,Honduras,250,89,161
2000,756,Switzerland,Honduras,382,151,231
2000,124,Canada,Honduras,4462,2152,2310
2000,840,United States of America,Honduras,290034,125606,164428
2005,196,Cyprus,Honduras,3,3,0
2005,28,Antigua and Barbuda,Honduras,7,4,3
2005,44,Bahamas,Honduras,27,19,8
2005,136,Cayman Islands,Honduras,1176,477,699
2005,214,Dominican Republic,Honduras,467,230,237
2005,388,Jamaica,Honduras,169,73,96
2005,630,Puerto Rico,Honduras,338,161,177
2005,84,Belize,Honduras,6375,3219,3156
2005,188,Costa Rica,Honduras,1961,841,1120
2005,222,El Salvador,Honduras,10362,4283,6079
2005,320,Guatemala,Honduras,6294,2636,3658
2005,484,Mexico,Honduras,6702,2968,3734
2005,558,Nicaragua,Honduras,10745,5189,5556
2005,591,Panama,Honduras,1034,483,551
2005,32,Argentina,Honduras,103,49,54
2005,68,Bolivia (Plurinational State of),Honduras,198,96,102
2005,76,Brazil,Honduras,131,90,41
2005,152,Chile,Honduras,351,152,199
2005,170,Colombia,Honduras,283,142,141
2005,218,Ecuador,Honduras,230,106,124
2005,604,Peru,Honduras,142,54,88
2005,862,Venezuela (Bolivarian Republic of),Honduras,299,124,175
2005,36,Australia,Honduras,230,128,102
2005,100,Bulgaria,Honduras,2,1,1
2005,203,Czechia,Honduras,6,3,3
2005,348,Hungary,Honduras,9,5,4
2005,208,Denmark,Honduras,91,33,58
2005,246,Finland,Honduras,27,10,17
2005,352,Iceland,Honduras,24,13,11
2005,372,Ireland,Honduras,14,5,9
2005,578,Norway,Honduras,69,34,35
2005,752,Sweden,Honduras,274,135,139
2005,826,United Kingdom,Honduras,490,185,305
2005,300,Greece,Honduras,42,10,32
2005,380,Italy,Honduras,1442,372,1070
2005,724,Spain,Honduras,7820,2814,5006
2005,40,Austria,Honduras,76,31,45
2005,56,Belgium,Honduras,131,41,90
2005,250,France,Honduras,453,158,295
2005,276,Germany,Honduras,890,309,581
2005,528,Netherlands,Honduras,326,119,207
2005,756,Switzerland,Honduras,425,157,268
2005,124,Canada,Honduras,5243,2539,2704
2005,840,United States of America,Honduras,383822,167426,216396
2010,196,Cyprus,Honduras,4,4,0
2010,28,Antigua and Barbuda,Honduras,7,4,3
2010,44,Bahamas,Honduras,40,32,8
2010,136,Cayman Islands,Honduras,1682,623,1059
2010,214,Dominican Republic,Honduras,402,193,209
2010,388,Jamaica,Honduras,164,71,93
2010,630,Puerto Rico,Honduras,174,82,92
2010,84,Belize,Honduras,7313,3693,3620
2010,188,Costa Rica,Honduras,3865,1664,2201
2010,222,El Salvador,Honduras,11198,4571,6627
2010,320,Guatemala,Honduras,7292,3279,4013
2010,484,Mexico,Honduras,9980,4599,5381
2010,558,Nicaragua,Honduras,11534,5598,5936
2010,591,Panama,Honduras,1280,610,670
2010,32,Argentina,Honduras,66,32,34
2010,68,Bolivia (Plurinational State of),Honduras,198,99,99
2010,76,Brazil,Honduras,125,75,50
2010,152,Chile,Honduras,468,205,263
2010,170,Colombia,Honduras,329,170,159
2010,218,Ecuador,Honduras,323,145,178
2010,604,Peru,Honduras,158,60,98
2010,862,Venezuela (Bolivarian Republic of),Honduras,293,131,162
2010,36,Australia,Honduras,240,122,118
2010,100,Bulgaria,Honduras,2,1,1
2010,203,Czechia,Honduras,10,6,4
2010,348,Hungary,Honduras,11,6,5
2010,208,Denmark,Honduras,111,41,70
2010,233,Estonia,Honduras,1,1,0
2010,246,Finland,Honduras,50,18,32
2010,352,Iceland,Honduras,32,14,18
2010,372,Ireland,Honduras,12,4,8
2010,578,Norway,Honduras,95,47,48
2010,752,Sweden,Honduras,330,169,161
2010,826,United Kingdom,Honduras,516,202,314
2010,300,Greece,Honduras,53,12,41
2010,380,Italy,Honduras,2117,564,1553
2010,724,Spain,Honduras,26902,8410,18492
2010,40,Austria,Honduras,84,34,50
2010,56,Belgium,Honduras,173,57,116
2010,250,France,Honduras,550,217,333
2010,276,Germany,Honduras,1165,427,738
2010,528,Netherlands,Honduras,393,142,251
2010,756,Switzerland,Honduras,505,165,340
2010,124,Canada,Honduras,5805,2826,2979
2010,840,United States of America,Honduras,491834,210726,281108
2015,324,Guinea,Honduras,298,166,132
2015,196,Cyprus,Honduras,3,3,0
2015,28,Antigua and Barbuda,Honduras,7,4,3
2015,44,Bahamas,Honduras,43,34,9
2015,136,Cayman Islands,Honduras,1832,676,1156
2015,214,Dominican Republic,Honduras,424,204,220
2015,388,Jamaica,Honduras,160,69,91
2015,630,Puerto Rico,Honduras,408,190,218
2015,84,Belize,Honduras,8624,4329,4295
2015,188,Costa Rica,Honduras,3924,1676,2248
2015,222,El Salvador,Honduras,11676,4775,6901
2015,320,Guatemala,Honduras,8387,3837,4550
2015,484,Mexico,Honduras,14840,6598,8242
2015,558,Nicaragua,Honduras,12439,6071,6368
2015,591,Panama,Honduras,1504,715,789
2015,32,Argentina,Honduras,66,32,34
2015,68,Bolivia (Plurinational State of),Honduras,231,116,115
2015,76,Brazil,Honduras,151,91,60
2015,152,Chile,Honduras,708,302,406
2015,170,Colombia,Honduras,368,192,176
2015,218,Ecuador,Honduras,469,209,260
2015,604,Peru,Honduras,168,67,101
2015,862,Venezuela (Bolivarian Republic of),Honduras,294,130,164
2015,36,Australia,Honduras,320,153,167
2015,100,Bulgaria,Honduras,2,1,1
2015,203,Czechia,Honduras,21,12,9
2015,348,Hungary,Honduras,10,7,3
2015,208,Denmark,Honduras,135,55,80
2015,233,Estonia,Honduras,2,2,0
2015,246,Finland,Honduras,75,31,44
2015,352,Iceland,Honduras,35,16,19
2015,372,Ireland,Honduras,12,4,8
2015,578,Norway,Honduras,119,51,68
2015,752,Sweden,Honduras,361,181,180
2015,826,United Kingdom,Honduras,659,246,413
2015,300,Greece,Honduras,49,9,40
2015,380,Italy,Honduras,2484,660,1824
2015,705,Slovenia,Honduras,5,3,2
2015,724,Spain,Honduras,41333,10959,30374
2015,40,Austria,Honduras,98,40,58
2015,56,Belgium,Honduras,261,77,184
2015,250,France,Honduras,609,231,378
2015,276,Germany,Honduras,1214,444,770
2015,528,Netherlands,Honduras,466,174,292
2015,756,Switzerland,Honduras,637,210,427
2015,124,Canada,Honduras,7737,3691,4046
2015,840,United States of America,Honduras,607457,258482,348975
2019,324,Guinea,Honduras,284,159,125
2019,196,Cyprus,Honduras,2,2,0
2019,28,Antigua and Barbuda,Honduras,7,4,3
2019,44,Bahamas,Honduras,45,36,9
2019,136,Cayman Islands,Honduras,2029,750,1279
2019,214,Dominican Republic,Honduras,438,211,227
2019,388,Jamaica,Honduras,162,70,92
2019,630,Puerto Rico,Honduras,574,267,307
2019,84,Belize,Honduras,9463,4750,4713
2019,188,Costa Rica,Honduras,3981,1715,2266
2019,222,El Salvador,Honduras,11834,4840,6994
2019,320,Guatemala,Honduras,8608,3938,4670
2019,484,Mexico,Honduras,15300,6803,8497
2019,558,Nicaragua,Honduras,13057,6360,6697
2019,591,Panama,Honduras,1592,758,834
2019,32,Argentina,Honduras,67,33,34
2019,68,Bolivia (Plurinational State of),Honduras,252,127,125
2019,76,Brazil,Honduras,170,103,67
2019,152,Chile,Honduras,945,373,572
2019,170,Colombia,Honduras,376,196,180
2019,218,Ecuador,Honduras,461,205,256
2019,604,Peru,Honduras,199,84,115
2019,862,Venezuela (Bolivarian Republic of),Honduras,287,126,161
2019,36,Australia,Honduras,338,160,178
2019,100,Bulgaria,Honduras,2,1,1
2019,203,Czechia,Honduras,31,15,16
2019,348,Hungary,Honduras,9,5,4
2019,208,Denmark,Honduras,162,70,92
2019,233,Estonia,Honduras,6,3,3
2019,246,Finland,Honduras,103,37,66
2019,352,Iceland,Honduras,46,22,24
2019,372,Ireland,Honduras,13,5,8
2019,578,Norway,Honduras,130,57,73
2019,752,Sweden,Honduras,407,194,213
2019,826,United Kingdom,Honduras,748,281,467
2019,300,Greece,Honduras,47,10,37
2019,380,Italy,Honduras,2880,792,2088
2019,705,Slovenia,Honduras,4,3,1
2019,724,Spain,Honduras,57764,14756,43008
2019,40,Austria,Honduras,115,48,67
2019,56,Belgium,Honduras,288,86,202
2019,250,France,Honduras,644,243,401
2019,276,Germany,Honduras,1331,536,795
2019,528,Netherlands,Honduras,545,200,345
2019,756,Switzerland,Honduras,706,240,466
2019,124,Canada,Honduras,8291,3956,4335
2019,840,United States of America,Honduras,655995,275080,380915
1990,800,Uganda,Hungary,10,1,9
1990,818,Egypt,Hungary,123,57,66
1990,434,Libya,Hungary,350,162,188
1990,196,Cyprus,Hungary,86,36,50
1990,376,Israel,Hungary,15656,7361,8295
1990,400,Jordan,Hungary,35,4,31
1990,422,Lebanon,Hungary,16,2,14
1990,792,Turkey,Hungary,126,57,69
1990,608,Philippines,Hungary,3,1,2
1990,192,Cuba,Hungary,155,65,90
1990,214,Dominican Republic,Hungary,51,31,20
1990,188,Costa Rica,Hungary,66,35,31
1990,484,Mexico,Hungary,290,140,150
1990,591,Panama,Hungary,79,32,47
1990,32,Argentina,Hungary,3297,1479,1818
1990,68,Bolivia (Plurinational State of),Hungary,50,22,28
1990,76,Brazil,Hungary,5282,2212,3070
1990,152,Chile,Hungary,498,260,238
1990,170,Colombia,Hungary,162,87,75
1990,218,Ecuador,Hungary,72,28,44
1990,604,Peru,Hungary,39,20,19
1990,862,Venezuela (Bolivarian Republic of),Hungary,908,458,450
1990,36,Australia,Hungary,29103,16048,13055
1990,554,New Zealand,Hungary,291,158,133
1990,112,Belarus,Hungary,291,149,142
1990,100,Bulgaria,Hungary,70,30,40
1990,203,Czechia,Hungary,1526,771,755
1990,616,Poland,Hungary,1907,833,1074
1990,498,Republic of Moldova,Hungary,690,350,340
1990,642,Romania,Hungary,9320,3291,6029
1990,643,Russian Federation,Hungary,18236,8949,9287
1990,703,Slovakia,Hungary,6010,2339,3671
1990,208,Denmark,Hungary,1210,668,542
1990,233,Estonia,Hungary,36,18,18
1990,246,Finland,Hungary,554,290,264
1990,352,Iceland,Hungary,35,14,21
1990,372,Ireland,Hungary,167,82,85
1990,428,Latvia,Hungary,293,153,140
1990,440,Lithuania,Hungary,132,68,64
1990,578,Norway,Hungary,1356,841,515
1990,752,Sweden,Hungary,11100,5727,5373
1990,826,United Kingdom,Hungary,12192,7141,5051
1990,70,Bosnia and Herzegovina,Hungary,233,67,166
1990,191,Croatia,Hungary,1666,510,1156
1990,300,Greece,Hungary,905,183,722
1990,380,Italy,Hungary,698,243,455
1990,470,Malta,Hungary,5,1,4
1990,807,North Macedonia,Hungary,82,34,48
1990,620,Portugal,Hungary,63,22,41
1990,688,Serbia,Hungary,221,80,141
1990,705,Slovenia,Hungary,385,128,257
1990,724,Spain,Hungary,587,239,348
1990,40,Austria,Hungary,14405,4769,9636
1990,56,Belgium,Hungary,1309,718,591
1990,250,France,Hungary,13404,7174,6230
1990,276,Germany,Hungary,50833,30410,20423
1990,438,Liechtenstein,Hungary,6,6,0
1990,442,Luxembourg,Hungary,58,28,30
1990,528,Netherlands,Hungary,4740,2024,2716
1990,756,Switzerland,Hungary,11002,5638,5364
1990,124,Canada,Hungary,54702,26631,28071
1990,840,United States of America,Hungary,110337,52805,57532
1995,800,Uganda,Hungary,9,1,8
1995,818,Egypt,Hungary,106,45,61
1995,434,Libya,Hungary,297,133,164
1995,196,Cyprus,Hungary,122,48,74
1995,376,Israel,Hungary,15907,7325,8582
1995,400,Jordan,Hungary,374,154,220
1995,422,Lebanon,Hungary,170,61,109
1995,792,Turkey,Hungary,304,129,175
1995,608,Philippines,Hungary,4,2,2
1995,192,Cuba,Hungary,118,47,71
1995,214,Dominican Republic,Hungary,57,34,23
1995,188,Costa Rica,Hungary,49,27,22
1995,484,Mexico,Hungary,313,135,178
1995,591,Panama,Hungary,47,19,28
1995,32,Argentina,Hungary,2503,1110,1393
1995,68,Bolivia (Plurinational State of),Hungary,44,20,24
1995,76,Brazil,Hungary,4074,1744,2330
1995,152,Chile,Hungary,410,197,213
1995,170,Colombia,Hungary,148,80,68
1995,218,Ecuador,Hungary,81,31,50
1995,604,Peru,Hungary,40,20,20
1995,862,Venezuela (Bolivarian Republic of),Hungary,896,452,444
1995,36,Australia,Hungary,28679,15590,13089
1995,554,New Zealand,Hungary,389,205,184
1995,112,Belarus,Hungary,323,141,182
1995,100,Bulgaria,Hungary,122,49,73
1995,203,Czechia,Hungary,2290,1189,1101
1995,616,Poland,Hungary,1631,699,932
1995,498,Republic of Moldova,Hungary,466,230,236
1995,642,Romania,Hungary,7522,2708,4814
1995,643,Russian Federation,Hungary,18740,9383,9357
1995,703,Slovakia,Hungary,7707,3145,4562
1995,208,Denmark,Hungary,1426,768,658
1995,233,Estonia,Hungary,56,28,28
1995,246,Finland,Hungary,644,356,288
1995,352,Iceland,Hungary,49,20,29
1995,372,Ireland,Hungary,906,431,475
1995,428,Latvia,Hungary,289,145,144
1995,440,Lithuania,Hungary,147,76,71
1995,578,Norway,Hungary,1328,803,525
1995,752,Sweden,Hungary,13173,6749,6424
1995,826,United Kingdom,Hungary,12352,6661,5691
1995,70,Bosnia and Herzegovina,Hungary,237,72,165
1995,191,Croatia,Hungary,1393,398,995
1995,300,Greece,Hungary,1228,401,827
1995,380,Italy,Hungary,2875,411,2464
1995,470,Malta,Hungary,6,1,5
1995,807,North Macedonia,Hungary,77,32,45
1995,620,Portugal,Hungary,136,47,89
1995,688,Serbia,Hungary,1404,490,914
1995,705,Slovenia,Hungary,329,111,218
1995,724,Spain,Hungary,770,320,450
1995,40,Austria,Hungary,16251,5557,10694
1995,56,Belgium,Hungary,1593,755,838
1995,250,France,Hungary,13837,7297,6540
1995,276,Germany,Hungary,69867,42307,27560
1995,438,Liechtenstein,Hungary,7,7,0
1995,442,Luxembourg,Hungary,89,34,55
1995,528,Netherlands,Hungary,4859,2027,2832
1995,756,Switzerland,Hungary,11046,5613,5433
1995,124,Canada,Hungary,51853,25131,26722
1995,840,United States of America,Hungary,102530,49472,53058
2000,800,Uganda,Hungary,9,0,9
2000,818,Egypt,Hungary,98,38,60
2000,434,Libya,Hungary,249,110,139
2000,196,Cyprus,Hungary,157,60,97
2000,268,Georgia,Hungary,49,21,28
2000,376,Israel,Hungary,15268,6971,8297
2000,400,Jordan,Hungary,712,305,407
2000,422,Lebanon,Hungary,323,120,203
2000,792,Turkey,Hungary,485,203,282
2000,608,Philippines,Hungary,125,99,26
2000,192,Cuba,Hungary,80,28,52
2000,214,Dominican Republic,Hungary,62,36,26
2000,188,Costa Rica,Hungary,56,30,26
2000,484,Mexico,Hungary,351,138,213
2000,591,Panama,Hungary,20,9,11
2000,32,Argentina,Hungary,1710,743,967
2000,68,Bolivia (Plurinational State of),Hungary,37,18,19
2000,76,Brazil,Hungary,2865,1275,1590
2000,152,Chile,Hungary,323,154,169
2000,170,Colombia,Hungary,133,73,60
2000,218,Ecuador,Hungary,90,35,55
2000,604,Peru,Hungary,47,23,24
2000,862,Venezuela (Bolivarian Republic of),Hungary,878,443,435
2000,36,Australia,Hungary,26130,13846,12284
2000,554,New Zealand,Hungary,962,468,494
2000,112,Belarus,Hungary,354,133,221
2000,100,Bulgaria,Hungary,174,68,106
2000,203,Czechia,Hungary,3053,1607,1446
2000,616,Poland,Hungary,1395,586,809
2000,498,Republic of Moldova,Hungary,315,151,164
2000,642,Romania,Hungary,5624,2088,3536
2000,643,Russian Federation,Hungary,18565,9479,9086
2000,703,Slovakia,Hungary,11565,4848,6717
2000,208,Denmark,Hungary,1641,867,774
2000,233,Estonia,Hungary,76,39,37
2000,246,Finland,Hungary,734,423,311
2000,352,Iceland,Hungary,63,26,37
2000,372,Ireland,Hungary,2144,1056,1088
2000,428,Latvia,Hungary,285,136,149
2000,440,Lithuania,Hungary,115,60,55
2000,578,Norway,Hungary,1409,793,616
2000,752,Sweden,Hungary,14127,7192,6935
2000,826,United Kingdom,Hungary,12721,6279,6442
2000,70,Bosnia and Herzegovina,Hungary,240,76,164
2000,191,Croatia,Hungary,971,257,714
2000,300,Greece,Hungary,1572,612,960
2000,380,Italy,Hungary,5052,580,4472
2000,470,Malta,Hungary,15,4,11
2000,807,North Macedonia,Hungary,72,30,42
2000,620,Portugal,Hungary,215,74,141
2000,688,Serbia,Hungary,1909,639,1270
2000,705,Slovenia,Hungary,398,143,255
2000,724,Spain,Hungary,1285,550,735
2000,40,Austria,Hungary,18097,6346,11751
2000,56,Belgium,Hungary,1832,773,1059
2000,250,France,Hungary,14270,7421,6849
2000,276,Germany,Hungary,88901,54205,34696
2000,438,Liechtenstein,Hungary,9,9,0
2000,442,Luxembourg,Hungary,122,40,82
2000,528,Netherlands,Hungary,5151,2094,3057
2000,756,Switzerland,Hungary,11132,5625,5507
2000,124,Canada,Hungary,50236,24234,26002
2000,840,United States of America,Hungary,94353,46020,48333
2005,800,Uganda,Hungary,8,0,8
2005,818,Egypt,Hungary,117,50,67
2005,434,Libya,Hungary,274,149,125
2005,196,Cyprus,Hungary,230,87,143
2005,268,Georgia,Hungary,46,20,26
2005,376,Israel,Hungary,13609,6146,7463
2005,400,Jordan,Hungary,1028,512,516
2005,422,Lebanon,Hungary,253,100,153
2005,792,Turkey,Hungary,499,202,297
2005,496,Mongolia,Hungary,4,3,1
2005,608,Philippines,Hungary,101,81,20
2005,192,Cuba,Hungary,53,19,34
2005,214,Dominican Republic,Hungary,41,25,16
2005,188,Costa Rica,Hungary,37,20,17
2005,484,Mexico,Hungary,340,132,208
2005,591,Panama,Hungary,34,20,14
2005,32,Argentina,Hungary,1262,559,703
2005,68,Bolivia (Plurinational State of),Hungary,30,15,15
2005,76,Brazil,Hungary,2204,1008,1196
2005,152,Chile,Hungary,484,235,249
2005,170,Colombia,Hungary,121,67,54
2005,218,Ecuador,Hungary,106,43,63
2005,604,Peru,Hungary,56,27,29
2005,862,Venezuela (Bolivarian Republic of),Hungary,923,467,456
2005,36,Australia,Hungary,24340,12559,11781
2005,554,New Zealand,Hungary,1199,582,617
2005,112,Belarus,Hungary,341,128,213
2005,100,Bulgaria,Hungary,254,102,152
2005,203,Czechia,Hungary,1998,1059,939
2005,616,Poland,Hungary,1372,609,763
2005,498,Republic of Moldova,Hungary,218,102,116
2005,642,Romania,Hungary,5868,2296,3572
2005,643,Russian Federation,Hungary,17727,8962,8765
2005,703,Slovakia,Hungary,12768,5375,7393
2005,208,Denmark,Hungary,2199,1110,1089
2005,233,Estonia,Hungary,88,42,46
2005,246,Finland,Hungary,1185,652,533
2005,352,Iceland,Hungary,110,57,53
2005,372,Ireland,Hungary,5545,3120,2425
2005,428,Latvia,Hungary,267,125,142
2005,440,Lithuania,Hungary,123,66,57
2005,578,Norway,Hungary,1514,817,697
2005,752,Sweden,Hungary,13600,6757,6843
2005,826,United Kingdom,Hungary,30132,14910,15222
2005,70,Bosnia and Herzegovina,Hungary,156,49,107
2005,191,Croatia,Hungary,1004,293,711
2005,300,Greece,Hungary,1669,602,1067
2005,380,Italy,Hungary,8970,1944,7026
2005,470,Malta,Hungary,27,7,20
2005,807,North Macedonia,Hungary,73,31,42
2005,620,Portugal,Hungary,309,105,204
2005,688,Serbia,Hungary,1884,617,1267
2005,705,Slovenia,Hungary,350,125,225
2005,724,Spain,Hungary,2869,1181,1688
2005,40,Austria,Hungary,28059,11728,16331
2005,56,Belgium,Hungary,3835,1743,2092
2005,250,France,Hungary,9674,4628,5046
2005,276,Germany,Hungary,116809,64415,52394
2005,438,Liechtenstein,Hungary,28,13,15
2005,442,Luxembourg,Hungary,414,137,277
2005,528,Netherlands,Hungary,5656,2274,3382
2005,756,Switzerland,Hungary,12895,6210,6685
2005,124,Canada,Hungary,43689,21266,22423
2005,840,United States of America,Hungary,87078,42719,44359
2010,800,Uganda,Hungary,8,0,8
2010,818,Egypt,Hungary,126,51,75
2010,434,Libya,Hungary,300,165,135
2010,196,Cyprus,Hungary,376,145,231
2010,268,Georgia,Hungary,46,20,26
2010,376,Israel,Hungary,12115,5380,6735
2010,400,Jordan,Hungary,1322,696,626
2010,422,Lebanon,Hungary,183,81,102
2010,792,Turkey,Hungary,514,202,312
2010,496,Mongolia,Hungary,9,5,4
2010,608,Philippines,Hungary,240,189,51
2010,192,Cuba,Hungary,29,10,19
2010,214,Dominican Republic,Hungary,20,14,6
2010,188,Costa Rica,Hungary,73,40,33
2010,484,Mexico,Hungary,369,142,227
2010,591,Panama,Hungary,50,32,18
2010,32,Argentina,Hungary,813,375,438
2010,68,Bolivia (Plurinational State of),Hungary,23,12,11
2010,76,Brazil,Hungary,1512,725,787
2010,152,Chile,Hungary,646,317,329
2010,170,Colombia,Hungary,131,74,57
2010,218,Ecuador,Hungary,149,58,91
2010,604,Peru,Hungary,62,30,32
2010,862,Venezuela (Bolivarian Republic of),Hungary,980,496,484
2010,36,Australia,Hungary,22850,11539,11311
2010,554,New Zealand,Hungary,1320,640,680
2010,112,Belarus,Hungary,327,123,204
2010,100,Bulgaria,Hungary,323,131,192
2010,203,Czechia,Hungary,771,463,308
2010,616,Poland,Hungary,1393,646,747
2010,498,Republic of Moldova,Hungary,153,73,80
2010,642,Romania,Hungary,6673,2700,3973
2010,643,Russian Federation,Hungary,16525,8266,8259
2010,703,Slovakia,Hungary,14561,6368,8193
2010,208,Denmark,Hungary,2708,1331,1377
2010,233,Estonia,Hungary,99,44,55
2010,246,Finland,Hungary,1874,950,924
2010,352,Iceland,Hungary,156,87,69
2010,372,Ireland,Hungary,8033,4362,3671
2010,428,Latvia,Hungary,244,110,134
2010,440,Lithuania,Hungary,115,59,56
2010,578,Norway,Hungary,2153,1164,989
2010,752,Sweden,Hungary,15339,7656,7683
2010,826,United Kingdom,Hungary,31742,16036,15706
2010,70,Bosnia and Herzegovina,Hungary,161,51,110
2010,191,Croatia,Hungary,1037,330,707
2010,300,Greece,Hungary,1837,616,1221
2010,380,Italy,Hungary,13074,3374,9700
2010,470,Malta,Hungary,117,41,76
2010,499,Montenegro,Hungary,45,30,15
2010,807,North Macedonia,Hungary,75,32,43
2010,620,Portugal,Hungary,352,118,234
2010,688,Serbia,Hungary,1842,599,1243
2010,705,Slovenia,Hungary,450,184,266
2010,724,Spain,Hungary,7773,3728,4045
2010,40,Austria,Hungary,38020,17109,20911
2010,56,Belgium,Hungary,6742,3073,3669
2010,250,France,Hungary,9909,5047,4862
2010,276,Germany,Hungary,139766,73044,66722
2010,438,Liechtenstein,Hungary,49,17,32
2010,442,Luxembourg,Hungary,711,235,476
2010,528,Netherlands,Hungary,8441,3620,4821
2010,756,Switzerland,Hungary,14708,6624,8084
2010,124,Canada,Hungary,38985,19251,19734
2010,840,United States of America,Hungary,82289,39793,42496
2015,800,Uganda,Hungary,8,0,8
2015,818,Egypt,Hungary,93,45,48
2015,434,Libya,Hungary,338,184,154
2015,196,Cyprus,Hungary,361,141,220
2015,268,Georgia,Hungary,48,21,27
2015,376,Israel,Hungary,12495,5515,6980
2015,400,Jordan,Hungary,569,240,329
2015,422,Lebanon,Hungary,154,74,80
2015,792,Turkey,Hungary,521,198,323
2015,496,Mongolia,Hungary,11,5,6
2015,608,Philippines,Hungary,244,192,52
2015,192,Cuba,Hungary,23,8,15
2015,214,Dominican Republic,Hungary,21,15,6
2015,188,Costa Rica,Hungary,74,41,33
2015,484,Mexico,Hungary,391,148,243
2015,591,Panama,Hungary,59,37,22
2015,32,Argentina,Hungary,816,376,440
2015,68,Bolivia (Plurinational State of),Hungary,27,14,13
2015,76,Brazil,Hungary,1821,873,948
2015,152,Chile,Hungary,978,470,508
2015,170,Colombia,Hungary,146,83,63
2015,218,Ecuador,Hungary,216,83,133
2015,604,Peru,Hungary,65,32,33
2015,862,Venezuela (Bolivarian Republic of),Hungary,1027,513,514
2015,36,Australia,Hungary,21120,10519,10601
2015,554,New Zealand,Hungary,1421,688,733
2015,112,Belarus,Hungary,342,128,214
2015,100,Bulgaria,Hungary,356,154,202
2015,203,Czechia,Hungary,1202,708,494
2015,616,Poland,Hungary,1343,637,706
2015,498,Republic of Moldova,Hungary,112,54,58
2015,642,Romania,Hungary,6420,3038,3382
2015,643,Russian Federation,Hungary,16841,8383,8458
2015,703,Slovakia,Hungary,17058,8345,8713
2015,208,Denmark,Hungary,4131,2041,2090
2015,233,Estonia,Hungary,201,96,105
2015,246,Finland,Hungary,2672,1365,1307
2015,352,Iceland,Hungary,218,109,109
2015,372,Ireland,Hungary,8206,4410,3796
2015,428,Latvia,Hungary,193,87,106
2015,440,Lithuania,Hungary,101,48,53
2015,578,Norway,Hungary,3945,2152,1793
2015,752,Sweden,Hungary,16531,8147,8384
2015,826,United Kingdom,Hungary,40593,19912,20681
2015,70,Bosnia and Herzegovina,Hungary,160,51,109
2015,191,Croatia,Hungary,1044,330,714
2015,300,Greece,Hungary,1724,530,1194
2015,380,Italy,Hungary,12672,3126,9546
2015,470,Malta,Hungary,199,79,120
2015,499,Montenegro,Hungary,47,32,15
2015,807,North Macedonia,Hungary,81,35,46
2015,620,Portugal,Hungary,398,120,278
2015,688,Serbia,Hungary,1800,585,1215
2015,705,Slovenia,Hungary,402,164,238
2015,724,Spain,Hungary,9297,4245,5052
2015,40,Austria,Hungary,44468,20145,24323
2015,56,Belgium,Hungary,8032,3640,4392
2015,250,France,Hungary,11458,5097,6361
2015,276,Germany,Hungary,145629,75944,69685
2015,438,Liechtenstein,Hungary,70,25,45
2015,442,Luxembourg,Hungary,1084,369,715
2015,528,Netherlands,Hungary,12801,5677,7124
2015,756,Switzerland,Hungary,24683,11699,12984
2015,124,Canada,Hungary,36594,17827,18767
2015,840,United States of America,Hungary,78760,37878,40882
2019,800,Uganda,Hungary,8,0,8
2019,818,Egypt,Hungary,132,56,76
2019,434,Libya,Hungary,358,195,163
2019,196,Cyprus,Hungary,360,143,217
2019,268,Georgia,Hungary,49,22,27
2019,376,Israel,Hungary,12151,5364,6787
2019,400,Jordan,Hungary,611,258,353
2019,422,Lebanon,Hungary,145,70,75
2019,792,Turkey,Hungary,704,272,432
2019,496,Mongolia,Hungary,11,5,6
2019,608,Philippines,Hungary,251,198,53
2019,192,Cuba,Hungary,21,8,13
2019,214,Dominican Republic,Hungary,21,15,6
2019,188,Costa Rica,Hungary,75,42,33
2019,484,Mexico,Hungary,403,153,250
2019,591,Panama,Hungary,61,39,22
2019,32,Argentina,Hungary,830,382,448
2019,68,Bolivia (Plurinational State of),Hungary,29,15,14
2019,76,Brazil,Hungary,2050,983,1067
2019,152,Chile,Hungary,1306,590,716
2019,170,Colombia,Hungary,149,85,64
2019,218,Ecuador,Hungary,212,82,130
2019,604,Peru,Hungary,76,39,37
2019,862,Venezuela (Bolivarian Republic of),Hungary,1005,500,505
2019,36,Australia,Hungary,21646,10618,11028
2019,554,New Zealand,Hungary,1460,707,753
2019,112,Belarus,Hungary,337,126,211
2019,100,Bulgaria,Hungary,415,178,237
2019,203,Czechia,Hungary,1393,818,575
2019,616,Poland,Hungary,1422,704,718
2019,498,Republic of Moldova,Hungary,110,54,56
2019,642,Romania,Hungary,8974,4386,4588
2019,643,Russian Federation,Hungary,16837,8381,8456
2019,703,Slovakia,Hungary,16741,8478,8263
2019,208,Denmark,Hungary,5866,2902,2964
2019,233,Estonia,Hungary,206,100,106
2019,246,Finland,Hungary,3068,1536,1532
2019,352,Iceland,Hungary,362,199,163
2019,372,Ireland,Hungary,9009,4855,4154
2019,428,Latvia,Hungary,176,79,97
2019,440,Lithuania,Hungary,106,53,53
2019,578,Norway,Hungary,4598,2448,2150
2019,752,Sweden,Hungary,17017,8327,8690
2019,826,United Kingdom,Hungary,46097,22671,23426
2019,70,Bosnia and Herzegovina,Hungary,148,47,101
2019,191,Croatia,Hungary,963,302,661
2019,300,Greece,Hungary,1683,562,1121
2019,380,Italy,Hungary,13500,3435,10065
2019,470,Malta,Hungary,321,129,192
2019,499,Montenegro,Hungary,47,33,14
2019,807,North Macedonia,Hungary,81,35,46
2019,620,Portugal,Hungary,404,122,282
2019,688,Serbia,Hungary,1828,595,1233
2019,705,Slovenia,Hungary,405,155,250
2019,724,Spain,Hungary,9633,4274,5359
2019,40,Austria,Hungary,52494,24276,28218
2019,56,Belgium,Hungary,8507,3789,4718
2019,250,France,Hungary,12128,5380,6748
2019,276,Germany,Hungary,184004,104932,79072
2019,438,Liechtenstein,Hungary,71,23,48
2019,442,Luxembourg,Hungary,1834,772,1062
2019,528,Netherlands,Hungary,15668,7213,8455
2019,756,Switzerland,Hungary,27425,13143,14282
2019,124,Canada,Hungary,39214,19104,20110
2019,840,United States of America,Hungary,85053,40431,44622
1990,710,South Africa,Iceland,16,11,5
1990,196,Cyprus,Iceland,8,2,6
1990,792,Turkey,Iceland,10,5,5
1990,188,Costa Rica,Iceland,2,1,1
1990,32,Argentina,Iceland,18,2,16
1990,68,Bolivia (Plurinational State of),Iceland,2,0,2
1990,152,Chile,Iceland,24,14,10
1990,604,Peru,Iceland,8,8,0
1990,36,Australia,Iceland,342,179,163
1990,100,Bulgaria,Iceland,1,1,0
1990,203,Czechia,Iceland,5,3,2
1990,348,Hungary,Iceland,8,2,6
1990,616,Poland,Iceland,58,39,19
1990,643,Russian Federation,Iceland,54,26,28
1990,208,Denmark,Iceland,2986,1366,1620
1990,234,Faroe Islands,Iceland,267,150,117
1990,246,Finland,Iceland,79,42,37
1990,372,Ireland,Iceland,7,3,4
1990,428,Latvia,Iceland,4,3,1
1990,440,Lithuania,Iceland,7,2,5
1990,578,Norway,Iceland,2221,1035,1186
1990,752,Sweden,Iceland,2773,1423,1350
1990,826,United Kingdom,Iceland,419,276,143
1990,300,Greece,Iceland,39,21,18
1990,380,Italy,Iceland,55,19,36
1990,620,Portugal,Iceland,9,5,4
1990,724,Spain,Iceland,138,64,74
1990,40,Austria,Iceland,104,47,57
1990,56,Belgium,Iceland,117,54,63
1990,250,France,Iceland,396,155,241
1990,276,Germany,Iceland,1239,635,604
1990,438,Liechtenstein,Iceland,1,0,1
1990,442,Luxembourg,Iceland,259,124,135
1990,528,Netherlands,Iceland,188,88,100
1990,756,Switzerland,Iceland,133,65,68
1990,124,Canada,Iceland,532,259,273
1990,304,Greenland,Iceland,21,17,4
1990,840,United States of America,Iceland,5071,2481,2590
1995,710,South Africa,Iceland,13,10,3
1995,196,Cyprus,Iceland,12,3,9
1995,792,Turkey,Iceland,24,12,12
1995,188,Costa Rica,Iceland,1,0,1
1995,32,Argentina,Iceland,18,1,17
1995,68,Bolivia (Plurinational State of),Iceland,3,2,1
1995,152,Chile,Iceland,17,10,7
1995,604,Peru,Iceland,9,8,1
1995,36,Australia,Iceland,480,257,223
1995,100,Bulgaria,Iceland,34,19,15
1995,203,Czechia,Iceland,7,4,3
1995,348,Hungary,Iceland,48,20,28
1995,616,Poland,Iceland,49,33,16
1995,643,Russian Federation,Iceland,56,28,28
1995,703,Slovakia,Iceland,13,6,7
1995,208,Denmark,Iceland,4471,2138,2333
1995,234,Faroe Islands,Iceland,183,98,85
1995,246,Finland,Iceland,90,50,40
1995,372,Ireland,Iceland,20,9,11
1995,428,Latvia,Iceland,6,5,1
1995,440,Lithuania,Iceland,8,3,5
1995,578,Norway,Iceland,2601,1241,1360
1995,752,Sweden,Iceland,3291,1677,1614
1995,826,United Kingdom,Iceland,947,459,488
1995,300,Greece,Iceland,35,15,20
1995,380,Italy,Iceland,141,40,101
1995,620,Portugal,Iceland,20,10,10
1995,724,Spain,Iceland,227,101,126
1995,40,Austria,Iceland,117,54,63
1995,56,Belgium,Iceland,116,53,63
1995,250,France,Iceland,409,156,253
1995,276,Germany,Iceland,1370,676,694
1995,438,Liechtenstein,Iceland,1,0,1
1995,442,Luxembourg,Iceland,273,123,150
1995,528,Netherlands,Iceland,277,125,152
1995,756,Switzerland,Iceland,173,90,83
1995,124,Canada,Iceland,483,234,249
1995,304,Greenland,Iceland,25,16,9
1995,840,United States of America,Iceland,5382,2658,2724
2000,710,South Africa,Iceland,14,12,2
2000,196,Cyprus,Iceland,15,3,12
2000,792,Turkey,Iceland,40,19,21
2000,608,Philippines,Iceland,58,46,12
2000,188,Costa Rica,Iceland,1,0,1
2000,32,Argentina,Iceland,18,1,17
2000,68,Bolivia (Plurinational State of),Iceland,3,3,0
2000,152,Chile,Iceland,11,6,5
2000,604,Peru,Iceland,11,9,2
2000,36,Australia,Iceland,560,308,252
2000,100,Bulgaria,Iceland,66,37,29
2000,203,Czechia,Iceland,9,5,4
2000,348,Hungary,Iceland,88,39,49
2000,616,Poland,Iceland,42,28,14
2000,643,Russian Federation,Iceland,56,28,28
2000,703,Slovakia,Iceland,30,13,17
2000,208,Denmark,Iceland,5955,2909,3046
2000,234,Faroe Islands,Iceland,218,126,92
2000,246,Finland,Iceland,101,59,42
2000,372,Ireland,Iceland,45,23,22
2000,428,Latvia,Iceland,9,7,2
2000,440,Lithuania,Iceland,6,3,3
2000,578,Norway,Iceland,3780,1833,1947
2000,752,Sweden,Iceland,3530,1787,1743
2000,826,United Kingdom,Iceland,1492,649,843
2000,300,Greece,Iceland,32,9,23
2000,380,Italy,Iceland,227,61,166
2000,620,Portugal,Iceland,33,16,17
2000,705,Slovenia,Iceland,10,5,5
2000,724,Spain,Iceland,414,185,229
2000,40,Austria,Iceland,130,61,69
2000,56,Belgium,Iceland,112,51,61
2000,250,France,Iceland,422,157,265
2000,276,Germany,Iceland,1500,716,784
2000,438,Liechtenstein,Iceland,1,0,1
2000,442,Luxembourg,Iceland,290,122,168
2000,528,Netherlands,Iceland,377,167,210
2000,756,Switzerland,Iceland,215,115,100
2000,124,Canada,Iceland,446,215,231
2000,304,Greenland,Iceland,123,99,24
2000,840,United States of America,Iceland,5694,2838,2856
2005,710,South Africa,Iceland,17,14,3
2005,196,Cyprus,Iceland,22,4,18
2005,792,Turkey,Iceland,41,19,22
2005,608,Philippines,Iceland,46,37,9
2005,188,Costa Rica,Iceland,1,0,1
2005,32,Argentina,Iceland,13,1,12
2005,68,Bolivia (Plurinational State of),Iceland,3,2,1
2005,76,Brazil,Iceland,239,160,79
2005,152,Chile,Iceland,16,9,7
2005,604,Peru,Iceland,13,10,3
2005,36,Australia,Iceland,670,352,318
2005,100,Bulgaria,Iceland,109,62,47
2005,203,Czechia,Iceland,19,12,7
2005,348,Hungary,Iceland,109,50,59
2005,616,Poland,Iceland,272,135,137
2005,643,Russian Federation,Iceland,50,25,25
2005,703,Slovakia,Iceland,34,15,19
2005,208,Denmark,Iceland,7375,3568,3807
2005,234,Faroe Islands,Iceland,241,137,104
2005,246,Finland,Iceland,129,75,54
2005,372,Ireland,Iceland,45,24,21
2005,428,Latvia,Iceland,24,20,4
2005,440,Lithuania,Iceland,32,18,14
2005,578,Norway,Iceland,3656,1785,1871
2005,752,Sweden,Iceland,3876,1969,1907
2005,826,United Kingdom,Iceland,1668,746,922
2005,300,Greece,Iceland,44,16,28
2005,380,Italy,Iceland,217,68,149
2005,620,Portugal,Iceland,31,15,16
2005,705,Slovenia,Iceland,10,4,6
2005,724,Spain,Iceland,682,322,360
2005,40,Austria,Iceland,146,66,80
2005,56,Belgium,Iceland,144,68,76
2005,250,France,Iceland,398,184,214
2005,276,Germany,Iceland,1479,753,726
2005,438,Liechtenstein,Iceland,1,1,0
2005,442,Luxembourg,Iceland,251,115,136
2005,528,Netherlands,Iceland,438,192,246
2005,756,Switzerland,Iceland,280,146,134
2005,124,Canada,Iceland,561,291,270
2005,304,Greenland,Iceland,104,89,15
2005,840,United States of America,Iceland,5298,2655,2643
2010,710,South Africa,Iceland,26,22,4
2010,196,Cyprus,Iceland,36,7,29
2010,792,Turkey,Iceland,42,19,23
2010,608,Philippines,Iceland,53,42,11
2010,188,Costa Rica,Iceland,1,0,1
2010,32,Argentina,Iceland,8,1,7
2010,68,Bolivia (Plurinational State of),Iceland,2,1,1
2010,76,Brazil,Iceland,478,319,159
2010,152,Chile,Iceland,22,13,9
2010,604,Peru,Iceland,14,11,3
2010,36,Australia,Iceland,700,356,344
2010,100,Bulgaria,Iceland,148,85,63
2010,203,Czechia,Iceland,27,17,10
2010,348,Hungary,Iceland,130,61,69
2010,616,Poland,Iceland,511,245,266
2010,643,Russian Federation,Iceland,44,21,23
2010,703,Slovakia,Iceland,38,17,21
2010,208,Denmark,Iceland,8639,4155,4484
2010,233,Estonia,Iceland,22,13,9
2010,234,Faroe Islands,Iceland,278,167,111
2010,246,Finland,Iceland,187,105,82
2010,372,Ireland,Iceland,37,17,20
2010,428,Latvia,Iceland,40,33,7
2010,440,Lithuania,Iceland,54,30,24
2010,578,Norway,Iceland,4862,2489,2373
2010,752,Sweden,Iceland,4728,2390,2338
2010,826,United Kingdom,Iceland,1757,806,951
2010,300,Greece,Iceland,57,24,33
2010,380,Italy,Iceland,220,76,144
2010,620,Portugal,Iceland,25,12,13
2010,705,Slovenia,Iceland,9,3,6
2010,724,Spain,Iceland,1043,517,526
2010,40,Austria,Iceland,161,71,90
2010,56,Belgium,Iceland,175,76,99
2010,250,France,Iceland,360,128,232
2010,276,Germany,Iceland,1457,777,680
2010,438,Liechtenstein,Iceland,2,1,1
2010,442,Luxembourg,Iceland,215,108,107
2010,528,Netherlands,Iceland,428,183,245
2010,756,Switzerland,Iceland,285,137,148
2010,124,Canada,Iceland,630,342,288
2010,304,Greenland,Iceland,95,76,19
2010,840,United States of America,Iceland,5057,2501,2556
2015,710,South Africa,Iceland,45,39,6
2015,196,Cyprus,Iceland,34,7,27
2015,792,Turkey,Iceland,42,19,23
2015,608,Philippines,Iceland,53,42,11
2015,188,Costa Rica,Iceland,1,0,1
2015,32,Argentina,Iceland,8,1,7
2015,68,Bolivia (Plurinational State of),Iceland,2,1,1
2015,76,Brazil,Iceland,576,385,191
2015,152,Chile,Iceland,33,20,13
2015,604,Peru,Iceland,15,12,3
2015,36,Australia,Iceland,610,333,277
2015,100,Bulgaria,Iceland,16,8,8
2015,203,Czechia,Iceland,30,22,8
2015,348,Hungary,Iceland,133,62,71
2015,616,Poland,Iceland,492,241,251
2015,643,Russian Federation,Iceland,44,21,23
2015,703,Slovakia,Iceland,63,31,32
2015,208,Denmark,Iceland,8772,4185,4587
2015,233,Estonia,Iceland,22,19,3
2015,234,Faroe Islands,Iceland,242,132,110
2015,246,Finland,Iceland,196,122,74
2015,372,Ireland,Iceland,38,17,21
2015,428,Latvia,Iceland,29,18,11
2015,440,Lithuania,Iceland,54,24,30
2015,578,Norway,Iceland,8313,4382,3931
2015,752,Sweden,Iceland,5644,2802,2842
2015,826,United Kingdom,Iceland,2246,994,1252
2015,300,Greece,Iceland,53,21,32
2015,380,Italy,Iceland,183,61,122
2015,620,Portugal,Iceland,28,12,16
2015,705,Slovenia,Iceland,8,2,6
2015,724,Spain,Iceland,1122,518,604
2015,40,Austria,Iceland,188,84,104
2015,56,Belgium,Iceland,233,99,134
2015,250,France,Iceland,398,135,263
2015,276,Germany,Iceland,1519,809,710
2015,438,Liechtenstein,Iceland,1,1,0
2015,442,Luxembourg,Iceland,328,168,160
2015,528,Netherlands,Iceland,407,194,213
2015,756,Switzerland,Iceland,419,202,217
2015,124,Canada,Iceland,586,268,318
2015,304,Greenland,Iceland,157,130,27
2015,840,United States of America,Iceland,5672,2790,2882
2019,710,South Africa,Iceland,49,43,6
2019,196,Cyprus,Iceland,33,7,26
2019,792,Turkey,Iceland,56,26,30
2019,608,Philippines,Iceland,54,43,11
2019,188,Costa Rica,Iceland,1,0,1
2019,32,Argentina,Iceland,8,1,7
2019,68,Bolivia (Plurinational State of),Iceland,2,1,1
2019,76,Brazil,Iceland,648,433,215
2019,152,Chile,Iceland,44,26,18
2019,604,Peru,Iceland,17,14,3
2019,36,Australia,Iceland,603,314,289
2019,100,Bulgaria,Iceland,25,13,12
2019,203,Czechia,Iceland,36,26,10
2019,348,Hungary,Iceland,143,62,81
2019,616,Poland,Iceland,521,266,255
2019,643,Russian Federation,Iceland,43,21,22
2019,703,Slovakia,Iceland,79,38,41
2019,208,Denmark,Iceland,8835,4089,4746
2019,233,Estonia,Iceland,18,17,1
2019,234,Faroe Islands,Iceland,257,144,113
2019,246,Finland,Iceland,223,138,85
2019,372,Ireland,Iceland,41,19,22
2019,428,Latvia,Iceland,33,22,11
2019,440,Lithuania,Iceland,39,14,25
2019,578,Norway,Iceland,8983,4639,4344
2019,752,Sweden,Iceland,6312,3131,3181
2019,826,United Kingdom,Iceland,2550,1132,1418
2019,300,Greece,Iceland,51,21,30
2019,380,Italy,Iceland,212,74,138
2019,620,Portugal,Iceland,28,12,16
2019,705,Slovenia,Iceland,6,2,4
2019,724,Spain,Iceland,1162,522,640
2019,40,Austria,Iceland,221,101,120
2019,56,Belgium,Iceland,223,98,125
2019,250,France,Iceland,421,142,279
2019,276,Germany,Iceland,1805,991,814
2019,438,Liechtenstein,Iceland,2,1,1
2019,442,Luxembourg,Iceland,495,243,252
2019,528,Netherlands,Iceland,551,277,274
2019,756,Switzerland,Iceland,452,225,227
2019,124,Canada,Iceland,627,287,340
2019,304,Greenland,Iceland,154,128,26
2019,840,United States of America,Iceland,6125,2980,3145
1990,232,Eritrea,India,39,22,17
1990,450,Madagascar,India,1171,648,523
1990,454,Malawi,India,1362,588,774
1990,480,Mauritius,India,515,252,263
1990,508,Mozambique,India,900,596,304
1990,690,Seychelles,India,1276,1012,264
1990,800,Uganda,India,1313,932,381
1990,834,United Republic of Tanzania,India,4968,2831,2137
1990,894,Zambia,India,4284,2155,2129
1990,72,Botswana,India,1967,1081,886
1990,426,Lesotho,India,308,172,136
1990,516,Namibia,India,997,649,348
1990,710,South Africa,India,8356,4419,3937
1990,288,Ghana,India,454,258,196
1990,430,Liberia,India,774,493,281
1990,694,Sierra Leone,India,405,244,161
1990,818,Egypt,India,801,487,314
1990,434,Libya,India,2288,1397,891
1990,729,Sudan,India,2259,1162,1097
1990,48,Bahrain,India,60505,46340,14165
1990,196,Cyprus,India,684,414,270
1990,368,Iraq,India,179,107,72
1990,376,Israel,India,16927,8204,8723
1990,400,Jordan,India,871,603,268
1990,414,Kuwait,India,375183,257851,117332
1990,422,Lebanon,India,398,276,122
1990,512,Oman,India,152554,130597,21957
1990,634,Qatar,India,2738,1998,740
1990,682,Saudi Arabia,India,906468,612071,294397
1990,792,Turkey,India,126,82,44
1990,784,United Arab Emirates,India,458294,353599,104695
1990,762,Tajikistan,India,935,411,524
1990,50,Bangladesh,India,13339,7204,6135
1990,64,Bhutan,India,20841,17317,3524
1990,462,Maldives,India,951,523,428
1990,524,Nepal,India,369370,101830,267540
1990,586,Pakistan,India,2818248,1532902,1285346
1990,144,Sri Lanka,India,39329,22147,17182
1990,156,China,India,4496,2552,1944
1990,344,"China, Hong Kong SAR",India,12064,6286,5778
1990,408,Dem. People's Republic of Korea,India,178,93,85
1990,392,Japan,India,3108,1583,1525
1990,496,Mongolia,India,24,16,8
1990,410,Republic of Korea,India,136,102,34
1990,96,Brunei Darussalam,India,2595,2181,414
1990,116,Cambodia,India,44,33,11
1990,360,Indonesia,India,7818,4448,3370
1990,458,Malaysia,India,20808,3865,16943
1990,104,Myanmar,India,41093,22056,19037
1990,608,Philippines,India,2611,1573,1038
1990,702,Singapore,India,14109,9343,4766
1990,764,Thailand,India,3389,1903,1486
1990,704,Viet Nam,India,116,34,82
1990,28,Antigua and Barbuda,India,32,15,17
1990,533,Aruba,India,39,25,14
1990,44,Bahamas,India,160,90,70
1990,52,Barbados,India,441,222,219
1990,92,British Virgin Islands,India,20,11,9
1990,535,"Bonaire, Sint Eustatius and Saba",India,12,5,7
1990,136,Cayman Islands,India,44,24,20
1990,212,Dominica,India,10,6,4
1990,214,Dominican Republic,India,287,161,126
1990,312,Guadeloupe,India,80,39,41
1990,388,Jamaica,India,711,398,313
1990,630,Puerto Rico,India,96,45,51
1990,662,Saint Lucia,India,49,30,19
1990,780,Trinidad and Tobago,India,768,389,379
1990,84,Belize,India,247,138,109
1990,188,Costa Rica,India,35,21,14
1990,222,El Salvador,India,18,11,7
1990,484,Mexico,India,128,93,35
1990,558,Nicaragua,India,12,9,3
1990,591,Panama,India,1474,887,587
1990,32,Argentina,India,215,94,121
1990,68,Bolivia (Plurinational State of),India,125,86,39
1990,76,Brazil,India,697,419,278
1990,152,Chile,India,274,163,111
1990,170,Colombia,India,101,54,47
1990,218,Ecuador,India,76,51,25
1990,604,Peru,India,128,80,48
1990,862,Venezuela (Bolivarian Republic of),India,229,122,107
1990,36,Australia,India,69928,35701,34227
1990,554,New Zealand,India,9292,5229,4063
1990,242,Fiji,India,1443,655,788
1990,598,Papua New Guinea,India,239,148,91
1990,258,French Polynesia,India,35,26,9
1990,776,Tonga,India,140,67,73
1990,112,Belarus,India,24,21,3
1990,100,Bulgaria,India,163,133,30
1990,203,Czechia,India,60,41,19
1990,348,Hungary,India,978,641,337
1990,616,Poland,India,436,305,131
1990,643,Russian Federation,India,9801,4809,4992
1990,703,Slovakia,India,7,4,3
1990,804,Ukraine,India,4609,3648,961
1990,208,Denmark,India,2604,1161,1443
1990,233,Estonia,India,25,16,9
1990,234,Faroe Islands,India,14,6,8
1990,246,Finland,India,549,369,180
1990,352,Iceland,India,62,26,36
1990,372,Ireland,India,750,369,381
1990,428,Latvia,India,35,26,9
1990,578,Norway,India,4422,2485,1937
1990,752,Sweden,India,8730,3559,5171
1990,826,United Kingdom,India,399526,194775,204751
1990,300,Greece,India,5351,4132,1219
1990,380,Italy,India,3413,1186,2227
1990,470,Malta,India,130,95,35
1990,620,Portugal,India,1939,1041,898
1990,688,Serbia,India,36,17,19
1990,705,Slovenia,India,11,6,5
1990,724,Spain,India,4147,2152,1995
1990,40,Austria,India,7478,4369,3109
1990,56,Belgium,India,5343,3316,2027
1990,250,France,India,25817,12675,13142
1990,276,Germany,India,31877,23578,8299
1990,442,Luxembourg,India,187,90,97
1990,528,Netherlands,India,7540,4100,3440
1990,756,Switzerland,India,7360,3821,3539
1990,60,Bermuda,India,156,91,65
1990,124,Canada,India,166640,81125,85515
1990,840,United States of America,India,450406,238925,211481
1995,232,Eritrea,India,54,23,31
1995,450,Madagascar,India,1037,580,457
1995,454,Malawi,India,2683,1455,1228
1995,480,Mauritius,India,1483,1171,312
1995,508,Mozambique,India,1238,821,417
1995,690,Seychelles,India,1651,1313,338
1995,800,Uganda,India,1244,871,373
1995,834,United Republic of Tanzania,India,6308,3591,2717
1995,894,Zambia,India,3854,1939,1915
1995,72,Botswana,India,2375,1298,1077
1995,426,Lesotho,India,266,148,118
1995,516,Namibia,India,953,623,330
1995,710,South Africa,India,10958,6015,4943
1995,288,Ghana,India,452,275,177
1995,430,Liberia,India,756,476,280
1995,694,Sierra Leone,India,395,234,161
1995,818,Egypt,India,823,507,316
1995,434,Libya,India,2902,1966,936
1995,729,Sudan,India,2304,1188,1116
1995,48,Bahrain,India,74599,55490,19109
1995,196,Cyprus,India,967,570,397
1995,368,Iraq,India,211,105,106
1995,376,Israel,India,18225,8712,9513
1995,400,Jordan,India,2572,2163,409
1995,414,Kuwait,India,332377,232387,99990
1995,422,Lebanon,India,1169,971,198
1995,512,Oman,India,282987,231637,51350
1995,634,Qatar,India,2975,2218,757
1995,682,Saudi Arabia,India,929709,627174,302535
1995,792,Turkey,India,304,192,112
1995,784,United Arab Emirates,India,667853,506060,161793
1995,762,Tajikistan,India,760,449,311
1995,50,Bangladesh,India,18075,9761,8314
1995,64,Bhutan,India,24485,20343,4142
1995,462,Maldives,India,6418,3202,3216
1995,524,Nepal,India,515578,132220,383358
1995,586,Pakistan,India,2365884,1284253,1081631
1995,144,Sri Lanka,India,35506,18861,16645
1995,156,China,India,5478,3097,2381
1995,344,"China, Hong Kong SAR",India,13464,6972,6492
1995,408,Dem. People's Republic of Korea,India,198,103,95
1995,392,Japan,India,5584,2680,2904
1995,496,Mongolia,India,26,18,8
1995,410,Republic of Korea,India,849,628,221
1995,96,Brunei Darussalam,India,2742,2309,433
1995,116,Cambodia,India,116,87,29
1995,360,Indonesia,India,5172,3001,2171
1995,458,Malaysia,India,46325,22384,23941
1995,104,Myanmar,India,37969,20168,17801
1995,608,Philippines,India,3513,2089,1424
1995,702,Singapore,India,29739,19593,10146
1995,764,Thailand,India,5665,3097,2568
1995,704,Viet Nam,India,350,174,176
1995,28,Antigua and Barbuda,India,49,24,25
1995,533,Aruba,India,98,64,34
1995,44,Bahamas,India,194,110,84
1995,52,Barbados,India,481,246,235
1995,92,British Virgin Islands,India,24,13,11
1995,535,"Bonaire, Sint Eustatius and Saba",India,25,10,15
1995,136,Cayman Islands,India,84,45,39
1995,212,Dominica,India,13,8,5
1995,214,Dominican Republic,India,319,175,144
1995,312,Guadeloupe,India,107,51,56
1995,388,Jamaica,India,962,576,386
1995,630,Puerto Rico,India,101,48,53
1995,662,Saint Lucia,India,65,40,25
1995,780,Trinidad and Tobago,India,697,353,344
1995,84,Belize,India,256,142,114
1995,188,Costa Rica,India,31,19,12
1995,222,El Salvador,India,14,8,6
1995,484,Mexico,India,347,202,145
1995,558,Nicaragua,India,10,7,3
1995,591,Panama,India,1738,1036,702
1995,32,Argentina,India,210,93,117
1995,68,Bolivia (Plurinational State of),India,123,77,46
1995,76,Brazil,India,730,433,297
1995,152,Chile,India,407,267,140
1995,170,Colombia,India,108,55,53
1995,218,Ecuador,India,86,58,28
1995,604,Peru,India,129,79,50
1995,862,Venezuela (Bolivarian Republic of),India,226,121,105
1995,36,Australia,India,78297,40084,38213
1995,554,New Zealand,India,12459,6604,5855
1995,242,Fiji,India,1374,647,727
1995,598,Papua New Guinea,India,244,164,80
1995,258,French Polynesia,India,38,28,10
1995,776,Tonga,India,158,78,80
1995,112,Belarus,India,37,31,6
1995,100,Bulgaria,India,149,119,30
1995,203,Czechia,India,90,63,27
1995,348,Hungary,India,867,563,304
1995,616,Poland,India,372,259,113
1995,643,Russian Federation,India,8083,5035,3048
1995,703,Slovakia,India,45,31,14
1995,804,Ukraine,India,4459,3556,903
1995,208,Denmark,India,3498,1501,1997
1995,233,Estonia,India,39,25,14
1995,234,Faroe Islands,India,24,9,15
1995,246,Finland,India,768,503,265
1995,352,Iceland,India,105,45,60
1995,372,Ireland,India,2655,1265,1390
1995,428,Latvia,India,54,41,13
1995,578,Norway,India,4621,2336,2285
1995,752,Sweden,India,10359,4176,6183
1995,826,United Kingdom,India,422284,204842,217442
1995,300,Greece,India,6117,5249,868
1995,380,Italy,India,23261,12309,10952
1995,470,Malta,India,152,111,41
1995,620,Portugal,India,4184,2243,1941
1995,688,Serbia,India,229,101,128
1995,705,Slovenia,India,22,14,8
1995,724,Spain,India,5084,2685,2399
1995,40,Austria,India,8436,4986,3450
1995,56,Belgium,India,6415,3840,2575
1995,250,France,India,26652,12857,13795
1995,276,Germany,India,32944,23465,9479
1995,442,Luxembourg,India,177,85,92
1995,528,Netherlands,India,8940,4781,4159
1995,756,Switzerland,India,9984,5478,4506
1995,60,Bermuda,India,220,127,93
1995,124,Canada,India,240035,116145,123890
1995,840,United States of America,India,746337,397485,348852
2000,232,Eritrea,India,70,24,46
2000,450,Madagascar,India,1152,647,505
2000,454,Malawi,India,2583,1397,1186
2000,480,Mauritius,India,3278,2685,593
2000,508,Mozambique,India,1441,940,501
2000,690,Seychelles,India,2026,1614,412
2000,800,Uganda,India,3591,2294,1297
2000,834,United Republic of Tanzania,India,6642,3785,2857
2000,894,Zambia,India,3468,1765,1703
2000,72,Botswana,India,3032,1650,1382
2000,426,Lesotho,India,215,120,95
2000,516,Namibia,India,886,580,306
2000,710,South Africa,India,16920,9232,7688
2000,288,Ghana,India,506,290,216
2000,430,Liberia,India,742,459,283
2000,694,Sierra Leone,India,385,224,161
2000,818,Egypt,India,910,568,342
2000,434,Libya,India,3564,2588,976
2000,729,Sudan,India,2351,1214,1137
2000,48,Bahrain,India,88904,64553,24351
2000,196,Cyprus,India,1250,726,524
2000,268,Georgia,India,32,19,13
2000,368,Iraq,India,200,75,125
2000,376,Israel,India,18502,8833,9669
2000,400,Jordan,India,4273,3726,547
2000,414,Kuwait,India,418664,298321,120343
2000,422,Lebanon,India,1940,1667,273
2000,512,Oman,India,333881,273163,60718
2000,634,Qatar,India,2769,2111,658
2000,682,Saudi Arabia,India,978992,664047,314945
2000,792,Turkey,India,485,304,181
2000,784,United Arab Emirates,India,915878,685691,230187
2000,762,Tajikistan,India,654,400,254
2000,50,Bangladesh,India,22811,12318,10493
2000,64,Bhutan,India,28128,23368,4760
2000,462,Maldives,India,11427,6287,5140
2000,524,Nepal,India,543594,152241,391353
2000,586,Pakistan,India,2101039,1137266,963773
2000,144,Sri Lanka,India,31618,16266,15352
2000,156,China,India,6460,3642,2818
2000,344,"China, Hong Kong SAR",India,14864,7659,7205
2000,408,Dem. People's Republic of Korea,India,217,112,105
2000,392,Japan,India,10065,4650,5415
2000,496,Mongolia,India,29,20,9
2000,410,Republic of Korea,India,1833,1368,465
2000,96,Brunei Darussalam,India,2889,2437,452
2000,116,Cambodia,India,187,140,47
2000,360,Indonesia,India,2527,1554,973
2000,458,Malaysia,India,87900,49409,38491
2000,104,Myanmar,India,35038,18140,16898
2000,608,Philippines,India,4632,2707,1925
2000,702,Singapore,India,48248,31559,16689
2000,764,Thailand,India,9112,4869,4243
2000,704,Viet Nam,India,933,552,381
2000,28,Antigua and Barbuda,India,65,32,33
2000,533,Aruba,India,157,103,54
2000,44,Bahamas,India,229,131,98
2000,52,Barbados,India,522,271,251
2000,92,British Virgin Islands,India,27,14,13
2000,535,"Bonaire, Sint Eustatius and Saba",India,38,15,23
2000,136,Cayman Islands,India,144,76,68
2000,212,Dominica,India,15,9,6
2000,214,Dominican Republic,India,351,190,161
2000,312,Guadeloupe,India,133,62,71
2000,388,Jamaica,India,1213,754,459
2000,630,Puerto Rico,India,108,51,57
2000,662,Saint Lucia,India,90,55,35
2000,780,Trinidad and Tobago,India,620,345,275
2000,84,Belize,India,265,147,118
2000,188,Costa Rica,India,42,26,16
2000,222,El Salvador,India,10,6,4
2000,484,Mexico,India,583,321,262
2000,558,Nicaragua,India,15,9,6
2000,591,Panama,India,2112,1246,866
2000,32,Argentina,India,205,92,113
2000,68,Bolivia (Plurinational State of),India,119,66,53
2000,76,Brazil,India,762,446,316
2000,152,Chile,India,540,353,187
2000,170,Colombia,India,114,55,59
2000,218,Ecuador,India,95,64,31
2000,604,Peru,India,151,92,59
2000,862,Venezuela (Bolivarian Republic of),India,221,118,103
2000,36,Australia,India,90680,47293,43387
2000,554,New Zealand,India,20329,9881,10448
2000,242,Fiji,India,1292,626,666
2000,598,Papua New Guinea,India,182,138,44
2000,258,French Polynesia,India,41,30,11
2000,776,Tonga,India,177,90,87
2000,112,Belarus,India,50,41,9
2000,100,Bulgaria,India,135,105,30
2000,203,Czechia,India,119,84,35
2000,348,Hungary,India,755,485,270
2000,616,Poland,India,318,219,99
2000,643,Russian Federation,India,6072,5078,994
2000,703,Slovakia,India,97,68,29
2000,804,Ukraine,India,4364,3507,857
2000,208,Denmark,India,4391,1840,2551
2000,233,Estonia,India,53,35,18
2000,234,Faroe Islands,India,38,15,23
2000,246,Finland,India,986,637,349
2000,352,Iceland,India,148,65,83
2000,372,Ireland,India,6019,2967,3052
2000,428,Latvia,India,74,56,18
2000,578,Norway,India,5130,2444,2686
2000,752,Sweden,India,11110,4436,6674
2000,826,United Kingdom,India,452144,217793,234351
2000,300,Greece,India,6983,6437,546
2000,380,Italy,India,43109,23432,19677
2000,470,Malta,India,194,143,51
2000,620,Portugal,India,6600,3543,3057
2000,688,Serbia,India,312,134,178
2000,705,Slovenia,India,19,11,8
2000,724,Spain,India,8210,4438,3772
2000,40,Austria,India,9394,5603,3791
2000,56,Belgium,India,7298,4259,3039
2000,250,France,India,27486,13038,14448
2000,276,Germany,India,34011,23352,10659
2000,442,Luxembourg,India,170,81,89
2000,528,Netherlands,India,10649,5616,5033
2000,756,Switzerland,India,12645,7168,5477
2000,60,Bermuda,India,283,163,120
2000,124,Canada,India,319138,153954,165184
2000,840,United States of America,India,1048517,560016,488501
2005,232,Eritrea,India,93,34,59
2005,450,Madagascar,India,1282,723,559
2005,454,Malawi,India,2462,1328,1134
2005,480,Mauritius,India,5252,4312,940
2005,508,Mozambique,India,1950,1208,742
2005,690,Seychelles,India,3907,2874,1033
2005,800,Uganda,India,3476,2200,1276
2005,834,United Republic of Tanzania,India,7198,4111,3087
2005,894,Zambia,India,4007,2040,1967
2005,72,Botswana,India,3941,2240,1701
2005,426,Lesotho,India,219,122,97
2005,516,Namibia,India,700,457,243
2005,710,South Africa,India,22261,11702,10559
2005,288,Ghana,India,712,426,286
2005,430,Liberia,India,546,443,103
2005,694,Sierra Leone,India,341,304,37
2005,818,Egypt,India,1083,701,382
2005,434,Libya,India,3926,3043,883
2005,729,Sudan,India,2397,1234,1163
2005,48,Bahrain,India,157081,117730,39351
2005,196,Cyprus,India,1830,1058,772
2005,268,Georgia,India,30,18,12
2005,368,Iraq,India,229,126,103
2005,376,Israel,India,18334,8770,9564
2005,400,Jordan,India,8892,7913,979
2005,414,Kuwait,India,485847,353914,131933
2005,422,Lebanon,India,1890,1638,252
2005,512,Oman,India,373411,311991,61420
2005,634,Qatar,India,193404,157924,35480
2005,682,Saudi Arabia,India,1216549,846607,369942
2005,792,Turkey,India,499,309,190
2005,784,United Arab Emirates,India,1286993,978024,308969
2005,762,Tajikistan,India,630,394,236
2005,50,Bangladesh,India,27687,14951,12736
2005,64,Bhutan,India,35256,29215,6041
2005,462,Maldives,India,13773,8124,5649
2005,524,Nepal,India,513955,151833,362122
2005,586,Pakistan,India,1998814,1081490,917324
2005,144,Sri Lanka,India,24499,13375,11124
2005,156,China,India,7126,4345,2781
2005,344,"China, Hong Kong SAR",India,16228,7967,8261
2005,408,Dem. People's Republic of Korea,India,274,142,132
2005,392,Japan,India,21219,9665,11554
2005,496,Mongolia,India,56,38,18
2005,410,Republic of Korea,India,2611,1886,725
2005,96,Brunei Darussalam,India,2953,2494,459
2005,116,Cambodia,India,146,110,36
2005,360,Indonesia,India,6465,3944,2521
2005,458,Malaysia,India,106098,60251,45847
2005,104,Myanmar,India,29680,15488,14192
2005,608,Philippines,India,3749,2216,1533
2005,702,Singapore,India,83963,47985,35978
2005,764,Thailand,India,8371,4651,3720
2005,704,Viet Nam,India,1143,695,448
2005,28,Antigua and Barbuda,India,70,34,36
2005,533,Aruba,India,238,157,81
2005,44,Bahamas,India,391,222,169
2005,52,Barbados,India,480,242,238
2005,92,British Virgin Islands,India,31,16,15
2005,535,"Bonaire, Sint Eustatius and Saba",India,40,16,24
2005,136,Cayman Islands,India,324,233,91
2005,212,Dominica,India,19,12,7
2005,214,Dominican Republic,India,221,129,92
2005,312,Guadeloupe,India,163,75,88
2005,388,Jamaica,India,1183,738,445
2005,630,Puerto Rico,India,84,40,44
2005,662,Saint Lucia,India,165,99,66
2005,534,Sint Maarten (Dutch part),India,411,400,11
2005,780,Trinidad and Tobago,India,665,370,295
2005,84,Belize,India,292,161,131
2005,188,Costa Rica,India,27,16,11
2005,222,El Salvador,India,11,7,4
2005,484,Mexico,India,683,400,283
2005,558,Nicaragua,India,22,11,11
2005,591,Panama,India,2895,1766,1129
2005,32,Argentina,India,151,68,83
2005,68,Bolivia (Plurinational State of),India,106,65,41
2005,76,Brazil,India,824,510,314
2005,152,Chile,India,810,534,276
2005,170,Colombia,India,114,54,60
2005,218,Ecuador,India,112,76,36
2005,604,Peru,India,177,108,69
2005,862,Venezuela (Bolivarian Republic of),India,232,124,108
2005,36,Australia,India,148960,82342,66618
2005,554,New Zealand,India,41448,20118,21330
2005,242,Fiji,India,1169,617,552
2005,598,Papua New Guinea,India,182,140,42
2005,258,French Polynesia,India,42,31,11
2005,776,Tonga,India,206,106,100
2005,112,Belarus,India,48,39,9
2005,100,Bulgaria,India,143,109,34
2005,203,Czechia,India,547,407,140
2005,348,Hungary,India,933,605,328
2005,616,Poland,India,594,397,197
2005,643,Russian Federation,India,5893,4677,1216
2005,703,Slovakia,India,401,345,56
2005,804,Ukraine,India,3987,3206,781
2005,208,Denmark,India,6356,2988,3368
2005,233,Estonia,India,82,61,21
2005,234,Faroe Islands,India,56,20,36
2005,246,Finland,India,2563,1615,948
2005,352,Iceland,India,213,96,117
2005,372,Ireland,India,13821,7227,6594
2005,428,Latvia,India,89,73,16
2005,578,Norway,India,5861,2749,3112
2005,752,Sweden,India,13593,6211,7382
2005,826,United Kingdom,India,549350,271942,277408
2005,191,Croatia,India,34,21,13
2005,300,Greece,India,8679,7406,1273
2005,380,Italy,India,89745,53525,36220
2005,470,Malta,India,228,168,60
2005,620,Portugal,India,7355,4110,3245
2005,688,Serbia,India,308,130,178
2005,705,Slovenia,India,49,33,16
2005,724,Spain,India,18346,12304,6042
2005,40,Austria,India,10501,6162,4339
2005,56,Belgium,India,10656,6464,4192
2005,250,France,India,41118,20919,20199
2005,276,Germany,India,45659,29365,16294
2005,438,Liechtenstein,India,11,7,4
2005,442,Luxembourg,India,147,75,72
2005,528,Netherlands,India,12034,6207,5827
2005,756,Switzerland,India,14302,7787,6515
2005,60,Bermuda,India,403,209,194
2005,124,Canada,India,424855,209794,215061
2005,840,United States of America,India,1390605,746307,644298
2010,232,Eritrea,India,117,44,73
2010,450,Madagascar,India,1425,808,617
2010,454,Malawi,India,2419,1303,1116
2010,480,Mauritius,India,7517,6223,1294
2010,508,Mozambique,India,2258,1398,860
2010,690,Seychelles,India,5788,4133,1655
2010,728,South Sudan,India,1454,837,617
2010,800,Uganda,India,3497,2200,1297
2010,834,United Republic of Tanzania,India,7629,4366,3263
2010,894,Zambia,India,4630,2518,2112
2010,72,Botswana,India,4850,2830,2020
2010,426,Lesotho,India,223,124,99
2010,516,Namibia,India,674,441,233
2010,710,South Africa,India,34871,18268,16603
2010,288,Ghana,India,708,433,275
2010,430,Liberia,India,712,603,109
2010,694,Sierra Leone,India,539,429,110
2010,818,Egypt,India,1169,741,428
2010,434,Libya,India,4295,3339,956
2010,729,Sudan,India,1396,721,675
2010,48,Bahrain,India,259915,196998,62917
2010,196,Cyprus,India,2996,1748,1248
2010,268,Georgia,India,30,18,12
2010,368,Iraq,India,231,133,98
2010,376,Israel,India,18389,8794,9595
2010,400,Jordan,India,13319,11906,1413
2010,414,Kuwait,India,674184,499384,174800
2010,422,Lebanon,India,1840,1610,230
2010,512,Oman,India,473206,403953,69253
2010,634,Qatar,India,540914,460980,79934
2010,682,Saudi Arabia,India,1579235,1120873,458362
2010,792,Turkey,India,514,314,200
2010,784,United Arab Emirates,India,2913858,2264033,649825
2010,762,Tajikistan,India,628,394,234
2010,50,Bangladesh,India,32301,17443,14858
2010,64,Bhutan,India,42383,35061,7322
2010,462,Maldives,India,13568,8972,4596
2010,524,Nepal,India,459935,132469,327466
2010,586,Pakistan,India,1943345,1053199,890146
2010,144,Sri Lanka,India,10529,5503,5026
2010,156,China,India,7793,5048,2745
2010,344,"China, Hong Kong SAR",India,17632,8295,9337
2010,408,Dem. People's Republic of Korea,India,330,171,159
2010,392,Japan,India,22497,10118,12379
2010,496,Mongolia,India,90,62,28
2010,410,Republic of Korea,India,4422,3104,1318
2010,96,Brunei Darussalam,India,3017,2551,466
2010,116,Cambodia,India,105,80,25
2010,360,Indonesia,India,10818,6314,4504
2010,458,Malaysia,India,119097,68566,50531
2010,104,Myanmar,India,27316,14480,12836
2010,608,Philippines,India,10476,6020,4456
2010,702,Singapore,India,124357,67037,57320
2010,764,Thailand,India,8232,4845,3387
2010,704,Viet Nam,India,1614,958,656
2010,28,Antigua and Barbuda,India,74,36,38
2010,533,Aruba,India,314,207,107
2010,44,Bahamas,India,552,312,240
2010,52,Barbados,India,441,215,226
2010,92,British Virgin Islands,India,35,18,17
2010,535,"Bonaire, Sint Eustatius and Saba",India,8,5,3
2010,136,Cayman Islands,India,535,412,123
2010,531,Curaçao,India,587,362,225
2010,212,Dominica,India,24,14,10
2010,214,Dominican Republic,India,90,67,23
2010,312,Guadeloupe,India,193,88,105
2010,388,Jamaica,India,1152,722,430
2010,630,Puerto Rico,India,51,24,27
2010,662,Saint Lucia,India,228,136,92
2010,534,Sint Maarten (Dutch part),India,801,776,25
2010,780,Trinidad and Tobago,India,926,536,390
2010,84,Belize,India,502,277,225
2010,188,Costa Rica,India,54,33,21
2010,222,El Salvador,India,11,7,4
2010,484,Mexico,India,863,526,337
2010,558,Nicaragua,India,23,12,11
2010,591,Panama,India,3816,2386,1430
2010,32,Argentina,India,97,45,52
2010,68,Bolivia (Plurinational State of),India,92,63,29
2010,76,Brazil,India,874,566,308
2010,152,Chile,India,1080,715,365
2010,170,Colombia,India,134,64,70
2010,218,Ecuador,India,157,106,51
2010,604,Peru,India,402,284,118
2010,862,Venezuela (Bolivarian Republic of),India,246,131,115
2010,36,Australia,India,329510,192500,137010
2010,554,New Zealand,India,56073,27161,28912
2010,242,Fiji,India,1255,671,584
2010,598,Papua New Guinea,India,154,120,34
2010,258,French Polynesia,India,41,31,10
2010,776,Tonga,India,220,114,106
2010,112,Belarus,India,46,37,9
2010,100,Bulgaria,India,145,108,37
2010,203,Czechia,India,921,696,225
2010,348,Hungary,India,1111,725,386
2010,616,Poland,India,889,585,304
2010,642,Romania,India,9,5,4
2010,643,Russian Federation,India,5594,4181,1413
2010,703,Slovakia,India,122,87,35
2010,804,Ukraine,India,3804,3060,744
2010,208,Denmark,India,8174,4065,4109
2010,233,Estonia,India,111,88,23
2010,234,Faroe Islands,India,58,20,38
2010,246,Finland,India,4711,2821,1890
2010,352,Iceland,India,277,128,149
2010,372,Ireland,India,19348,9462,9886
2010,428,Latvia,India,102,87,15
2010,578,Norway,India,8243,4151,4092
2010,752,Sweden,India,17863,9101,8762
2010,826,United Kingdom,India,684136,352918,331218
2010,191,Croatia,India,67,41,26
2010,300,Greece,India,10794,8715,2079
2010,380,Italy,India,128999,79254,49745
2010,470,Malta,India,215,144,71
2010,620,Portugal,India,6889,4002,2887
2010,688,Serbia,India,302,127,175
2010,705,Slovenia,India,83,57,26
2010,724,Spain,India,35224,24277,10947
2010,40,Austria,India,11607,6720,4887
2010,56,Belgium,India,15229,7797,7432
2010,250,France,India,45131,20875,24256
2010,276,Germany,India,55250,34395,20855
2010,438,Liechtenstein,India,23,13,10
2010,442,Luxembourg,India,127,71,56
2010,528,Netherlands,India,17366,9511,7855
2010,756,Switzerland,India,16707,8668,8039
2010,60,Bermuda,India,522,254,268
2010,124,Canada,India,517890,259701,258189
2010,840,United States of America,India,1784284,946212,838072
2015,232,Eritrea,India,119,46,73
2015,450,Madagascar,India,1581,900,681
2015,454,Malawi,India,2390,1288,1102
2015,480,Mauritius,India,8651,7235,1416
2015,508,Mozambique,India,2370,1468,902
2015,690,Seychelles,India,6482,4726,1756
2015,728,South Sudan,India,1414,852,562
2015,800,Uganda,India,3520,2202,1318
2015,834,United Republic of Tanzania,India,8010,4583,3427
2015,894,Zambia,India,4078,2211,1867
2015,72,Botswana,India,5293,3087,2206
2015,426,Lesotho,India,228,127,101
2015,516,Namibia,India,659,432,227
2015,710,South Africa,India,37740,18856,18884
2015,288,Ghana,India,871,533,338
2015,324,Guinea,India,49,46,3
2015,430,Liberia,India,817,691,126
2015,694,Sierra Leone,India,855,523,332
2015,818,Egypt,India,866,590,276
2015,434,Libya,India,4842,3750,1092
2015,729,Sudan,India,1277,660,617
2015,48,Bahrain,India,302635,228273,74362
2015,196,Cyprus,India,2878,1687,1191
2015,268,Georgia,India,31,19,12
2015,368,Iraq,India,232,149,83
2015,376,Israel,India,18965,9021,9944
2015,400,Jordan,India,5733,4988,745
2015,414,Kuwait,India,1061758,748549,313209
2015,422,Lebanon,India,1548,741,807
2015,512,Oman,India,1076151,942362,133789
2015,634,Qatar,India,645577,556448,89129
2015,682,Saudi Arabia,India,2003256,1406156,597100
2015,792,Turkey,India,521,314,207
2015,784,United Arab Emirates,India,3184043,2445963,738080
2015,762,Tajikistan,India,617,386,231
2015,50,Bangladesh,India,34431,18593,15838
2015,64,Bhutan,India,44732,38509,6223
2015,462,Maldives,India,13364,9821,3543
2015,524,Nepal,India,446113,127498,318615
2015,586,Pakistan,India,1709217,988946,720271
2015,144,Sri Lanka,India,10730,5514,5216
2015,156,China,India,8968,5954,3014
2015,344,"China, Hong Kong SAR",India,18004,8097,9907
2015,408,Dem. People's Republic of Korea,India,363,189,174
2015,392,Japan,India,26244,11706,14538
2015,496,Mongolia,India,111,67,44
2015,410,Republic of Korea,India,5494,3819,1675
2015,96,Brunei Darussalam,India,3081,2608,473
2015,116,Cambodia,India,95,73,22
2015,360,Indonesia,India,11976,7098,4878
2015,458,Malaysia,India,139752,81379,58373
2015,104,Myanmar,India,26205,13999,12206
2015,608,Philippines,India,10639,6120,4519
2015,702,Singapore,India,150082,79268,70814
2015,764,Thailand,India,8901,5227,3674
2015,704,Viet Nam,India,1938,1142,796
2015,28,Antigua and Barbuda,India,79,39,40
2015,533,Aruba,India,330,217,113
2015,44,Bahamas,India,598,336,262
2015,52,Barbados,India,463,226,237
2015,92,British Virgin Islands,India,39,20,19
2015,535,"Bonaire, Sint Eustatius and Saba",India,9,6,3
2015,136,Cayman Islands,India,582,449,133
2015,531,Curaçao,India,637,393,244
2015,212,Dominica,India,28,16,12
2015,214,Dominican Republic,India,94,70,24
2015,312,Guadeloupe,India,200,90,110
2015,388,Jamaica,India,1127,706,421
2015,630,Puerto Rico,India,49,23,26
2015,662,Saint Lucia,India,218,130,88
2015,534,Sint Maarten (Dutch part),India,834,794,40
2015,780,Trinidad and Tobago,India,959,562,397
2015,84,Belize,India,592,326,266
2015,188,Costa Rica,India,54,33,21
2015,222,El Salvador,India,11,7,4
2015,484,Mexico,India,1994,1456,538
2015,558,Nicaragua,India,24,13,11
2015,591,Panama,India,4481,2798,1683
2015,32,Argentina,India,97,45,52
2015,68,Bolivia (Plurinational State of),India,107,73,34
2015,76,Brazil,India,1052,681,371
2015,152,Chile,India,1636,1072,564
2015,170,Colombia,India,150,73,77
2015,218,Ecuador,India,228,154,74
2015,604,Peru,India,1434,1228,206
2015,862,Venezuela (Bolivarian Republic of),India,258,136,122
2015,36,Australia,India,449040,246605,202435
2015,554,New Zealand,India,69800,33754,36046
2015,242,Fiji,India,1292,697,595
2015,598,Papua New Guinea,India,156,123,33
2015,258,French Polynesia,India,38,29,9
2015,776,Tonga,India,188,98,90
2015,112,Belarus,India,48,39,9
2015,100,Bulgaria,India,286,195,91
2015,203,Czechia,India,1707,1242,465
2015,348,Hungary,India,1187,770,417
2015,616,Poland,India,857,570,287
2015,642,Romania,India,78,54,24
2015,643,Russian Federation,India,5701,4254,1447
2015,703,Slovakia,India,155,113,42
2015,804,Ukraine,India,3816,3071,745
2015,208,Denmark,India,9998,4987,5011
2015,233,Estonia,India,318,252,66
2015,234,Faroe Islands,India,63,24,39
2015,246,Finland,India,6669,3886,2783
2015,352,Iceland,India,305,145,160
2015,372,Ireland,India,19764,9540,10224
2015,428,Latvia,India,131,118,13
2015,578,Norway,India,11977,6304,5673
2015,752,Sweden,India,23237,11862,11375
2015,826,United Kingdom,India,808104,414786,393318
2015,191,Croatia,India,67,41,26
2015,300,Greece,India,10130,8096,2034
2015,380,Italy,India,139115,84099,55016
2015,470,Malta,India,364,251,113
2015,620,Portugal,India,7809,4367,3442
2015,688,Serbia,India,295,124,171
2015,705,Slovenia,India,143,102,41
2015,724,Spain,India,34447,20810,13637
2015,40,Austria,India,13576,7891,5685
2015,56,Belgium,India,19815,10320,9495
2015,250,France,India,49996,22385,27611
2015,276,Germany,India,57568,35787,21781
2015,438,Liechtenstein,India,27,17,10
2015,442,Luxembourg,India,193,109,84
2015,528,Netherlands,India,22713,12562,10151
2015,756,Switzerland,India,21961,11456,10505
2015,60,Bermuda,India,529,258,271
2015,124,Canada,India,664465,331826,332639
2015,840,United States of America,India,2389639,1258676,1130963
2019,232,Eritrea,India,120,47,73
2019,450,Madagascar,India,1721,980,741
2019,454,Malawi,India,2424,1306,1118
2019,480,Mauritius,India,8741,7304,1437
2019,508,Mozambique,India,2464,1526,938
2019,690,Seychelles,India,6550,4776,1774
2019,728,South Sudan,India,1449,873,576
2019,800,Uganda,India,3524,2200,1324
2019,834,United Republic of Tanzania,India,7187,4089,3098
2019,894,Zambia,India,5255,2855,2400
2019,72,Botswana,India,5668,3306,2362
2019,426,Lesotho,India,240,134,106
2019,516,Namibia,India,697,457,240
2019,710,South Africa,India,42302,21156,21146
2019,288,Ghana,India,980,601,379
2019,324,Guinea,India,46,44,2
2019,430,Liberia,India,678,574,104
2019,694,Sierra Leone,India,995,520,475
2019,818,Egypt,India,1234,795,439
2019,434,Libya,India,5137,3979,1158
2019,729,Sudan,India,1574,802,772
2019,48,Bahrain,India,318547,240276,78271
2019,196,Cyprus,India,2876,1698,1178
2019,268,Georgia,India,31,19,12
2019,368,Iraq,India,237,152,85
2019,376,Israel,India,18442,8772,9670
2019,400,Jordan,India,6165,5364,801
2019,414,Kuwait,India,1124256,792611,331645
2019,422,Lebanon,India,1462,700,762
2019,512,Oman,India,1325444,1160663,164781
2019,634,Qatar,India,698088,600826,97262
2019,682,Saudi Arabia,India,2440489,1697032,743457
2019,792,Turkey,India,704,427,277
2019,784,United Arab Emirates,India,3419875,2626998,792877
2019,762,Tajikistan,India,614,384,230
2019,50,Bangladesh,India,34884,10638,24246
2019,64,Bhutan,India,46627,40135,6492
2019,462,Maldives,India,14411,10583,3828
2019,524,Nepal,India,429769,120892,308877
2019,586,Pakistan,India,1588067,918849,669218
2019,144,Sri Lanka,India,10814,5558,5256
2019,156,China,India,9452,6276,3176
2019,344,"China, Hong Kong SAR",India,23326,10106,13220
2019,408,Dem. People's Republic of Korea,India,370,193,177
2019,392,Japan,India,30063,13410,16653
2019,496,Mongolia,India,117,71,46
2019,410,Republic of Korea,India,5592,3887,1705
2019,96,Brunei Darussalam,India,3318,2809,509
2019,116,Cambodia,India,101,78,23
2019,360,Indonesia,India,12507,7413,5094
2019,458,Malaysia,India,146128,85540,60588
2019,104,Myanmar,India,27166,14513,12653
2019,608,Philippines,India,10973,6312,4661
2019,702,Singapore,India,127189,67102,60087
2019,764,Thailand,India,9280,5449,3831
2019,704,Viet Nam,India,2026,1194,832
2019,28,Antigua and Barbuda,India,82,41,41
2019,533,Aruba,India,333,219,114
2019,44,Bahamas,India,634,356,278
2019,52,Barbados,India,467,228,239
2019,92,British Virgin Islands,India,42,22,20
2019,535,"Bonaire, Sint Eustatius and Saba",India,10,7,3
2019,136,Cayman Islands,India,643,496,147
2019,531,Curaçao,India,692,427,265
2019,212,Dominica,India,28,16,12
2019,214,Dominican Republic,India,97,73,24
2019,312,Guadeloupe,India,203,92,111
2019,388,Jamaica,India,1141,715,426
2019,630,Puerto Rico,India,46,22,24
2019,662,Saint Lucia,India,210,125,85
2019,534,Sint Maarten (Dutch part),India,863,822,41
2019,780,Trinidad and Tobago,India,1032,625,407
2019,84,Belize,India,649,358,291
2019,188,Costa Rica,India,54,33,21
2019,222,El Salvador,India,11,7,4
2019,484,Mexico,India,2055,1501,554
2019,558,Nicaragua,India,25,14,11
2019,591,Panama,India,4770,2980,1790
2019,32,Argentina,India,98,46,52
2019,68,Bolivia (Plurinational State of),India,116,79,37
2019,76,Brazil,India,1184,767,417
2019,152,Chile,India,2185,1390,795
2019,170,Colombia,India,153,75,78
2019,218,Ecuador,India,224,152,72
2019,604,Peru,India,1708,1473,235
2019,862,Venezuela (Bolivarian Republic of),India,252,132,120
2019,36,Australia,India,568971,311883,257088
2019,554,New Zealand,India,71747,34696,37051
2019,242,Fiji,India,1318,711,607
2019,598,Papua New Guinea,India,157,124,33
2019,258,French Polynesia,India,39,30,9
2019,776,Tonga,India,178,93,85
2019,112,Belarus,India,47,39,8
2019,100,Bulgaria,India,370,255,115
2019,203,Czechia,India,2862,2098,764
2019,348,Hungary,India,1721,1091,630
2019,616,Poland,India,907,615,292
2019,642,Romania,India,452,326,126
2019,643,Russian Federation,India,5699,4253,1446
2019,703,Slovakia,India,180,134,46
2019,804,Ukraine,India,3854,3102,752
2019,208,Denmark,India,14253,7370,6883
2019,233,Estonia,India,460,374,86
2019,234,Faroe Islands,India,70,28,42
2019,246,Finland,India,7854,4546,3308
2019,352,Iceland,India,375,175,200
2019,372,Ireland,India,21698,10508,11190
2019,428,Latvia,India,213,187,26
2019,578,Norway,India,13627,7034,6593
2019,752,Sweden,India,37803,20371,17432
2019,826,United Kingdom,India,917686,472161,445525
2019,191,Croatia,India,61,37,24
2019,300,Greece,India,9893,7982,1911
2019,380,Italy,India,161364,97904,63460
2019,470,Malta,India,587,406,181
2019,620,Portugal,India,7941,4449,3492
2019,688,Serbia,India,299,126,173
2019,705,Slovenia,India,168,116,52
2019,724,Spain,India,37857,22213,15644
2019,40,Austria,India,16026,9431,6595
2019,56,Belgium,India,22852,11885,10967
2019,250,France,India,52921,23628,29293
2019,276,Germany,India,89704,57964,31740
2019,438,Liechtenstein,India,25,16,9
2019,442,Luxembourg,India,2035,1106,929
2019,528,Netherlands,India,32833,18365,14468
2019,756,Switzerland,India,23969,12548,11421
2019,60,Bermuda,India,534,261,273
2019,124,Canada,India,712050,355590,356460
2019,840,United States of America,India,2661470,1399494,1261976
1990,690,Seychelles,Indonesia,2,0,2
1990,516,Namibia,Indonesia,133,49,84
1990,710,South Africa,Indonesia,1191,474,717
1990,12,Algeria,Indonesia,1000,809,191
1990,818,Egypt,Indonesia,1481,1188,293
1990,434,Libya,Indonesia,4228,3395,833
1990,48,Bahrain,Indonesia,6151,3065,3086
1990,196,Cyprus,Indonesia,43,7,36
1990,400,Jordan,Indonesia,183,72,111
1990,414,Kuwait,Indonesia,38147,11651,26496
1990,422,Lebanon,Indonesia,84,33,51
1990,512,Oman,Indonesia,4605,355,4250
1990,634,Qatar,Indonesia,108178,84970,23208
1990,682,Saudi Arabia,Indonesia,635007,422395,212612
1990,792,Turkey,Indonesia,43,17,26
1990,784,United Arab Emirates,Indonesia,46598,22969,23629
1990,50,Bangladesh,Indonesia,70627,38139,32488
1990,356,India,Indonesia,1786,777,1009
1990,586,Pakistan,Indonesia,599,338,261
1990,144,Sri Lanka,Indonesia,3,1,2
1990,156,China,Indonesia,21305,5823,15482
1990,344,"China, Hong Kong SAR",Indonesia,90186,16930,73256
1990,408,Dem. People's Republic of Korea,Indonesia,845,172,673
1990,392,Japan,Indonesia,3624,1846,1778
1990,410,Republic of Korea,Indonesia,65,53,12
1990,96,Brunei Darussalam,Indonesia,3324,581,2743
1990,116,Cambodia,Indonesia,49,38,11
1990,458,Malaysia,Indonesia,252710,167538,85172
1990,608,Philippines,Indonesia,3752,2116,1636
1990,702,Singapore,Indonesia,21520,9521,11999
1990,764,Thailand,Indonesia,545,266,279
1990,626,Timor-Leste,Indonesia,4485,2093,2392
1990,704,Viet Nam,Indonesia,793,488,305
1990,44,Bahamas,Indonesia,8,6,2
1990,535,"Bonaire, Sint Eustatius and Saba",Indonesia,59,31,28
1990,188,Costa Rica,Indonesia,13,8,5
1990,320,Guatemala,Indonesia,27,10,17
1990,484,Mexico,Indonesia,69,46,23
1990,591,Panama,Indonesia,49,35,14
1990,32,Argentina,Indonesia,47,13,34
1990,68,Bolivia (Plurinational State of),Indonesia,12,8,4
1990,152,Chile,Indonesia,51,26,25
1990,170,Colombia,Indonesia,77,41,36
1990,218,Ecuador,Indonesia,22,12,10
1990,604,Peru,Indonesia,25,10,15
1990,862,Venezuela (Bolivarian Republic of),Indonesia,52,22,30
1990,36,Australia,Indonesia,39102,20104,18998
1990,554,New Zealand,Indonesia,2024,1092,932
1990,540,New Caledonia,Indonesia,819,501,318
1990,598,Papua New Guinea,Indonesia,8108,4648,3460
1990,90,Solomon Islands,Indonesia,85,76,9
1990,258,French Polynesia,Indonesia,15,8,7
1990,100,Bulgaria,Indonesia,1,0,1
1990,203,Czechia,Indonesia,22,15,7
1990,348,Hungary,Indonesia,191,80,111
1990,616,Poland,Indonesia,62,42,20
1990,643,Russian Federation,Indonesia,377,185,192
1990,208,Denmark,Indonesia,422,198,224
1990,234,Faroe Islands,Indonesia,1,0,1
1990,246,Finland,Indonesia,36,23,13
1990,352,Iceland,Indonesia,59,24,35
1990,372,Ireland,Indonesia,24,9,15
1990,428,Latvia,Indonesia,2,1,1
1990,578,Norway,Indonesia,427,207,220
1990,752,Sweden,Indonesia,1276,680,596
1990,826,United Kingdom,Indonesia,938,503,435
1990,300,Greece,Indonesia,195,31,164
1990,380,Italy,Indonesia,166,58,108
1990,470,Malta,Indonesia,11,4,7
1990,620,Portugal,Indonesia,28,15,13
1990,688,Serbia,Indonesia,3,2,1
1990,705,Slovenia,Indonesia,2,1,1
1990,724,Spain,Indonesia,595,222,373
1990,40,Austria,Indonesia,669,220,449
1990,56,Belgium,Indonesia,1692,892,800
1990,250,France,Indonesia,3852,1438,2414
1990,276,Germany,Indonesia,8819,5608,3211
1990,528,Netherlands,Indonesia,186717,88321,98396
1990,756,Switzerland,Indonesia,2137,871,1266
1990,124,Canada,Indonesia,7298,3553,3745
1990,840,United States of America,Indonesia,48387,24589,23798
1995,690,Seychelles,Indonesia,114,110,4
1995,516,Namibia,Indonesia,127,48,79
1995,710,South Africa,Indonesia,742,331,411
1995,12,Algeria,Indonesia,1223,941,282
1995,818,Egypt,Indonesia,1725,1341,384
1995,434,Libya,Indonesia,6863,5488,1375
1995,48,Bahrain,Indonesia,7640,3194,4446
1995,196,Cyprus,Indonesia,61,8,53
1995,400,Jordan,Indonesia,6415,87,6328
1995,414,Kuwait,Indonesia,34017,10650,23367
1995,422,Lebanon,Indonesia,2911,635,2276
1995,512,Oman,Indonesia,12728,911,11817
1995,634,Qatar,Indonesia,130606,102805,27801
1995,682,Saudi Arabia,Indonesia,650793,434034,216759
1995,792,Turkey,Indonesia,104,38,66
1995,784,United Arab Emirates,Indonesia,68471,30221,38250
1995,50,Bangladesh,Indonesia,84052,45389,38663
1995,356,India,Indonesia,1394,595,799
1995,586,Pakistan,Indonesia,502,283,219
1995,144,Sri Lanka,Indonesia,40,30,10
1995,156,China,Indonesia,24962,7536,17426
1995,344,"China, Hong Kong SAR",Indonesia,100652,18349,82303
1995,408,Dem. People's Republic of Korea,Indonesia,904,207,697
1995,392,Japan,Indonesia,7052,3385,3667
1995,410,Republic of Korea,Indonesia,8121,6489,1632
1995,96,Brunei Darussalam,Indonesia,4551,838,3713
1995,116,Cambodia,Indonesia,129,100,29
1995,458,Malaysia,Indonesia,421423,255624,165799
1995,608,Philippines,Indonesia,5049,2804,2245
1995,702,Singapore,Indonesia,34241,13196,21045
1995,764,Thailand,Indonesia,495,246,249
1995,626,Timor-Leste,Indonesia,4893,2252,2641
1995,704,Viet Nam,Indonesia,2197,1281,916
1995,44,Bahamas,Indonesia,7,5,2
1995,535,"Bonaire, Sint Eustatius and Saba",Indonesia,123,65,58
1995,188,Costa Rica,Indonesia,10,6,4
1995,320,Guatemala,Indonesia,26,11,15
1995,484,Mexico,Indonesia,82,43,39
1995,591,Panama,Indonesia,70,51,19
1995,32,Argentina,Indonesia,46,13,33
1995,68,Bolivia (Plurinational State of),Indonesia,14,8,6
1995,152,Chile,Indonesia,68,37,31
1995,170,Colombia,Indonesia,75,40,35
1995,218,Ecuador,Indonesia,25,14,11
1995,604,Peru,Indonesia,26,10,16
1995,862,Venezuela (Bolivarian Republic of),Indonesia,51,22,29
1995,36,Australia,Indonesia,45651,22944,22707
1995,554,New Zealand,Indonesia,2641,1373,1268
1995,540,New Caledonia,Indonesia,949,575,374
1995,598,Papua New Guinea,Indonesia,7293,4312,2981
1995,90,Solomon Islands,Indonesia,85,76,9
1995,258,French Polynesia,Indonesia,16,8,8
1995,100,Bulgaria,Indonesia,6,2,4
1995,203,Czechia,Indonesia,33,23,10
1995,348,Hungary,Indonesia,169,69,100
1995,616,Poland,Indonesia,53,36,17
1995,643,Russian Federation,Indonesia,336,194,142
1995,703,Slovakia,Indonesia,7,4,3
1995,208,Denmark,Indonesia,528,238,290
1995,234,Faroe Islands,Indonesia,1,0,1
1995,246,Finland,Indonesia,74,36,38
1995,352,Iceland,Indonesia,67,28,39
1995,372,Ireland,Indonesia,67,23,44
1995,428,Latvia,Indonesia,2,1,1
1995,578,Norway,Indonesia,463,211,252
1995,752,Sweden,Indonesia,1514,801,713
1995,826,United Kingdom,Indonesia,3687,1507,2180
1995,300,Greece,Indonesia,225,54,171
1995,380,Italy,Indonesia,697,161,536
1995,470,Malta,Indonesia,14,5,9
1995,620,Portugal,Indonesia,59,31,28
1995,688,Serbia,Indonesia,24,15,9
1995,705,Slovenia,Indonesia,4,3,1
1995,724,Spain,Indonesia,682,265,417
1995,40,Austria,Indonesia,755,257,498
1995,56,Belgium,Indonesia,1838,821,1017
1995,250,France,Indonesia,3977,1443,2534
1995,276,Germany,Indonesia,9827,5515,4312
1995,528,Netherlands,Indonesia,173584,80744,92840
1995,756,Switzerland,Indonesia,2316,991,1325
1995,124,Canada,Indonesia,8723,4224,4499
1995,840,United States of America,Indonesia,61278,31437,29841
2000,690,Seychelles,Indonesia,226,220,6
2000,516,Namibia,Indonesia,120,45,75
2000,710,South Africa,Indonesia,512,270,242
2000,12,Algeria,Indonesia,1446,1074,372
2000,818,Egypt,Indonesia,2107,1601,506
2000,434,Libya,Indonesia,9612,7703,1909
2000,48,Bahrain,Indonesia,9152,3275,5877
2000,196,Cyprus,Indonesia,79,9,70
2000,400,Jordan,Indonesia,12641,154,12487
2000,414,Kuwait,Indonesia,43100,14052,29048
2000,422,Lebanon,Indonesia,5738,1238,4500
2000,512,Oman,Indonesia,17274,2498,14776
2000,634,Qatar,Indonesia,133562,105462,28100
2000,682,Saudi Arabia,Indonesia,668666,446901,221765
2000,792,Turkey,Indonesia,167,59,108
2000,784,United Arab Emirates,Indonesia,94285,38758,55527
2000,50,Bangladesh,Indonesia,97476,52638,44838
2000,356,India,Indonesia,1002,414,588
2000,586,Pakistan,Indonesia,443,250,193
2000,144,Sri Lanka,Indonesia,79,47,32
2000,156,China,Indonesia,28619,9248,19371
2000,344,"China, Hong Kong SAR",Indonesia,111117,19767,91350
2000,408,Dem. People's Republic of Korea,Indonesia,963,243,720
2000,392,Japan,Indonesia,19347,8938,10409
2000,410,Republic of Korea,Indonesia,18763,15093,3670
2000,96,Brunei Darussalam,Indonesia,5778,1095,4683
2000,116,Cambodia,Indonesia,208,161,47
2000,458,Malaysia,Indonesia,726961,423850,303111
2000,608,Philippines,Indonesia,4711,2380,2331
2000,702,Singapore,Indonesia,50277,17775,32502
2000,764,Thailand,Indonesia,549,271,278
2000,626,Timor-Leste,Indonesia,5337,2419,2918
2000,704,Viet Nam,Indonesia,5662,3387,2275
2000,44,Bahamas,Indonesia,6,4,2
2000,535,"Bonaire, Sint Eustatius and Saba",Indonesia,187,98,89
2000,188,Costa Rica,Indonesia,13,8,5
2000,320,Guatemala,Indonesia,25,12,13
2000,484,Mexico,Indonesia,99,42,57
2000,591,Panama,Indonesia,97,71,26
2000,32,Argentina,Indonesia,45,13,32
2000,68,Bolivia (Plurinational State of),Indonesia,15,8,7
2000,152,Chile,Indonesia,85,45,40
2000,170,Colombia,Indonesia,73,39,34
2000,218,Ecuador,Indonesia,27,15,12
2000,604,Peru,Indonesia,31,12,19
2000,862,Venezuela (Bolivarian Republic of),Indonesia,51,22,29
2000,36,Australia,Indonesia,58650,28325,30325
2000,554,New Zealand,Indonesia,3689,1794,1895
2000,540,New Caledonia,Indonesia,1079,649,430
2000,598,Papua New Guinea,Indonesia,6663,3526,3137
2000,90,Solomon Islands,Indonesia,81,72,9
2000,258,French Polynesia,Indonesia,18,9,9
2000,100,Bulgaria,Indonesia,11,4,7
2000,203,Czechia,Indonesia,43,30,13
2000,348,Hungary,Indonesia,147,58,89
2000,616,Poland,Indonesia,46,31,15
2000,643,Russian Federation,Indonesia,283,196,87
2000,703,Slovakia,Indonesia,17,9,8
2000,208,Denmark,Indonesia,633,278,355
2000,246,Finland,Indonesia,112,49,63
2000,352,Iceland,Indonesia,75,32,43
2000,372,Ireland,Indonesia,148,54,94
2000,428,Latvia,Indonesia,3,2,1
2000,578,Norway,Indonesia,573,256,317
2000,752,Sweden,Indonesia,1624,854,770
2000,826,United Kingdom,Indonesia,6499,2531,3968
2000,300,Greece,Indonesia,259,75,184
2000,380,Italy,Indonesia,1227,263,964
2000,470,Malta,Indonesia,18,8,10
2000,620,Portugal,Indonesia,94,49,45
2000,688,Serbia,Indonesia,33,20,13
2000,705,Slovenia,Indonesia,8,7,1
2000,724,Spain,Indonesia,1063,433,630
2000,40,Austria,Indonesia,841,294,547
2000,56,Belgium,Indonesia,1928,726,1202
2000,250,France,Indonesia,4101,1447,2654
2000,276,Germany,Indonesia,10834,5421,5413
2000,528,Netherlands,Indonesia,166679,75814,90865
2000,756,Switzerland,Indonesia,2504,1118,1386
2000,124,Canada,Indonesia,10356,4996,5360
2000,840,United States of America,Indonesia,74394,38449,35945
2005,690,Seychelles,Indonesia,176,155,21
2005,516,Namibia,Indonesia,94,35,59
2005,710,South Africa,Indonesia,673,342,331
2005,12,Algeria,Indonesia,1141,848,293
2005,818,Egypt,Indonesia,2508,1943,565
2005,434,Libya,Indonesia,10591,8864,1727
2005,48,Bahrain,Indonesia,14859,4975,9884
2005,196,Cyprus,Indonesia,115,12,103
2005,400,Jordan,Indonesia,18257,2408,15849
2005,414,Kuwait,Indonesia,52859,15455,37404
2005,422,Lebanon,Indonesia,4491,676,3815
2005,512,Oman,Indonesia,19887,3298,16589
2005,634,Qatar,Indonesia,64612,43548,21064
2005,682,Saudi Arabia,Indonesia,825998,567849,258149
2005,792,Turkey,Indonesia,172,59,113
2005,784,United Arab Emirates,Indonesia,121621,43878,77743
2005,50,Bangladesh,Indonesia,123383,66627,56756
2005,356,India,Indonesia,926,381,545
2005,586,Pakistan,Indonesia,423,239,184
2005,144,Sri Lanka,Indonesia,157,53,104
2005,156,China,Indonesia,31573,12451,19122
2005,344,"China, Hong Kong SAR",Indonesia,121316,16575,104741
2005,408,Dem. People's Republic of Korea,Indonesia,1124,285,839
2005,392,Japan,Indonesia,23481,10695,12786
2005,410,Republic of Korea,Indonesia,18502,15988,2514
2005,96,Brunei Darussalam,Indonesia,5907,1148,4759
2005,116,Cambodia,Indonesia,162,126,36
2005,458,Malaysia,Indonesia,863998,519990,344008
2005,608,Philippines,Indonesia,3813,1956,1857
2005,702,Singapore,Indonesia,91090,31219,59871
2005,764,Thailand,Indonesia,564,294,270
2005,626,Timor-Leste,Indonesia,5666,2603,3063
2005,704,Viet Nam,Indonesia,5861,3594,2267
2005,44,Bahamas,Indonesia,18,8,10
2005,535,"Bonaire, Sint Eustatius and Saba",Indonesia,199,105,94
2005,534,Sint Maarten (Dutch part),Indonesia,28,17,11
2005,188,Costa Rica,Indonesia,9,6,3
2005,320,Guatemala,Indonesia,30,15,15
2005,484,Mexico,Indonesia,119,57,62
2005,591,Panama,Indonesia,103,78,25
2005,32,Argentina,Indonesia,33,10,23
2005,68,Bolivia (Plurinational State of),Indonesia,12,6,6
2005,76,Brazil,Indonesia,361,168,193
2005,152,Chile,Indonesia,127,68,59
2005,170,Colombia,Indonesia,69,37,32
2005,218,Ecuador,Indonesia,32,19,13
2005,604,Peru,Indonesia,37,14,23
2005,862,Venezuela (Bolivarian Republic of),Indonesia,53,23,30
2005,36,Australia,Indonesia,60250,27806,32444
2005,554,New Zealand,Indonesia,4412,2142,2270
2005,540,New Caledonia,Indonesia,1150,694,456
2005,598,Papua New Guinea,Indonesia,9806,4671,5135
2005,90,Solomon Islands,Indonesia,75,56,19
2005,258,French Polynesia,Indonesia,18,10,8
2005,100,Bulgaria,Indonesia,17,7,10
2005,203,Czechia,Indonesia,84,43,41
2005,348,Hungary,Indonesia,182,74,108
2005,616,Poland,Indonesia,80,63,17
2005,643,Russian Federation,Indonesia,223,148,75
2005,703,Slovakia,Indonesia,20,11,9
2005,208,Denmark,Indonesia,870,372,498
2005,234,Faroe Islands,Indonesia,3,0,3
2005,246,Finland,Indonesia,230,82,148
2005,352,Iceland,Indonesia,93,38,55
2005,372,Ireland,Indonesia,149,60,89
2005,428,Latvia,Indonesia,3,2,1
2005,578,Norway,Indonesia,862,381,481
2005,752,Sweden,Indonesia,1926,922,1004
2005,826,United Kingdom,Indonesia,7546,2741,4805
2005,191,Croatia,Indonesia,14,5,9
2005,300,Greece,Indonesia,356,96,260
2005,380,Italy,Indonesia,2193,492,1701
2005,470,Malta,Indonesia,22,9,13
2005,620,Portugal,Indonesia,170,54,116
2005,688,Serbia,Indonesia,33,20,13
2005,705,Slovenia,Indonesia,14,7,7
2005,724,Spain,Indonesia,1057,421,636
2005,40,Austria,Indonesia,940,314,626
2005,56,Belgium,Indonesia,2622,840,1782
2005,250,France,Indonesia,4242,1427,2815
2005,276,Germany,Indonesia,13611,6152,7459
2005,528,Netherlands,Indonesia,155822,69989,85833
2005,756,Switzerland,Indonesia,2780,1154,1626
2005,124,Canada,Indonesia,12039,5782,6257
2005,840,United States of America,Indonesia,83425,43339,40086
2010,690,Seychelles,Indonesia,126,89,37
2010,516,Namibia,Indonesia,90,34,56
2010,710,South Africa,Indonesia,1053,534,519
2010,12,Algeria,Indonesia,1253,918,335
2010,818,Egypt,Indonesia,2707,2074,633
2010,434,Libya,Indonesia,11587,9719,1868
2010,48,Bahrain,Indonesia,23845,7801,16044
2010,196,Cyprus,Indonesia,188,22,166
2010,400,Jordan,Indonesia,23478,4246,19232
2010,414,Kuwait,Indonesia,75801,21174,54627
2010,422,Lebanon,Indonesia,3243,114,3129
2010,512,Oman,Indonesia,25710,5382,20328
2010,634,Qatar,Indonesia,48072,28326,19746
2010,682,Saudi Arabia,Indonesia,1070951,753771,317180
2010,792,Turkey,Indonesia,177,58,119
2010,784,United Arab Emirates,Indonesia,267618,101732,165886
2010,50,Bangladesh,Indonesia,143647,77570,66077
2010,356,India,Indonesia,850,349,501
2010,586,Pakistan,Indonesia,413,226,187
2010,144,Sri Lanka,Indonesia,317,110,207
2010,156,China,Indonesia,34528,15654,18874
2010,344,"China, Hong Kong SAR",Indonesia,131809,13427,118382
2010,408,Dem. People's Republic of Korea,Indonesia,1284,326,958
2010,392,Japan,Indonesia,24895,11196,13699
2010,410,Republic of Korea,Indonesia,25545,23041,2504
2010,96,Brunei Darussalam,Indonesia,6036,1201,4835
2010,116,Cambodia,Indonesia,116,91,25
2010,458,Malaysia,Indonesia,960819,594408,366411
2010,608,Philippines,Indonesia,3253,1605,1648
2010,702,Singapore,Indonesia,136979,46323,90656
2010,764,Thailand,Indonesia,621,345,276
2010,626,Timor-Leste,Indonesia,5779,2667,3112
2010,704,Viet Nam,Indonesia,6511,3867,2644
2010,44,Bahamas,Indonesia,30,12,18
2010,535,"Bonaire, Sint Eustatius and Saba",Indonesia,39,29,10
2010,531,Curaçao,Indonesia,168,81,87
2010,534,Sint Maarten (Dutch part),Indonesia,57,34,23
2010,188,Costa Rica,Indonesia,17,10,7
2010,320,Guatemala,Indonesia,35,19,16
2010,484,Mexico,Indonesia,153,78,75
2010,591,Panama,Indonesia,115,89,26
2010,32,Argentina,Indonesia,21,7,14
2010,68,Bolivia (Plurinational State of),Indonesia,9,4,5
2010,76,Brazil,Indonesia,722,336,386
2010,152,Chile,Indonesia,170,92,78
2010,170,Colombia,Indonesia,78,42,36
2010,218,Ecuador,Indonesia,44,25,19
2010,604,Peru,Indonesia,41,16,25
2010,862,Venezuela (Bolivarian Republic of),Indonesia,56,24,32
2010,36,Australia,Indonesia,71170,31255,39915
2010,554,New Zealand,Indonesia,4796,2324,2472
2010,540,New Caledonia,Indonesia,1221,739,482
2010,598,Papua New Guinea,Indonesia,13219,6921,6298
2010,90,Solomon Islands,Indonesia,74,42,32
2010,258,French Polynesia,Indonesia,18,10,8
2010,100,Bulgaria,Indonesia,23,10,13
2010,203,Czechia,Indonesia,118,55,63
2010,348,Hungary,Indonesia,217,90,127
2010,616,Poland,Indonesia,117,97,20
2010,643,Russian Federation,Indonesia,160,98,62
2010,703,Slovakia,Indonesia,22,12,10
2010,208,Denmark,Indonesia,1086,458,628
2010,233,Estonia,Indonesia,6,5,1
2010,234,Faroe Islands,Indonesia,6,1,5
2010,246,Finland,Indonesia,404,117,287
2010,352,Iceland,Indonesia,110,44,66
2010,372,Ireland,Indonesia,125,45,80
2010,428,Latvia,Indonesia,3,2,1
2010,578,Norway,Indonesia,1256,500,756
2010,752,Sweden,Indonesia,2198,979,1219
2010,826,United Kingdom,Indonesia,7949,2992,4957
2010,191,Croatia,Indonesia,27,10,17
2010,300,Greece,Indonesia,471,122,349
2010,380,Italy,Indonesia,3122,738,2384
2010,470,Malta,Indonesia,18,9,9
2010,620,Portugal,Indonesia,218,50,168
2010,688,Serbia,Indonesia,33,20,13
2010,705,Slovenia,Indonesia,25,11,14
2010,724,Spain,Indonesia,1967,1076,891
2010,40,Austria,Indonesia,1038,333,705
2010,56,Belgium,Indonesia,3253,1277,1976
2010,250,France,Indonesia,4644,1572,3072
2010,276,Germany,Indonesia,15889,6774,9115
2010,528,Netherlands,Indonesia,141028,62545,78483
2010,756,Switzerland,Indonesia,3309,1274,2035
2010,124,Canada,Indonesia,13520,6489,7031
2010,840,United States of America,Indonesia,95254,48855,46399
2015,690,Seychelles,Indonesia,141,102,39
2015,516,Namibia,Indonesia,88,34,54
2015,710,South Africa,Indonesia,1899,916,983
2015,12,Algeria,Indonesia,1382,1012,370
2015,818,Egypt,Indonesia,2007,1599,408
2015,434,Libya,Indonesia,13064,10929,2135
2015,48,Bahrain,Indonesia,22513,7137,15376
2015,196,Cyprus,Indonesia,180,22,158
2015,400,Jordan,Indonesia,18344,3240,15104
2015,414,Kuwait,Indonesia,99485,17914,81571
2015,422,Lebanon,Indonesia,2730,1307,1423
2015,512,Oman,Indonesia,58468,19197,39271
2015,634,Qatar,Indonesia,43049,26529,16520
2015,682,Saudi Arabia,Indonesia,1368407,947919,420488
2015,792,Turkey,Indonesia,179,56,123
2015,784,United Arab Emirates,Indonesia,292432,104016,188416
2015,50,Bangladesh,Indonesia,152862,82546,70316
2015,356,India,Indonesia,818,336,482
2015,586,Pakistan,Indonesia,408,230,178
2015,144,Sri Lanka,Indonesia,322,108,214
2015,156,China,Indonesia,39736,19007,20729
2015,344,"China, Hong Kong SAR",Indonesia,134593,8983,125610
2015,408,Dem. People's Republic of Korea,Indonesia,1414,365,1049
2015,392,Japan,Indonesia,35910,16017,19893
2015,410,Republic of Korea,Indonesia,31739,28556,3183
2015,96,Brunei Darussalam,Indonesia,6165,1254,4911
2015,116,Cambodia,Indonesia,105,83,22
2015,458,Malaysia,Indonesia,1171677,731189,440488
2015,608,Philippines,Indonesia,3304,1632,1672
2015,702,Singapore,Indonesia,163237,55071,108166
2015,764,Thailand,Indonesia,671,372,299
2015,626,Timor-Leste,Indonesia,4177,2380,1797
2015,704,Viet Nam,Indonesia,7860,4637,3223
2015,44,Bahamas,Indonesia,33,13,20
2015,535,"Bonaire, Sint Eustatius and Saba",Indonesia,44,33,11
2015,531,Curaçao,Indonesia,182,88,94
2015,534,Sint Maarten (Dutch part),Indonesia,60,36,24
2015,188,Costa Rica,Indonesia,17,10,7
2015,320,Guatemala,Indonesia,40,22,18
2015,484,Mexico,Indonesia,162,82,80
2015,591,Panama,Indonesia,135,105,30
2015,32,Argentina,Indonesia,21,7,14
2015,68,Bolivia (Plurinational State of),Indonesia,10,4,6
2015,76,Brazil,Indonesia,869,404,465
2015,152,Chile,Indonesia,257,137,120
2015,170,Colombia,Indonesia,87,48,39
2015,218,Ecuador,Indonesia,64,37,27
2015,604,Peru,Indonesia,43,18,25
2015,862,Venezuela (Bolivarian Republic of),Indonesia,59,24,35
2015,36,Australia,Indonesia,77000,33884,43116
2015,554,New Zealand,Indonesia,5105,2469,2636
2015,540,New Caledonia,Indonesia,938,526,412
2015,598,Papua New Guinea,Indonesia,13527,6950,6577
2015,90,Solomon Islands,Indonesia,69,40,29
2015,258,French Polynesia,Indonesia,17,10,7
2015,100,Bulgaria,Indonesia,43,14,29
2015,203,Czechia,Indonesia,179,69,110
2015,348,Hungary,Indonesia,225,89,136
2015,616,Poland,Indonesia,112,94,18
2015,643,Russian Federation,Indonesia,163,100,63
2015,703,Slovakia,Indonesia,35,18,17
2015,208,Denmark,Indonesia,1201,499,702
2015,233,Estonia,Indonesia,12,7,5
2015,234,Faroe Islands,Indonesia,10,1,9
2015,246,Finland,Indonesia,601,183,418
2015,352,Iceland,Indonesia,129,44,85
2015,372,Ireland,Indonesia,128,45,83
2015,428,Latvia,Indonesia,3,2,1
2015,578,Norway,Indonesia,1543,594,949
2015,752,Sweden,Indonesia,2429,1041,1388
2015,826,United Kingdom,Indonesia,10165,3638,6527
2015,191,Croatia,Indonesia,27,10,17
2015,300,Greece,Indonesia,442,101,341
2015,380,Italy,Indonesia,3161,644,2517
2015,470,Malta,Indonesia,30,16,14
2015,620,Portugal,Indonesia,247,46,201
2015,688,Serbia,Indonesia,32,20,12
2015,705,Slovenia,Indonesia,43,14,29
2015,724,Spain,Indonesia,1937,1016,921
2015,40,Austria,Indonesia,1214,394,820
2015,56,Belgium,Indonesia,3354,1257,2097
2015,250,France,Indonesia,5145,1649,3496
2015,276,Germany,Indonesia,16555,7035,9520
2015,528,Netherlands,Indonesia,132159,58389,73770
2015,756,Switzerland,Indonesia,3601,1277,2324
2015,124,Canada,Indonesia,14192,6352,7840
2015,840,United States of America,Indonesia,104522,51365,53157
2019,690,Seychelles,Indonesia,142,103,39
2019,516,Namibia,Indonesia,93,36,57
2019,710,South Africa,Indonesia,2127,1027,1100
2019,12,Algeria,Indonesia,1437,1053,384
2019,818,Egypt,Indonesia,2860,2210,650
2019,434,Libya,Indonesia,13861,11596,2265
2019,48,Bahrain,Indonesia,23696,7512,16184
2019,196,Cyprus,Indonesia,179,23,156
2019,400,Jordan,Indonesia,19727,3485,16242
2019,414,Kuwait,Indonesia,105340,18968,86372
2019,422,Lebanon,Indonesia,2578,1234,1344
2019,512,Oman,Indonesia,72012,23644,48368
2019,634,Qatar,Indonesia,43909,25856,18053
2019,682,Saudi Arabia,Indonesia,1667077,1143522,523555
2019,792,Turkey,Indonesia,242,78,164
2019,784,United Arab Emirates,Indonesia,314089,111685,202404
2019,50,Bangladesh,Indonesia,154877,47229,107648
2019,356,India,Indonesia,804,329,475
2019,586,Pakistan,Indonesia,379,214,165
2019,144,Sri Lanka,Indonesia,324,109,215
2019,156,China,Indonesia,41882,20034,21848
2019,344,"China, Hong Kong SAR",Indonesia,174380,6753,167627
2019,408,Dem. People's Republic of Korea,Indonesia,1441,372,1069
2019,392,Japan,Indonesia,44937,20044,24893
2019,410,Republic of Korea,Indonesia,32310,29069,3241
2019,96,Brunei Darussalam,Indonesia,6639,1351,5288
2019,116,Cambodia,Indonesia,111,88,23
2019,458,Malaysia,Indonesia,1225156,767934,457222
2019,608,Philippines,Indonesia,3407,1683,1724
2019,702,Singapore,Indonesia,138338,46557,91781
2019,764,Thailand,Indonesia,699,388,311
2019,626,Timor-Leste,Indonesia,4126,2347,1779
2019,704,Viet Nam,Indonesia,8217,4848,3369
2019,44,Bahamas,Indonesia,35,14,21
2019,535,"Bonaire, Sint Eustatius and Saba",Indonesia,52,39,13
2019,531,Curaçao,Indonesia,197,95,102
2019,534,Sint Maarten (Dutch part),Indonesia,62,38,24
2019,188,Costa Rica,Indonesia,17,10,7
2019,320,Guatemala,Indonesia,41,23,18
2019,484,Mexico,Indonesia,167,85,82
2019,591,Panama,Indonesia,142,112,30
2019,32,Argentina,Indonesia,21,7,14
2019,68,Bolivia (Plurinational State of),Indonesia,10,4,6
2019,76,Brazil,Indonesia,978,455,523
2019,152,Chile,Indonesia,343,174,169
2019,170,Colombia,Indonesia,88,49,39
2019,218,Ecuador,Indonesia,63,37,26
2019,604,Peru,Indonesia,50,22,28
2019,862,Venezuela (Bolivarian Republic of),Indonesia,57,23,34
2019,36,Australia,Indonesia,87274,38099,49175
2019,554,New Zealand,Indonesia,5247,2538,2709
2019,540,New Caledonia,Indonesia,987,552,435
2019,598,Papua New Guinea,Indonesia,13648,7044,6604
2019,90,Solomon Islands,Indonesia,67,39,28
2019,258,French Polynesia,Indonesia,17,10,7
2019,100,Bulgaria,Indonesia,64,18,46
2019,203,Czechia,Indonesia,237,98,139
2019,348,Hungary,Indonesia,272,106,166
2019,616,Poland,Indonesia,118,100,18
2019,643,Russian Federation,Indonesia,162,100,62
2019,703,Slovakia,Indonesia,42,20,22
2019,208,Denmark,Indonesia,1353,524,829
2019,233,Estonia,Indonesia,18,9,9
2019,234,Faroe Islands,Indonesia,11,1,10
2019,246,Finland,Indonesia,768,246,522
2019,352,Iceland,Indonesia,154,59,95
2019,372,Ireland,Indonesia,140,50,90
2019,428,Latvia,Indonesia,3,3,0
2019,578,Norway,Indonesia,1675,616,1059
2019,752,Sweden,Indonesia,2963,1283,1680
2019,826,United Kingdom,Indonesia,11543,4150,7393
2019,191,Croatia,Indonesia,24,9,15
2019,300,Greece,Indonesia,431,111,320
2019,380,Italy,Indonesia,3594,748,2846
2019,470,Malta,Indonesia,48,26,22
2019,620,Portugal,Indonesia,251,48,203
2019,688,Serbia,Indonesia,32,20,12
2019,705,Slovenia,Indonesia,56,20,36
2019,724,Spain,Indonesia,2007,1030,977
2019,40,Austria,Indonesia,1433,482,951
2019,56,Belgium,Indonesia,3643,1340,2303
2019,250,France,Indonesia,5446,1738,3708
2019,276,Germany,Indonesia,18160,7838,10322
2019,528,Netherlands,Indonesia,129575,57453,72122
2019,756,Switzerland,Indonesia,3785,1319,2466
2019,124,Canada,Indonesia,15208,6807,8401
2019,840,United States of America,Indonesia,112873,54853,58020
1990,516,Namibia,Iran (Islamic Republic of),45,27,18
1990,710,South Africa,Iran (Islamic Republic of),680,269,411
1990,818,Egypt,Iran (Islamic Republic of),134,73,61
1990,434,Libya,Iran (Islamic Republic of),383,211,172
1990,51,Armenia,Iran (Islamic Republic of),9654,4003,5651
1990,31,Azerbaijan,Iran (Islamic Republic of),2088,1263,825
1990,196,Cyprus,Iran (Islamic Republic of),299,189,110
1990,368,Iraq,Iran (Islamic Republic of),14976,9828,5148
1990,376,Israel,Iran (Islamic Republic of),47785,23622,24163
1990,400,Jordan,Iran (Islamic Republic of),119,46,73
1990,792,Turkey,Iran (Islamic Republic of),23816,13895,9921
1990,762,Tajikistan,Iran (Islamic Republic of),1813,796,1017
1990,795,Turkmenistan,Iran (Islamic Republic of),2699,1239,1460
1990,356,India,Iran (Islamic Republic of),3051,1535,1516
1990,586,Pakistan,Iran (Islamic Republic of),4108,2246,1862
1990,144,Sri Lanka,Iran (Islamic Republic of),1,1,0
1990,392,Japan,Iran (Islamic Republic of),1237,630,607
1990,608,Philippines,Iran (Islamic Republic of),212,159,53
1990,136,Cayman Islands,Iran (Islamic Republic of),2,2,0
1990,214,Dominican Republic,Iran (Islamic Republic of),70,64,6
1990,188,Costa Rica,Iran (Islamic Republic of),81,63,18
1990,222,El Salvador,Iran (Islamic Republic of),20,13,7
1990,320,Guatemala,Iran (Islamic Republic of),12,5,7
1990,484,Mexico,Iran (Islamic Republic of),58,46,12
1990,591,Panama,Iran (Islamic Republic of),31,24,7
1990,32,Argentina,Iran (Islamic Republic of),302,151,151
1990,68,Bolivia (Plurinational State of),Iran (Islamic Republic of),21,12,9
1990,152,Chile,Iran (Islamic Republic of),82,54,28
1990,170,Colombia,Iran (Islamic Republic of),61,33,28
1990,218,Ecuador,Iran (Islamic Republic of),64,45,19
1990,604,Peru,Iran (Islamic Republic of),34,24,10
1990,862,Venezuela (Bolivarian Republic of),Iran (Islamic Republic of),201,122,79
1990,36,Australia,Iran (Islamic Republic of),17599,9586,8013
1990,554,New Zealand,Iran (Islamic Republic of),394,216,178
1990,112,Belarus,Iran (Islamic Republic of),25,22,3
1990,100,Bulgaria,Iran (Islamic Republic of),98,86,12
1990,203,Czechia,Iran (Islamic Republic of),47,33,14
1990,348,Hungary,Iran (Islamic Republic of),1800,1125,675
1990,616,Poland,Iran (Islamic Republic of),197,145,52
1990,642,Romania,Iran (Islamic Republic of),853,717,136
1990,643,Russian Federation,Iran (Islamic Republic of),3096,1519,1577
1990,703,Slovakia,Iran (Islamic Republic of),11,10,1
1990,804,Ukraine,Iran (Islamic Republic of),2580,2070,510
1990,208,Denmark,Iran (Islamic Republic of),8022,5474,2548
1990,246,Finland,Iran (Islamic Republic of),558,378,180
1990,352,Iceland,Iran (Islamic Republic of),14,11,3
1990,372,Ireland,Iran (Islamic Republic of),85,56,29
1990,428,Latvia,Iran (Islamic Republic of),15,11,4
1990,440,Lithuania,Iran (Islamic Republic of),24,18,6
1990,578,Norway,Iran (Islamic Republic of),5198,3446,1752
1990,752,Sweden,Iran (Islamic Republic of),40154,22023,18131
1990,826,United Kingdom,Iran (Islamic Republic of),31563,18450,13113
1990,300,Greece,Iran (Islamic Republic of),2645,1618,1027
1990,380,Italy,Iran (Islamic Republic of),19096,10789,8307
1990,470,Malta,Iran (Islamic Republic of),9,6,3
1990,620,Portugal,Iran (Islamic Republic of),52,29,23
1990,688,Serbia,Iran (Islamic Republic of),7,7,0
1990,705,Slovenia,Iran (Islamic Republic of),8,4,4
1990,724,Spain,Iran (Islamic Republic of),1771,1068,703
1990,40,Austria,Iran (Islamic Republic of),8535,4827,3708
1990,56,Belgium,Iran (Islamic Republic of),3157,1854,1303
1990,250,France,Iran (Islamic Republic of),23359,12838,10521
1990,276,Germany,Iran (Islamic Republic of),95723,63328,32395
1990,442,Luxembourg,Iran (Islamic Republic of),224,115,109
1990,528,Netherlands,Iran (Islamic Republic of),5187,3100,2087
1990,756,Switzerland,Iran (Islamic Republic of),4686,2655,2031
1990,124,Canada,Iran (Islamic Republic of),29467,14346,15121
1990,840,United States of America,Iran (Islamic Republic of),210941,119568,91373
1995,516,Namibia,Iran (Islamic Republic of),43,26,17
1995,710,South Africa,Iran (Islamic Republic of),424,189,235
1995,818,Egypt,Iran (Islamic Republic of),118,66,52
1995,434,Libya,Iran (Islamic Republic of),340,207,133
1995,51,Armenia,Iran (Islamic Republic of),10242,4478,5764
1995,31,Azerbaijan,Iran (Islamic Republic of),1832,1152,680
1995,196,Cyprus,Iran (Islamic Republic of),423,261,162
1995,368,Iraq,Iran (Islamic Republic of),44953,25623,19330
1995,376,Israel,Iran (Islamic Republic of),51220,24963,26257
1995,400,Jordan,Iran (Islamic Republic of),117,52,65
1995,792,Turkey,Iran (Islamic Republic of),13188,8104,5084
1995,762,Tajikistan,Iran (Islamic Republic of),1473,753,720
1995,795,Turkmenistan,Iran (Islamic Republic of),2204,1119,1085
1995,356,India,Iran (Islamic Republic of),2569,1246,1323
1995,586,Pakistan,Iran (Islamic Republic of),3060,1685,1375
1995,144,Sri Lanka,Iran (Islamic Republic of),12,10,2
1995,392,Japan,Iran (Islamic Republic of),8764,4206,4558
1995,608,Philippines,Iran (Islamic Republic of),285,213,72
1995,764,Thailand,Iran (Islamic Republic of),9,5,4
1995,136,Cayman Islands,Iran (Islamic Republic of),6,5,1
1995,214,Dominican Republic,Iran (Islamic Republic of),78,71,7
1995,188,Costa Rica,Iran (Islamic Republic of),63,50,13
1995,222,El Salvador,Iran (Islamic Republic of),17,11,6
1995,320,Guatemala,Iran (Islamic Republic of),12,6,6
1995,484,Mexico,Iran (Islamic Republic of),150,115,35
1995,591,Panama,Iran (Islamic Republic of),45,36,9
1995,32,Argentina,Iran (Islamic Republic of),295,149,146
1995,68,Bolivia (Plurinational State of),Iran (Islamic Republic of),29,18,11
1995,152,Chile,Iran (Islamic Republic of),81,58,23
1995,170,Colombia,Iran (Islamic Republic of),74,47,27
1995,218,Ecuador,Iran (Islamic Republic of),72,51,21
1995,604,Peru,Iran (Islamic Republic of),35,24,11
1995,862,Venezuela (Bolivarian Republic of),Iran (Islamic Republic of),154,99,55
1995,36,Australia,Iran (Islamic Republic of),19260,10417,8843
1995,554,New Zealand,Iran (Islamic Republic of),732,424,308
1995,112,Belarus,Iran (Islamic Republic of),38,31,7
1995,100,Bulgaria,Iran (Islamic Republic of),127,105,22
1995,203,Czechia,Iran (Islamic Republic of),70,50,20
1995,348,Hungary,Iran (Islamic Republic of),1595,987,608
1995,616,Poland,Iran (Islamic Republic of),168,123,45
1995,642,Romania,Iran (Islamic Republic of),875,737,138
1995,643,Russian Federation,Iran (Islamic Republic of),2829,1591,1238
1995,703,Slovakia,Iran (Islamic Republic of),198,170,28
1995,804,Ukraine,Iran (Islamic Republic of),2496,2017,479
1995,208,Denmark,Iran (Islamic Republic of),9753,6222,3531
1995,246,Finland,Iran (Islamic Republic of),1160,738,422
1995,352,Iceland,Iran (Islamic Republic of),16,12,4
1995,372,Ireland,Iran (Islamic Republic of),237,154,83
1995,428,Latvia,Iran (Islamic Republic of),22,16,6
1995,440,Lithuania,Iran (Islamic Republic of),27,21,6
1995,578,Norway,Iran (Islamic Republic of),7055,4463,2592
1995,752,Sweden,Iran (Islamic Republic of),47650,25971,21679
1995,826,United Kingdom,Iran (Islamic Republic of),36022,20843,15179
1995,300,Greece,Iran (Islamic Republic of),1946,1222,724
1995,380,Italy,Iran (Islamic Republic of),14034,7969,6065
1995,470,Malta,Iran (Islamic Republic of),11,7,4
1995,620,Portugal,Iran (Islamic Republic of),113,63,50
1995,688,Serbia,Iran (Islamic Republic of),50,45,5
1995,705,Slovenia,Iran (Islamic Republic of),17,10,7
1995,724,Spain,Iran (Islamic Republic of),2159,1324,835
1995,40,Austria,Iran (Islamic Republic of),9629,5514,4115
1995,56,Belgium,Iran (Islamic Republic of),2480,1371,1109
1995,250,France,Iran (Islamic Republic of),24114,13070,11044
1995,276,Germany,Iran (Islamic Republic of),100027,61488,38539
1995,442,Luxembourg,Iran (Islamic Republic of),212,108,104
1995,528,Netherlands,Iran (Islamic Republic of),12357,7249,5108
1995,756,Switzerland,Iran (Islamic Republic of),5372,3105,2267
1995,124,Canada,Iran (Islamic Republic of),51266,24793,26473
1995,840,United States of America,Iran (Islamic Republic of),250390,142340,108050
2000,516,Namibia,Iran (Islamic Republic of),41,24,17
2000,710,South Africa,Iran (Islamic Republic of),295,157,138
2000,818,Egypt,Iran (Islamic Republic of),111,63,48
2000,434,Libya,Iran (Islamic Republic of),303,209,94
2000,51,Armenia,Iran (Islamic Republic of),11205,5047,6158
2000,31,Azerbaijan,Iran (Islamic Republic of),1846,1151,695
2000,196,Cyprus,Iran (Islamic Republic of),547,333,214
2000,268,Georgia,Iran (Islamic Republic of),120,67,53
2000,368,Iraq,Iran (Islamic Republic of),42602,19779,22823
2000,376,Israel,Iran (Islamic Republic of),51786,25188,26598
2000,400,Jordan,Iran (Islamic Republic of),115,58,57
2000,792,Turkey,Iran (Islamic Republic of),13427,8274,5153
2000,762,Tajikistan,Iran (Islamic Republic of),1267,662,605
2000,795,Turkmenistan,Iran (Islamic Republic of),1786,880,906
2000,356,India,Iran (Islamic Republic of),2086,957,1129
2000,586,Pakistan,Iran (Islamic Republic of),2940,1620,1320
2000,144,Sri Lanka,Iran (Islamic Republic of),25,19,6
2000,392,Japan,Iran (Islamic Republic of),6167,2849,3318
2000,608,Philippines,Iran (Islamic Republic of),975,426,549
2000,764,Thailand,Iran (Islamic Republic of),21,11,10
2000,136,Cayman Islands,Iran (Islamic Republic of),11,8,3
2000,214,Dominican Republic,Iran (Islamic Republic of),85,77,8
2000,188,Costa Rica,Iran (Islamic Republic of),77,63,14
2000,222,El Salvador,Iran (Islamic Republic of),14,9,5
2000,320,Guatemala,Iran (Islamic Republic of),12,7,5
2000,484,Mexico,Iran (Islamic Republic of),249,189,60
2000,591,Panama,Iran (Islamic Republic of),62,49,13
2000,32,Argentina,Iran (Islamic Republic of),288,147,141
2000,68,Bolivia (Plurinational State of),Iran (Islamic Republic of),36,24,12
2000,152,Chile,Iran (Islamic Republic of),80,57,23
2000,170,Colombia,Iran (Islamic Republic of),87,61,26
2000,218,Ecuador,Iran (Islamic Republic of),80,57,23
2000,604,Peru,Iran (Islamic Republic of),42,29,13
2000,862,Venezuela (Bolivarian Republic of),Iran (Islamic Republic of),118,80,38
2000,36,Australia,Iran (Islamic Republic of),21360,11580,9780
2000,554,New Zealand,Iran (Islamic Republic of),1925,937,988
2000,112,Belarus,Iran (Islamic Republic of),51,41,10
2000,100,Bulgaria,Iran (Islamic Republic of),155,123,32
2000,203,Czechia,Iran (Islamic Republic of),93,67,26
2000,348,Hungary,Iran (Islamic Republic of),1389,849,540
2000,616,Poland,Iran (Islamic Republic of),144,105,39
2000,642,Romania,Iran (Islamic Republic of),899,757,142
2000,643,Russian Federation,Iran (Islamic Republic of),2461,1607,854
2000,703,Slovakia,Iran (Islamic Republic of),93,64,29
2000,804,Ukraine,Iran (Islamic Republic of),2443,1988,455
2000,208,Denmark,Iran (Islamic Republic of),11483,6970,4513
2000,246,Finland,Iran (Islamic Republic of),1762,1099,663
2000,352,Iceland,Iran (Islamic Republic of),18,14,4
2000,372,Ireland,Iran (Islamic Republic of),519,344,175
2000,428,Latvia,Iran (Islamic Republic of),30,22,8
2000,440,Lithuania,Iran (Islamic Republic of),21,17,4
2000,578,Norway,Iran (Islamic Republic of),8857,5212,3645
2000,752,Sweden,Iran (Islamic Republic of),51101,27700,23401
2000,826,United Kingdom,Iran (Islamic Republic of),41087,23547,17540
2000,300,Greece,Iran (Islamic Republic of),1279,833,446
2000,380,Italy,Iran (Islamic Republic of),8971,5148,3823
2000,470,Malta,Iran (Islamic Republic of),13,9,4
2000,620,Portugal,Iran (Islamic Republic of),179,100,79
2000,688,Serbia,Iran (Islamic Republic of),68,61,7
2000,705,Slovenia,Iran (Islamic Republic of),30,15,15
2000,724,Spain,Iran (Islamic Republic of),3477,2172,1305
2000,40,Austria,Iran (Islamic Republic of),10723,6201,4522
2000,56,Belgium,Iran (Islamic Republic of),1731,850,881
2000,250,France,Iran (Islamic Republic of),24869,13302,11567
2000,276,Germany,Iran (Islamic Republic of),104331,59649,44682
2000,442,Luxembourg,Iran (Islamic Republic of),204,104,100
2000,528,Netherlands,Iran (Islamic Republic of),19921,11614,8307
2000,756,Switzerland,Iran (Islamic Republic of),6078,3572,2506
2000,124,Canada,Iran (Islamic Republic of),74284,35835,38449
2000,840,United States of America,Iran (Islamic Republic of),290417,165592,124825
2005,516,Namibia,Iran (Islamic Republic of),32,19,13
2005,710,South Africa,Iran (Islamic Republic of),389,198,191
2005,818,Egypt,Iran (Islamic Republic of),132,78,54
2005,434,Libya,Iran (Islamic Republic of),333,249,84
2005,51,Armenia,Iran (Islamic Republic of),7411,3471,3940
2005,31,Azerbaijan,Iran (Islamic Republic of),1752,1072,680
2005,196,Cyprus,Iran (Islamic Republic of),801,486,315
2005,268,Georgia,Iran (Islamic Republic of),113,63,50
2005,368,Iraq,Iran (Islamic Republic of),17396,8077,9319
2005,376,Israel,Iran (Islamic Republic of),50950,24796,26154
2005,400,Jordan,Iran (Islamic Republic of),166,94,72
2005,792,Turkey,Iran (Islamic Republic of),14397,8760,5637
2005,762,Tajikistan,Iran (Islamic Republic of),1221,644,577
2005,795,Turkmenistan,Iran (Islamic Republic of),1771,882,889
2005,356,India,Iran (Islamic Republic of),1928,882,1046
2005,586,Pakistan,Iran (Islamic Republic of),2381,1319,1062
2005,144,Sri Lanka,Iran (Islamic Republic of),51,32,19
2005,392,Japan,Iran (Islamic Republic of),4566,2080,2486
2005,608,Philippines,Iran (Islamic Republic of),789,352,437
2005,764,Thailand,Iran (Islamic Republic of),16,9,7
2005,136,Cayman Islands,Iran (Islamic Republic of),10,7,3
2005,214,Dominican Republic,Iran (Islamic Republic of),57,50,7
2005,188,Costa Rica,Iran (Islamic Republic of),50,40,10
2005,222,El Salvador,Iran (Islamic Republic of),16,10,6
2005,320,Guatemala,Iran (Islamic Republic of),14,9,5
2005,484,Mexico,Iran (Islamic Republic of),246,175,71
2005,591,Panama,Iran (Islamic Republic of),65,50,15
2005,32,Argentina,Iran (Islamic Republic of),213,111,102
2005,68,Bolivia (Plurinational State of),Iran (Islamic Republic of),45,29,16
2005,76,Brazil,Iran (Islamic Republic of),265,140,125
2005,152,Chile,Iran (Islamic Republic of),120,87,33
2005,170,Colombia,Iran (Islamic Republic of),91,66,25
2005,218,Ecuador,Iran (Islamic Republic of),94,68,26
2005,604,Peru,Iran (Islamic Republic of),50,34,16
2005,862,Venezuela (Bolivarian Republic of),Iran (Islamic Republic of),105,68,37
2005,36,Australia,Iran (Islamic Republic of),26720,14182,12538
2005,554,New Zealand,Iran (Islamic Republic of),2671,1297,1374
2005,112,Belarus,Iran (Islamic Republic of),49,39,10
2005,100,Bulgaria,Iran (Islamic Republic of),208,162,46
2005,203,Czechia,Iran (Islamic Republic of),212,150,62
2005,348,Hungary,Iran (Islamic Republic of),1716,1061,655
2005,616,Poland,Iran (Islamic Republic of),188,134,54
2005,642,Romania,Iran (Islamic Republic of),937,788,149
2005,643,Russian Federation,Iran (Islamic Republic of),2240,1465,775
2005,703,Slovakia,Iran (Islamic Republic of),206,168,38
2005,804,Ukraine,Iran (Islamic Republic of),2232,1817,415
2005,208,Denmark,Iran (Islamic Republic of),12029,7125,4904
2005,246,Finland,Iran (Islamic Republic of),3040,1799,1241
2005,352,Iceland,Iran (Islamic Republic of),27,18,9
2005,372,Ireland,Iran (Islamic Republic of),520,355,165
2005,428,Latvia,Iran (Islamic Republic of),34,27,7
2005,440,Lithuania,Iran (Islamic Republic of),55,47,8
2005,578,Norway,Iran (Islamic Republic of),11637,6548,5089
2005,752,Sweden,Iran (Islamic Republic of),54470,29045,25425
2005,826,United Kingdom,Iran (Islamic Republic of),58694,34449,24245
2005,191,Croatia,Iran (Islamic Republic of),24,13,11
2005,300,Greece,Iran (Islamic Republic of),1613,1129,484
2005,380,Italy,Iran (Islamic Republic of),11701,6588,5113
2005,470,Malta,Iran (Islamic Republic of),17,11,6
2005,620,Portugal,Iran (Islamic Republic of),195,108,87
2005,688,Serbia,Iran (Islamic Republic of),68,61,7
2005,705,Slovenia,Iran (Islamic Republic of),31,19,12
2005,724,Spain,Iran (Islamic Republic of),4212,2560,1652
2005,40,Austria,Iran (Islamic Republic of),11986,6811,5175
2005,56,Belgium,Iran (Islamic Republic of),4445,2451,1994
2005,250,France,Iran (Islamic Republic of),20643,10849,9794
2005,276,Germany,Iran (Islamic Republic of),108310,62264,46046
2005,442,Luxembourg,Iran (Islamic Republic of),177,96,81
2005,528,Netherlands,Iran (Islamic Republic of),24051,13552,10499
2005,756,Switzerland,Iran (Islamic Republic of),6953,3920,3033
2005,124,Canada,Iran (Islamic Republic of),95395,47899,47496
2005,840,United States of America,Iran (Islamic Republic of),314199,179899,134300
2010,516,Namibia,Iran (Islamic Republic of),30,18,12
2010,710,South Africa,Iran (Islamic Republic of),608,309,299
2010,818,Egypt,Iran (Islamic Republic of),142,82,60
2010,434,Libya,Iran (Islamic Republic of),365,274,91
2010,51,Armenia,Iran (Islamic Republic of),6172,3001,3171
2010,31,Azerbaijan,Iran (Islamic Republic of),1604,1004,600
2010,196,Cyprus,Iran (Islamic Republic of),1311,802,509
2010,268,Georgia,Iran (Islamic Republic of),114,64,50
2010,368,Iraq,Iran (Islamic Republic of),17568,8720,8848
2010,376,Israel,Iran (Islamic Republic of),50732,24651,26081
2010,400,Jordan,Iran (Islamic Republic of),214,127,87
2010,792,Turkey,Iran (Islamic Republic of),14728,8898,5830
2010,887,Yemen,Iran (Islamic Republic of),10,6,4
2010,762,Tajikistan,Iran (Islamic Republic of),1218,645,573
2010,795,Turkmenistan,Iran (Islamic Republic of),1718,823,895
2010,356,India,Iran (Islamic Republic of),1769,807,962
2010,586,Pakistan,Iran (Islamic Republic of),2345,1297,1048
2010,144,Sri Lanka,Iran (Islamic Republic of),103,65,38
2010,392,Japan,Iran (Islamic Republic of),4841,2177,2664
2010,608,Philippines,Iran (Islamic Republic of),577,245,332
2010,764,Thailand,Iran (Islamic Republic of),13,7,6
2010,136,Cayman Islands,Iran (Islamic Republic of),10,6,4
2010,214,Dominican Republic,Iran (Islamic Republic of),29,23,6
2010,188,Costa Rica,Iran (Islamic Republic of),99,80,19
2010,222,El Salvador,Iran (Islamic Republic of),17,11,6
2010,320,Guatemala,Iran (Islamic Republic of),16,11,5
2010,484,Mexico,Iran (Islamic Republic of),273,181,92
2010,591,Panama,Iran (Islamic Republic of),73,55,18
2010,32,Argentina,Iran (Islamic Republic of),137,74,63
2010,68,Bolivia (Plurinational State of),Iran (Islamic Republic of),53,33,20
2010,76,Brazil,Iran (Islamic Republic of),530,280,250
2010,152,Chile,Iran (Islamic Republic of),160,116,44
2010,170,Colombia,Iran (Islamic Republic of),110,82,28
2010,218,Ecuador,Iran (Islamic Republic of),132,94,38
2010,604,Peru,Iran (Islamic Republic of),55,38,17
2010,862,Venezuela (Bolivarian Republic of),Iran (Islamic Republic of),98,61,37
2010,36,Australia,Iran (Islamic Republic of),36480,19386,17094
2010,554,New Zealand,Iran (Islamic Republic of),2959,1434,1525
2010,520,Nauru,Iran (Islamic Republic of),31,23,8
2010,112,Belarus,Iran (Islamic Republic of),47,37,10
2010,100,Bulgaria,Iran (Islamic Republic of),252,194,58
2010,203,Czechia,Iran (Islamic Republic of),310,221,89
2010,348,Hungary,Iran (Islamic Republic of),2043,1273,770
2010,616,Poland,Iran (Islamic Republic of),239,166,73
2010,642,Romania,Iran (Islamic Republic of),1144,961,183
2010,643,Russian Federation,Iran (Islamic Republic of),1974,1293,681
2010,703,Slovakia,Iran (Islamic Republic of),104,79,25
2010,804,Ukraine,Iran (Islamic Republic of),2129,1734,395
2010,208,Denmark,Iran (Islamic Republic of),12352,7154,5198
2010,233,Estonia,Iran (Islamic Republic of),28,23,5
2010,246,Finland,Iran (Islamic Republic of),5101,2775,2326
2010,352,Iceland,Iran (Islamic Republic of),35,21,14
2010,372,Ireland,Iran (Islamic Republic of),436,287,149
2010,428,Latvia,Iran (Islamic Republic of),38,32,6
2010,440,Lithuania,Iran (Islamic Republic of),82,69,13
2010,578,Norway,Iran (Islamic Republic of),13086,7251,5835
2010,752,Sweden,Iran (Islamic Republic of),62120,32688,29432
2010,826,United Kingdom,Iran (Islamic Republic of),61831,36815,25016
2010,191,Croatia,Iran (Islamic Republic of),48,27,21
2010,300,Greece,Iran (Islamic Republic of),2025,1483,542
2010,380,Italy,Iran (Islamic Republic of),14360,8091,6269
2010,470,Malta,Iran (Islamic Republic of),24,12,12
2010,620,Portugal,Iran (Islamic Republic of),180,99,81
2010,688,Serbia,Iran (Islamic Republic of),67,60,7
2010,705,Slovenia,Iran (Islamic Republic of),54,35,19
2010,724,Spain,Iran (Islamic Republic of),4920,3027,1893
2010,40,Austria,Iran (Islamic Republic of),13249,7421,5828
2010,56,Belgium,Iran (Islamic Republic of),8569,4807,3762
2010,250,France,Iran (Islamic Republic of),21399,11223,10176
2010,276,Germany,Iran (Islamic Republic of),111268,64102,47166
2010,442,Luxembourg,Iran (Islamic Republic of),152,89,63
2010,528,Netherlands,Iran (Islamic Republic of),25486,14036,11450
2010,756,Switzerland,Iran (Islamic Republic of),8030,4351,3679
2010,124,Canada,Iran (Islamic Republic of),120685,62170,58515
2010,840,United States of America,Iran (Islamic Republic of),348249,182256,165993
2015,516,Namibia,Iran (Islamic Republic of),29,18,11
2015,710,South Africa,Iran (Islamic Republic of),1096,530,566
2015,818,Egypt,Iran (Islamic Republic of),105,67,38
2015,434,Libya,Iran (Islamic Republic of),411,307,104
2015,51,Armenia,Iran (Islamic Republic of),8135,3956,4179
2015,31,Azerbaijan,Iran (Islamic Republic of),1530,970,560
2015,196,Cyprus,Iran (Islamic Republic of),1259,774,485
2015,268,Georgia,Iran (Islamic Republic of),119,67,52
2015,368,Iraq,Iran (Islamic Republic of),14406,8252,6154
2015,376,Israel,Iran (Islamic Republic of),52322,25292,27030
2015,400,Jordan,Iran (Islamic Republic of),91,45,46
2015,792,Turkey,Iran (Islamic Republic of),39332,23600,15732
2015,887,Yemen,Iran (Islamic Republic of),7,4,3
2015,762,Tajikistan,Iran (Islamic Republic of),1197,630,567
2015,795,Turkmenistan,Iran (Islamic Republic of),1904,930,974
2015,356,India,Iran (Islamic Republic of),1704,777,927
2015,586,Pakistan,Iran (Islamic Republic of),2301,1272,1029
2015,144,Sri Lanka,Iran (Islamic Republic of),104,65,39
2015,392,Japan,Iran (Islamic Republic of),4359,1944,2415
2015,608,Philippines,Iran (Islamic Republic of),586,250,336
2015,764,Thailand,Iran (Islamic Republic of),14,8,6
2015,136,Cayman Islands,Iran (Islamic Republic of),9,6,3
2015,214,Dominican Republic,Iran (Islamic Republic of),30,24,6
2015,188,Costa Rica,Iran (Islamic Republic of),100,81,19
2015,222,El Salvador,Iran (Islamic Republic of),18,12,6
2015,320,Guatemala,Iran (Islamic Republic of),18,12,6
2015,484,Mexico,Iran (Islamic Republic of),289,191,98
2015,591,Panama,Iran (Islamic Republic of),86,64,22
2015,32,Argentina,Iran (Islamic Republic of),137,74,63
2015,68,Bolivia (Plurinational State of),Iran (Islamic Republic of),62,39,23
2015,76,Brazil,Iran (Islamic Republic of),638,337,301
2015,152,Chile,Iran (Islamic Republic of),242,175,67
2015,170,Colombia,Iran (Islamic Republic of),123,92,31
2015,218,Ecuador,Iran (Islamic Republic of),192,137,55
2015,604,Peru,Iran (Islamic Republic of),59,41,18
2015,862,Venezuela (Bolivarian Republic of),Iran (Islamic Republic of),90,56,34
2015,36,Australia,Iran (Islamic Republic of),61690,32733,28957
2015,554,New Zealand,Iran (Islamic Republic of),3201,1548,1653
2015,520,Nauru,Iran (Islamic Republic of),372,274,98
2015,112,Belarus,Iran (Islamic Republic of),49,39,10
2015,100,Bulgaria,Iran (Islamic Republic of),346,253,93
2015,203,Czechia,Iran (Islamic Republic of),502,322,180
2015,348,Hungary,Iran (Islamic Republic of),2135,1311,824
2015,616,Poland,Iran (Islamic Republic of),230,161,69
2015,642,Romania,Iran (Islamic Republic of),1261,1051,210
2015,643,Russian Federation,Iran (Islamic Republic of),2012,1315,697
2015,703,Slovakia,Iran (Islamic Republic of),130,99,31
2015,804,Ukraine,Iran (Islamic Republic of),2136,1741,395
2015,208,Denmark,Iran (Islamic Republic of),14689,8601,6088
2015,233,Estonia,Iran (Islamic Republic of),75,56,19
2015,246,Finland,Iran (Islamic Republic of),7225,3908,3317
2015,352,Iceland,Iran (Islamic Republic of),63,40,23
2015,372,Ireland,Iran (Islamic Republic of),445,291,154
2015,428,Latvia,Iran (Islamic Republic of),35,22,13
2015,440,Lithuania,Iran (Islamic Republic of),121,91,30
2015,578,Norway,Iran (Islamic Republic of),16222,8730,7492
2015,752,Sweden,Iran (Islamic Republic of),69067,35941,33126
2015,826,United Kingdom,Iran (Islamic Republic of),79072,46132,32940
2015,191,Croatia,Iran (Islamic Republic of),48,27,21
2015,300,Greece,Iran (Islamic Republic of),1900,1370,530
2015,380,Italy,Iran (Islamic Republic of),14925,8201,6724
2015,470,Malta,Iran (Islamic Republic of),41,22,19
2015,620,Portugal,Iran (Islamic Republic of),203,108,95
2015,688,Serbia,Iran (Islamic Republic of),65,59,6
2015,705,Slovenia,Iran (Islamic Republic of),89,61,28
2015,724,Spain,Iran (Islamic Republic of),5888,3436,2452
2015,40,Austria,Iran (Islamic Republic of),15495,8716,6779
2015,56,Belgium,Iran (Islamic Republic of),10554,5912,4642
2015,250,France,Iran (Islamic Republic of),23705,12124,11581
2015,276,Germany,Iran (Islamic Republic of),115936,66676,49260
2015,442,Luxembourg,Iran (Islamic Republic of),231,137,94
2015,528,Netherlands,Iran (Islamic Republic of),29405,15973,13432
2015,756,Switzerland,Iran (Islamic Republic of),11562,6212,5350
2015,124,Canada,Iran (Islamic Republic of),153473,77453,76020
2015,840,United States of America,Iran (Islamic Republic of),394223,204887,189336
2019,516,Namibia,Iran (Islamic Republic of),30,19,11
2019,710,South Africa,Iran (Islamic Republic of),1228,596,632
2019,818,Egypt,Iran (Islamic Republic of),149,89,60
2019,434,Libya,Iran (Islamic Republic of),436,326,110
2019,51,Armenia,Iran (Islamic Republic of),8090,3970,4120
2019,31,Azerbaijan,Iran (Islamic Republic of),1470,932,538
2019,196,Cyprus,Iran (Islamic Republic of),1258,779,479
2019,268,Georgia,Iran (Islamic Republic of),122,69,53
2019,368,Iraq,Iran (Islamic Republic of),14753,8451,6302
2019,376,Israel,Iran (Islamic Republic of),50881,24596,26285
2019,400,Jordan,Iran (Islamic Republic of),97,48,49
2019,792,Turkey,Iran (Islamic Republic of),83183,47122,36061
2019,887,Yemen,Iran (Islamic Republic of),7,4,3
2019,762,Tajikistan,Iran (Islamic Republic of),1192,628,564
2019,795,Turkmenistan,Iran (Islamic Republic of),1891,936,955
2019,356,India,Iran (Islamic Republic of),1675,764,911
2019,586,Pakistan,Iran (Islamic Republic of),2137,1181,956
2019,144,Sri Lanka,Iran (Islamic Republic of),104,65,39
2019,392,Japan,Iran (Islamic Republic of),4879,2176,2703
2019,608,Philippines,Iran (Islamic Republic of),604,258,346
2019,764,Thailand,Iran (Islamic Republic of),14,8,6
2019,136,Cayman Islands,Iran (Islamic Republic of),10,7,3
2019,214,Dominican Republic,Iran (Islamic Republic of),31,25,6
2019,188,Costa Rica,Iran (Islamic Republic of),101,82,19
2019,222,El Salvador,Iran (Islamic Republic of),18,12,6
2019,320,Guatemala,Iran (Islamic Republic of),18,12,6
2019,484,Mexico,Iran (Islamic Republic of),297,196,101
2019,591,Panama,Iran (Islamic Republic of),87,67,20
2019,32,Argentina,Iran (Islamic Republic of),139,75,64
2019,68,Bolivia (Plurinational State of),Iran (Islamic Republic of),67,42,25
2019,76,Brazil,Iran (Islamic Republic of),718,380,338
2019,152,Chile,Iran (Islamic Republic of),323,229,94
2019,170,Colombia,Iran (Islamic Republic of),125,94,31
2019,218,Ecuador,Iran (Islamic Republic of),189,135,54
2019,604,Peru,Iran (Islamic Republic of),69,49,20
2019,862,Venezuela (Bolivarian Republic of),Iran (Islamic Republic of),88,55,33
2019,36,Australia,Iran (Islamic Republic of),73002,39957,33045
2019,554,New Zealand,Iran (Islamic Republic of),3290,1591,1699
2019,520,Nauru,Iran (Islamic Republic of),342,253,89
2019,112,Belarus,Iran (Islamic Republic of),48,39,9
2019,100,Bulgaria,Iran (Islamic Republic of),455,322,133
2019,203,Czechia,Iran (Islamic Republic of),629,381,248
2019,348,Hungary,Iran (Islamic Republic of),2842,1652,1190
2019,616,Poland,Iran (Islamic Republic of),243,173,70
2019,642,Romania,Iran (Islamic Republic of),1605,1288,317
2019,643,Russian Federation,Iran (Islamic Republic of),2011,1315,696
2019,703,Slovakia,Iran (Islamic Republic of),152,115,37
2019,804,Ukraine,Iran (Islamic Republic of),2157,1759,398
2019,208,Denmark,Iran (Islamic Republic of),17716,10193,7523
2019,233,Estonia,Iran (Islamic Republic of),115,83,32
2019,246,Finland,Iran (Islamic Republic of),9137,4985,4152
2019,352,Iceland,Iran (Islamic Republic of),114,74,40
2019,372,Ireland,Iran (Islamic Republic of),488,320,168
2019,428,Latvia,Iran (Islamic Republic of),33,20,13
2019,440,Lithuania,Iran (Islamic Republic of),129,97,32
2019,578,Norway,Iran (Islamic Republic of),18707,9948,8759
2019,752,Sweden,Iran (Islamic Republic of),79308,41926,37382
2019,826,United Kingdom,Iran (Islamic Republic of),89794,52482,37312
2019,191,Croatia,Iran (Islamic Republic of),44,25,19
2019,300,Greece,Iran (Islamic Republic of),2199,1073,1126
2019,380,Italy,Iran (Islamic Republic of),17059,9317,7742
2019,470,Malta,Iran (Islamic Republic of),66,36,30
2019,620,Portugal,Iran (Islamic Republic of),657,365,292
2019,688,Serbia,Iran (Islamic Republic of),66,60,6
2019,705,Slovenia,Iran (Islamic Republic of),125,82,43
2019,724,Spain,Iran (Islamic Republic of),6100,3499,2601
2019,40,Austria,Iran (Islamic Republic of),18291,10427,7864
2019,56,Belgium,Iran (Islamic Republic of),11399,6351,5048
2019,250,France,Iran (Islamic Republic of),25091,12805,12286
2019,276,Germany,Iran (Islamic Republic of),127177,76901,50276
2019,442,Luxembourg,Iran (Islamic Republic of),1089,609,480
2019,528,Netherlands,Iran (Islamic Republic of),33819,18568,15251
2019,756,Switzerland,Iran (Islamic Republic of),12998,6947,6051
2019,124,Canada,Iran (Islamic Republic of),164463,82999,81464
2019,840,United States of America,Iran (Islamic Republic of),403136,209154,193982
1990,710,South Africa,Iraq,142,106,36
1990,478,Mauritania,Iraq,77,33,44
1990,12,Algeria,Iraq,918,355,563
1990,818,Egypt,Iraq,1359,489,870
1990,434,Libya,Iraq,3879,1412,2467
1990,504,Morocco,Iraq,1171,620,551
1990,196,Cyprus,Iraq,78,54,24
1990,376,Israel,Iraq,74502,37111,37391
1990,400,Jordan,Iraq,25773,15543,10230
1990,422,Lebanon,Iraq,11774,7101,4673
1990,512,Oman,Iraq,118,66,52
1990,682,Saudi Arabia,Iraq,42857,21581,21276
1990,760,Syrian Arab Republic,Iraq,3825,1932,1893
1990,792,Turkey,Iraq,33620,18174,15446
1990,887,Yemen,Iraq,4943,2743,2200
1990,762,Tajikistan,Iraq,97,43,54
1990,356,India,Iraq,1189,521,668
1990,364,Iran (Islamic Republic of),Iraq,1153969,660582,493387
1990,586,Pakistan,Iraq,894,459,435
1990,458,Malaysia,Iraq,32,18,14
1990,608,Philippines,Iraq,18,17,1
1990,214,Dominican Republic,Iraq,6,6,0
1990,188,Costa Rica,Iraq,10,7,3
1990,484,Mexico,Iraq,23,0,23
1990,32,Argentina,Iraq,81,32,49
1990,68,Bolivia (Plurinational State of),Iraq,2,2,0
1990,152,Chile,Iraq,22,14,8
1990,170,Colombia,Iraq,56,35,21
1990,218,Ecuador,Iraq,12,11,1
1990,604,Peru,Iraq,10,9,1
1990,862,Venezuela (Bolivarian Republic of),Iraq,68,47,21
1990,36,Australia,Iraq,5202,2844,2358
1990,554,New Zealand,Iraq,967,529,438
1990,100,Bulgaria,Iraq,171,118,53
1990,203,Czechia,Iraq,65,52,13
1990,348,Hungary,Iraq,732,504,228
1990,616,Poland,Iraq,562,486,76
1990,642,Romania,Iraq,299,218,81
1990,643,Russian Federation,Iraq,1424,699,725
1990,703,Slovakia,Iraq,10,9,1
1990,208,Denmark,Iraq,2418,1703,715
1990,246,Finland,Iraq,206,133,73
1990,352,Iceland,Iraq,2,1,1
1990,372,Ireland,Iraq,87,54,33
1990,428,Latvia,Iraq,3,2,1
1990,578,Norway,Iraq,738,536,202
1990,752,Sweden,Iraq,38795,22101,16694
1990,826,United Kingdom,Iraq,15166,9161,6005
1990,300,Greece,Iraq,6631,4355,2276
1990,380,Italy,Iraq,176,61,115
1990,470,Malta,Iraq,32,21,11
1990,620,Portugal,Iraq,16,10,6
1990,688,Serbia,Iraq,21,14,7
1990,705,Slovenia,Iraq,12,6,6
1990,724,Spain,Iraq,638,413,225
1990,40,Austria,Iraq,3043,1897,1146
1990,56,Belgium,Iraq,70,35,35
1990,250,France,Iraq,4614,2681,1933
1990,276,Germany,Iraq,6844,5201,1643
1990,528,Netherlands,Iraq,1151,744,407
1990,756,Switzerland,Iraq,3291,2298,993
1990,124,Canada,Iraq,6875,3346,3529
1990,840,United States of America,Iraq,44916,25595,19321
1995,710,South Africa,Iraq,88,68,20
1995,478,Mauritania,Iraq,82,40,42
1995,12,Algeria,Iraq,4249,2064,2185
1995,818,Egypt,Iraq,4401,2007,2394
1995,434,Libya,Iraq,26910,15858,11052
1995,504,Morocco,Iraq,1075,561,514
1995,196,Cyprus,Iraq,111,75,36
1995,376,Israel,Iraq,77265,37760,39505
1995,400,Jordan,Iraq,40831,24550,16281
1995,422,Lebanon,Iraq,18572,10685,7887
1995,512,Oman,Iraq,1361,753,608
1995,682,Saudi Arabia,Iraq,33020,17505,15515
1995,760,Syrian Arab Republic,Iraq,3036,1528,1508
1995,792,Turkey,Iraq,21033,11614,9419
1995,887,Yemen,Iraq,5140,3054,2086
1995,762,Tajikistan,Iraq,78,40,38
1995,356,India,Iraq,900,408,492
1995,364,Iran (Islamic Republic of),Iraq,833700,477247,356453
1995,586,Pakistan,Iraq,466,240,226
1995,144,Sri Lanka,Iraq,4,4,0
1995,458,Malaysia,Iraq,72,42,30
1995,608,Philippines,Iraq,24,23,1
1995,764,Thailand,Iraq,16,8,8
1995,214,Dominican Republic,Iraq,7,7,0
1995,188,Costa Rica,Iraq,8,5,3
1995,484,Mexico,Iraq,40,19,21
1995,32,Argentina,Iraq,79,31,48
1995,68,Bolivia (Plurinational State of),Iraq,4,3,1
1995,152,Chile,Iraq,22,20,2
1995,170,Colombia,Iraq,44,28,16
1995,218,Ecuador,Iraq,14,13,1
1995,604,Peru,Iraq,11,9,2
1995,862,Venezuela (Bolivarian Republic of),Iraq,67,47,20
1995,36,Australia,Iraq,16334,9114,7220
1995,554,New Zealand,Iraq,1795,1038,757
1995,100,Bulgaria,Iraq,265,195,70
1995,203,Czechia,Iraq,98,79,19
1995,348,Hungary,Iraq,649,444,205
1995,616,Poland,Iraq,480,414,66
1995,642,Romania,Iraq,638,466,172
1995,643,Russian Federation,Iraq,1213,732,481
1995,703,Slovakia,Iraq,25,22,3
1995,208,Denmark,Iraq,7703,4646,3057
1995,246,Finland,Iraq,1453,856,597
1995,352,Iceland,Iraq,9,6,3
1995,372,Ireland,Iraq,241,146,95
1995,428,Latvia,Iraq,4,3,1
1995,578,Norway,Iraq,2376,1551,825
1995,752,Sweden,Iraq,46038,26077,19961
1995,826,United Kingdom,Iraq,22970,14130,8840
1995,300,Greece,Iraq,6698,4545,2153
1995,380,Italy,Iraq,837,544,293
1995,470,Malta,Iraq,38,25,13
1995,620,Portugal,Iraq,34,21,13
1995,688,Serbia,Iraq,137,91,46
1995,705,Slovenia,Iraq,25,17,8
1995,724,Spain,Iraq,786,508,278
1995,40,Austria,Iraq,3433,2161,1272
1995,56,Belgium,Iraq,59,30,29
1995,250,France,Iraq,4763,2734,2029
1995,276,Germany,Iraq,32864,21751,11113
1995,528,Netherlands,Iraq,15178,9623,5555
1995,756,Switzerland,Iraq,4104,2826,1278
1995,124,Canada,Iraq,16443,7946,8497
1995,840,United States of America,Iraq,68305,39244,29061
2000,710,South Africa,Iraq,68,54,14
2000,478,Mauritania,Iraq,84,46,38
2000,12,Algeria,Iraq,7579,3772,3807
2000,818,Egypt,Iraq,7793,3686,4107
2000,434,Libya,Iraq,50384,30826,19558
2000,504,Morocco,Iraq,1133,582,551
2000,788,Tunisia,Iraq,11,6,5
2000,51,Armenia,Iraq,2,1,1
2000,196,Cyprus,Iraq,143,96,47
2000,376,Israel,Iraq,75702,36719,38983
2000,400,Jordan,Iraq,55884,33648,22236
2000,422,Lebanon,Iraq,25369,14269,11100
2000,512,Oman,Iraq,2223,1296,927
2000,682,Saudi Arabia,Iraq,10177,5470,4707
2000,760,Syrian Arab Republic,Iraq,1829,924,905
2000,792,Turkey,Iraq,8922,5308,3614
2000,887,Yemen,Iraq,5389,2898,2491
2000,762,Tajikistan,Iraq,68,36,32
2000,356,India,Iraq,610,294,316
2000,364,Iran (Islamic Republic of),Iraq,540400,309350,231050
2000,586,Pakistan,Iraq,586,310,276
2000,144,Sri Lanka,Iraq,9,7,2
2000,458,Malaysia,Iraq,138,81,57
2000,608,Philippines,Iraq,24,24,0
2000,764,Thailand,Iraq,36,18,18
2000,214,Dominican Republic,Iraq,7,7,0
2000,188,Costa Rica,Iraq,11,7,4
2000,484,Mexico,Iraq,60,40,20
2000,32,Argentina,Iraq,77,31,46
2000,68,Bolivia (Plurinational State of),Iraq,5,3,2
2000,152,Chile,Iraq,22,19,3
2000,170,Colombia,Iraq,32,21,11
2000,218,Ecuador,Iraq,15,14,1
2000,604,Peru,Iraq,14,11,3
2000,862,Venezuela (Bolivarian Republic of),Iraq,66,46,20
2000,36,Australia,Iraq,26480,14856,11624
2000,554,New Zealand,Iraq,4717,2294,2423
2000,100,Bulgaria,Iraq,358,271,87
2000,203,Czechia,Iraq,131,107,24
2000,348,Hungary,Iraq,565,383,182
2000,616,Poland,Iraq,410,352,58
2000,642,Romania,Iraq,998,729,269
2000,643,Russian Federation,Iraq,959,738,221
2000,703,Slovakia,Iraq,49,41,8
2000,208,Denmark,Iraq,12988,7589,5399
2000,246,Finland,Iraq,2699,1578,1121
2000,352,Iceland,Iraq,15,10,5
2000,372,Ireland,Iraq,528,326,202
2000,428,Latvia,Iraq,5,3,2
2000,578,Norway,Iraq,6941,4345,2596
2000,752,Sweden,Iraq,49372,27826,21546
2000,826,United Kingdom,Iraq,31162,19315,11847
2000,300,Greece,Iraq,6875,4770,2105
2000,380,Italy,Iraq,1498,1027,471
2000,470,Malta,Iraq,48,32,16
2000,620,Portugal,Iraq,54,32,22
2000,688,Serbia,Iraq,187,123,64
2000,705,Slovenia,Iraq,46,34,12
2000,724,Spain,Iraq,1274,830,444
2000,40,Austria,Iraq,3823,2426,1397
2000,56,Belgium,Iraq,45,24,21
2000,250,France,Iraq,4912,2787,2125
2000,276,Germany,Iraq,58884,38302,20582
2000,528,Netherlands,Iraq,29654,18769,10885
2000,756,Switzerland,Iraq,4932,3367,1565
2000,124,Canada,Iraq,26401,12736,13665
2000,840,United States of America,Iraq,92174,53222,38952
2005,710,South Africa,Iraq,91,68,23
2005,478,Mauritania,Iraq,84,48,36
2005,12,Algeria,Iraq,5982,2978,3004
2005,818,Egypt,Iraq,9278,4691,4587
2005,434,Libya,Iraq,55518,37815,17703
2005,504,Morocco,Iraq,1162,589,573
2005,788,Tunisia,Iraq,8,5,3
2005,51,Armenia,Iraq,282,117,165
2005,196,Cyprus,Iraq,209,140,69
2005,376,Israel,Iraq,70291,33773,36518
2005,400,Jordan,Iraq,268747,139442,129305
2005,422,Lebanon,Iraq,84380,44015,40365
2005,512,Oman,Iraq,2983,1761,1222
2005,682,Saudi Arabia,Iraq,5363,2920,2443
2005,760,Syrian Arab Republic,Iraq,336344,172062,164282
2005,792,Turkey,Iraq,8658,5102,3556
2005,887,Yemen,Iraq,6731,3653,3078
2005,762,Tajikistan,Iraq,65,35,30
2005,356,India,Iraq,564,271,293
2005,364,Iran (Islamic Republic of),Iraq,98094,56154,41940
2005,586,Pakistan,Iraq,289,151,138
2005,144,Sri Lanka,Iraq,19,10,9
2005,458,Malaysia,Iraq,351,212,139
2005,608,Philippines,Iraq,19,19,0
2005,764,Thailand,Iraq,54,27,27
2005,214,Dominican Republic,Iraq,17,13,4
2005,188,Costa Rica,Iraq,7,4,3
2005,484,Mexico,Iraq,50,37,13
2005,32,Argentina,Iraq,57,24,33
2005,68,Bolivia (Plurinational State of),Iraq,7,5,2
2005,76,Brazil,Iraq,253,162,91
2005,152,Chile,Iraq,33,29,4
2005,170,Colombia,Iraq,24,16,8
2005,218,Ecuador,Iraq,17,16,1
2005,604,Peru,Iraq,17,13,4
2005,862,Venezuela (Bolivarian Republic of),Iraq,69,49,20
2005,36,Australia,Iraq,37100,20027,17073
2005,554,New Zealand,Iraq,5760,2796,2964
2005,100,Bulgaria,Iraq,509,395,114
2005,203,Czechia,Iraq,298,211,87
2005,348,Hungary,Iraq,698,477,221
2005,616,Poland,Iraq,418,336,82
2005,642,Romania,Iraq,1018,750,268
2005,643,Russian Federation,Iraq,973,770,203
2005,703,Slovakia,Iraq,55,46,9
2005,208,Denmark,Iraq,17645,9960,7685
2005,246,Finland,Iraq,5101,3098,2003
2005,352,Iceland,Iraq,32,19,13
2005,372,Ireland,Iraq,529,338,191
2005,428,Latvia,Iraq,8,5,3
2005,578,Norway,Iraq,15420,9090,6330
2005,752,Sweden,Iraq,72553,39466,33087
2005,826,United Kingdom,Iraq,49586,30939,18647
2005,191,Croatia,Iraq,41,32,9
2005,300,Greece,Iraq,5303,3910,1393
2005,380,Italy,Iraq,2693,1945,748
2005,470,Malta,Iraq,57,37,20
2005,620,Portugal,Iraq,49,31,18
2005,688,Serbia,Iraq,185,121,64
2005,705,Slovenia,Iraq,46,35,11
2005,724,Spain,Iraq,1660,1101,559
2005,40,Austria,Iraq,4273,2674,1599
2005,56,Belgium,Iraq,1805,1100,705
2005,250,France,Iraq,4953,2858,2095
2005,276,Germany,Iraq,77641,48646,28995
2005,528,Netherlands,Iraq,35882,21413,14469
2005,756,Switzerland,Iraq,5619,3734,1885
2005,124,Canada,Iraq,36851,18569,18282
2005,840,United States of America,Iraq,105551,61194,44357
2010,710,South Africa,Iraq,142,106,36
2010,478,Mauritania,Iraq,135,79,56
2010,694,Sierra Leone,Iraq,1,1,0
2010,12,Algeria,Iraq,6574,3130,3444
2010,818,Egypt,Iraq,10013,4874,5139
2010,434,Libya,Iraq,60735,41592,19143
2010,504,Morocco,Iraq,1300,656,644
2010,788,Tunisia,Iraq,449,232,217
2010,51,Armenia,Iraq,888,369,519
2010,196,Cyprus,Iraq,342,231,111
2010,376,Israel,Iraq,65732,31162,34570
2010,400,Jordan,Iraq,475782,239229,236553
2010,422,Lebanon,Iraq,143391,73761,69630
2010,512,Oman,Iraq,4226,2566,1660
2010,682,Saudi Arabia,Iraq,5039,2788,2251
2010,760,Syrian Arab Republic,Iraq,1113326,567797,545529
2010,792,Turkey,Iraq,14069,8173,5896
2010,887,Yemen,Iraq,10441,5564,4877
2010,762,Tajikistan,Iraq,64,35,29
2010,356,India,Iraq,517,248,269
2010,364,Iran (Islamic Republic of),Iraq,86387,55676,30711
2010,586,Pakistan,Iraq,287,149,138
2010,144,Sri Lanka,Iraq,40,22,18
2010,458,Malaysia,Iraq,686,385,301
2010,608,Philippines,Iraq,70,70,0
2010,764,Thailand,Iraq,76,37,39
2010,214,Dominican Republic,Iraq,26,18,8
2010,188,Costa Rica,Iraq,15,10,5
2010,484,Mexico,Iraq,47,38,9
2010,32,Argentina,Iraq,37,17,20
2010,68,Bolivia (Plurinational State of),Iraq,9,7,2
2010,76,Brazil,Iraq,506,324,182
2010,152,Chile,Iraq,44,39,5
2010,170,Colombia,Iraq,21,14,7
2010,218,Ecuador,Iraq,24,23,1
2010,604,Peru,Iraq,18,14,4
2010,862,Venezuela (Bolivarian Republic of),Iraq,74,52,22
2010,36,Australia,Iraq,51830,26888,24942
2010,554,New Zealand,Iraq,5775,2799,2976
2010,100,Bulgaria,Iraq,638,501,137
2010,203,Czechia,Iraq,436,299,137
2010,348,Hungary,Iraq,831,571,260
2010,616,Poland,Iraq,441,331,110
2010,642,Romania,Iraq,1245,915,330
2010,643,Russian Federation,Iraq,968,786,182
2010,703,Slovakia,Iraq,62,52,10
2010,208,Denmark,Iraq,21909,12119,9790
2010,233,Estonia,Iraq,10,8,2
2010,246,Finland,Iraq,8034,4519,3515
2010,352,Iceland,Iraq,48,28,20
2010,372,Ireland,Iraq,443,271,172
2010,428,Latvia,Iraq,11,6,5
2010,578,Norway,Iraq,20604,11784,8820
2010,752,Sweden,Iraq,121761,66025,55736
2010,826,United Kingdom,Iraq,52236,32996,19240
2010,191,Croatia,Iraq,81,63,18
2010,300,Greece,Iraq,3882,3175,707
2010,380,Italy,Iraq,3952,2837,1115
2010,470,Malta,Iraq,73,38,35
2010,620,Portugal,Iraq,37,26,11
2010,688,Serbia,Iraq,181,118,63
2010,705,Slovenia,Iraq,56,41,15
2010,724,Spain,Iraq,1694,1080,614
2010,40,Austria,Iraq,4723,2923,1800
2010,56,Belgium,Iraq,5147,3241,1906
2010,250,France,Iraq,5747,3206,2541
2010,276,Germany,Iraq,93073,57265,35808
2010,528,Netherlands,Iraq,41043,24471,16572
2010,756,Switzerland,Iraq,6516,4219,2297
2010,124,Canada,Iraq,49520,25571,23949
2010,840,United States of America,Iraq,122517,69799,52718
2015,710,South Africa,Iraq,255,188,67
2015,478,Mauritania,Iraq,112,67,45
2015,12,Algeria,Iraq,7256,3452,3804
2015,818,Egypt,Iraq,13877,6939,6938
2015,434,Libya,Iraq,68477,46598,21879
2015,504,Morocco,Iraq,1694,852,842
2015,788,Tunisia,Iraq,636,332,304
2015,51,Armenia,Iraq,1033,430,603
2015,196,Cyprus,Iraq,1342,732,610
2015,376,Israel,Iraq,67791,31964,35827
2015,400,Jordan,Iraq,198676,103312,95364
2015,422,Lebanon,Iraq,120739,57793,62946
2015,512,Oman,Iraq,9610,6404,3206
2015,682,Saudi Arabia,Iraq,4865,2765,2100
2015,760,Syrian Arab Republic,Iraq,203609,103842,99767
2015,792,Turkey,Iraq,142392,85436,56956
2015,887,Yemen,Iraq,9801,5068,4733
2015,762,Tajikistan,Iraq,62,34,28
2015,356,India,Iraq,498,238,260
2015,364,Iran (Islamic Republic of),Iraq,85523,54812,30711
2015,586,Pakistan,Iraq,251,125,126
2015,144,Sri Lanka,Iraq,40,22,18
2015,458,Malaysia,Iraq,1244,720,524
2015,608,Philippines,Iraq,71,71,0
2015,764,Thailand,Iraq,82,40,42
2015,214,Dominican Republic,Iraq,27,19,8
2015,188,Costa Rica,Iraq,15,10,5
2015,484,Mexico,Iraq,49,40,9
2015,32,Argentina,Iraq,37,17,20
2015,68,Bolivia (Plurinational State of),Iraq,10,8,2
2015,76,Brazil,Iraq,609,390,219
2015,152,Chile,Iraq,66,59,7
2015,170,Colombia,Iraq,23,16,7
2015,218,Ecuador,Iraq,36,19,17
2015,604,Peru,Iraq,19,15,4
2015,862,Venezuela (Bolivarian Republic of),Iraq,79,55,24
2015,36,Australia,Iraq,70870,36813,34057
2015,554,New Zealand,Iraq,5698,2756,2942
2015,100,Bulgaria,Iraq,942,689,253
2015,203,Czechia,Iraq,519,355,164
2015,348,Hungary,Iraq,888,630,258
2015,616,Poland,Iraq,425,321,104
2015,642,Romania,Iraq,1419,1018,401
2015,643,Russian Federation,Iraq,986,800,186
2015,703,Slovakia,Iraq,79,65,14
2015,208,Denmark,Iraq,23515,13051,10464
2015,233,Estonia,Iraq,12,10,2
2015,246,Finland,Iraq,12431,7518,4913
2015,352,Iceland,Iraq,57,35,22
2015,372,Ireland,Iraq,453,275,178
2015,428,Latvia,Iraq,33,17,16
2015,578,Norway,Iraq,22252,12509,9743
2015,752,Sweden,Iraq,131888,70815,61073
2015,826,United Kingdom,Iraq,66802,41468,25334
2015,191,Croatia,Iraq,82,64,18
2015,300,Greece,Iraq,4745,2316,2429
2015,380,Italy,Iraq,3913,2914,999
2015,470,Malta,Iraq,114,80,34
2015,620,Portugal,Iraq,42,29,13
2015,688,Serbia,Iraq,176,115,61
2015,705,Slovenia,Iraq,58,42,16
2015,724,Spain,Iraq,1829,1141,688
2015,40,Austria,Iraq,5524,3430,2094
2015,56,Belgium,Iraq,11076,7010,4066
2015,250,France,Iraq,6366,3474,2892
2015,276,Germany,Iraq,96977,59579,37398
2015,528,Netherlands,Iraq,41384,23455,17929
2015,756,Switzerland,Iraq,9900,6211,3689
2015,124,Canada,Iraq,68065,34557,33508
2015,840,United States of America,Iraq,213417,104878,108539
2019,710,South Africa,Iraq,285,211,74
2019,478,Mauritania,Iraq,116,70,46
2019,12,Algeria,Iraq,7546,3590,3956
2019,818,Egypt,Iraq,19779,8723,11056
2019,434,Libya,Iraq,72656,49442,23214
2019,504,Morocco,Iraq,1806,909,897
2019,788,Tunisia,Iraq,646,338,308
2019,51,Armenia,Iraq,1077,483,594
2019,196,Cyprus,Iraq,1341,738,603
2019,376,Israel,Iraq,65924,31084,34840
2019,400,Jordan,Iraq,213658,111103,102555
2019,422,Lebanon,Iraq,114049,54591,59458
2019,512,Oman,Iraq,11836,7888,3948
2019,682,Saudi Arabia,Iraq,5926,3312,2614
2019,760,Syrian Arab Republic,Iraq,202831,103764,99067
2019,792,Turkey,Iraq,230277,54028,176249
2019,887,Yemen,Iraq,9949,5145,4804
2019,762,Tajikistan,Iraq,61,34,27
2019,356,India,Iraq,489,235,254
2019,364,Iran (Islamic Republic of),Iraq,84136,53923,30213
2019,586,Pakistan,Iraq,233,116,117
2019,144,Sri Lanka,Iraq,40,22,18
2019,458,Malaysia,Iraq,1300,757,543
2019,608,Philippines,Iraq,73,73,0
2019,764,Thailand,Iraq,85,42,43
2019,214,Dominican Republic,Iraq,27,19,8
2019,188,Costa Rica,Iraq,15,10,5
2019,484,Mexico,Iraq,50,41,9
2019,32,Argentina,Iraq,37,17,20
2019,68,Bolivia (Plurinational State of),Iraq,10,8,2
2019,76,Brazil,Iraq,685,439,246
2019,152,Chile,Iraq,88,79,9
2019,170,Colombia,Iraq,23,16,7
2019,218,Ecuador,Iraq,68,36,32
2019,604,Peru,Iraq,22,18,4
2019,862,Venezuela (Bolivarian Republic of),Iraq,77,54,23
2019,36,Australia,Iraq,89168,46337,42831
2019,554,New Zealand,Iraq,5856,2832,3024
2019,100,Bulgaria,Iraq,1285,918,367
2019,203,Czechia,Iraq,657,466,191
2019,348,Hungary,Iraq,1174,843,331
2019,616,Poland,Iraq,450,345,105
2019,642,Romania,Iraq,2563,1723,840
2019,643,Russian Federation,Iraq,985,800,185
2019,703,Slovakia,Iraq,209,128,81
2019,208,Denmark,Iraq,22936,12553,10383
2019,233,Estonia,Iraq,47,33,14
2019,246,Finland,Iraq,18580,11593,6987
2019,352,Iceland,Iraq,91,60,31
2019,372,Ireland,Iraq,497,303,194
2019,428,Latvia,Iraq,33,21,12
2019,578,Norway,Iraq,24438,13687,10751
2019,752,Sweden,Iraq,141430,75961,65469
2019,826,United Kingdom,Iraq,75860,47164,28696
2019,191,Croatia,Iraq,75,59,16
2019,300,Greece,Iraq,9909,4835,5074
2019,380,Italy,Iraq,4794,3645,1149
2019,470,Malta,Iraq,183,126,57
2019,620,Portugal,Iraq,229,129,100
2019,688,Serbia,Iraq,178,117,61
2019,705,Slovenia,Iraq,78,55,23
2019,724,Spain,Iraq,1895,1166,729
2019,40,Austria,Iraq,6521,4092,2429
2019,56,Belgium,Iraq,20681,13839,6842
2019,250,France,Iraq,6738,3670,3068
2019,276,Germany,Iraq,188759,118372,70387
2019,528,Netherlands,Iraq,46245,26418,19827
2019,756,Switzerland,Iraq,10616,6455,4161
2019,124,Canada,Iraq,72939,37032,35907
2019,840,United States of America,Iraq,230469,111997,118472
1990,480,Mauritius,Ireland,30,14,16
1990,140,Central African Republic,Ireland,1,0,1
1990,72,Botswana,Ireland,185,103,82
1990,516,Namibia,Ireland,89,42,47
1990,710,South Africa,Ireland,5788,2572,3216
1990,818,Egypt,Ireland,111,45,66
1990,196,Cyprus,Ireland,193,70,123
1990,400,Jordan,Ireland,75,17,58
1990,792,Turkey,Ireland,130,68,62
1990,344,"China, Hong Kong SAR",Ireland,466,282,184
1990,392,Japan,Ireland,671,342,329
1990,496,Mongolia,Ireland,2,1,1
1990,608,Philippines,Ireland,33,27,6
1990,44,Bahamas,Ireland,55,35,20
1990,136,Cayman Islands,Ireland,79,41,38
1990,214,Dominican Republic,Ireland,51,28,23
1990,662,Saint Lucia,Ireland,10,6,4
1990,188,Costa Rica,Ireland,24,14,10
1990,222,El Salvador,Ireland,24,15,9
1990,484,Mexico,Ireland,186,105,81
1990,558,Nicaragua,Ireland,15,7,8
1990,591,Panama,Ireland,9,6,3
1990,32,Argentina,Ireland,143,74,69
1990,68,Bolivia (Plurinational State of),Ireland,22,11,11
1990,76,Brazil,Ireland,109,66,43
1990,152,Chile,Ireland,91,49,42
1990,170,Colombia,Ireland,94,48,46
1990,218,Ecuador,Ireland,67,39,28
1990,604,Peru,Ireland,130,66,64
1990,862,Venezuela (Bolivarian Republic of),Ireland,55,32,23
1990,36,Australia,Ireland,51999,27096,24903
1990,554,New Zealand,Ireland,7053,3557,3496
1990,598,Papua New Guinea,Ireland,67,35,32
1990,112,Belarus,Ireland,16,7,9
1990,100,Bulgaria,Ireland,4,2,2
1990,203,Czechia,Ireland,16,11,5
1990,348,Hungary,Ireland,26,12,14
1990,616,Poland,Ireland,101,74,27
1990,642,Romania,Ireland,96,50,46
1990,643,Russian Federation,Ireland,194,95,99
1990,703,Slovakia,Ireland,1,1,0
1990,830,Channel Islands,Ireland,1660,781,879
1990,208,Denmark,Ireland,895,509,386
1990,246,Finland,Ireland,88,61,27
1990,352,Iceland,Ireland,81,42,39
1990,833,Isle of Man,Ireland,1628,693,935
1990,428,Latvia,Ireland,14,5,9
1990,440,Lithuania,Ireland,18,9,9
1990,578,Norway,Ireland,446,188,258
1990,752,Sweden,Ireland,870,535,335
1990,826,United Kingdom,Ireland,611877,280892,330985
1990,300,Greece,Ireland,1042,378,664
1990,380,Italy,Ireland,4114,1070,3044
1990,470,Malta,Ireland,47,17,30
1990,620,Portugal,Ireland,199,70,129
1990,688,Serbia,Ireland,6,4,2
1990,705,Slovenia,Ireland,2,1,1
1990,724,Spain,Ireland,2044,878,1166
1990,40,Austria,Ireland,544,303,241
1990,56,Belgium,Ireland,1630,728,902
1990,250,France,Ireland,6702,2542,4160
1990,276,Germany,Ireland,12186,6458,5728
1990,438,Liechtenstein,Ireland,1,0,1
1990,442,Luxembourg,Ireland,412,181,231
1990,528,Netherlands,Ireland,3733,1795,1938
1990,756,Switzerland,Ireland,1367,578,789
1990,60,Bermuda,Ireland,87,58,29
1990,124,Canada,Ireland,27255,13269,13986
1990,840,United States of America,Ireland,169827,66010,103817
1995,480,Mauritius,Ireland,14,8,6
1995,140,Central African Republic,Ireland,9,4,5
1995,72,Botswana,Ireland,178,98,80
1995,516,Namibia,Ireland,85,41,44
1995,710,South Africa,Ireland,4728,2189,2539
1995,818,Egypt,Ireland,87,34,53
1995,196,Cyprus,Ireland,273,92,181
1995,400,Jordan,Ireland,70,22,48
1995,792,Turkey,Ireland,314,157,157
1995,344,"China, Hong Kong SAR",Ireland,520,313,207
1995,392,Japan,Ireland,869,417,452
1995,496,Mongolia,Ireland,1,1,0
1995,608,Philippines,Ireland,44,36,8
1995,44,Bahamas,Ireland,62,39,23
1995,136,Cayman Islands,Ireland,150,78,72
1995,214,Dominican Republic,Ireland,57,31,26
1995,662,Saint Lucia,Ireland,10,5,5
1995,188,Costa Rica,Ireland,19,11,8
1995,222,El Salvador,Ireland,18,11,7
1995,484,Mexico,Ireland,211,117,94
1995,558,Nicaragua,Ireland,12,5,7
1995,591,Panama,Ireland,15,10,5
1995,32,Argentina,Ireland,140,73,67
1995,68,Bolivia (Plurinational State of),Ireland,41,24,17
1995,76,Brazil,Ireland,165,119,46
1995,152,Chile,Ireland,109,59,50
1995,170,Colombia,Ireland,99,54,45
1995,218,Ecuador,Ireland,75,43,32
1995,604,Peru,Ireland,131,65,66
1995,862,Venezuela (Bolivarian Republic of),Ireland,54,32,22
1995,36,Australia,Ireland,54399,28236,26163
1995,554,New Zealand,Ireland,6154,3089,3065
1995,598,Papua New Guinea,Ireland,68,33,35
1995,112,Belarus,Ireland,20,7,13
1995,100,Bulgaria,Ireland,5,2,3
1995,203,Czechia,Ireland,25,17,8
1995,348,Hungary,Ireland,287,145,142
1995,616,Poland,Ireland,86,63,23
1995,642,Romania,Ireland,83,47,36
1995,643,Russian Federation,Ireland,178,100,78
1995,703,Slovakia,Ireland,233,116,117
1995,830,Channel Islands,Ireland,1629,766,863
1995,208,Denmark,Ireland,1024,608,416
1995,246,Finland,Ireland,128,94,34
1995,352,Iceland,Ireland,68,36,32
1995,833,Isle of Man,Ireland,1700,717,983
1995,428,Latvia,Ireland,21,7,14
1995,440,Lithuania,Ireland,21,10,11
1995,578,Norway,Ireland,474,215,259
1995,752,Sweden,Ireland,1033,632,401
1995,826,United Kingdom,Ireland,559011,251820,307191
1995,191,Croatia,Ireland,5,2,3
1995,300,Greece,Ireland,762,255,507
1995,380,Italy,Ireland,3211,924,2287
1995,470,Malta,Ireland,56,21,35
1995,620,Portugal,Ireland,356,154,202
1995,688,Serbia,Ireland,40,22,18
1995,705,Slovenia,Ireland,3,2,1
1995,724,Spain,Ireland,2622,1189,1433
1995,40,Austria,Ireland,614,346,268
1995,56,Belgium,Ireland,2195,986,1209
1995,250,France,Ireland,6919,2552,4367
1995,276,Germany,Ireland,13677,7139,6538
1995,438,Liechtenstein,Ireland,5,3,2
1995,442,Luxembourg,Ireland,585,270,315
1995,528,Netherlands,Ireland,3923,1850,2073
1995,756,Switzerland,Ireland,1850,914,936
1995,60,Bermuda,Ireland,91,60,31
1995,124,Canada,Ireland,26295,12744,13551
1995,840,United States of America,Ireland,165333,65065,100268
2000,480,Mauritius,Ireland,6,3,3
2000,140,Central African Republic,Ireland,16,7,9
2000,72,Botswana,Ireland,190,104,86
2000,516,Namibia,Ireland,80,38,42
2000,710,South Africa,Ireland,5085,2351,2734
2000,818,Egypt,Ireland,70,26,44
2000,196,Cyprus,Ireland,353,114,239
2000,400,Jordan,Ireland,64,27,37
2000,792,Turkey,Ireland,501,247,254
2000,344,"China, Hong Kong SAR",Ireland,574,344,230
2000,392,Japan,Ireland,974,450,524
2000,496,Mongolia,Ireland,2,1,1
2000,608,Philippines,Ireland,212,125,87
2000,44,Bahamas,Ireland,69,43,26
2000,136,Cayman Islands,Ireland,258,134,124
2000,214,Dominican Republic,Ireland,62,33,29
2000,662,Saint Lucia,Ireland,19,10,9
2000,188,Costa Rica,Ireland,23,12,11
2000,222,El Salvador,Ireland,12,7,5
2000,484,Mexico,Ireland,246,135,111
2000,558,Nicaragua,Ireland,16,10,6
2000,591,Panama,Ireland,24,16,8
2000,32,Argentina,Ireland,137,73,64
2000,68,Bolivia (Plurinational State of),Ireland,60,37,23
2000,76,Brazil,Ireland,220,172,48
2000,152,Chile,Ireland,127,68,59
2000,170,Colombia,Ireland,104,61,43
2000,218,Ecuador,Ireland,83,48,35
2000,604,Peru,Ireland,154,77,77
2000,862,Venezuela (Bolivarian Republic of),Ireland,53,31,22
2000,36,Australia,Ireland,53580,27833,25747
2000,554,New Zealand,Ireland,6547,3183,3364
2000,598,Papua New Guinea,Ireland,50,20,30
2000,112,Belarus,Ireland,24,8,16
2000,100,Bulgaria,Ireland,6,3,3
2000,203,Czechia,Ireland,33,22,11
2000,348,Hungary,Ireland,548,278,270
2000,616,Poland,Ireland,74,53,21
2000,642,Romania,Ireland,69,43,26
2000,643,Russian Federation,Ireland,156,101,55
2000,703,Slovakia,Ireland,530,262,268
2000,830,Channel Islands,Ireland,1731,814,917
2000,208,Denmark,Ireland,1153,708,445
2000,246,Finland,Ireland,168,128,40
2000,352,Iceland,Ireland,54,29,25
2000,833,Isle of Man,Ireland,1771,740,1031
2000,428,Latvia,Ireland,28,9,19
2000,440,Lithuania,Ireland,16,8,8
2000,578,Norway,Ireland,498,252,246
2000,752,Sweden,Ireland,1108,675,433
2000,826,United Kingdom,Ireland,515544,226188,289356
2000,191,Croatia,Ireland,10,5,5
2000,300,Greece,Ireland,494,127,367
2000,380,Italy,Ireland,2307,778,1529
2000,470,Malta,Ireland,141,53,88
2000,620,Portugal,Ireland,529,245,284
2000,688,Serbia,Ireland,55,29,26
2000,705,Slovenia,Ireland,5,1,4
2000,724,Spain,Ireland,4329,2050,2279
2000,40,Austria,Ireland,683,389,294
2000,56,Belgium,Ireland,2697,1221,1476
2000,250,France,Ireland,7135,2561,4574
2000,276,Germany,Ireland,15167,7819,7348
2000,438,Liechtenstein,Ireland,9,5,4
2000,442,Luxembourg,Ireland,765,363,402
2000,528,Netherlands,Ireland,4252,1964,2288
2000,756,Switzerland,Ireland,2341,1257,1084
2000,60,Bermuda,Ireland,94,61,33
2000,124,Canada,Ireland,25960,12524,13436
2000,840,United States of America,Ireland,160447,64088,96359
2005,480,Mauritius,Ireland,24,13,11
2005,140,Central African Republic,Ireland,12,5,7
2005,72,Botswana,Ireland,364,197,167
2005,516,Namibia,Ireland,63,30,33
2005,710,South Africa,Ireland,6690,2935,3755
2005,818,Egypt,Ireland,83,34,49
2005,196,Cyprus,Ireland,517,165,352
2005,400,Jordan,Ireland,92,46,46
2005,792,Turkey,Ireland,516,249,267
2005,344,"China, Hong Kong SAR",Ireland,627,364,263
2005,392,Japan,Ireland,1001,456,545
2005,496,Mongolia,Ireland,4,3,1
2005,608,Philippines,Ireland,171,102,69
2005,44,Bahamas,Ireland,62,36,26
2005,136,Cayman Islands,Ireland,225,112,113
2005,214,Dominican Republic,Ireland,47,26,21
2005,662,Saint Lucia,Ireland,19,11,8
2005,188,Costa Rica,Ireland,15,8,7
2005,222,El Salvador,Ireland,12,7,5
2005,484,Mexico,Ireland,243,147,96
2005,558,Nicaragua,Ireland,22,16,6
2005,591,Panama,Ireland,50,36,14
2005,32,Argentina,Ireland,101,54,47
2005,68,Bolivia (Plurinational State of),Ireland,63,37,26
2005,76,Brazil,Ireland,196,154,42
2005,152,Chile,Ireland,190,103,87
2005,170,Colombia,Ireland,104,64,40
2005,218,Ecuador,Ireland,98,58,40
2005,604,Peru,Ireland,181,91,90
2005,862,Venezuela (Bolivarian Republic of),Ireland,55,32,23
2005,36,Australia,Ireland,55700,29063,26637
2005,554,New Zealand,Ireland,6587,3198,3389
2005,598,Papua New Guinea,Ireland,50,22,28
2005,112,Belarus,Ireland,23,7,16
2005,100,Bulgaria,Ireland,8,4,4
2005,203,Czechia,Ireland,262,200,62
2005,348,Hungary,Ireland,678,350,328
2005,616,Poland,Ireland,3912,1995,1917
2005,642,Romania,Ireland,204,114,90
2005,643,Russian Federation,Ireland,165,95,70
2005,703,Slovakia,Ireland,595,299,296
2005,830,Channel Islands,Ireland,2731,1295,1436
2005,208,Denmark,Ireland,1286,787,499
2005,246,Finland,Ireland,311,233,78
2005,352,Iceland,Ireland,68,42,26
2005,833,Isle of Man,Ireland,1955,770,1185
2005,428,Latvia,Ireland,399,201,198
2005,440,Lithuania,Ireland,794,429,365
2005,578,Norway,Ireland,504,258,246
2005,752,Sweden,Ireland,1468,948,520
2005,826,United Kingdom,Ireland,462925,202881,260044
2005,191,Croatia,Ireland,32,15,17
2005,300,Greece,Ireland,549,162,387
2005,380,Italy,Ireland,2968,1168,1800
2005,470,Malta,Ireland,223,84,139
2005,620,Portugal,Ireland,1039,508,531
2005,688,Serbia,Ireland,55,29,26
2005,705,Slovenia,Ireland,9,4,5
2005,724,Spain,Ireland,9107,4582,4525
2005,40,Austria,Ireland,763,426,337
2005,56,Belgium,Ireland,2702,1259,1443
2005,250,France,Ireland,8596,3833,4763
2005,276,Germany,Ireland,11942,6357,5585
2005,438,Liechtenstein,Ireland,8,4,4
2005,442,Luxembourg,Ireland,910,432,478
2005,528,Netherlands,Ireland,4490,2119,2371
2005,756,Switzerland,Ireland,2696,1398,1298
2005,60,Bermuda,Ireland,98,59,39
2005,124,Canada,Ireland,27166,13219,13947
2005,840,United States of America,Ireland,145477,58591,86886
2010,480,Mauritius,Ireland,44,23,21
2010,140,Central African Republic,Ireland,12,5,7
2010,72,Botswana,Ireland,539,291,248
2010,516,Namibia,Ireland,60,29,31
2010,710,South Africa,Ireland,10480,4576,5904
2010,818,Egypt,Ireland,90,35,55
2010,196,Cyprus,Ireland,846,277,569
2010,400,Jordan,Ireland,118,62,56
2010,792,Turkey,Ireland,531,250,281
2010,344,"China, Hong Kong SAR",Ireland,681,384,297
2010,392,Japan,Ireland,1061,477,584
2010,496,Mongolia,Ireland,7,5,2
2010,608,Philippines,Ireland,425,246,179
2010,44,Bahamas,Ireland,54,29,25
2010,136,Cayman Islands,Ireland,213,99,114
2010,214,Dominican Republic,Ireland,31,19,12
2010,662,Saint Lucia,Ireland,18,10,8
2010,188,Costa Rica,Ireland,29,14,15
2010,222,El Salvador,Ireland,11,6,5
2010,484,Mexico,Ireland,270,178,92
2010,558,Nicaragua,Ireland,23,17,6
2010,591,Panama,Ireland,79,57,22
2010,32,Argentina,Ireland,64,35,29
2010,68,Bolivia (Plurinational State of),Ireland,66,37,29
2010,76,Brazil,Ireland,170,134,36
2010,152,Chile,Ireland,254,139,115
2010,170,Colombia,Ireland,122,78,44
2010,218,Ecuador,Ireland,137,79,58
2010,604,Peru,Ireland,203,102,101
2010,862,Venezuela (Bolivarian Republic of),Ireland,58,33,25
2010,36,Australia,Ireland,70970,38445,32525
2010,554,New Zealand,Ireland,8057,3904,4153
2010,598,Papua New Guinea,Ireland,42,19,23
2010,112,Belarus,Ireland,21,5,16
2010,100,Bulgaria,Ireland,10,6,4
2010,203,Czechia,Ireland,466,362,104
2010,348,Hungary,Ireland,807,421,386
2010,616,Poland,Ireland,7874,3987,3887
2010,642,Romania,Ireland,379,205,174
2010,643,Russian Federation,Ireland,171,87,84
2010,703,Slovakia,Ireland,667,340,327
2010,830,Channel Islands,Ireland,3731,1777,1954
2010,208,Denmark,Ireland,1394,853,541
2010,233,Estonia,Ireland,146,85,61
2010,246,Finland,Ireland,527,386,141
2010,352,Iceland,Ireland,81,55,26
2010,833,Isle of Man,Ireland,2116,786,1330
2010,428,Latvia,Ireland,761,385,376
2010,440,Lithuania,Ireland,1465,773,692
2010,578,Norway,Ireland,706,406,300
2010,752,Sweden,Ireland,1950,1320,630
2010,826,United Kingdom,Ireland,398201,175558,222643
2010,191,Croatia,Ireland,53,25,28
2010,300,Greece,Ireland,627,205,422
2010,380,Italy,Ireland,4025,1731,2294
2010,470,Malta,Ireland,223,102,121
2010,620,Portugal,Ireland,1377,687,690
2010,688,Serbia,Ireland,54,28,26
2010,705,Slovenia,Ireland,27,13,14
2010,724,Spain,Ireland,13455,6937,6518
2010,40,Austria,Ireland,843,464,379
2010,56,Belgium,Ireland,2983,1432,1551
2010,250,France,Ireland,9229,3180,6049
2010,276,Germany,Ireland,9201,5038,4163
2010,438,Liechtenstein,Ireland,9,4,5
2010,442,Luxembourg,Ireland,1067,506,561
2010,528,Netherlands,Ireland,4543,2225,2318
2010,756,Switzerland,Ireland,3094,1502,1592
2010,60,Bermuda,Ireland,101,56,45
2010,124,Canada,Ireland,28035,13777,14258
2010,840,United States of America,Ireland,134587,53099,81488
2015,480,Mauritius,Ireland,50,28,22
2015,140,Central African Republic,Ireland,10,4,6
2015,72,Botswana,Ireland,588,318,270
2015,516,Namibia,Ireland,58,28,30
2015,710,South Africa,Ireland,18903,7712,11191
2015,818,Egypt,Ireland,66,31,35
2015,196,Cyprus,Ireland,812,269,543
2015,400,Jordan,Ireland,50,21,29
2015,792,Turkey,Ireland,539,248,291
2015,344,"China, Hong Kong SAR",Ireland,695,380,315
2015,392,Japan,Ireland,1140,509,631
2015,496,Mongolia,Ireland,8,5,3
2015,608,Philippines,Ireland,431,250,181
2015,44,Bahamas,Ireland,59,32,27
2015,136,Cayman Islands,Ireland,231,108,123
2015,214,Dominican Republic,Ireland,32,20,12
2015,662,Saint Lucia,Ireland,17,10,7
2015,188,Costa Rica,Ireland,29,14,15
2015,222,El Salvador,Ireland,11,6,5
2015,484,Mexico,Ireland,286,188,98
2015,558,Nicaragua,Ireland,24,18,6
2015,591,Panama,Ireland,92,67,25
2015,32,Argentina,Ireland,64,35,29
2015,68,Bolivia (Plurinational State of),Ireland,77,43,34
2015,76,Brazil,Ireland,205,162,43
2015,152,Chile,Ireland,384,207,177
2015,170,Colombia,Ireland,136,88,48
2015,218,Ecuador,Ireland,199,115,84
2015,604,Peru,Ireland,215,111,104
2015,862,Venezuela (Bolivarian Republic of),Ireland,62,36,26
2015,36,Australia,Ireland,90530,48787,41743
2015,554,New Zealand,Ireland,9398,4545,4853
2015,598,Papua New Guinea,Ireland,42,20,22
2015,112,Belarus,Ireland,24,8,16
2015,100,Bulgaria,Ireland,244,134,110
2015,203,Czechia,Ireland,584,456,128
2015,348,Hungary,Ireland,1197,630,567
2015,616,Poland,Ireland,7591,3915,3676
2015,642,Romania,Ireland,657,320,337
2015,643,Russian Federation,Ireland,175,89,86
2015,703,Slovakia,Ireland,914,493,421
2015,830,Channel Islands,Ireland,3958,1890,2068
2015,208,Denmark,Ireland,1708,1043,665
2015,233,Estonia,Ireland,87,59,28
2015,246,Finland,Ireland,714,512,202
2015,352,Iceland,Ireland,105,62,43
2015,833,Isle of Man,Ireland,1540,649,891
2015,428,Latvia,Ireland,731,418,313
2015,440,Lithuania,Ireland,1465,759,706
2015,578,Norway,Ireland,1115,686,429
2015,752,Sweden,Ireland,2565,1751,814
2015,826,United Kingdom,Ireland,389921,171203,218718
2015,191,Croatia,Ireland,53,25,28
2015,300,Greece,Ireland,588,176,412
2015,380,Italy,Ireland,3526,1482,2044
2015,470,Malta,Ireland,377,185,192
2015,620,Portugal,Ireland,1561,738,823
2015,688,Serbia,Ireland,52,27,25
2015,705,Slovenia,Ireland,44,26,18
2015,724,Spain,Ireland,14925,7710,7215
2015,40,Austria,Ireland,985,544,441
2015,56,Belgium,Ireland,3333,1666,1667
2015,250,France,Ireland,9737,4484,5253
2015,276,Germany,Ireland,9587,5239,4348
2015,438,Liechtenstein,Ireland,17,8,9
2015,442,Luxembourg,Ireland,1627,785,842
2015,528,Netherlands,Ireland,5161,2573,2588
2015,756,Switzerland,Ireland,3838,1916,1922
2015,60,Bermuda,Ireland,102,57,45
2015,124,Canada,Ireland,28151,14261,13890
2015,840,United States of America,Ireland,120144,46849,73295
2019,480,Mauritius,Ireland,50,28,22
2019,140,Central African Republic,Ireland,11,5,6
2019,72,Botswana,Ireland,629,340,289
2019,516,Namibia,Ireland,61,30,31
2019,710,South Africa,Ireland,21187,8656,12531
2019,818,Egypt,Ireland,94,39,55
2019,196,Cyprus,Ireland,811,274,537
2019,400,Jordan,Ireland,53,22,31
2019,792,Turkey,Ireland,728,339,389
2019,344,"China, Hong Kong SAR",Ireland,900,480,420
2019,392,Japan,Ireland,1275,570,705
2019,496,Mongolia,Ireland,8,5,3
2019,608,Philippines,Ireland,444,258,186
2019,44,Bahamas,Ireland,62,34,28
2019,136,Cayman Islands,Ireland,255,120,135
2019,214,Dominican Republic,Ireland,33,21,12
2019,662,Saint Lucia,Ireland,16,10,6
2019,188,Costa Rica,Ireland,29,14,15
2019,222,El Salvador,Ireland,11,6,5
2019,484,Mexico,Ireland,294,193,101
2019,558,Nicaragua,Ireland,25,19,6
2019,591,Panama,Ireland,96,71,25
2019,32,Argentina,Ireland,65,36,29
2019,68,Bolivia (Plurinational State of),Ireland,84,47,37
2019,76,Brazil,Ireland,230,182,48
2019,152,Chile,Ireland,513,264,249
2019,170,Colombia,Ireland,139,90,49
2019,218,Ecuador,Ireland,195,113,82
2019,604,Peru,Ireland,256,138,118
2019,862,Venezuela (Bolivarian Republic of),Ireland,60,35,25
2019,36,Australia,Ireland,92077,49620,42457
2019,554,New Zealand,Ireland,9660,4672,4988
2019,598,Papua New Guinea,Ireland,42,20,22
2019,112,Belarus,Ireland,23,8,15
2019,100,Bulgaria,Ireland,349,199,150
2019,203,Czechia,Ireland,609,473,136
2019,348,Hungary,Ireland,1580,831,749
2019,616,Poland,Ireland,8039,4296,3743
2019,642,Romania,Ireland,2057,1090,967
2019,643,Russian Federation,Ireland,174,89,85
2019,703,Slovakia,Ireland,1195,643,552
2019,830,Channel Islands,Ireland,4031,1925,2106
2019,208,Denmark,Ireland,2087,1310,777
2019,233,Estonia,Ireland,116,72,44
2019,246,Finland,Ireland,854,607,247
2019,352,Iceland,Ireland,137,82,55
2019,833,Isle of Man,Ireland,1562,658,904
2019,428,Latvia,Ireland,829,475,354
2019,440,Lithuania,Ireland,1470,745,725
2019,578,Norway,Ireland,1258,763,495
2019,752,Sweden,Ireland,2984,2044,940
2019,826,United Kingdom,Ireland,442796,195047,247749
2019,191,Croatia,Ireland,48,23,25
2019,300,Greece,Ireland,574,187,387
2019,380,Italy,Ireland,3751,1585,2166
2019,470,Malta,Ireland,608,301,307
2019,620,Portugal,Ireland,1587,752,835
2019,688,Serbia,Ireland,52,27,25
2019,705,Slovenia,Ireland,59,37,22
2019,724,Spain,Ireland,15225,7783,7442
2019,40,Austria,Ireland,1162,651,511
2019,56,Belgium,Ireland,3555,1797,1758
2019,250,France,Ireland,10306,4733,5573
2019,276,Germany,Ireland,12943,7490,5453
2019,438,Liechtenstein,Ireland,19,10,9
2019,442,Luxembourg,Ireland,1445,752,693
2019,528,Netherlands,Ireland,6157,3156,3001
2019,756,Switzerland,Ireland,4075,2079,1996
2019,60,Bermuda,Ireland,103,58,45
2019,124,Canada,Ireland,30167,15283,14884
2019,840,United States of America,Ireland,122529,47638,74891
1990,36,Australia,Isle of Man,731,383,348
1990,826,United Kingdom,Isle of Man,9974,4703,5271
1990,300,Greece,Isle of Man,18,9,9
1990,250,France,Isle of Man,12,3,9
1995,36,Australia,Isle of Man,737,377,360
1995,826,United Kingdom,Isle of Man,8238,3975,4263
1995,300,Greece,Isle of Man,15,8,7
1995,250,France,Isle of Man,13,3,10
2000,36,Australia,Isle of Man,710,361,349
2000,826,United Kingdom,Isle of Man,6642,3304,3338
2000,300,Greece,Isle of Man,12,7,5
2000,250,France,Isle of Man,13,3,10
2005,68,Bolivia (Plurinational State of),Isle of Man,1,1,0
2005,36,Australia,Isle of Man,760,395,365
2005,826,United Kingdom,Isle of Man,7719,3772,3947
2005,300,Greece,Isle of Man,9,5,4
2005,250,France,Isle of Man,12,2,10
2010,68,Bolivia (Plurinational State of),Isle of Man,2,2,0
2010,36,Australia,Isle of Man,880,467,413
2010,826,United Kingdom,Isle of Man,8131,4059,4072
2010,300,Greece,Isle of Man,5,3,2
2010,250,France,Isle of Man,12,2,10
2015,68,Bolivia (Plurinational State of),Isle of Man,2,2,0
2015,36,Australia,Isle of Man,810,453,357
2015,826,United Kingdom,Isle of Man,10398,5037,5361
2015,300,Greece,Isle of Man,4,3,1
2015,250,France,Isle of Man,13,2,11
2019,68,Bolivia (Plurinational State of),Isle of Man,2,2,0
2019,36,Australia,Isle of Man,983,513,470
2019,826,United Kingdom,Isle of Man,11808,5736,6072
2019,300,Greece,Isle of Man,3,3,0
2019,250,France,Isle of Man,13,2,11
1990,266,Gabon,Israel,5,3,2
1990,516,Namibia,Israel,161,90,71
1990,710,South Africa,Israel,2441,1192,1249
1990,288,Ghana,Israel,24,12,12
1990,818,Egypt,Israel,995,585,410
1990,196,Cyprus,Israel,95,54,41
1990,400,Jordan,Israel,6,2,4
1990,422,Lebanon,Israel,3,1,2
1990,275,State of Palestine,Israel,98290,42646,55644
1990,792,Turkey,Israel,658,358,300
1990,608,Philippines,Israel,59,47,12
1990,136,Cayman Islands,Israel,3,1,2
1990,214,Dominican Republic,Israel,185,148,37
1990,630,Puerto Rico,Israel,87,41,46
1990,188,Costa Rica,Israel,123,80,43
1990,222,El Salvador,Israel,177,86,91
1990,320,Guatemala,Israel,58,31,27
1990,340,Honduras,Israel,68,45,23
1990,484,Mexico,Israel,1195,653,542
1990,591,Panama,Israel,414,269,145
1990,32,Argentina,Israel,1466,733,733
1990,68,Bolivia (Plurinational State of),Israel,79,38,41
1990,76,Brazil,Israel,2137,1363,774
1990,152,Chile,Israel,1367,730,637
1990,170,Colombia,Israel,605,364,241
1990,218,Ecuador,Israel,174,107,67
1990,604,Peru,Israel,315,193,122
1990,862,Venezuela (Bolivarian Republic of),Israel,1035,614,421
1990,36,Australia,Israel,7756,4205,3551
1990,112,Belarus,Israel,192,111,81
1990,100,Bulgaria,Israel,58,41,17
1990,203,Czechia,Israel,35,24,11
1990,348,Hungary,Israel,425,189,236
1990,616,Poland,Israel,542,380,162
1990,498,Republic of Moldova,Israel,308,184,124
1990,642,Romania,Israel,262,194,68
1990,643,Russian Federation,Israel,2842,1395,1447
1990,703,Slovakia,Israel,15,10,5
1990,804,Ukraine,Israel,4532,2184,2348
1990,208,Denmark,Israel,1048,709,339
1990,246,Finland,Israel,350,239,111
1990,352,Iceland,Israel,20,13,7
1990,372,Ireland,Israel,42,23,19
1990,428,Latvia,Israel,21,14,7
1990,440,Lithuania,Israel,30,20,10
1990,578,Norway,Israel,422,262,160
1990,752,Sweden,Israel,1192,734,458
1990,826,United Kingdom,Israel,11935,6186,5749
1990,300,Greece,Israel,1413,785,628
1990,380,Italy,Israel,7287,4208,3079
1990,470,Malta,Israel,8,5,3
1990,620,Portugal,Israel,28,17,11
1990,688,Serbia,Israel,13,7,6
1990,705,Slovenia,Israel,3,2,1
1990,724,Spain,Israel,656,439,217
1990,40,Austria,Israel,1412,795,617
1990,56,Belgium,Israel,4093,2366,1727
1990,250,France,Israel,5866,2964,2902
1990,276,Germany,Israel,9659,5830,3829
1990,442,Luxembourg,Israel,40,22,18
1990,528,Netherlands,Israel,2958,1745,1213
1990,756,Switzerland,Israel,1754,1004,750
1990,60,Bermuda,Israel,15,10,5
1990,124,Canada,Israel,16092,7834,8258
1990,840,United States of America,Israel,86048,43723,42325
1995,266,Gabon,Israel,6,4,2
1995,516,Namibia,Israel,153,86,67
1995,710,South Africa,Israel,1879,978,901
1995,288,Ghana,Israel,24,13,11
1995,818,Egypt,Israel,728,427,301
1995,196,Cyprus,Israel,135,74,61
1995,400,Jordan,Israel,956,634,322
1995,422,Lebanon,Israel,434,274,160
1995,275,State of Palestine,Israel,96052,41403,54649
1995,792,Turkey,Israel,1592,836,756
1995,144,Sri Lanka,Israel,5,5,0
1995,608,Philippines,Israel,79,63,16
1995,136,Cayman Islands,Israel,7,1,6
1995,214,Dominican Republic,Israel,206,164,42
1995,630,Puerto Rico,Israel,91,43,48
1995,188,Costa Rica,Israel,101,66,35
1995,222,El Salvador,Israel,123,59,64
1995,320,Guatemala,Israel,71,41,30
1995,340,Honduras,Israel,68,44,24
1995,484,Mexico,Israel,1303,725,578
1995,591,Panama,Israel,472,308,164
1995,32,Argentina,Israel,1317,653,664
1995,68,Bolivia (Plurinational State of),Israel,130,74,56
1995,76,Brazil,Israel,1961,1216,745
1995,152,Chile,Israel,948,546,402
1995,170,Colombia,Israel,536,327,209
1995,218,Ecuador,Israel,195,120,75
1995,604,Peru,Israel,316,191,125
1995,862,Venezuela (Bolivarian Republic of),Israel,792,473,319
1995,36,Australia,Israel,7358,3959,3399
1995,112,Belarus,Israel,297,149,148
1995,100,Bulgaria,Israel,114,73,41
1995,203,Czechia,Israel,52,36,16
1995,348,Hungary,Israel,786,426,360
1995,616,Poland,Israel,463,323,140
1995,498,Republic of Moldova,Israel,208,122,86
1995,642,Romania,Israel,516,394,122
1995,643,Russian Federation,Israel,2641,1462,1179
1995,703,Slovakia,Israel,58,39,19
1995,804,Ukraine,Israel,4384,2177,2207
1995,208,Denmark,Israel,1251,818,433
1995,246,Finland,Israel,371,257,114
1995,352,Iceland,Israel,20,13,7
1995,372,Ireland,Israel,116,61,55
1995,428,Latvia,Israel,32,21,11
1995,440,Lithuania,Israel,34,22,12
1995,578,Norway,Israel,506,310,196
1995,752,Sweden,Israel,1414,866,548
1995,826,United Kingdom,Israel,11621,6029,5592
1995,300,Greece,Israel,1032,581,451
1995,380,Italy,Israel,4920,2826,2094
1995,470,Malta,Israel,10,6,4
1995,620,Portugal,Israel,60,36,24
1995,688,Serbia,Israel,84,44,40
1995,705,Slovenia,Israel,5,3,2
1995,724,Spain,Israel,796,526,270
1995,40,Austria,Israel,1593,908,685
1995,56,Belgium,Israel,4018,2257,1761
1995,250,France,Israel,6056,3009,3047
1995,276,Germany,Israel,9305,5493,3812
1995,442,Luxembourg,Israel,38,22,16
1995,528,Netherlands,Israel,3486,2029,1457
1995,756,Switzerland,Israel,2141,1247,894
1995,60,Bermuda,Israel,24,8,16
1995,124,Canada,Israel,16166,7833,8333
1995,840,United States of America,Israel,99193,50853,48340
2000,266,Gabon,Israel,7,4,3
2000,516,Namibia,Israel,143,79,64
2000,710,South Africa,Israel,1877,1019,858
2000,288,Ghana,Israel,27,14,13
2000,818,Egypt,Israel,518,303,215
2000,196,Cyprus,Israel,174,94,80
2000,268,Georgia,Israel,32,20,12
2000,400,Jordan,Israel,1906,1270,636
2000,422,Lebanon,Israel,865,548,317
2000,275,State of Palestine,Israel,93814,40159,53655
2000,792,Turkey,Israel,2533,1315,1218
2000,144,Sri Lanka,Israel,12,10,2
2000,608,Philippines,Israel,555,266,289
2000,136,Cayman Islands,Israel,13,2,11
2000,214,Dominican Republic,Israel,226,179,47
2000,630,Puerto Rico,Israel,97,46,51
2000,188,Costa Rica,Israel,130,84,46
2000,222,El Salvador,Israel,68,32,36
2000,320,Guatemala,Israel,83,51,32
2000,340,Honduras,Israel,67,43,24
2000,484,Mexico,Israel,1469,833,636
2000,591,Panama,Israel,560,365,195
2000,32,Argentina,Israel,1169,574,595
2000,68,Bolivia (Plurinational State of),Israel,180,110,70
2000,76,Brazil,Israel,1784,1068,716
2000,152,Chile,Israel,529,303,226
2000,170,Colombia,Israel,467,290,177
2000,218,Ecuador,Israel,216,133,83
2000,604,Peru,Israel,370,224,146
2000,862,Venezuela (Bolivarian Republic of),Israel,601,360,241
2000,36,Australia,Israel,7380,4049,3331
2000,112,Belarus,Israel,402,187,215
2000,100,Bulgaria,Israel,169,104,65
2000,203,Czechia,Israel,69,48,21
2000,348,Hungary,Israel,1147,663,484
2000,616,Poland,Israel,396,274,122
2000,498,Republic of Moldova,Israel,141,81,60
2000,642,Romania,Israel,785,604,181
2000,643,Russian Federation,Israel,2345,1476,869
2000,703,Slovakia,Israel,118,78,40
2000,804,Ukraine,Israel,4291,2197,2094
2000,208,Denmark,Israel,1454,928,526
2000,246,Finland,Israel,391,274,117
2000,352,Iceland,Israel,19,12,7
2000,372,Ireland,Israel,255,138,117
2000,428,Latvia,Israel,43,28,15
2000,440,Lithuania,Israel,26,17,9
2000,578,Norway,Israel,506,298,208
2000,752,Sweden,Israel,1517,925,592
2000,826,United Kingdom,Israel,11503,5959,5544
2000,300,Greece,Israel,667,378,289
2000,380,Italy,Israel,2553,1445,1108
2000,470,Malta,Israel,12,8,4
2000,620,Portugal,Israel,96,57,39
2000,688,Serbia,Israel,115,59,56
2000,705,Slovenia,Israel,19,16,3
2000,724,Spain,Israel,1280,847,433
2000,40,Austria,Israel,1774,1021,753
2000,56,Belgium,Israel,3827,2091,1736
2000,250,France,Israel,6245,3054,3191
2000,276,Germany,Israel,8951,5156,3795
2000,442,Luxembourg,Israel,37,21,16
2000,528,Netherlands,Israel,4136,2380,1756
2000,756,Switzerland,Israel,2537,1498,1039
2000,60,Bermuda,Israel,33,6,27
2000,124,Canada,Israel,16625,8020,8605
2000,840,United States of America,Israel,112505,58140,54365
2005,266,Gabon,Israel,8,5,3
2005,516,Namibia,Israel,113,63,50
2005,710,South Africa,Israel,2470,1290,1180
2005,288,Ghana,Israel,38,21,17
2005,818,Egypt,Israel,617,377,240
2005,196,Cyprus,Israel,255,137,118
2005,268,Georgia,Israel,30,19,11
2005,400,Jordan,Israel,2752,1945,807
2005,422,Lebanon,Israel,677,439,238
2005,275,State of Palestine,Israel,78664,33428,45236
2005,792,Turkey,Israel,2610,1327,1283
2005,144,Sri Lanka,Israel,26,17,9
2005,608,Philippines,Israel,449,219,230
2005,136,Cayman Islands,Israel,12,2,10
2005,214,Dominican Republic,Israel,143,111,32
2005,630,Puerto Rico,Israel,76,37,39
2005,188,Costa Rica,Israel,85,54,31
2005,222,El Salvador,Israel,55,25,30
2005,320,Guatemala,Israel,99,62,37
2005,340,Honduras,Israel,66,43,23
2005,484,Mexico,Israel,1248,726,522
2005,591,Panama,Israel,736,494,242
2005,32,Argentina,Israel,862,430,432
2005,68,Bolivia (Plurinational State of),Israel,168,100,68
2005,76,Brazil,Israel,1903,1148,755
2005,152,Chile,Israel,793,460,333
2005,170,Colombia,Israel,416,263,153
2005,218,Ecuador,Israel,255,159,96
2005,604,Peru,Israel,434,264,170
2005,862,Venezuela (Bolivarian Republic of),Israel,538,321,217
2005,36,Australia,Israel,8950,4950,4000
2005,112,Belarus,Israel,386,179,207
2005,100,Bulgaria,Israel,251,154,97
2005,203,Czechia,Israel,252,187,65
2005,348,Hungary,Israel,1418,831,587
2005,616,Poland,Israel,371,243,128
2005,498,Republic of Moldova,Israel,98,55,43
2005,642,Romania,Israel,849,646,203
2005,643,Russian Federation,Israel,2993,1743,1250
2005,703,Slovakia,Israel,133,88,45
2005,804,Ukraine,Israel,3920,2010,1910
2005,208,Denmark,Israel,1575,999,576
2005,246,Finland,Israel,566,398,168
2005,352,Iceland,Israel,26,17,9
2005,372,Ireland,Israel,256,146,110
2005,428,Latvia,Israel,81,49,32
2005,440,Lithuania,Israel,34,16,18
2005,578,Norway,Israel,613,371,242
2005,752,Sweden,Israel,2002,1233,769
2005,826,United Kingdom,Israel,13912,7242,6670
2005,191,Croatia,Israel,28,19,9
2005,300,Greece,Israel,698,390,308
2005,380,Italy,Israel,3218,1895,1323
2005,470,Malta,Israel,15,9,6
2005,620,Portugal,Israel,215,178,37
2005,688,Serbia,Israel,114,58,56
2005,705,Slovenia,Israel,30,18,12
2005,724,Spain,Israel,2184,1396,788
2005,40,Austria,Israel,1983,1121,862
2005,56,Belgium,Israel,3587,1996,1591
2005,250,France,Israel,8559,4256,4303
2005,276,Germany,Israel,10661,6630,4031
2005,442,Luxembourg,Israel,31,19,12
2005,528,Netherlands,Israel,5338,3025,2313
2005,756,Switzerland,Israel,2872,1634,1238
2005,60,Bermuda,Israel,54,25,29
2005,124,Canada,Israel,19930,10103,9827
2005,840,United States of America,Israel,124955,64908,60047
2010,266,Gabon,Israel,11,7,4
2010,516,Namibia,Israel,108,60,48
2010,710,South Africa,Israel,3868,2014,1854
2010,288,Ghana,Israel,38,22,16
2010,466,Mali,Israel,1091,584,507
2010,818,Egypt,Israel,666,397,269
2010,196,Cyprus,Israel,417,227,190
2010,268,Georgia,Israel,30,19,11
2010,400,Jordan,Israel,3539,2560,979
2010,422,Lebanon,Israel,489,330,159
2010,275,State of Palestine,Israel,63515,26697,36818
2010,792,Turkey,Israel,2689,1337,1352
2010,144,Sri Lanka,Israel,55,37,18
2010,608,Philippines,Israel,605,283,322
2010,136,Cayman Islands,Israel,12,2,10
2010,214,Dominican Republic,Israel,58,41,17
2010,630,Puerto Rico,Israel,46,22,24
2010,188,Costa Rica,Israel,168,108,60
2010,222,El Salvador,Israel,41,18,23
2010,320,Guatemala,Israel,114,73,41
2010,340,Honduras,Israel,64,42,22
2010,484,Mexico,Israel,1172,704,468
2010,591,Panama,Israel,948,650,298
2010,32,Argentina,Israel,555,287,268
2010,68,Bolivia (Plurinational State of),Israel,156,91,65
2010,76,Brazil,Israel,1994,1210,784
2010,152,Chile,Israel,1058,617,441
2010,170,Colombia,Israel,437,283,154
2010,218,Ecuador,Israel,358,220,138
2010,604,Peru,Israel,486,295,191
2010,862,Venezuela (Bolivarian Republic of),Israel,487,290,197
2010,36,Australia,Israel,10700,5974,4726
2010,112,Belarus,Israel,370,172,198
2010,100,Bulgaria,Israel,323,198,125
2010,203,Czechia,Israel,411,311,100
2010,348,Hungary,Israel,1688,998,690
2010,616,Poland,Israel,359,220,139
2010,498,Republic of Moldova,Israel,232,132,100
2010,642,Romania,Israel,1006,751,255
2010,643,Russian Federation,Israel,3580,1975,1605
2010,703,Slovakia,Israel,149,100,49
2010,804,Ukraine,Israel,3740,1921,1819
2010,208,Denmark,Israel,1665,1051,614
2010,233,Estonia,Israel,49,34,15
2010,246,Finland,Israel,894,605,289
2010,352,Iceland,Israel,31,20,11
2010,372,Ireland,Israel,215,116,99
2010,428,Latvia,Israel,117,67,50
2010,440,Lithuania,Israel,39,12,27
2010,578,Norway,Israel,713,413,300
2010,752,Sweden,Israel,2339,1399,940
2010,826,United Kingdom,Israel,14655,7773,6882
2010,191,Croatia,Israel,55,37,18
2010,300,Greece,Israel,757,417,340
2010,380,Italy,Israel,4541,2758,1783
2010,470,Malta,Israel,9,7,2
2010,620,Portugal,Israel,299,270,29
2010,688,Serbia,Israel,112,57,55
2010,705,Slovenia,Israel,39,25,14
2010,724,Spain,Israel,2659,1673,986
2010,40,Austria,Israel,2191,1221,970
2010,56,Belgium,Israel,3428,1984,1444
2010,250,France,Israel,8636,4124,4512
2010,276,Germany,Israel,12055,7832,4223
2010,442,Luxembourg,Israel,27,17,10
2010,528,Netherlands,Israel,5276,2962,2314
2010,756,Switzerland,Israel,3353,1828,1525
2010,60,Bermuda,Israel,74,43,31
2010,124,Canada,Israel,22845,11988,10857
2010,840,United States of America,Israel,141567,72602,68965
2015,266,Gabon,Israel,15,11,4
2015,516,Namibia,Israel,105,59,46
2015,710,South Africa,Israel,6976,3463,3513
2015,288,Ghana,Israel,46,27,19
2015,324,Guinea,Israel,11,7,4
2015,466,Mali,Israel,1351,723,628
2015,818,Egypt,Israel,493,320,173
2015,196,Cyprus,Israel,400,219,181
2015,268,Georgia,Israel,31,20,11
2015,400,Jordan,Israel,1523,1007,516
2015,422,Lebanon,Israel,412,198,214
2015,275,State of Palestine,Israel,62895,26351,36544
2015,792,Turkey,Israel,2729,1326,1403
2015,144,Sri Lanka,Israel,55,37,18
2015,608,Philippines,Israel,614,287,327
2015,136,Cayman Islands,Israel,12,3,9
2015,214,Dominican Republic,Israel,61,44,17
2015,630,Puerto Rico,Israel,45,21,24
2015,188,Costa Rica,Israel,170,109,61
2015,222,El Salvador,Israel,43,19,24
2015,320,Guatemala,Israel,131,85,46
2015,340,Honduras,Israel,90,60,30
2015,484,Mexico,Israel,1960,1172,788
2015,591,Panama,Israel,1114,764,350
2015,32,Argentina,Israel,557,288,269
2015,68,Bolivia (Plurinational State of),Israel,182,106,76
2015,76,Brazil,Israel,2401,1457,944
2015,152,Chile,Israel,1602,920,682
2015,170,Colombia,Israel,489,319,170
2015,218,Ecuador,Israel,520,318,202
2015,604,Peru,Israel,516,319,197
2015,862,Venezuela (Bolivarian Republic of),Israel,468,276,192
2015,36,Australia,Israel,11240,6356,4884
2015,112,Belarus,Israel,387,179,208
2015,100,Bulgaria,Israel,555,351,204
2015,203,Czechia,Israel,510,364,146
2015,348,Hungary,Israel,1664,993,671
2015,616,Poland,Israel,346,215,131
2015,498,Republic of Moldova,Israel,400,228,172
2015,642,Romania,Israel,1837,1338,499
2015,643,Russian Federation,Israel,3649,2005,1644
2015,703,Slovakia,Israel,192,134,58
2015,804,Ukraine,Israel,3752,1930,1822
2015,208,Denmark,Israel,1778,1131,647
2015,233,Estonia,Israel,65,35,30
2015,246,Finland,Israel,923,637,286
2015,352,Iceland,Israel,37,23,14
2015,372,Ireland,Israel,220,118,102
2015,428,Latvia,Israel,78,46,32
2015,440,Lithuania,Israel,18,0,18
2015,578,Norway,Israel,795,442,353
2015,752,Sweden,Israel,2611,1558,1053
2015,826,United Kingdom,Israel,18741,9679,9062
2015,191,Croatia,Israel,55,37,18
2015,300,Greece,Israel,710,378,332
2015,380,Italy,Israel,3703,2184,1519
2015,470,Malta,Israel,15,12,3
2015,620,Portugal,Israel,339,304,35
2015,688,Serbia,Israel,109,56,53
2015,705,Slovenia,Israel,34,23,11
2015,724,Spain,Israel,2858,1769,1089
2015,40,Austria,Israel,2562,1433,1129
2015,56,Belgium,Israel,3532,2095,1437
2015,250,France,Israel,9567,4431,5136
2015,276,Germany,Israel,12560,8149,4411
2015,442,Luxembourg,Israel,41,26,15
2015,528,Netherlands,Israel,5086,2858,2228
2015,756,Switzerland,Israel,3852,2097,1755
2015,60,Bermuda,Israel,75,44,31
2015,124,Canada,Israel,26571,14287,12284
2015,840,United States of America,Israel,129681,66026,63655
2019,266,Gabon,Israel,16,12,4
2019,516,Namibia,Israel,111,63,48
2019,710,South Africa,Israel,7818,3885,3933
2019,288,Ghana,Israel,51,30,21
2019,324,Guinea,Israel,10,7,3
2019,466,Mali,Israel,1504,805,699
2019,818,Egypt,Israel,702,427,275
2019,196,Cyprus,Israel,399,220,179
2019,268,Georgia,Israel,31,20,11
2019,400,Jordan,Israel,1637,1083,554
2019,422,Lebanon,Israel,389,187,202
2019,275,State of Palestine,Israel,62458,26168,36290
2019,792,Turkey,Israel,3690,1812,1878
2019,144,Sri Lanka,Israel,55,37,18
2019,608,Philippines,Israel,633,296,337
2019,136,Cayman Islands,Israel,13,3,10
2019,214,Dominican Republic,Israel,63,46,17
2019,630,Puerto Rico,Israel,42,20,22
2019,188,Costa Rica,Israel,172,111,61
2019,222,El Salvador,Israel,43,19,24
2019,320,Guatemala,Israel,134,87,47
2019,340,Honduras,Israel,91,61,30
2019,484,Mexico,Israel,2020,1208,812
2019,591,Panama,Israel,1185,814,371
2019,32,Argentina,Israel,566,292,274
2019,68,Bolivia (Plurinational State of),Israel,198,116,82
2019,76,Brazil,Israel,2704,1641,1063
2019,152,Chile,Israel,2140,1179,961
2019,170,Colombia,Israel,500,327,173
2019,218,Ecuador,Israel,511,313,198
2019,604,Peru,Israel,614,389,225
2019,862,Venezuela (Bolivarian Republic of),Israel,458,270,188
2019,36,Australia,Israel,12442,6986,5456
2019,112,Belarus,Israel,382,177,205
2019,100,Bulgaria,Israel,734,466,268
2019,203,Czechia,Israel,670,454,216
2019,348,Hungary,Israel,1662,994,668
2019,616,Poland,Israel,366,233,133
2019,498,Republic of Moldova,Israel,393,225,168
2019,642,Romania,Israel,3219,2333,886
2019,643,Russian Federation,Israel,3648,2005,1643
2019,703,Slovakia,Israel,220,154,66
2019,804,Ukraine,Israel,3789,1949,1840
2019,208,Denmark,Israel,1838,1139,699
2019,233,Estonia,Israel,84,47,37
2019,246,Finland,Israel,1065,719,346
2019,352,Iceland,Israel,43,27,16
2019,372,Ireland,Israel,241,130,111
2019,428,Latvia,Israel,83,53,30
2019,440,Lithuania,Israel,32,10,22
2019,578,Norway,Israel,928,511,417
2019,752,Sweden,Israel,2743,1611,1132
2019,826,United Kingdom,Israel,21282,11018,10264
2019,191,Croatia,Israel,50,34,16
2019,300,Greece,Israel,693,382,311
2019,380,Italy,Israel,4034,2384,1650
2019,470,Malta,Israel,24,20,4
2019,620,Portugal,Israel,344,309,35
2019,688,Serbia,Israel,110,57,53
2019,705,Slovenia,Israel,38,25,13
2019,724,Spain,Israel,2961,1806,1155
2019,40,Austria,Israel,3024,1715,1309
2019,56,Belgium,Israel,3607,2158,1449
2019,250,France,Israel,10126,4678,5448
2019,276,Germany,Israel,13777,8834,4943
2019,442,Luxembourg,Israel,255,137,118
2019,528,Netherlands,Israel,5817,3315,2502
2019,756,Switzerland,Israel,4091,2229,1862
2019,60,Bermuda,Israel,75,44,31
2019,124,Canada,Israel,28473,15310,13163
2019,840,United States of America,Israel,145719,74057,71662
1990,480,Mauritius,Italy,38,17,21
1990,690,Seychelles,Italy,22,13,9
1990,800,Uganda,Italy,390,356,34
1990,834,United Republic of Tanzania,Italy,360,207,153
1990,140,Central African Republic,Italy,7,2,5
1990,72,Botswana,Italy,161,105,56
1990,516,Namibia,Italy,1219,542,677
1990,710,South Africa,Italy,10652,5359,5293
1990,132,Cabo Verde,Italy,201,112,89
1990,288,Ghana,Italy,123,70,53
1990,324,Guinea,Italy,102,85,17
1990,430,Liberia,Italy,252,150,102
1990,478,Mauritania,Italy,50,22,28
1990,12,Algeria,Italy,3143,1767,1376
1990,818,Egypt,Italy,4657,2535,2122
1990,434,Libya,Italy,13295,7269,6026
1990,504,Morocco,Italy,1296,686,610
1990,788,Tunisia,Italy,1622,807,815
1990,196,Cyprus,Italy,120,61,59
1990,376,Israel,Italy,4617,2178,2439
1990,400,Jordan,Italy,518,234,284
1990,792,Turkey,Italy,1958,1079,879
1990,64,Bhutan,Italy,6,4,2
1990,462,Maldives,Italy,310,170,140
1990,144,Sri Lanka,Italy,3,3,0
1990,344,"China, Hong Kong SAR",Italy,430,279,151
1990,392,Japan,Italy,940,479,461
1990,496,Mongolia,Italy,3,3,0
1990,116,Cambodia,Italy,7,4,3
1990,608,Philippines,Italy,207,119,88
1990,764,Thailand,Italy,662,493,169
1990,28,Antigua and Barbuda,Italy,49,24,25
1990,44,Bahamas,Italy,78,52,26
1990,535,"Bonaire, Sint Eustatius and Saba",Italy,24,17,7
1990,136,Cayman Islands,Italy,28,25,3
1990,192,Cuba,Italy,492,359,133
1990,214,Dominican Republic,Italy,6960,4969,1991
1990,312,Guadeloupe,Italy,143,69,74
1990,332,Haiti,Italy,1227,866,361
1990,474,Martinique,Italy,37,18,19
1990,630,Puerto Rico,Italy,483,229,254
1990,662,Saint Lucia,Italy,7,3,4
1990,188,Costa Rica,Italy,1408,856,552
1990,222,El Salvador,Italy,391,275,116
1990,320,Guatemala,Italy,325,175,150
1990,340,Honduras,Italy,198,150,48
1990,484,Mexico,Italy,3503,2118,1385
1990,558,Nicaragua,Italy,187,124,63
1990,591,Panama,Italy,454,284,170
1990,32,Argentina,Italy,336040,163819,172221
1990,68,Bolivia (Plurinational State of),Italy,883,479,404
1990,76,Brazil,Italy,70081,38009,32072
1990,152,Chile,Italy,4422,2504,1918
1990,170,Colombia,Italy,2660,1689,971
1990,218,Ecuador,Italy,1252,752,500
1990,254,French Guiana,Italy,108,58,50
1990,600,Paraguay,Italy,699,415,284
1990,604,Peru,Italy,2086,1156,930
1990,858,Uruguay,Italy,15780,6051,9729
1990,862,Venezuela (Bolivarian Republic of),Italy,64792,40837,23955
1990,36,Australia,Italy,271095,145172,125923
1990,554,New Zealand,Italy,425,231,194
1990,540,New Caledonia,Italy,231,169,62
1990,258,French Polynesia,Italy,132,104,28
1990,112,Belarus,Italy,10,9,1
1990,100,Bulgaria,Italy,113,82,31
1990,203,Czechia,Italy,255,175,80
1990,348,Hungary,Italy,389,173,216
1990,616,Poland,Italy,6091,3226,2865
1990,498,Republic of Moldova,Italy,930,497,433
1990,642,Romania,Italy,461,200,261
1990,643,Russian Federation,Italy,1020,501,519
1990,703,Slovakia,Italy,41,27,14
1990,208,Denmark,Italy,2203,1570,633
1990,246,Finland,Italy,504,385,119
1990,352,Iceland,Italy,38,21,17
1990,372,Ireland,Italy,1296,773,523
1990,428,Latvia,Italy,16,8,8
1990,440,Lithuania,Italy,40,23,17
1990,578,Norway,Italy,1090,737,353
1990,752,Sweden,Italy,4979,3387,1592
1990,826,United Kingdom,Italy,88822,44154,44668
1990,8,Albania,Italy,11287,5573,5714
1990,20,Andorra,Italy,109,58,51
1990,70,Bosnia and Herzegovina,Italy,165,69,96
1990,191,Croatia,Italy,2065,841,1224
1990,300,Greece,Italy,12933,6235,6698
1990,470,Malta,Italy,665,378,287
1990,807,North Macedonia,Italy,39,16,23
1990,620,Portugal,Italy,985,529,456
1990,674,San Marino,Italy,2986,1595,1391
1990,688,Serbia,Italy,51,16,35
1990,705,Slovenia,Italy,4654,2015,2639
1990,724,Spain,Italy,12204,7415,4789
1990,40,Austria,Italy,18566,7824,10742
1990,56,Belgium,Italy,176201,94592,81609
1990,250,France,Italy,521793,258913,262880
1990,276,Germany,Italy,486516,303657,182859
1990,438,Liechtenstein,Italy,806,500,306
1990,442,Luxembourg,Italy,12479,7069,5410
1990,492,Monaco,Italy,3886,2233,1653
1990,528,Netherlands,Italy,14055,9777,4278
1990,756,Switzerland,Italy,208147,117155,90992
1990,60,Bermuda,Italy,81,56,25
1990,124,Canada,Italy,337392,164251,173141
1990,840,United States of America,Italy,580592,255422,325170
1995,480,Mauritius,Italy,56,31,25
1995,690,Seychelles,Italy,29,18,11
1995,800,Uganda,Italy,369,336,33
1995,834,United Republic of Tanzania,Italy,457,263,194
1995,140,Central African Republic,Italy,56,32,24
1995,72,Botswana,Italy,155,101,54
1995,516,Namibia,Italy,1165,522,643
1995,710,South Africa,Italy,8891,4764,4127
1995,132,Cabo Verde,Italy,253,144,109
1995,288,Ghana,Italy,123,75,48
1995,430,Liberia,Italy,246,146,100
1995,478,Mauritania,Italy,53,26,27
1995,12,Algeria,Italy,1942,1035,907
1995,818,Egypt,Italy,3710,1969,1741
1995,434,Libya,Italy,9034,4881,4153
1995,504,Morocco,Italy,1189,621,568
1995,788,Tunisia,Italy,1610,809,801
1995,196,Cyprus,Italy,170,83,87
1995,376,Israel,Italy,4981,2294,2687
1995,400,Jordan,Italy,447,205,242
1995,792,Turkey,Italy,2298,1283,1015
1995,64,Bhutan,Italy,7,5,2
1995,462,Maldives,Italy,352,174,178
1995,144,Sri Lanka,Italy,637,518,119
1995,344,"China, Hong Kong SAR",Italy,480,310,170
1995,392,Japan,Italy,1279,614,665
1995,496,Mongolia,Italy,3,3,0
1995,116,Cambodia,Italy,19,11,8
1995,608,Philippines,Italy,278,158,120
1995,764,Thailand,Italy,598,449,149
1995,28,Antigua and Barbuda,Italy,54,26,28
1995,44,Bahamas,Italy,86,54,32
1995,535,"Bonaire, Sint Eustatius and Saba",Italy,49,34,15
1995,136,Cayman Islands,Italy,54,47,7
1995,192,Cuba,Italy,373,268,105
1995,214,Dominican Republic,Italy,7731,5466,2265
1995,312,Guadeloupe,Italy,192,91,101
1995,332,Haiti,Italy,1165,823,342
1995,474,Martinique,Italy,55,26,29
1995,630,Puerto Rico,Italy,448,213,235
1995,662,Saint Lucia,Italy,9,4,5
1995,188,Costa Rica,Italy,1214,755,459
1995,222,El Salvador,Italy,312,215,97
1995,320,Guatemala,Italy,279,163,116
1995,340,Honduras,Italy,196,147,49
1995,484,Mexico,Italy,4434,2730,1704
1995,558,Nicaragua,Italy,149,98,51
1995,591,Panama,Italy,500,314,186
1995,32,Argentina,Italy,273401,131547,141854
1995,68,Bolivia (Plurinational State of),Italy,894,507,387
1995,76,Brazil,Italy,62623,34167,28456
1995,152,Chile,Italy,4062,2224,1838
1995,170,Colombia,Italy,2565,1637,928
1995,218,Ecuador,Italy,1424,849,575
1995,254,French Guiana,Italy,120,61,59
1995,600,Paraguay,Italy,845,513,332
1995,604,Peru,Italy,2088,1145,943
1995,858,Uruguay,Italy,14943,7070,7873
1995,862,Venezuela (Bolivarian Republic of),Italy,57175,35453,21722
1995,36,Australia,Italy,260694,138080,122614
1995,554,New Zealand,Italy,566,298,268
1995,540,New Caledonia,Italy,267,194,73
1995,258,French Polynesia,Italy,144,113,31
1995,112,Belarus,Italy,17,15,2
1995,100,Bulgaria,Italy,312,207,105
1995,203,Czechia,Italy,382,266,116
1995,348,Hungary,Italy,1499,896,603
1995,616,Poland,Italy,5210,2723,2487
1995,498,Republic of Moldova,Italy,628,328,300
1995,642,Romania,Italy,1436,1036,400
1995,643,Russian Federation,Italy,974,525,449
1995,703,Slovakia,Italy,793,571,222
1995,208,Denmark,Italy,2768,1942,826
1995,246,Finland,Italy,655,501,154
1995,352,Iceland,Italy,73,41,32
1995,372,Ireland,Italy,1977,1155,822
1995,428,Latvia,Italy,36,22,14
1995,440,Lithuania,Italy,45,26,19
1995,578,Norway,Italy,1157,754,403
1995,752,Sweden,Italy,5909,4006,1903
1995,826,United Kingdom,Italy,95453,47818,47635
1995,8,Albania,Italy,12200,6061,6139
1995,20,Andorra,Italy,130,69,61
1995,70,Bosnia and Herzegovina,Italy,189,79,110
1995,191,Croatia,Italy,1941,831,1110
1995,300,Greece,Italy,9328,4311,5017
1995,470,Malta,Italy,778,447,331
1995,807,North Macedonia,Italy,36,15,21
1995,620,Portugal,Italy,1436,816,620
1995,674,San Marino,Italy,3273,1805,1468
1995,688,Serbia,Italy,540,211,329
1995,705,Slovenia,Italy,3670,1614,2056
1995,724,Spain,Italy,16048,9924,6124
1995,40,Austria,Italy,20946,9025,11921
1995,56,Belgium,Italy,163850,89295,74555
1995,250,France,Italy,538661,262716,275945
1995,276,Germany,Italy,492300,302511,189789
1995,438,Liechtenstein,Italy,1148,694,454
1995,442,Luxembourg,Italy,14300,7627,6673
1995,492,Monaco,Italy,4180,2406,1774
1995,528,Netherlands,Italy,15067,10399,4668
1995,756,Switzerland,Italy,191945,110871,81074
1995,60,Bermuda,Italy,79,52,27
1995,124,Canada,Italy,322392,156243,166149
1995,840,United States of America,Italy,534018,235839,298179
2000,480,Mauritius,Italy,106,57,49
2000,690,Seychelles,Italy,37,23,14
2000,800,Uganda,Italy,370,336,34
2000,834,United Republic of Tanzania,Italy,482,278,204
2000,140,Central African Republic,Italy,101,60,41
2000,72,Botswana,Italy,165,107,58
2000,516,Namibia,Italy,1083,488,595
2000,710,South Africa,Italy,9798,5423,4375
2000,132,Cabo Verde,Italy,305,177,128
2000,288,Ghana,Italy,137,79,58
2000,430,Liberia,Italy,242,143,99
2000,478,Mauritania,Italy,54,29,25
2000,12,Algeria,Italy,740,302,438
2000,818,Egypt,Italy,3058,1561,1497
2000,434,Libya,Italy,4923,2672,2251
2000,504,Morocco,Italy,1253,644,609
2000,788,Tunisia,Italy,1620,824,796
2000,196,Cyprus,Italy,219,104,115
2000,268,Georgia,Italy,18,11,7
2000,376,Israel,Italy,5066,2311,2755
2000,400,Jordan,Italy,375,177,198
2000,792,Turkey,Italy,2648,1490,1158
2000,64,Bhutan,Italy,8,6,2
2000,462,Maldives,Italy,374,204,170
2000,144,Sri Lanka,Italy,1273,883,390
2000,344,"China, Hong Kong SAR",Italy,530,342,188
2000,392,Japan,Italy,1579,729,850
2000,496,Mongolia,Italy,4,4,0
2000,116,Cambodia,Italy,30,17,13
2000,608,Philippines,Italy,1020,506,514
2000,764,Thailand,Italy,658,493,165
2000,28,Antigua and Barbuda,Italy,59,29,30
2000,44,Bahamas,Italy,94,57,37
2000,535,"Bonaire, Sint Eustatius and Saba",Italy,75,52,23
2000,136,Cayman Islands,Italy,94,82,12
2000,192,Cuba,Italy,254,177,77
2000,214,Dominican Republic,Italy,8501,5962,2539
2000,312,Guadeloupe,Italy,240,112,128
2000,332,Haiti,Italy,1106,782,324
2000,474,Martinique,Italy,74,35,39
2000,630,Puerto Rico,Italy,416,198,218
2000,662,Saint Lucia,Italy,13,6,7
2000,188,Costa Rica,Italy,1626,1012,614
2000,222,El Salvador,Italy,233,156,77
2000,320,Guatemala,Italy,232,151,81
2000,340,Honduras,Italy,194,144,50
2000,484,Mexico,Italy,5558,3470,2088
2000,558,Nicaragua,Italy,155,111,44
2000,591,Panama,Italy,578,363,215
2000,32,Argentina,Italy,210762,99276,111486
2000,68,Bolivia (Plurinational State of),Italy,896,530,366
2000,76,Brazil,Italy,55164,30324,24840
2000,152,Chile,Italy,3699,2016,1683
2000,170,Colombia,Italy,2470,1585,885
2000,218,Ecuador,Italy,1595,946,649
2000,254,French Guiana,Italy,132,65,67
2000,600,Paraguay,Italy,990,609,381
2000,604,Peru,Italy,2448,1351,1097
2000,858,Uruguay,Italy,13403,7350,6053
2000,862,Venezuela (Bolivarian Republic of),Italy,49982,30443,19539
2000,36,Australia,Italy,234040,123800,110240
2000,554,New Zealand,Italy,1400,681,719
2000,540,New Caledonia,Italy,304,220,84
2000,258,French Polynesia,Italy,155,121,34
2000,112,Belarus,Italy,24,21,3
2000,100,Bulgaria,Italy,511,333,178
2000,203,Czechia,Italy,509,357,152
2000,348,Hungary,Italy,2609,1619,990
2000,616,Poland,Italy,4457,2297,2160
2000,498,Republic of Moldova,Italy,424,216,208
2000,642,Romania,Italy,2469,1912,557
2000,643,Russian Federation,Italy,894,530,364
2000,703,Slovakia,Italy,1764,1271,493
2000,208,Denmark,Italy,3333,2315,1018
2000,246,Finland,Italy,806,618,188
2000,352,Iceland,Italy,107,61,46
2000,372,Ireland,Italy,3745,2237,1508
2000,428,Latvia,Italy,57,36,21
2000,440,Lithuania,Italy,35,21,14
2000,578,Norway,Italy,1413,909,504
2000,752,Sweden,Italy,6337,4282,2055
2000,826,United Kingdom,Italy,103689,52163,51526
2000,8,Albania,Italy,13113,6549,6564
2000,20,Andorra,Italy,151,80,71
2000,70,Bosnia and Herzegovina,Italy,213,90,123
2000,191,Croatia,Italy,1609,746,863
2000,300,Greece,Italy,5876,2367,3509
2000,470,Malta,Italy,968,606,362
2000,807,North Macedonia,Italy,34,14,20
2000,620,Portugal,Italy,1946,1138,808
2000,674,San Marino,Italy,3540,2025,1515
2000,688,Serbia,Italy,1224,570,654
2000,705,Slovenia,Italy,4809,2174,2635
2000,724,Spain,Italy,26797,16867,9930
2000,40,Austria,Italy,23325,10226,13099
2000,56,Belgium,Italy,146188,79663,66525
2000,250,France,Italy,555528,266519,289009
2000,276,Germany,Italy,498084,301365,196719
2000,438,Liechtenstein,Italy,1471,871,600
2000,442,Luxembourg,Italy,16274,8277,7997
2000,492,Monaco,Italy,4480,2583,1897
2000,528,Netherlands,Italy,16607,11372,5235
2000,756,Switzerland,Italy,176442,105227,71215
2000,60,Bermuda,Italy,76,47,29
2000,124,Canada,Italy,315058,151986,163072
2000,840,United States of America,Italy,485357,215630,269727
2005,480,Mauritius,Italy,113,62,51
2005,690,Seychelles,Italy,73,44,29
2005,800,Uganda,Italy,358,325,33
2005,834,United Republic of Tanzania,Italy,536,310,226
2005,120,Cameroon,Italy,511,292,219
2005,140,Central African Republic,Italy,77,46,31
2005,72,Botswana,Italy,317,204,113
2005,516,Namibia,Italy,856,383,473
2005,710,South Africa,Italy,12890,6880,6010
2005,132,Cabo Verde,Italy,349,195,154
2005,288,Ghana,Italy,193,116,77
2005,430,Liberia,Italy,109,77,32
2005,478,Mauritania,Italy,54,30,24
2005,12,Algeria,Italy,584,239,345
2005,818,Egypt,Italy,3641,1969,1672
2005,434,Libya,Italy,5424,3387,2037
2005,504,Morocco,Italy,1285,651,634
2005,788,Tunisia,Italy,1548,794,754
2005,196,Cyprus,Italy,321,152,169
2005,268,Georgia,Italy,17,11,6
2005,376,Israel,Italy,5035,2267,2768
2005,400,Jordan,Italy,541,290,251
2005,792,Turkey,Italy,2728,1508,1220
2005,64,Bhutan,Italy,10,7,3
2005,462,Maldives,Italy,294,167,127
2005,144,Sri Lanka,Italy,2571,1288,1283
2005,344,"China, Hong Kong SAR",Italy,579,363,216
2005,392,Japan,Italy,2576,1173,1403
2005,496,Mongolia,Italy,9,6,3
2005,116,Cambodia,Italy,23,13,10
2005,608,Philippines,Italy,825,416,409
2005,764,Thailand,Italy,591,436,155
2005,28,Antigua and Barbuda,Italy,64,32,32
2005,44,Bahamas,Italy,120,77,43
2005,535,"Bonaire, Sint Eustatius and Saba",Italy,79,55,24
2005,136,Cayman Islands,Italy,85,74,11
2005,192,Cuba,Italy,170,119,51
2005,214,Dominican Republic,Italy,6070,4277,1793
2005,312,Guadeloupe,Italy,294,135,159
2005,332,Haiti,Italy,1050,743,307
2005,474,Martinique,Italy,77,36,41
2005,630,Puerto Rico,Italy,325,154,171
2005,662,Saint Lucia,Italy,14,7,7
2005,188,Costa Rica,Italy,1065,658,407
2005,222,El Salvador,Italy,252,165,87
2005,320,Guatemala,Italy,276,188,88
2005,340,Honduras,Italy,190,142,48
2005,484,Mexico,Italy,4972,3201,1771
2005,558,Nicaragua,Italy,166,127,39
2005,591,Panama,Italy,829,554,275
2005,32,Argentina,Italy,171388,78151,93237
2005,68,Bolivia (Plurinational State of),Italy,1062,620,442
2005,76,Brazil,Italy,46336,26203,20133
2005,152,Chile,Italy,5552,3067,2485
2005,170,Colombia,Italy,2343,1515,828
2005,218,Ecuador,Italy,1882,1132,750
2005,254,French Guiana,Italy,125,60,65
2005,600,Paraguay,Italy,943,581,362
2005,604,Peru,Italy,2867,1586,1281
2005,858,Uruguay,Italy,7655,4198,3457
2005,862,Venezuela (Bolivarian Republic of),Italy,49767,30862,18905
2005,36,Australia,Italy,220550,115075,105475
2005,554,New Zealand,Italy,1471,714,757
2005,540,New Caledonia,Italy,324,236,88
2005,258,French Polynesia,Italy,162,127,35
2005,112,Belarus,Italy,23,20,3
2005,100,Bulgaria,Italy,791,518,273
2005,203,Czechia,Italy,1467,1223,244
2005,348,Hungary,Italy,3222,2021,1201
2005,616,Poland,Italy,7266,3880,3386
2005,498,Republic of Moldova,Italy,293,146,147
2005,642,Romania,Italy,7152,4333,2819
2005,643,Russian Federation,Italy,1391,849,542
2005,703,Slovakia,Italy,1978,1434,544
2005,208,Denmark,Italy,4199,2843,1356
2005,246,Finland,Italy,1340,995,345
2005,352,Iceland,Italy,165,97,68
2005,372,Ireland,Italy,6259,3537,2722
2005,428,Latvia,Italy,189,128,61
2005,440,Lithuania,Italy,200,138,62
2005,578,Norway,Italy,1561,1013,548
2005,752,Sweden,Italy,6597,4419,2178
2005,826,United Kingdom,Italy,114731,58866,55865
2005,8,Albania,Italy,11069,5950,5119
2005,20,Andorra,Italy,349,185,164
2005,70,Bosnia and Herzegovina,Italy,128,53,75
2005,191,Croatia,Italy,2365,1172,1193
2005,300,Greece,Italy,6159,2545,3614
2005,470,Malta,Italy,1118,742,376
2005,807,North Macedonia,Italy,34,14,20
2005,620,Portugal,Italy,2372,1390,982
2005,674,San Marino,Italy,3714,2147,1567
2005,688,Serbia,Italy,2013,1080,933
2005,705,Slovenia,Italy,3956,1783,2173
2005,724,Spain,Italy,47475,29544,17931
2005,40,Austria,Italy,24376,11522,12854
2005,56,Belgium,Italy,126370,68144,58226
2005,250,France,Italy,373839,180965,192874
2005,276,Germany,Italy,410250,251850,158400
2005,438,Liechtenstein,Italy,1185,717,468
2005,442,Luxembourg,Italy,14814,7532,7282
2005,492,Monaco,Italy,4430,2510,1920
2005,528,Netherlands,Italy,17574,11680,5894
2005,756,Switzerland,Italy,198947,114787,84160
2005,60,Bermuda,Italy,74,41,33
2005,124,Canada,Italy,275657,135688,139969
2005,840,United States of America,Italy,438874,196328,242546
2010,480,Mauritius,Italy,127,72,55
2010,690,Seychelles,Italy,109,64,45
2010,800,Uganda,Italy,360,327,33
2010,834,United Republic of Tanzania,Italy,550,318,232
2010,120,Cameroon,Italy,407,241,166
2010,140,Central African Republic,Italy,76,45,31
2010,72,Botswana,Italy,470,302,168
2010,516,Namibia,Italy,824,370,454
2010,710,South Africa,Italy,20192,10743,9449
2010,132,Cabo Verde,Italy,392,212,180
2010,288,Ghana,Italy,192,118,74
2010,430,Liberia,Italy,50,27,23
2010,478,Mauritania,Italy,54,31,23
2010,12,Algeria,Italy,641,246,395
2010,818,Egypt,Italy,3930,2057,1873
2010,434,Libya,Italy,5934,3730,2204
2010,504,Morocco,Italy,1438,725,713
2010,788,Tunisia,Italy,1705,878,827
2010,196,Cyprus,Italy,525,252,273
2010,268,Georgia,Italy,17,11,6
2010,376,Israel,Italy,5066,2246,2820
2010,400,Jordan,Italy,696,392,304
2010,792,Turkey,Italy,2811,1526,1285
2010,64,Bhutan,Italy,12,8,4
2010,462,Maldives,Italy,229,129,100
2010,144,Sri Lanka,Italy,5236,2670,2566
2010,344,"China, Hong Kong SAR",Italy,629,385,244
2010,392,Japan,Italy,2731,1229,1502
2010,496,Mongolia,Italy,17,9,8
2010,116,Cambodia,Italy,17,10,7
2010,608,Philippines,Italy,1705,825,880
2010,764,Thailand,Italy,567,414,153
2010,28,Antigua and Barbuda,Italy,68,34,34
2010,44,Bahamas,Italy,146,97,49
2010,535,"Bonaire, Sint Eustatius and Saba",Italy,15,8,7
2010,136,Cayman Islands,Italy,85,74,11
2010,192,Cuba,Italy,94,66,28
2010,531,Curaçao,Italy,22,16,6
2010,214,Dominican Republic,Italy,3595,2561,1034
2010,312,Guadeloupe,Italy,348,159,189
2010,332,Haiti,Italy,1102,780,322
2010,474,Martinique,Italy,81,37,44
2010,630,Puerto Rico,Italy,195,91,104
2010,662,Saint Lucia,Italy,15,7,8
2010,188,Costa Rica,Italy,2100,1300,800
2010,222,El Salvador,Italy,270,173,97
2010,320,Guatemala,Italy,320,226,94
2010,340,Honduras,Italy,186,140,46
2010,484,Mexico,Italy,4964,3306,1658
2010,558,Nicaragua,Italy,177,136,41
2010,591,Panama,Italy,1121,777,344
2010,32,Argentina,Italy,132014,57027,74987
2010,68,Bolivia (Plurinational State of),Italy,1226,710,516
2010,76,Brazil,Italy,36843,21682,15161
2010,152,Chile,Italy,7404,4117,3287
2010,170,Colombia,Italy,2621,1718,903
2010,218,Ecuador,Italy,2644,1564,1080
2010,254,French Guiana,Italy,117,55,62
2010,600,Paraguay,Italy,898,553,345
2010,604,Peru,Italy,3521,1968,1553
2010,858,Uruguay,Italy,7095,3862,3233
2010,862,Venezuela (Bolivarian Republic of),Italy,50056,31598,18458
2010,36,Australia,Italy,204690,105567,99123
2010,554,New Zealand,Italy,1771,858,913
2010,540,New Caledonia,Italy,344,251,93
2010,258,French Polynesia,Italy,156,123,33
2010,112,Belarus,Italy,21,18,3
2010,100,Bulgaria,Italy,1038,682,356
2010,203,Czechia,Italy,2283,1980,303
2010,348,Hungary,Italy,3835,2423,1412
2010,616,Poland,Italy,10304,5563,4741
2010,498,Republic of Moldova,Italy,1669,849,820
2010,642,Romania,Italy,13083,7468,5615
2010,643,Russian Federation,Italy,1861,1152,709
2010,703,Slovakia,Italy,2217,1616,601
2010,208,Denmark,Italy,4975,3312,1663
2010,233,Estonia,Italy,295,214,81
2010,246,Finland,Italy,2210,1565,645
2010,352,Iceland,Italy,222,133,89
2010,372,Ireland,Italy,7743,3911,3832
2010,428,Latvia,Italy,317,216,101
2010,440,Lithuania,Italy,338,233,105
2010,578,Norway,Italy,2279,1469,810
2010,752,Sweden,Italy,7804,5119,2685
2010,826,United Kingdom,Italy,111540,57227,54313
2010,8,Albania,Italy,9025,4851,4174
2010,20,Andorra,Italy,527,278,249
2010,70,Bosnia and Herzegovina,Italy,117,49,68
2010,191,Croatia,Italy,3120,1598,1522
2010,300,Greece,Italy,6701,2833,3868
2010,470,Malta,Italy,1198,817,381
2010,499,Montenegro,Italy,186,53,133
2010,807,North Macedonia,Italy,35,14,21
2010,620,Portugal,Italy,2405,1414,991
2010,674,San Marino,Italy,4288,2577,1711
2010,688,Serbia,Italy,1968,1055,913
2010,705,Slovenia,Italy,4322,2143,2179
2010,724,Spain,Italy,87330,54205,33125
2010,40,Austria,Italy,25426,12818,12608
2010,56,Belgium,Italy,120471,61942,58529
2010,250,France,Italy,345189,161575,183614
2010,276,Germany,Italy,335329,207846,127483
2010,438,Liechtenstein,Italy,878,569,309
2010,442,Luxembourg,Italy,13517,6868,6649
2010,492,Monaco,Italy,4443,2471,1972
2010,528,Netherlands,Italy,20152,13068,7084
2010,756,Switzerland,Italy,233104,128581,104523
2010,60,Bermuda,Italy,72,35,37
2010,124,Canada,Italy,240825,119946,120879
2010,840,United States of America,Italy,404664,177947,226717
2015,480,Mauritius,Italy,146,86,60
2015,690,Seychelles,Italy,122,75,47
2015,800,Uganda,Italy,362,329,33
2015,834,United Republic of Tanzania,Italy,575,333,242
2015,120,Cameroon,Italy,519,279,240
2015,140,Central African Republic,Italy,66,39,27
2015,72,Botswana,Italy,512,329,183
2015,516,Namibia,Italy,806,363,443
2015,710,South Africa,Italy,36422,18510,17912
2015,132,Cabo Verde,Italy,407,219,188
2015,288,Ghana,Italy,236,145,91
2015,324,Guinea,Italy,82,47,35
2015,430,Liberia,Italy,57,31,26
2015,478,Mauritania,Italy,54,32,22
2015,12,Algeria,Italy,707,271,436
2015,818,Egypt,Italy,2913,1705,1208
2015,434,Libya,Italy,6690,4171,2519
2015,504,Morocco,Italy,1874,941,933
2015,788,Tunisia,Italy,2208,1143,1065
2015,196,Cyprus,Italy,504,244,260
2015,268,Georgia,Italy,17,11,6
2015,376,Israel,Italy,5225,2302,2923
2015,400,Jordan,Italy,299,139,160
2015,792,Turkey,Italy,2853,1520,1333
2015,64,Bhutan,Italy,13,9,4
2015,462,Maldives,Italy,164,91,73
2015,144,Sri Lanka,Italy,5130,2467,2663
2015,344,"China, Hong Kong SAR",Italy,642,383,259
2015,392,Japan,Italy,3536,1578,1958
2015,496,Mongolia,Italy,21,9,12
2015,116,Cambodia,Italy,15,9,6
2015,608,Philippines,Italy,1731,838,893
2015,764,Thailand,Italy,613,447,166
2015,28,Antigua and Barbuda,Italy,72,36,36
2015,44,Bahamas,Italy,158,105,53
2015,535,"Bonaire, Sint Eustatius and Saba",Italy,17,10,7
2015,136,Cayman Islands,Italy,91,80,11
2015,192,Cuba,Italy,75,53,22
2015,531,Curaçao,Italy,23,17,6
2015,214,Dominican Republic,Italy,4192,3120,1072
2015,312,Guadeloupe,Italy,361,163,198
2015,332,Haiti,Italy,1157,819,338
2015,474,Martinique,Italy,83,38,45
2015,630,Puerto Rico,Italy,192,90,102
2015,662,Saint Lucia,Italy,14,7,7
2015,188,Costa Rica,Italy,2132,1315,817
2015,222,El Salvador,Italy,282,181,101
2015,320,Guatemala,Italy,368,261,107
2015,340,Honduras,Italy,260,196,64
2015,484,Mexico,Italy,5892,4300,1592
2015,558,Nicaragua,Italy,190,146,44
2015,591,Panama,Italy,1318,913,405
2015,32,Argentina,Italy,152338,65756,86582
2015,68,Bolivia (Plurinational State of),Italy,1427,826,601
2015,76,Brazil,Italy,44366,26109,18257
2015,152,Chile,Italy,11216,6129,5087
2015,170,Colombia,Italy,2934,1933,1001
2015,218,Ecuador,Italy,3845,2263,1582
2015,254,French Guiana,Italy,118,55,63
2015,600,Paraguay,Italy,876,539,337
2015,604,Peru,Italy,4153,2479,1674
2015,858,Uruguay,Italy,7327,3987,3340
2015,862,Venezuela (Bolivarian Republic of),Italy,51068,31971,19097
2015,36,Australia,Italy,198510,103617,94893
2015,554,New Zealand,Italy,2044,989,1055
2015,540,New Caledonia,Italy,263,184,79
2015,258,French Polynesia,Italy,148,117,31
2015,112,Belarus,Italy,24,21,3
2015,100,Bulgaria,Italy,2830,1736,1094
2015,203,Czechia,Italy,3364,2880,484
2015,348,Hungary,Italy,4735,3036,1699
2015,616,Poland,Italy,9934,5450,4484
2015,498,Republic of Moldova,Italy,3285,1669,1616
2015,642,Romania,Italy,38580,21202,17378
2015,643,Russian Federation,Italy,1896,1170,726
2015,703,Slovakia,Italy,2841,2117,724
2015,208,Denmark,Italy,6629,4336,2293
2015,233,Estonia,Italy,626,436,190
2015,246,Finland,Italy,2993,2045,948
2015,352,Iceland,Italy,260,149,111
2015,372,Ireland,Italy,7910,3947,3963
2015,428,Latvia,Italy,249,175,74
2015,440,Lithuania,Italy,355,248,107
2015,578,Norway,Italy,4020,2543,1477
2015,752,Sweden,Italy,10769,6778,3991
2015,826,United Kingdom,Italy,152611,78066,74545
2015,8,Albania,Italy,8896,4782,4114
2015,20,Andorra,Italy,458,243,215
2015,70,Bosnia and Herzegovina,Italy,116,49,67
2015,191,Croatia,Italy,3140,1604,1536
2015,300,Greece,Italy,6289,2504,3785
2015,470,Malta,Italy,2166,1529,637
2015,499,Montenegro,Italy,209,61,148
2015,807,North Macedonia,Italy,37,15,22
2015,620,Portugal,Italy,2726,1546,1180
2015,674,San Marino,Italy,4460,2663,1797
2015,688,Serbia,Italy,1923,1029,894
2015,705,Slovenia,Italy,3646,2029,1617
2015,724,Spain,Italy,106324,64435,41889
2015,40,Austria,Italy,29738,15072,14666
2015,56,Belgium,Italy,119955,61660,58295
2015,250,France,Italy,324282,157540,166742
2015,276,Germany,Italy,349395,216252,133143
2015,438,Liechtenstein,Italy,860,545,315
2015,442,Luxembourg,Italy,20621,10634,9987
2015,492,Monaco,Italy,5841,3216,2625
2015,528,Netherlands,Italy,24402,15436,8966
2015,756,Switzerland,Italy,262749,147198,115551
2015,60,Bermuda,Italy,73,36,37
2015,124,Canada,Italy,235183,117814,117369
2015,840,United States of America,Italy,352492,153503,198989
2019,480,Mauritius,Italy,147,87,60
2019,690,Seychelles,Italy,123,76,47
2019,800,Uganda,Italy,362,329,33
2019,834,United Republic of Tanzania,Italy,515,297,218
2019,120,Cameroon,Italy,516,278,238
2019,140,Central African Republic,Italy,73,44,29
2019,72,Botswana,Italy,548,353,195
2019,516,Namibia,Italy,853,385,468
2019,710,South Africa,Italy,40824,20767,20057
2019,132,Cabo Verde,Italy,427,230,197
2019,288,Ghana,Italy,265,163,102
2019,324,Guinea,Italy,78,45,33
2019,430,Liberia,Italy,47,26,21
2019,478,Mauritania,Italy,56,34,22
2019,12,Algeria,Italy,735,282,453
2019,818,Egypt,Italy,4151,2226,1925
2019,434,Libya,Italy,7098,4426,2672
2019,504,Morocco,Italy,1998,1004,994
2019,788,Tunisia,Italy,2244,1163,1081
2019,196,Cyprus,Italy,503,246,257
2019,268,Georgia,Italy,17,11,6
2019,376,Israel,Italy,5081,2239,2842
2019,400,Jordan,Italy,321,149,172
2019,792,Turkey,Italy,3857,2073,1784
2019,64,Bhutan,Italy,13,9,4
2019,462,Maldives,Italy,176,98,78
2019,144,Sri Lanka,Italy,5170,2487,2683
2019,344,"China, Hong Kong SAR",Italy,831,486,345
2019,392,Japan,Italy,4010,1790,2220
2019,496,Mongolia,Italy,22,10,12
2019,116,Cambodia,Italy,15,9,6
2019,608,Philippines,Italy,1785,864,921
2019,764,Thailand,Italy,639,466,173
2019,28,Antigua and Barbuda,Italy,74,37,37
2019,44,Bahamas,Italy,167,111,56
2019,535,"Bonaire, Sint Eustatius and Saba",Italy,20,12,8
2019,136,Cayman Islands,Italy,101,90,11
2019,192,Cuba,Italy,68,48,20
2019,531,Curaçao,Italy,25,19,6
2019,214,Dominican Republic,Italy,4332,3225,1107
2019,312,Guadeloupe,Italy,366,165,201
2019,332,Haiti,Italy,1203,852,351
2019,474,Martinique,Italy,82,38,44
2019,630,Puerto Rico,Italy,182,85,97
2019,662,Saint Lucia,Italy,13,7,6
2019,188,Costa Rica,Italy,2163,1340,823
2019,222,El Salvador,Italy,285,183,102
2019,320,Guatemala,Italy,377,268,109
2019,340,Honduras,Italy,264,199,65
2019,484,Mexico,Italy,6074,4433,1641
2019,558,Nicaragua,Italy,199,153,46
2019,591,Panama,Italy,1406,975,431
2019,32,Argentina,Italy,155008,66764,88244
2019,68,Bolivia (Plurinational State of),Italy,1557,901,656
2019,76,Brazil,Italy,49965,29404,20561
2019,152,Chile,Italy,14985,7810,7175
2019,170,Colombia,Italy,3001,1978,1023
2019,218,Ecuador,Italy,3785,2227,1558
2019,254,French Guiana,Italy,130,61,69
2019,600,Paraguay,Italy,898,553,345
2019,604,Peru,Italy,4949,3056,1893
2019,858,Uruguay,Italy,7576,4133,3443
2019,862,Venezuela (Bolivarian Republic of),Italy,50022,31233,18789
2019,36,Australia,Italy,202617,105054,97563
2019,554,New Zealand,Italy,2101,1017,1084
2019,540,New Caledonia,Italy,276,193,83
2019,258,French Polynesia,Italy,153,121,32
2019,112,Belarus,Italy,23,21,2
2019,100,Bulgaria,Italy,3790,2327,1463
2019,203,Czechia,Italy,4006,3402,604
2019,348,Hungary,Italy,5562,3594,1968
2019,616,Poland,Italy,10520,5954,4566
2019,498,Republic of Moldova,Italy,3233,1644,1589
2019,642,Romania,Italy,61975,34262,27713
2019,643,Russian Federation,Italy,1895,1170,725
2019,703,Slovakia,Italy,3410,2556,854
2019,208,Denmark,Italy,9947,6303,3644
2019,233,Estonia,Italy,784,532,252
2019,246,Finland,Italy,3716,2478,1238
2019,352,Iceland,Italy,385,233,152
2019,372,Ireland,Italy,8684,4347,4337
2019,428,Latvia,Italy,255,194,61
2019,440,Lithuania,Italy,431,316,115
2019,578,Norway,Italy,4893,3091,1802
2019,752,Sweden,Italy,14288,8587,5701
2019,826,United Kingdom,Italy,173305,88866,84439
2019,8,Albania,Italy,8405,4519,3886
2019,20,Andorra,Italy,488,261,227
2019,70,Bosnia and Herzegovina,Italy,107,45,62
2019,191,Croatia,Italy,2899,1477,1422
2019,300,Greece,Italy,6141,2585,3556
2019,470,Malta,Italy,3495,2475,1020
2019,499,Montenegro,Italy,209,62,147
2019,807,North Macedonia,Italy,37,15,22
2019,620,Portugal,Italy,2772,1575,1197
2019,674,San Marino,Italy,4727,2743,1984
2019,688,Serbia,Italy,1953,1046,907
2019,705,Slovenia,Italy,4027,2366,1661
2019,724,Spain,Italy,125820,74544,51276
2019,40,Austria,Italy,35105,18090,17015
2019,56,Belgium,Italy,126432,65517,60915
2019,250,France,Italy,343255,166355,176900
2019,276,Germany,Italy,578841,358407,220434
2019,438,Liechtenstein,Italy,892,562,330
2019,442,Luxembourg,Italy,19659,11529,8130
2019,492,Monaco,Italy,5959,3280,2679
2019,528,Netherlands,Italy,32013,19722,12291
2019,756,Switzerland,Italy,273918,154265,119653
2019,60,Bermuda,Italy,73,36,37
2019,124,Canada,Italy,252025,126251,125774
2019,840,United States of America,Italy,340419,147882,192537
1990,710,South Africa,Jamaica,192,51,141
1990,196,Cyprus,Jamaica,4,2,2
1990,660,Anguilla,Jamaica,220,128,92
1990,28,Antigua and Barbuda,Jamaica,386,185,201
1990,533,Aruba,Jamaica,162,24,138
1990,44,Bahamas,Jamaica,2792,746,2046
1990,52,Barbados,Jamaica,622,197,425
1990,92,British Virgin Islands,Jamaica,272,114,158
1990,535,"Bonaire, Sint Eustatius and Saba",Jamaica,450,189,261
1990,136,Cayman Islands,Jamaica,3767,1620,2147
1990,192,Cuba,Jamaica,656,322,334
1990,212,Dominica,Jamaica,47,16,31
1990,214,Dominican Republic,Jamaica,421,283,138
1990,308,Grenada,Jamaica,65,32,33
1990,630,Puerto Rico,Jamaica,84,40,44
1990,659,Saint Kitts and Nevis,Jamaica,62,29,33
1990,662,Saint Lucia,Jamaica,78,31,47
1990,670,Saint Vincent and the Grenadines,Jamaica,111,58,53
1990,780,Trinidad and Tobago,Jamaica,811,394,417
1990,850,United States Virgin Islands,Jamaica,260,116,144
1990,84,Belize,Jamaica,445,260,185
1990,188,Costa Rica,Jamaica,356,171,185
1990,222,El Salvador,Jamaica,16,9,7
1990,340,Honduras,Jamaica,20,16,4
1990,484,Mexico,Jamaica,116,24,92
1990,558,Nicaragua,Jamaica,39,23,16
1990,591,Panama,Jamaica,942,394,548
1990,32,Argentina,Jamaica,27,27,0
1990,68,Bolivia (Plurinational State of),Jamaica,5,3,2
1990,76,Brazil,Jamaica,24,24,0
1990,152,Chile,Jamaica,14,6,8
1990,170,Colombia,Jamaica,96,49,47
1990,218,Ecuador,Jamaica,13,6,7
1990,328,Guyana,Jamaica,83,44,39
1990,862,Venezuela (Bolivarian Republic of),Jamaica,220,94,126
1990,36,Australia,Jamaica,662,321,341
1990,100,Bulgaria,Jamaica,1,0,1
1990,203,Czechia,Jamaica,1,1,0
1990,348,Hungary,Jamaica,4,3,1
1990,208,Denmark,Jamaica,74,32,42
1990,246,Finland,Jamaica,21,16,5
1990,352,Iceland,Jamaica,5,2,3
1990,372,Ireland,Jamaica,23,8,15
1990,578,Norway,Jamaica,44,17,27
1990,752,Sweden,Jamaica,153,91,62
1990,826,United Kingdom,Jamaica,138898,67029,71869
1990,300,Greece,Jamaica,72,40,32
1990,380,Italy,Jamaica,38,13,25
1990,620,Portugal,Jamaica,7,4,3
1990,724,Spain,Jamaica,20,7,13
1990,40,Austria,Jamaica,115,49,66
1990,56,Belgium,Jamaica,264,97,167
1990,250,France,Jamaica,463,185,278
1990,276,Germany,Jamaica,701,314,387
1990,528,Netherlands,Jamaica,392,153,239
1990,756,Switzerland,Jamaica,430,185,245
1990,60,Bermuda,Jamaica,316,98,218
1990,124,Canada,Jamaica,98288,47849,50439
1990,840,United States of America,Jamaica,334140,145948,188192
1995,710,South Africa,Jamaica,119,39,80
1995,196,Cyprus,Jamaica,6,3,3
1995,660,Anguilla,Jamaica,283,162,121
1995,28,Antigua and Barbuda,Jamaica,1832,642,1190
1995,533,Aruba,Jamaica,439,125,314
1995,44,Bahamas,Jamaica,3282,1020,2262
1995,52,Barbados,Jamaica,679,223,456
1995,92,British Virgin Islands,Jamaica,320,129,191
1995,535,"Bonaire, Sint Eustatius and Saba",Jamaica,938,392,546
1995,136,Cayman Islands,Jamaica,4987,2177,2810
1995,192,Cuba,Jamaica,497,233,264
1995,212,Dominica,Jamaica,62,21,41
1995,214,Dominican Republic,Jamaica,468,311,157
1995,308,Grenada,Jamaica,85,42,43
1995,630,Puerto Rico,Jamaica,88,42,46
1995,659,Saint Kitts and Nevis,Jamaica,82,39,43
1995,662,Saint Lucia,Jamaica,105,43,62
1995,670,Saint Vincent and the Grenadines,Jamaica,115,57,58
1995,780,Trinidad and Tobago,Jamaica,736,357,379
1995,850,United States Virgin Islands,Jamaica,305,136,169
1995,84,Belize,Jamaica,424,253,171
1995,188,Costa Rica,Jamaica,209,99,110
1995,222,El Salvador,Jamaica,13,7,6
1995,340,Honduras,Jamaica,20,16,4
1995,484,Mexico,Jamaica,115,36,79
1995,558,Nicaragua,Jamaica,31,18,13
1995,591,Panama,Jamaica,724,305,419
1995,32,Argentina,Jamaica,26,26,0
1995,68,Bolivia (Plurinational State of),Jamaica,4,2,2
1995,76,Brazil,Jamaica,41,30,11
1995,152,Chile,Jamaica,17,11,6
1995,170,Colombia,Jamaica,81,42,39
1995,218,Ecuador,Jamaica,15,7,8
1995,328,Guyana,Jamaica,124,66,58
1995,862,Venezuela (Bolivarian Republic of),Jamaica,167,75,92
1995,36,Australia,Jamaica,830,427,403
1995,100,Bulgaria,Jamaica,2,0,2
1995,203,Czechia,Jamaica,2,1,1
1995,348,Hungary,Jamaica,12,8,4
1995,208,Denmark,Jamaica,103,50,53
1995,246,Finland,Jamaica,25,17,8
1995,352,Iceland,Jamaica,7,3,4
1995,372,Ireland,Jamaica,64,20,44
1995,578,Norway,Jamaica,54,24,30
1995,752,Sweden,Jamaica,181,106,75
1995,826,United Kingdom,Jamaica,139059,65648,73411
1995,300,Greece,Jamaica,68,37,31
1995,380,Italy,Jamaica,106,33,73
1995,620,Portugal,Jamaica,16,8,8
1995,724,Spain,Jamaica,31,12,19
1995,40,Austria,Jamaica,130,57,73
1995,56,Belgium,Jamaica,264,97,167
1995,250,France,Jamaica,478,186,292
1995,276,Germany,Jamaica,985,406,579
1995,528,Netherlands,Jamaica,577,217,360
1995,756,Switzerland,Jamaica,491,230,261
1995,60,Bermuda,Jamaica,374,125,249
1995,124,Canada,Jamaica,108174,52392,55782
1995,840,United States of America,Jamaica,449926,197556,252370
2000,710,South Africa,Jamaica,82,36,46
2000,196,Cyprus,Jamaica,7,3,4
2000,660,Anguilla,Jamaica,346,196,150
2000,28,Antigua and Barbuda,Jamaica,3278,1099,2179
2000,533,Aruba,Jamaica,715,226,489
2000,44,Bahamas,Jamaica,3773,1295,2478
2000,52,Barbados,Jamaica,736,248,488
2000,92,British Virgin Islands,Jamaica,368,145,223
2000,535,"Bonaire, Sint Eustatius and Saba",Jamaica,1426,595,831
2000,136,Cayman Islands,Jamaica,7468,3269,4199
2000,192,Cuba,Jamaica,338,145,193
2000,212,Dominica,Jamaica,74,26,48
2000,214,Dominican Republic,Jamaica,514,338,176
2000,308,Grenada,Jamaica,105,52,53
2000,630,Puerto Rico,Jamaica,94,45,49
2000,659,Saint Kitts and Nevis,Jamaica,116,56,60
2000,662,Saint Lucia,Jamaica,144,59,85
2000,670,Saint Vincent and the Grenadines,Jamaica,119,59,60
2000,780,Trinidad and Tobago,Jamaica,798,392,406
2000,850,United States Virgin Islands,Jamaica,352,157,195
2000,84,Belize,Jamaica,403,246,157
2000,188,Costa Rica,Jamaica,166,72,94
2000,222,El Salvador,Jamaica,9,5,4
2000,340,Honduras,Jamaica,20,16,4
2000,484,Mexico,Jamaica,121,51,70
2000,558,Nicaragua,Jamaica,24,15,9
2000,591,Panama,Jamaica,553,233,320
2000,32,Argentina,Jamaica,25,25,0
2000,68,Bolivia (Plurinational State of),Jamaica,2,1,1
2000,76,Brazil,Jamaica,57,36,21
2000,152,Chile,Jamaica,21,13,8
2000,170,Colombia,Jamaica,66,35,31
2000,218,Ecuador,Jamaica,16,7,9
2000,328,Guyana,Jamaica,165,89,76
2000,862,Venezuela (Bolivarian Republic of),Jamaica,126,59,67
2000,36,Australia,Jamaica,930,486,444
2000,100,Bulgaria,Jamaica,3,1,2
2000,203,Czechia,Jamaica,3,2,1
2000,348,Hungary,Jamaica,19,12,7
2000,208,Denmark,Jamaica,132,68,64
2000,246,Finland,Jamaica,29,19,10
2000,352,Iceland,Jamaica,9,4,5
2000,372,Ireland,Jamaica,139,45,94
2000,578,Norway,Jamaica,73,27,46
2000,752,Sweden,Jamaica,195,114,81
2000,826,United Kingdom,Jamaica,141559,65181,76378
2000,300,Greece,Jamaica,65,33,32
2000,380,Italy,Jamaica,173,53,120
2000,620,Portugal,Jamaica,26,12,14
2000,705,Slovenia,Jamaica,2,2,0
2000,724,Spain,Jamaica,378,167,211
2000,40,Austria,Jamaica,144,64,80
2000,56,Belgium,Jamaica,255,94,161
2000,250,France,Jamaica,493,188,305
2000,276,Germany,Jamaica,1269,498,771
2000,528,Netherlands,Jamaica,784,289,495
2000,756,Switzerland,Jamaica,554,275,279
2000,60,Bermuda,Jamaica,432,153,279
2000,124,Canada,Jamaica,120632,58193,62439
2000,840,United States of America,Jamaica,567890,250525,317365
2005,710,South Africa,Jamaica,107,42,65
2005,196,Cyprus,Jamaica,10,4,6
2005,660,Anguilla,Jamaica,398,226,172
2005,28,Antigua and Barbuda,Jamaica,3515,1176,2339
2005,533,Aruba,Jamaica,719,231,488
2005,44,Bahamas,Jamaica,5349,1715,3634
2005,52,Barbados,Jamaica,839,287,552
2005,92,British Virgin Islands,Jamaica,422,166,256
2005,535,"Bonaire, Sint Eustatius and Saba",Jamaica,1519,634,885
2005,136,Cayman Islands,Jamaica,8110,3839,4271
2005,192,Cuba,Jamaica,226,97,129
2005,212,Dominica,Jamaica,91,31,60
2005,214,Dominican Republic,Jamaica,321,216,105
2005,308,Grenada,Jamaica,109,54,55
2005,630,Puerto Rico,Jamaica,73,35,38
2005,659,Saint Kitts and Nevis,Jamaica,128,62,66
2005,662,Saint Lucia,Jamaica,286,110,176
2005,670,Saint Vincent and the Grenadines,Jamaica,122,62,60
2005,534,Sint Maarten (Dutch part),Jamaica,1134,487,647
2005,780,Trinidad and Tobago,Jamaica,856,420,436
2005,850,United States Virgin Islands,Jamaica,362,163,199
2005,84,Belize,Jamaica,412,251,161
2005,188,Costa Rica,Jamaica,109,47,62
2005,222,El Salvador,Jamaica,10,6,4
2005,340,Honduras,Jamaica,20,16,4
2005,484,Mexico,Jamaica,116,59,57
2005,558,Nicaragua,Jamaica,18,12,6
2005,591,Panama,Jamaica,559,252,307
2005,32,Argentina,Jamaica,18,18,0
2005,68,Bolivia (Plurinational State of),Jamaica,4,2,2
2005,76,Brazil,Jamaica,98,77,21
2005,152,Chile,Jamaica,31,20,11
2005,170,Colombia,Jamaica,56,31,25
2005,218,Ecuador,Jamaica,19,9,10
2005,328,Guyana,Jamaica,209,113,96
2005,862,Venezuela (Bolivarian Republic of),Jamaica,111,50,61
2005,36,Australia,Jamaica,1000,518,482
2005,100,Bulgaria,Jamaica,5,2,3
2005,203,Czechia,Jamaica,7,4,3
2005,348,Hungary,Jamaica,25,17,8
2005,208,Denmark,Jamaica,144,70,74
2005,246,Finland,Jamaica,44,27,17
2005,352,Iceland,Jamaica,13,4,9
2005,372,Ireland,Jamaica,139,50,89
2005,578,Norway,Jamaica,116,51,65
2005,752,Sweden,Jamaica,222,131,91
2005,826,United Kingdom,Jamaica,141923,63763,78160
2005,300,Greece,Jamaica,39,19,20
2005,380,Italy,Jamaica,260,97,163
2005,620,Portugal,Jamaica,26,14,12
2005,705,Slovenia,Jamaica,5,5,0
2005,724,Spain,Jamaica,182,79,103
2005,40,Austria,Jamaica,161,69,92
2005,56,Belgium,Jamaica,305,120,185
2005,250,France,Jamaica,732,274,458
2005,276,Germany,Jamaica,1586,678,908
2005,528,Netherlands,Jamaica,862,326,536
2005,756,Switzerland,Jamaica,612,284,328
2005,60,Bermuda,Jamaica,517,235,282
2005,124,Canada,Jamaica,119447,53785,65662
2005,840,United States of America,Jamaica,611604,271699,339905
2010,710,South Africa,Jamaica,167,65,102
2010,196,Cyprus,Jamaica,16,7,9
2010,660,Anguilla,Jamaica,433,247,186
2010,28,Antigua and Barbuda,Jamaica,3752,1253,2499
2010,533,Aruba,Jamaica,709,231,478
2010,44,Bahamas,Jamaica,6925,2136,4789
2010,52,Barbados,Jamaica,947,328,619
2010,92,British Virgin Islands,Jamaica,1697,709,988
2010,535,"Bonaire, Sint Eustatius and Saba",Jamaica,347,165,182
2010,136,Cayman Islands,Jamaica,9467,4769,4698
2010,192,Cuba,Jamaica,125,53,72
2010,531,Curaçao,Jamaica,1197,348,849
2010,212,Dominica,Jamaica,111,38,73
2010,214,Dominican Republic,Jamaica,126,92,34
2010,308,Grenada,Jamaica,114,56,58
2010,630,Puerto Rico,Jamaica,44,21,23
2010,659,Saint Kitts and Nevis,Jamaica,138,68,70
2010,662,Saint Lucia,Jamaica,407,163,244
2010,670,Saint Vincent and the Grenadines,Jamaica,125,64,61
2010,534,Sint Maarten (Dutch part),Jamaica,2269,974,1295
2010,780,Trinidad and Tobago,Jamaica,1445,748,697
2010,850,United States Virgin Islands,Jamaica,373,169,204
2010,84,Belize,Jamaica,421,257,164
2010,188,Costa Rica,Jamaica,214,91,123
2010,222,El Salvador,Jamaica,10,6,4
2010,340,Honduras,Jamaica,19,16,3
2010,484,Mexico,Jamaica,126,75,51
2010,558,Nicaragua,Jamaica,19,13,6
2010,591,Panama,Jamaica,593,288,305
2010,32,Argentina,Jamaica,11,11,0
2010,68,Bolivia (Plurinational State of),Jamaica,6,4,2
2010,76,Brazil,Jamaica,137,116,21
2010,152,Chile,Jamaica,42,27,15
2010,170,Colombia,Jamaica,56,33,23
2010,218,Ecuador,Jamaica,26,12,14
2010,328,Guyana,Jamaica,252,137,115
2010,862,Venezuela (Bolivarian Republic of),Jamaica,99,43,56
2010,36,Australia,Jamaica,1090,576,514
2010,100,Bulgaria,Jamaica,6,3,3
2010,203,Czechia,Jamaica,11,7,4
2010,348,Hungary,Jamaica,30,21,9
2010,208,Denmark,Jamaica,152,71,81
2010,233,Estonia,Jamaica,2,1,1
2010,246,Finland,Jamaica,70,37,33
2010,352,Iceland,Jamaica,17,5,12
2010,372,Ireland,Jamaica,117,37,80
2010,428,Latvia,Jamaica,1,1,0
2010,578,Norway,Jamaica,145,69,76
2010,752,Sweden,Jamaica,280,168,112
2010,826,United Kingdom,Jamaica,147673,61806,85867
2010,300,Greece,Jamaica,12,4,8
2010,380,Italy,Jamaica,373,145,228
2010,620,Portugal,Jamaica,23,14,9
2010,705,Slovenia,Jamaica,7,6,1
2010,724,Spain,Jamaica,262,122,140
2010,40,Austria,Jamaica,178,75,103
2010,56,Belgium,Jamaica,338,122,216
2010,250,France,Jamaica,486,178,308
2010,276,Germany,Jamaica,1846,827,1019
2010,528,Netherlands,Jamaica,823,320,503
2010,756,Switzerland,Jamaica,732,322,410
2010,60,Bermuda,Jamaica,601,317,284
2010,124,Canada,Jamaica,126035,53038,72997
2010,840,United States of America,Jamaica,675237,294805,380432
2015,710,South Africa,Jamaica,300,108,192
2015,196,Cyprus,Jamaica,15,7,8
2015,660,Anguilla,Jamaica,464,265,199
2015,28,Antigua and Barbuda,Jamaica,3990,1331,2659
2015,533,Aruba,Jamaica,746,243,503
2015,44,Bahamas,Jamaica,7503,2276,5227
2015,52,Barbados,Jamaica,994,344,650
2015,92,British Virgin Islands,Jamaica,1901,794,1107
2015,535,"Bonaire, Sint Eustatius and Saba",Jamaica,394,187,207
2015,136,Cayman Islands,Jamaica,10348,5188,5160
2015,192,Cuba,Jamaica,100,42,58
2015,531,Curaçao,Jamaica,1300,379,921
2015,212,Dominica,Jamaica,129,44,85
2015,214,Dominican Republic,Jamaica,132,97,35
2015,308,Grenada,Jamaica,115,57,58
2015,630,Puerto Rico,Jamaica,43,20,23
2015,659,Saint Kitts and Nevis,Jamaica,141,70,71
2015,662,Saint Lucia,Jamaica,390,156,234
2015,670,Saint Vincent and the Grenadines,Jamaica,126,60,66
2015,534,Sint Maarten (Dutch part),Jamaica,2364,1013,1351
2015,780,Trinidad and Tobago,Jamaica,1497,787,710
2015,850,United States Virgin Islands,Jamaica,373,169,204
2015,84,Belize,Jamaica,496,302,194
2015,188,Costa Rica,Jamaica,217,92,125
2015,222,El Salvador,Jamaica,10,6,4
2015,340,Honduras,Jamaica,27,23,4
2015,484,Mexico,Jamaica,133,79,54
2015,558,Nicaragua,Jamaica,20,14,6
2015,591,Panama,Jamaica,697,337,360
2015,32,Argentina,Jamaica,11,11,0
2015,68,Bolivia (Plurinational State of),Jamaica,7,5,2
2015,76,Brazil,Jamaica,165,140,25
2015,152,Chile,Jamaica,63,41,22
2015,170,Colombia,Jamaica,62,37,25
2015,218,Ecuador,Jamaica,37,17,20
2015,328,Guyana,Jamaica,295,160,135
2015,862,Venezuela (Bolivarian Republic of),Jamaica,95,41,54
2015,36,Australia,Jamaica,1290,696,594
2015,100,Bulgaria,Jamaica,5,2,3
2015,203,Czechia,Jamaica,22,14,8
2015,348,Hungary,Jamaica,26,14,12
2015,208,Denmark,Jamaica,181,81,100
2015,233,Estonia,Jamaica,2,1,1
2015,246,Finland,Jamaica,95,57,38
2015,352,Iceland,Jamaica,18,5,13
2015,372,Ireland,Jamaica,120,37,83
2015,428,Latvia,Jamaica,1,1,0
2015,578,Norway,Jamaica,162,76,86
2015,752,Sweden,Jamaica,355,222,133
2015,826,United Kingdom,Jamaica,138924,54660,84264
2015,300,Greece,Jamaica,11,4,7
2015,380,Italy,Jamaica,345,133,212
2015,620,Portugal,Jamaica,26,15,11
2015,705,Slovenia,Jamaica,9,6,3
2015,724,Spain,Jamaica,282,134,148
2015,40,Austria,Jamaica,208,89,119
2015,56,Belgium,Jamaica,397,155,242
2015,250,France,Jamaica,537,186,351
2015,276,Germany,Jamaica,1923,859,1064
2015,528,Netherlands,Jamaica,930,385,545
2015,756,Switzerland,Jamaica,780,327,453
2015,60,Bermuda,Jamaica,609,322,287
2015,124,Canada,Jamaica,137496,59552,77944
2015,840,United States of America,Jamaica,711134,307426,403708
2019,710,South Africa,Jamaica,336,122,214
2019,196,Cyprus,Jamaica,14,7,7
2019,660,Anguilla,Jamaica,481,275,206
2019,28,Antigua and Barbuda,Jamaica,4149,1384,2765
2019,533,Aruba,Jamaica,754,246,508
2019,44,Bahamas,Jamaica,7965,2416,5549
2019,52,Barbados,Jamaica,1003,347,656
2019,92,British Virgin Islands,Jamaica,2064,862,1202
2019,535,"Bonaire, Sint Eustatius and Saba",Jamaica,469,223,246
2019,136,Cayman Islands,Jamaica,11448,5742,5706
2019,192,Cuba,Jamaica,91,38,53
2019,531,Curaçao,Jamaica,1413,412,1001
2019,212,Dominica,Jamaica,131,45,86
2019,214,Dominican Republic,Jamaica,136,100,36
2019,308,Grenada,Jamaica,116,58,58
2019,630,Puerto Rico,Jamaica,40,19,21
2019,659,Saint Kitts and Nevis,Jamaica,143,71,72
2019,662,Saint Lucia,Jamaica,376,150,226
2019,670,Saint Vincent and the Grenadines,Jamaica,126,60,66
2019,534,Sint Maarten (Dutch part),Jamaica,2447,1049,1398
2019,780,Trinidad and Tobago,Jamaica,1611,882,729
2019,850,United States Virgin Islands,Jamaica,373,169,204
2019,84,Belize,Jamaica,544,332,212
2019,188,Costa Rica,Jamaica,220,94,126
2019,222,El Salvador,Jamaica,10,6,4
2019,340,Honduras,Jamaica,27,23,4
2019,484,Mexico,Jamaica,137,82,55
2019,558,Nicaragua,Jamaica,20,14,6
2019,591,Panama,Jamaica,735,356,379
2019,32,Argentina,Jamaica,11,11,0
2019,68,Bolivia (Plurinational State of),Jamaica,7,5,2
2019,76,Brazil,Jamaica,185,157,28
2019,152,Chile,Jamaica,84,53,31
2019,170,Colombia,Jamaica,63,38,25
2019,218,Ecuador,Jamaica,36,17,19
2019,328,Guyana,Jamaica,301,164,137
2019,862,Venezuela (Bolivarian Republic of),Jamaica,93,40,53
2019,36,Australia,Jamaica,1385,725,660
2019,100,Bulgaria,Jamaica,6,2,4
2019,203,Czechia,Jamaica,25,16,9
2019,348,Hungary,Jamaica,28,14,14
2019,208,Denmark,Jamaica,180,81,99
2019,233,Estonia,Jamaica,1,1,0
2019,246,Finland,Jamaica,107,63,44
2019,352,Iceland,Jamaica,22,6,16
2019,372,Ireland,Jamaica,131,41,90
2019,428,Latvia,Jamaica,2,2,0
2019,578,Norway,Jamaica,182,81,101
2019,752,Sweden,Jamaica,425,265,160
2019,826,United Kingdom,Jamaica,157762,62314,95448
2019,300,Greece,Jamaica,10,4,6
2019,380,Italy,Jamaica,383,154,229
2019,620,Portugal,Jamaica,26,15,11
2019,705,Slovenia,Jamaica,7,6,1
2019,724,Spain,Jamaica,292,135,157
2019,40,Austria,Jamaica,245,107,138
2019,56,Belgium,Jamaica,446,183,263
2019,250,France,Jamaica,568,196,372
2019,276,Germany,Jamaica,2109,1003,1106
2019,528,Netherlands,Jamaica,1108,527,581
2019,756,Switzerland,Jamaica,821,347,474
2019,60,Bermuda,Jamaica,615,325,290
2019,124,Canada,Jamaica,147342,63817,83525
2019,840,United States of America,Jamaica,759172,327378,431794
1990,480,Mauritius,Japan,23,12,11
1990,800,Uganda,Japan,68,49,19
1990,894,Zambia,Japan,146,99,47
1990,266,Gabon,Japan,10,5,5
1990,516,Namibia,Japan,168,63,105
1990,710,South Africa,Japan,1070,578,492
1990,132,Cabo Verde,Japan,2,0,2
1990,288,Ghana,Japan,30,18,12
1990,324,Guinea,Japan,27,12,15
1990,694,Sierra Leone,Japan,7,3,4
1990,818,Egypt,Japan,1455,751,704
1990,434,Libya,Japan,4156,2158,1998
1990,196,Cyprus,Japan,21,9,12
1990,400,Jordan,Japan,143,88,55
1990,792,Turkey,Japan,972,512,460
1990,50,Bangladesh,Japan,9042,4883,4159
1990,64,Bhutan,Japan,59,38,21
1990,356,India,Japan,903,410,493
1990,462,Maldives,Japan,65,36,29
1990,144,Sri Lanka,Japan,9,6,3
1990,156,China,Japan,4547,2665,1882
1990,344,"China, Hong Kong SAR",Japan,9505,5210,4295
1990,408,Dem. People's Republic of Korea,Japan,180,98,82
1990,496,Mongolia,Japan,122,64,58
1990,410,Republic of Korea,Japan,4447,2390,2057
1990,96,Brunei Darussalam,Japan,83,49,34
1990,116,Cambodia,Japan,58,36,22
1990,360,Indonesia,Japan,12535,7733,4802
1990,458,Malaysia,Japan,5255,2919,2336
1990,608,Philippines,Japan,2891,2061,830
1990,764,Thailand,Japan,10091,6054,4037
1990,704,Viet Nam,Japan,124,81,43
1990,28,Antigua and Barbuda,Japan,2,1,1
1990,44,Bahamas,Japan,5,3,2
1990,535,"Bonaire, Sint Eustatius and Saba",Japan,76,38,38
1990,136,Cayman Islands,Japan,6,5,1
1990,214,Dominican Republic,Japan,1256,691,565
1990,332,Haiti,Japan,221,119,102
1990,630,Puerto Rico,Japan,163,77,86
1990,662,Saint Lucia,Japan,11,2,9
1990,188,Costa Rica,Japan,207,121,86
1990,222,El Salvador,Japan,40,31,9
1990,320,Guatemala,Japan,84,36,48
1990,340,Honduras,Japan,106,60,46
1990,484,Mexico,Japan,3096,1676,1420
1990,558,Nicaragua,Japan,54,36,18
1990,591,Panama,Japan,169,104,65
1990,32,Argentina,Japan,5812,2915,2897
1990,68,Bolivia (Plurinational State of),Japan,1401,741,660
1990,76,Brazil,Japan,86768,45342,41426
1990,152,Chile,Japan,645,407,238
1990,170,Colombia,Japan,515,300,215
1990,218,Ecuador,Japan,245,142,103
1990,600,Paraguay,Japan,2648,1424,1224
1990,604,Peru,Japan,2090,1060,1030
1990,862,Venezuela (Bolivarian Republic of),Japan,763,452,311
1990,36,Australia,Japan,21752,9991,11761
1990,554,New Zealand,Japan,2145,852,1293
1990,598,Papua New Guinea,Japan,263,145,118
1990,90,Solomon Islands,Japan,101,85,16
1990,316,Guam,Japan,2455,1147,1308
1990,583,Micronesia (Fed. States of),Japan,66,38,28
1990,580,Northern Mariana Islands,Japan,715,463,252
1990,585,Palau,Japan,69,49,20
1990,258,French Polynesia,Japan,21,10,11
1990,882,Samoa,Japan,26,21,5
1990,776,Tonga,Japan,50,29,21
1990,100,Bulgaria,Japan,26,13,13
1990,203,Czechia,Japan,48,26,22
1990,348,Hungary,Japan,271,120,151
1990,616,Poland,Japan,326,162,164
1990,642,Romania,Japan,8,4,4
1990,643,Russian Federation,Japan,655,321,334
1990,703,Slovakia,Japan,6,4,2
1990,208,Denmark,Japan,935,353,582
1990,246,Finland,Japan,372,221,151
1990,352,Iceland,Japan,17,5,12
1990,372,Ireland,Japan,102,35,67
1990,428,Latvia,Japan,4,1,3
1990,440,Lithuania,Japan,14,7,7
1990,578,Norway,Japan,826,320,506
1990,752,Sweden,Japan,1793,749,1044
1990,826,United Kingdom,Japan,27561,12564,14997
1990,300,Greece,Japan,1185,531,654
1990,380,Italy,Japan,13179,4691,8488
1990,470,Malta,Japan,15,2,13
1990,620,Portugal,Japan,81,38,43
1990,688,Serbia,Japan,4,2,2
1990,705,Slovenia,Japan,8,4,4
1990,724,Spain,Japan,1640,782,858
1990,40,Austria,Japan,1636,483,1153
1990,56,Belgium,Japan,3001,1572,1429
1990,250,France,Japan,18064,6710,11354
1990,276,Germany,Japan,24560,12816,11744
1990,442,Luxembourg,Japan,336,157,179
1990,528,Netherlands,Japan,4076,2014,2062
1990,756,Switzerland,Japan,3892,1392,2500
1990,60,Bermuda,Japan,109,78,31
1990,124,Canada,Japan,11783,5736,6047
1990,840,United States of America,Japan,290128,141913,148215
1995,480,Mauritius,Japan,14,6,8
1995,800,Uganda,Japan,64,46,18
1995,894,Zambia,Japan,137,93,44
1995,266,Gabon,Japan,13,7,6
1995,516,Namibia,Japan,160,61,99
1995,710,South Africa,Japan,786,412,374
1995,132,Cabo Verde,Japan,3,0,3
1995,288,Ghana,Japan,30,19,11
1995,324,Guinea,Japan,31,16,15
1995,694,Sierra Leone,Japan,6,2,4
1995,818,Egypt,Japan,1105,566,539
1995,434,Libya,Japan,2428,1264,1164
1995,196,Cyprus,Japan,30,12,18
1995,400,Jordan,Japan,135,85,50
1995,792,Turkey,Japan,1415,676,739
1995,50,Bangladesh,Japan,9330,5039,4291
1995,64,Bhutan,Japan,69,44,25
1995,356,India,Japan,890,381,509
1995,462,Maldives,Japan,76,38,38
1995,144,Sri Lanka,Japan,107,84,23
1995,156,China,Japan,4732,2779,1953
1995,344,"China, Hong Kong SAR",Japan,10608,5782,4826
1995,408,Dem. People's Republic of Korea,Japan,173,94,79
1995,496,Mongolia,Japan,134,74,60
1995,410,Republic of Korea,Japan,8709,3011,5698
1995,96,Brunei Darussalam,Japan,138,82,56
1995,116,Cambodia,Japan,152,94,58
1995,360,Indonesia,Japan,8293,5199,3094
1995,458,Malaysia,Japan,6016,3350,2666
1995,608,Philippines,Japan,3890,2751,1139
1995,764,Thailand,Japan,9092,5625,3467
1995,704,Viet Nam,Japan,224,145,79
1995,28,Antigua and Barbuda,Japan,10,5,5
1995,44,Bahamas,Japan,22,6,16
1995,535,"Bonaire, Sint Eustatius and Saba",Japan,159,79,80
1995,136,Cayman Islands,Japan,13,10,3
1995,214,Dominican Republic,Japan,1395,752,643
1995,332,Haiti,Japan,209,113,96
1995,630,Puerto Rico,Japan,172,82,90
1995,662,Saint Lucia,Japan,14,3,11
1995,188,Costa Rica,Japan,169,99,70
1995,222,El Salvador,Japan,38,28,10
1995,320,Guatemala,Japan,89,44,45
1995,340,Honduras,Japan,105,58,47
1995,484,Mexico,Japan,3647,1858,1789
1995,558,Nicaragua,Japan,43,28,15
1995,591,Panama,Japan,244,152,92
1995,32,Argentina,Japan,5181,2585,2596
1995,68,Bolivia (Plurinational State of),Japan,1455,761,694
1995,76,Brazil,Japan,78935,40959,37976
1995,152,Chile,Japan,721,409,312
1995,170,Colombia,Japan,546,318,228
1995,218,Ecuador,Japan,275,159,116
1995,600,Paraguay,Japan,2448,1304,1144
1995,604,Peru,Japan,2093,1049,1044
1995,862,Venezuela (Bolivarian Republic of),Japan,590,348,242
1995,36,Australia,Japan,24485,12181,12304
1995,554,New Zealand,Japan,6324,2323,4001
1995,598,Papua New Guinea,Japan,269,147,122
1995,90,Solomon Islands,Japan,100,84,16
1995,316,Guam,Japan,2451,1161,1290
1995,583,Micronesia (Fed. States of),Japan,59,38,21
1995,580,Northern Mariana Islands,Japan,730,448,282
1995,585,Palau,Japan,118,78,40
1995,258,French Polynesia,Japan,23,11,12
1995,882,Samoa,Japan,45,36,9
1995,776,Tonga,Japan,58,34,24
1995,100,Bulgaria,Japan,44,22,22
1995,203,Czechia,Japan,72,39,33
1995,348,Hungary,Japan,595,288,307
1995,616,Poland,Japan,278,136,142
1995,642,Romania,Japan,23,12,11
1995,643,Russian Federation,Japan,679,337,342
1995,703,Slovakia,Japan,41,16,25
1995,208,Denmark,Japan,1129,401,728
1995,246,Finland,Japan,455,248,207
1995,352,Iceland,Japan,31,10,21
1995,372,Ireland,Japan,282,90,192
1995,428,Latvia,Japan,6,2,4
1995,440,Lithuania,Japan,15,7,8
1995,578,Norway,Japan,867,321,546
1995,752,Sweden,Japan,2128,880,1248
1995,826,United Kingdom,Japan,31661,13434,18227
1995,300,Greece,Japan,863,349,514
1995,380,Italy,Japan,10155,3420,6735
1995,470,Malta,Japan,18,2,16
1995,620,Portugal,Japan,175,81,94
1995,688,Serbia,Japan,29,13,16
1995,705,Slovenia,Japan,16,7,9
1995,724,Spain,Japan,2027,974,1053
1995,40,Austria,Japan,1846,567,1279
1995,56,Belgium,Japan,3490,1759,1731
1995,250,France,Japan,18648,6730,11918
1995,276,Germany,Japan,27918,13273,14645
1995,442,Luxembourg,Japan,290,132,158
1995,528,Netherlands,Japan,4799,2325,2474
1995,756,Switzerland,Japan,4434,1625,2809
1995,60,Bermuda,Japan,188,75,113
1995,124,Canada,Japan,18672,9032,9640
1995,840,United States of America,Japan,323100,159521,163579
2000,480,Mauritius,Japan,15,3,12
2000,800,Uganda,Japan,187,122,65
2000,894,Zambia,Japan,129,88,41
2000,266,Gabon,Japan,16,9,7
2000,516,Namibia,Japan,150,56,94
2000,710,South Africa,Japan,735,351,384
2000,132,Cabo Verde,Japan,4,1,3
2000,288,Ghana,Japan,33,20,13
2000,324,Guinea,Japan,33,17,16
2000,694,Sierra Leone,Japan,5,1,4
2000,818,Egypt,Japan,843,426,417
2000,434,Libya,Japan,740,418,322
2000,196,Cyprus,Japan,38,15,23
2000,400,Jordan,Japan,126,82,44
2000,792,Turkey,Japan,1865,841,1024
2000,50,Bangladesh,Japan,9618,5194,4424
2000,64,Bhutan,Japan,80,52,28
2000,356,India,Japan,876,352,524
2000,462,Maldives,Japan,83,45,38
2000,144,Sri Lanka,Japan,207,139,68
2000,156,China,Japan,4917,2892,2025
2000,344,"China, Hong Kong SAR",Japan,11711,6355,5356
2000,408,Dem. People's Republic of Korea,Japan,166,91,75
2000,496,Mongolia,Japan,149,85,64
2000,410,Republic of Korea,Japan,15744,4950,10794
2000,96,Brunei Darussalam,Japan,192,114,78
2000,116,Cambodia,Japan,246,152,94
2000,360,Indonesia,Japan,4052,2666,1386
2000,458,Malaysia,Japan,8490,4713,3777
2000,608,Philippines,Japan,6249,3690,2559
2000,764,Thailand,Japan,9971,6274,3697
2000,704,Viet Nam,Japan,471,310,161
2000,28,Antigua and Barbuda,Japan,17,8,9
2000,44,Bahamas,Japan,39,10,29
2000,535,"Bonaire, Sint Eustatius and Saba",Japan,242,120,122
2000,136,Cayman Islands,Japan,22,16,6
2000,214,Dominican Republic,Japan,1534,814,720
2000,332,Haiti,Japan,198,107,91
2000,630,Puerto Rico,Japan,182,86,96
2000,662,Saint Lucia,Japan,20,4,16
2000,188,Costa Rica,Japan,216,125,91
2000,222,El Salvador,Japan,35,25,10
2000,320,Guatemala,Japan,94,53,41
2000,340,Honduras,Japan,103,55,48
2000,484,Mexico,Japan,4356,2130,2226
2000,558,Nicaragua,Japan,39,26,13
2000,591,Panama,Japan,335,208,127
2000,32,Argentina,Japan,4550,2255,2295
2000,68,Bolivia (Plurinational State of),Japan,1493,772,721
2000,76,Brazil,Japan,71102,36576,34526
2000,152,Chile,Japan,798,450,348
2000,170,Colombia,Japan,576,335,241
2000,218,Ecuador,Japan,305,177,128
2000,600,Paraguay,Japan,2240,1172,1068
2000,604,Peru,Japan,2446,1221,1225
2000,862,Venezuela (Bolivarian Republic of),Japan,452,264,188
2000,36,Australia,Japan,25300,9576,15724
2000,554,New Zealand,Japan,8389,4078,4311
2000,598,Papua New Guinea,Japan,201,108,93
2000,90,Solomon Islands,Japan,96,80,16
2000,316,Guam,Japan,2446,1174,1272
2000,583,Micronesia (Fed. States of),Japan,55,32,23
2000,580,Northern Mariana Islands,Japan,791,443,348
2000,585,Palau,Japan,290,182,108
2000,258,French Polynesia,Japan,25,11,14
2000,882,Samoa,Japan,65,52,13
2000,776,Tonga,Japan,66,38,28
2000,100,Bulgaria,Japan,61,31,30
2000,203,Czechia,Japan,95,52,43
2000,348,Hungary,Japan,919,456,463
2000,616,Poland,Japan,238,115,123
2000,642,Romania,Japan,39,20,19
2000,643,Russian Federation,Japan,679,340,339
2000,703,Slovakia,Japan,88,32,56
2000,208,Denmark,Japan,1323,450,873
2000,246,Finland,Japan,538,276,262
2000,352,Iceland,Japan,44,15,29
2000,372,Ireland,Japan,616,208,408
2000,428,Latvia,Japan,9,4,5
2000,440,Lithuania,Japan,11,5,6
2000,578,Norway,Japan,926,335,591
2000,752,Sweden,Japan,2283,935,1348
2000,826,United Kingdom,Japan,36294,14483,21811
2000,300,Greece,Japan,555,163,392
2000,380,Italy,Japan,7130,2149,4981
2000,470,Malta,Japan,23,4,19
2000,620,Portugal,Japan,278,128,150
2000,688,Serbia,Japan,40,17,23
2000,705,Slovenia,Japan,30,14,16
2000,724,Spain,Japan,3286,1612,1674
2000,40,Austria,Japan,2055,650,1405
2000,56,Belgium,Japan,3878,1901,1977
2000,250,France,Japan,19232,6750,12482
2000,276,Germany,Japan,31276,13731,17545
2000,442,Luxembourg,Japan,249,110,139
2000,528,Netherlands,Japan,5687,2706,2981
2000,756,Switzerland,Japan,4993,1873,3120
2000,60,Bermuda,Japan,266,72,194
2000,124,Canada,Japan,26004,12544,13460
2000,840,United States of America,Japan,356364,177511,178853
2005,480,Mauritius,Japan,11,3,8
2005,800,Uganda,Japan,181,118,63
2005,894,Zambia,Japan,113,78,35
2005,266,Gabon,Japan,18,10,8
2005,516,Namibia,Japan,118,44,74
2005,710,South Africa,Japan,967,441,526
2005,132,Cabo Verde,Japan,3,1,2
2005,288,Ghana,Japan,46,29,17
2005,324,Guinea,Japan,39,25,14
2005,694,Sierra Leone,Japan,2,2,0
2005,818,Egypt,Japan,1004,538,466
2005,434,Libya,Japan,815,524,291
2005,196,Cyprus,Japan,56,22,34
2005,400,Jordan,Japan,181,126,55
2005,792,Turkey,Japan,1921,842,1079
2005,50,Bangladesh,Japan,11317,6112,5205
2005,64,Bhutan,Japan,100,64,36
2005,356,India,Japan,810,324,486
2005,462,Maldives,Japan,86,52,34
2005,144,Sri Lanka,Japan,410,192,218
2005,156,China,Japan,5424,3425,1999
2005,344,"China, Hong Kong SAR",Japan,12786,6645,6141
2005,408,Dem. People's Republic of Korea,Japan,179,98,81
2005,496,Mongolia,Japan,229,126,103
2005,410,Republic of Korea,Japan,14133,4429,9704
2005,96,Brunei Darussalam,Japan,196,117,79
2005,116,Cambodia,Japan,192,121,71
2005,360,Indonesia,Japan,10237,6829,3408
2005,458,Malaysia,Japan,12057,6955,5102
2005,608,Philippines,Japan,5057,3019,2038
2005,764,Thailand,Japan,8458,5344,3114
2005,704,Viet Nam,Japan,809,538,271
2005,28,Antigua and Barbuda,Japan,18,8,10
2005,44,Bahamas,Japan,36,9,27
2005,535,"Bonaire, Sint Eustatius and Saba",Japan,257,127,130
2005,136,Cayman Islands,Japan,20,15,5
2005,214,Dominican Republic,Japan,934,491,443
2005,332,Haiti,Japan,188,102,86
2005,630,Puerto Rico,Japan,142,67,75
2005,662,Saint Lucia,Japan,16,3,13
2005,188,Costa Rica,Japan,142,82,60
2005,222,El Salvador,Japan,44,31,13
2005,320,Guatemala,Japan,111,66,45
2005,340,Honduras,Japan,101,54,47
2005,484,Mexico,Japan,3478,1719,1759
2005,558,Nicaragua,Japan,36,23,13
2005,591,Panama,Japan,317,185,132
2005,32,Argentina,Japan,4205,2052,2153
2005,68,Bolivia (Plurinational State of),Japan,1461,752,709
2005,76,Brazil,Japan,60300,30950,29350
2005,152,Chile,Japan,1197,684,513
2005,170,Colombia,Japan,575,336,239
2005,218,Ecuador,Japan,360,212,148
2005,600,Paraguay,Japan,2133,1116,1017
2005,604,Peru,Japan,2874,1456,1418
2005,862,Venezuela (Bolivarian Republic of),Japan,408,240,168
2005,36,Australia,Japan,33110,11413,21697
2005,554,New Zealand,Japan,9154,4444,4710
2005,598,Papua New Guinea,Japan,301,211,90
2005,90,Solomon Islands,Japan,61,47,14
2005,316,Guam,Japan,2264,1124,1140
2005,583,Micronesia (Fed. States of),Japan,51,29,22
2005,580,Northern Mariana Islands,Japan,811,428,383
2005,585,Palau,Japan,163,89,74
2005,258,French Polynesia,Japan,26,12,14
2005,882,Samoa,Japan,60,48,12
2005,776,Tonga,Japan,77,45,32
2005,100,Bulgaria,Japan,88,46,42
2005,203,Czechia,Japan,758,385,373
2005,348,Hungary,Japan,1135,574,561
2005,616,Poland,Japan,377,154,223
2005,642,Romania,Japan,28,15,13
2005,643,Russian Federation,Japan,850,428,422
2005,703,Slovakia,Japan,99,37,62
2005,208,Denmark,Japan,1525,503,1022
2005,246,Finland,Japan,870,379,491
2005,352,Iceland,Japan,66,23,43
2005,372,Ireland,Japan,618,233,385
2005,428,Latvia,Japan,12,5,7
2005,440,Lithuania,Japan,20,11,9
2005,578,Norway,Japan,962,345,617
2005,752,Sweden,Japan,2611,915,1696
2005,826,United Kingdom,Japan,34598,12812,21786
2005,191,Croatia,Japan,28,7,21
2005,300,Greece,Japan,538,143,395
2005,380,Italy,Japan,7707,2303,5404
2005,470,Malta,Japan,28,5,23
2005,620,Portugal,Japan,300,132,168
2005,688,Serbia,Japan,40,17,23
2005,705,Slovenia,Japan,36,16,20
2005,724,Spain,Japan,5083,2188,2895
2005,40,Austria,Japan,2297,689,1608
2005,56,Belgium,Japan,4254,1977,2277
2005,250,France,Japan,18116,5904,12212
2005,276,Germany,Japan,28874,12239,16635
2005,442,Luxembourg,Japan,215,102,113
2005,528,Netherlands,Japan,6138,2804,3334
2005,756,Switzerland,Japan,5673,1952,3721
2005,60,Bermuda,Japan,466,241,225
2005,124,Canada,Japan,28340,11218,17122
2005,840,United States of America,Japan,355980,178307,177673
2010,480,Mauritius,Japan,8,3,5
2010,800,Uganda,Japan,182,118,64
2010,894,Zambia,Japan,100,50,50
2010,266,Gabon,Japan,21,12,9
2010,516,Namibia,Japan,113,42,71
2010,710,South Africa,Japan,1514,688,826
2010,132,Cabo Verde,Japan,1,1,0
2010,288,Ghana,Japan,46,30,16
2010,324,Guinea,Japan,46,29,17
2010,466,Mali,Japan,518,259,259
2010,694,Sierra Leone,Japan,1,1,0
2010,818,Egypt,Japan,1084,562,522
2010,434,Libya,Japan,892,577,315
2010,196,Cyprus,Japan,91,37,54
2010,400,Jordan,Japan,233,166,67
2010,792,Turkey,Japan,1979,842,1137
2010,50,Bangladesh,Japan,13041,7043,5998
2010,64,Bhutan,Japan,120,76,44
2010,356,India,Japan,743,296,447
2010,462,Maldives,Japan,97,39,58
2010,144,Sri Lanka,Japan,828,394,434
2010,156,China,Japan,5932,3959,1973
2010,344,"China, Hong Kong SAR",Japan,13892,6952,6940
2010,408,Dem. People's Republic of Korea,Japan,191,104,87
2010,496,Mongolia,Japan,336,193,143
2010,410,Republic of Korea,Japan,18100,5060,13040
2010,96,Brunei Darussalam,Japan,200,120,80
2010,116,Cambodia,Japan,138,90,48
2010,360,Indonesia,Japan,17080,11061,6019
2010,458,Malaysia,Japan,14764,8742,6022
2010,608,Philippines,Japan,13537,7860,5677
2010,764,Thailand,Japan,7553,4862,2691
2010,704,Viet Nam,Japan,1542,991,551
2010,28,Antigua and Barbuda,Japan,19,9,10
2010,44,Bahamas,Japan,32,7,25
2010,535,"Bonaire, Sint Eustatius and Saba",Japan,26,19,7
2010,136,Cayman Islands,Japan,20,14,6
2010,531,Curaçao,Japan,120,56,64
2010,214,Dominican Republic,Japan,327,165,162
2010,332,Haiti,Japan,197,107,90
2010,630,Puerto Rico,Japan,85,39,46
2010,662,Saint Lucia,Japan,11,2,9
2010,188,Costa Rica,Japan,279,160,119
2010,222,El Salvador,Japan,52,36,16
2010,320,Guatemala,Japan,128,80,48
2010,340,Honduras,Japan,99,54,45
2010,484,Mexico,Japan,3004,1511,1493
2010,558,Nicaragua,Japan,38,25,13
2010,591,Panama,Japan,316,173,143
2010,32,Argentina,Japan,3859,1849,2010
2010,68,Bolivia (Plurinational State of),Japan,1426,731,695
2010,76,Brazil,Japan,48633,24846,23787
2010,152,Chile,Japan,1597,918,679
2010,170,Colombia,Japan,674,400,274
2010,218,Ecuador,Japan,505,292,213
2010,600,Paraguay,Japan,2032,1061,971
2010,604,Peru,Japan,3214,1621,1593
2010,862,Venezuela (Bolivarian Republic of),Japan,373,222,151
2010,36,Australia,Japan,40250,14080,26170
2010,554,New Zealand,Japan,9992,4843,5149
2010,598,Papua New Guinea,Japan,255,182,73
2010,90,Solomon Islands,Japan,31,18,13
2010,316,Guam,Japan,2082,1075,1007
2010,583,Micronesia (Fed. States of),Japan,49,28,21
2010,580,Northern Mariana Islands,Japan,599,294,305
2010,585,Palau,Japan,156,82,74
2010,258,French Polynesia,Japan,25,12,13
2010,882,Samoa,Japan,53,42,11
2010,776,Tonga,Japan,82,48,34
2010,100,Bulgaria,Japan,111,58,53
2010,203,Czechia,Japan,1346,695,651
2010,348,Hungary,Japan,1351,693,658
2010,616,Poland,Japan,529,197,332
2010,642,Romania,Japan,22,13,9
2010,643,Russian Federation,Japan,1005,507,498
2010,703,Slovakia,Japan,111,43,68
2010,208,Denmark,Japan,1695,547,1148
2010,233,Estonia,Japan,55,28,27
2010,246,Finland,Japan,1433,514,919
2010,352,Iceland,Japan,87,31,56
2010,372,Ireland,Japan,518,171,347
2010,428,Latvia,Japan,15,6,9
2010,440,Lithuania,Japan,28,16,12
2010,578,Norway,Japan,1203,415,788
2010,752,Sweden,Japan,2963,914,2049
2010,826,United Kingdom,Japan,36447,13968,22479
2010,191,Croatia,Japan,56,14,42
2010,300,Greece,Japan,541,128,413
2010,380,Italy,Japan,9489,3167,6322
2010,470,Malta,Japan,37,8,29
2010,620,Portugal,Japan,273,115,158
2010,688,Serbia,Japan,40,17,23
2010,705,Slovenia,Japan,72,36,36
2010,724,Spain,Japan,5638,2246,3392
2010,40,Austria,Japan,2539,728,1811
2010,56,Belgium,Japan,4832,2183,2649
2010,250,France,Japan,20073,5616,14457
2010,276,Germany,Japan,26764,10858,15906
2010,442,Luxembourg,Japan,185,96,89
2010,528,Netherlands,Japan,5869,2572,3297
2010,756,Switzerland,Japan,6597,2017,4580
2010,60,Bermuda,Japan,665,410,255
2010,124,Canada,Japan,25805,8457,17348
2010,840,United States of America,Japan,366522,181072,185450
2015,480,Mauritius,Japan,9,4,5
2015,800,Uganda,Japan,183,119,64
2015,894,Zambia,Japan,88,44,44
2015,266,Gabon,Japan,29,18,11
2015,516,Namibia,Japan,110,41,69
2015,710,South Africa,Japan,2730,1165,1565
2015,132,Cabo Verde,Japan,1,1,0
2015,288,Ghana,Japan,56,37,19
2015,324,Guinea,Japan,54,33,21
2015,466,Mali,Japan,641,321,320
2015,694,Sierra Leone,Japan,1,1,0
2015,818,Egypt,Japan,803,467,336
2015,434,Libya,Japan,1005,645,360
2015,196,Cyprus,Japan,87,36,51
2015,400,Jordan,Japan,100,65,35
2015,792,Turkey,Japan,2008,828,1180
2015,50,Bangladesh,Japan,13763,7433,6330
2015,64,Bhutan,Japan,127,81,46
2015,356,India,Japan,715,285,430
2015,462,Maldives,Japan,109,26,83
2015,144,Sri Lanka,Japan,843,394,449
2015,156,China,Japan,6826,4660,2166
2015,344,"China, Hong Kong SAR",Japan,14185,6821,7364
2015,408,Dem. People's Republic of Korea,Japan,210,115,95
2015,496,Mongolia,Japan,415,190,225
2015,410,Republic of Korea,Japan,22489,5910,16579
2015,96,Brunei Darussalam,Japan,204,123,81
2015,116,Cambodia,Japan,125,83,42
2015,360,Indonesia,Japan,18909,12391,6518
2015,458,Malaysia,Japan,18004,10772,7232
2015,608,Philippines,Japan,13749,7992,5757
2015,764,Thailand,Japan,8167,5248,2919
2015,704,Viet Nam,Japan,1843,1178,665
2015,28,Antigua and Barbuda,Japan,20,9,11
2015,44,Bahamas,Japan,35,8,27
2015,535,"Bonaire, Sint Eustatius and Saba",Japan,29,22,7
2015,136,Cayman Islands,Japan,20,15,5
2015,531,Curaçao,Japan,130,61,69
2015,214,Dominican Republic,Japan,345,174,171
2015,332,Haiti,Japan,206,112,94
2015,630,Puerto Rico,Japan,83,39,44
2015,662,Saint Lucia,Japan,10,2,8
2015,188,Costa Rica,Japan,283,162,121
2015,222,El Salvador,Japan,54,37,17
2015,320,Guatemala,Japan,147,93,54
2015,340,Honduras,Japan,139,76,63
2015,484,Mexico,Japan,3808,2280,1528
2015,558,Nicaragua,Japan,40,27,13
2015,591,Panama,Japan,372,204,168
2015,32,Argentina,Japan,4453,2132,2321
2015,68,Bolivia (Plurinational State of),Japan,1660,851,809
2015,76,Brazil,Japan,58564,29820,28744
2015,152,Chile,Japan,2419,1369,1050
2015,170,Colombia,Japan,754,451,303
2015,218,Ecuador,Japan,734,422,312
2015,600,Paraguay,Japan,1983,1035,948
2015,604,Peru,Japan,3417,1769,1648
2015,862,Venezuela (Bolivarian Republic of),Japan,359,212,147
2015,36,Australia,Japan,47560,15726,31834
2015,554,New Zealand,Japan,10670,5160,5510
2015,598,Papua New Guinea,Japan,258,186,72
2015,90,Solomon Islands,Japan,29,17,12
2015,316,Guam,Japan,2100,1084,1016
2015,583,Micronesia (Fed. States of),Japan,48,28,20
2015,580,Northern Mariana Islands,Japan,536,262,274
2015,585,Palau,Japan,140,77,63
2015,258,French Polynesia,Japan,23,11,12
2015,882,Samoa,Japan,43,35,8
2015,776,Tonga,Japan,70,41,29
2015,100,Bulgaria,Japan,181,84,97
2015,203,Czechia,Japan,1519,767,752
2015,348,Hungary,Japan,1521,845,676
2015,616,Poland,Japan,510,196,314
2015,642,Romania,Japan,34,15,19
2015,643,Russian Federation,Japan,1025,515,510
2015,703,Slovakia,Japan,137,59,78
2015,208,Denmark,Japan,2000,655,1345
2015,233,Estonia,Japan,85,48,37
2015,246,Finland,Japan,1556,549,1007
2015,352,Iceland,Japan,98,33,65
2015,372,Ireland,Japan,529,170,359
2015,428,Latvia,Japan,16,7,9
2015,440,Lithuania,Japan,26,11,15
2015,578,Norway,Japan,1396,470,926
2015,752,Sweden,Japan,3150,932,2218
2015,826,United Kingdom,Japan,46610,17011,29599
2015,191,Croatia,Japan,56,14,42
2015,300,Greece,Japan,507,103,404
2015,380,Italy,Japan,8127,2326,5801
2015,470,Malta,Japan,62,17,45
2015,620,Portugal,Japan,309,121,188
2015,688,Serbia,Japan,39,17,22
2015,705,Slovenia,Japan,81,35,46
2015,724,Spain,Japan,6128,2291,3837
2015,40,Austria,Japan,2970,863,2107
2015,56,Belgium,Japan,4677,1994,2683
2015,250,France,Japan,22236,5780,16456
2015,276,Germany,Japan,27886,11273,16613
2015,442,Luxembourg,Japan,282,149,133
2015,528,Netherlands,Japan,5835,2566,3269
2015,756,Switzerland,Japan,7677,2372,5305
2015,60,Bermuda,Japan,674,416,258
2015,124,Canada,Japan,27072,7897,19175
2015,840,United States of America,Japan,335767,164585,171182
2019,480,Mauritius,Japan,9,4,5
2019,800,Uganda,Japan,183,119,64
2019,894,Zambia,Japan,113,57,56
2019,266,Gabon,Japan,30,18,12
2019,516,Namibia,Japan,116,43,73
2019,710,South Africa,Japan,3059,1308,1751
2019,132,Cabo Verde,Japan,1,1,0
2019,288,Ghana,Japan,63,42,21
2019,324,Guinea,Japan,51,31,20
2019,466,Mali,Japan,713,357,356
2019,818,Egypt,Japan,1144,609,535
2019,434,Libya,Japan,1066,685,381
2019,196,Cyprus,Japan,86,36,50
2019,400,Jordan,Japan,107,70,37
2019,792,Turkey,Japan,2715,1136,1579
2019,50,Bangladesh,Japan,13943,4252,9691
2019,64,Bhutan,Japan,132,85,47
2019,356,India,Japan,703,281,422
2019,462,Maldives,Japan,117,28,89
2019,144,Sri Lanka,Japan,849,397,452
2019,156,China,Japan,7194,4912,2282
2019,344,"China, Hong Kong SAR",Japan,18378,8551,9827
2019,408,Dem. People's Republic of Korea,Japan,214,118,96
2019,496,Mongolia,Japan,440,201,239
2019,410,Republic of Korea,Japan,22893,6010,16883
2019,96,Brunei Darussalam,Japan,219,132,87
2019,116,Cambodia,Japan,132,88,44
2019,360,Indonesia,Japan,19748,12941,6807
2019,458,Malaysia,Japan,18825,11319,7506
2019,608,Philippines,Japan,14181,8243,5938
2019,764,Thailand,Japan,8514,5471,3043
2019,704,Viet Nam,Japan,1926,1231,695
2019,28,Antigua and Barbuda,Japan,20,9,11
2019,44,Bahamas,Japan,37,9,28
2019,535,"Bonaire, Sint Eustatius and Saba",Japan,34,26,8
2019,136,Cayman Islands,Japan,22,17,5
2019,531,Curaçao,Japan,141,66,75
2019,214,Dominican Republic,Japan,356,180,176
2019,332,Haiti,Japan,214,117,97
2019,630,Puerto Rico,Japan,78,37,41
2019,662,Saint Lucia,Japan,9,2,7
2019,188,Costa Rica,Japan,287,166,121
2019,222,El Salvador,Japan,54,37,17
2019,320,Guatemala,Japan,150,95,55
2019,340,Honduras,Japan,141,77,64
2019,484,Mexico,Japan,3926,2351,1575
2019,558,Nicaragua,Japan,41,28,13
2019,591,Panama,Japan,395,217,178
2019,32,Argentina,Japan,4531,2166,2365
2019,68,Bolivia (Plurinational State of),Japan,1812,929,883
2019,76,Brazil,Japan,65955,33584,32371
2019,152,Chile,Japan,3231,1750,1481
2019,170,Colombia,Japan,771,462,309
2019,218,Ecuador,Japan,722,415,307
2019,600,Paraguay,Japan,2034,1062,972
2019,604,Peru,Japan,4072,2298,1774
2019,862,Venezuela (Bolivarian Republic of),Japan,351,207,144
2019,36,Australia,Japan,53175,17437,35738
2019,554,New Zealand,Japan,10967,5304,5663
2019,598,Papua New Guinea,Japan,260,188,72
2019,90,Solomon Islands,Japan,28,17,11
2019,316,Guam,Japan,2203,1137,1066
2019,583,Micronesia (Fed. States of),Japan,49,29,20
2019,580,Northern Mariana Islands,Japan,540,264,276
2019,585,Palau,Japan,143,72,71
2019,258,French Polynesia,Japan,23,11,12
2019,882,Samoa,Japan,40,33,7
2019,776,Tonga,Japan,66,39,27
2019,100,Bulgaria,Japan,214,99,115
2019,203,Czechia,Japan,1725,873,852
2019,348,Hungary,Japan,1714,925,789
2019,616,Poland,Japan,540,221,319
2019,642,Romania,Japan,248,119,129
2019,643,Russian Federation,Japan,1024,515,509
2019,703,Slovakia,Japan,147,65,82
2019,208,Denmark,Japan,2148,713,1435
2019,233,Estonia,Japan,115,59,56
2019,246,Finland,Japan,1780,613,1167
2019,352,Iceland,Japan,110,38,72
2019,372,Ireland,Japan,580,188,392
2019,428,Latvia,Japan,21,11,10
2019,440,Lithuania,Japan,24,9,15
2019,578,Norway,Japan,1558,525,1033
2019,752,Sweden,Japan,3613,1052,2561
2019,826,United Kingdom,Japan,52930,19403,33527
2019,191,Croatia,Japan,51,13,38
2019,300,Greece,Japan,495,116,379
2019,380,Italy,Japan,8843,2594,6249
2019,470,Malta,Japan,100,28,72
2019,620,Portugal,Japan,314,124,190
2019,688,Serbia,Japan,39,17,22
2019,705,Slovenia,Japan,92,44,48
2019,724,Spain,Japan,6349,2279,4070
2019,40,Austria,Japan,3506,1062,2444
2019,56,Belgium,Japan,4827,2092,2735
2019,250,France,Japan,23536,6078,17458
2019,276,Germany,Japan,31157,13052,18105
2019,442,Luxembourg,Japan,678,274,404
2019,528,Netherlands,Japan,6914,2953,3961
2019,756,Switzerland,Japan,7966,2443,5523
2019,60,Bermuda,Japan,681,421,260
2019,124,Canada,Japan,29010,8462,20548
2019,840,United States of America,Japan,351166,171795,179371
1990,710,South Africa,Jordan,54,24,30
1990,12,Algeria,Jordan,2286,1236,1050
1990,818,Egypt,Jordan,3386,1768,1618
1990,434,Libya,Jordan,9668,5073,4595
1990,48,Bahrain,Jordan,3442,2070,1372
1990,196,Cyprus,Jordan,110,71,39
1990,368,Iraq,Jordan,7970,5522,2448
1990,414,Kuwait,Jordan,21348,9571,11777
1990,422,Lebanon,Jordan,1380,554,826
1990,512,Oman,Jordan,4527,2639,1888
1990,634,Qatar,Jordan,10999,5758,5241
1990,682,Saudi Arabia,Jordan,90278,60052,30226
1990,275,State of Palestine,Jordan,55317,25066,30251
1990,792,Turkey,Jordan,217,143,74
1990,784,United Arab Emirates,Jordan,26078,15576,10502
1990,144,Sri Lanka,Jordan,3,2,1
1990,360,Indonesia,Jordan,4851,2330,2521
1990,608,Philippines,Jordan,182,171,11
1990,630,Puerto Rico,Jordan,175,83,92
1990,188,Costa Rica,Jordan,8,6,2
1990,340,Honduras,Jordan,31,17,14
1990,484,Mexico,Jordan,35,35,0
1990,558,Nicaragua,Jordan,13,11,2
1990,591,Panama,Jordan,43,30,13
1990,32,Argentina,Jordan,160,101,59
1990,68,Bolivia (Plurinational State of),Jordan,20,13,7
1990,152,Chile,Jordan,139,73,66
1990,170,Colombia,Jordan,237,157,80
1990,218,Ecuador,Jordan,24,19,5
1990,604,Peru,Jordan,23,18,5
1990,862,Venezuela (Bolivarian Republic of),Jordan,462,272,190
1990,36,Australia,Jordan,2175,1184,991
1990,112,Belarus,Jordan,13,13,0
1990,100,Bulgaria,Jordan,83,74,9
1990,203,Czechia,Jordan,25,22,3
1990,348,Hungary,Jordan,350,264,86
1990,616,Poland,Jordan,223,194,29
1990,642,Romania,Jordan,261,202,59
1990,643,Russian Federation,Jordan,1555,763,792
1990,703,Slovakia,Jordan,9,8,1
1990,804,Ukraine,Jordan,4486,4378,108
1990,208,Denmark,Jordan,579,363,216
1990,246,Finland,Jordan,58,54,4
1990,372,Ireland,Jordan,22,13,9
1990,428,Latvia,Jordan,3,2,1
1990,578,Norway,Jordan,48,31,17
1990,752,Sweden,Jordan,839,478,361
1990,826,United Kingdom,Jordan,2469,1573,896
1990,300,Greece,Jordan,2473,2153,320
1990,380,Italy,Jordan,5005,4155,850
1990,470,Malta,Jordan,12,11,1
1990,620,Portugal,Jordan,3,3,0
1990,688,Serbia,Jordan,12,10,2
1990,705,Slovenia,Jordan,8,4,4
1990,724,Spain,Jordan,910,719,191
1990,40,Austria,Jordan,412,286,126
1990,56,Belgium,Jordan,467,309,158
1990,250,France,Jordan,940,639,301
1990,276,Germany,Jordan,12527,9231,3296
1990,528,Netherlands,Jordan,389,249,140
1990,756,Switzerland,Jordan,279,175,104
1990,124,Canada,Jordan,2025,986,1039
1990,840,United States of America,Jordan,31871,20409,11462
1995,710,South Africa,Jordan,34,17,17
1995,12,Algeria,Jordan,2272,1234,1038
1995,818,Egypt,Jordan,3473,1826,1647
1995,434,Libya,Jordan,12240,7293,4947
1995,48,Bahrain,Jordan,4019,2468,1551
1995,196,Cyprus,Jordan,156,98,58
1995,368,Iraq,Jordan,9397,5787,3610
1995,414,Kuwait,Jordan,18028,9422,8606
1995,422,Lebanon,Jordan,1196,473,723
1995,512,Oman,Jordan,8732,5409,3323
1995,634,Qatar,Jordan,13371,6857,6514
1995,682,Saudi Arabia,Jordan,92523,61707,30816
1995,275,State of Palestine,Jordan,54057,24347,29710
1995,792,Turkey,Jordan,525,339,186
1995,784,United Arab Emirates,Jordan,35757,22664,13093
1995,144,Sri Lanka,Jordan,34,27,7
1995,360,Indonesia,Jordan,3209,1585,1624
1995,608,Philippines,Jordan,244,229,15
1995,630,Puerto Rico,Jordan,185,88,97
1995,188,Costa Rica,Jordan,6,4,2
1995,340,Honduras,Jordan,31,16,15
1995,484,Mexico,Jordan,48,39,9
1995,558,Nicaragua,Jordan,11,9,2
1995,591,Panama,Jordan,61,43,18
1995,32,Argentina,Jordan,156,99,57
1995,68,Bolivia (Plurinational State of),Jordan,17,12,5
1995,152,Chile,Jordan,111,69,42
1995,170,Colombia,Jordan,209,145,64
1995,218,Ecuador,Jordan,27,21,6
1995,604,Peru,Jordan,24,18,6
1995,862,Venezuela (Bolivarian Republic of),Jordan,350,213,137
1995,36,Australia,Jordan,2918,1606,1312
1995,112,Belarus,Jordan,22,21,1
1995,100,Bulgaria,Jordan,94,82,12
1995,203,Czechia,Jordan,38,33,5
1995,348,Hungary,Jordan,310,232,78
1995,616,Poland,Jordan,190,165,25
1995,642,Romania,Jordan,527,421,106
1995,643,Russian Federation,Jordan,1300,798,502
1995,703,Slovakia,Jordan,19,16,3
1995,804,Ukraine,Jordan,4340,4239,101
1995,208,Denmark,Jordan,773,472,301
1995,246,Finland,Jordan,88,74,14
1995,352,Iceland,Jordan,6,2,4
1995,372,Ireland,Jordan,60,33,27
1995,428,Latvia,Jordan,5,4,1
1995,578,Norway,Jordan,74,47,27
1995,752,Sweden,Jordan,995,564,431
1995,826,United Kingdom,Jordan,2712,1698,1014
1995,300,Greece,Jordan,1630,1376,254
1995,380,Italy,Jordan,3989,3082,907
1995,470,Malta,Jordan,15,13,2
1995,620,Portugal,Jordan,6,6,0
1995,688,Serbia,Jordan,77,61,16
1995,705,Slovenia,Jordan,16,13,3
1995,724,Spain,Jordan,1069,841,228
1995,40,Austria,Jordan,465,325,140
1995,56,Belgium,Jordan,271,175,96
1995,250,France,Jordan,971,655,316
1995,276,Germany,Jordan,11543,8218,3325
1995,528,Netherlands,Jordan,572,360,212
1995,756,Switzerland,Jordan,366,231,135
1995,124,Canada,Jordan,3524,1704,1820
1995,840,United States of America,Jordan,39858,25664,14194
2000,710,South Africa,Jordan,24,14,10
2000,12,Algeria,Jordan,2258,1233,1025
2000,818,Egypt,Jordan,3836,2029,1807
2000,434,Libya,Jordan,15015,9750,5265
2000,48,Bahrain,Jordan,4609,2853,1756
2000,196,Cyprus,Jordan,201,125,76
2000,368,Iraq,Jordan,8905,4643,4262
2000,414,Kuwait,Jordan,21710,13029,8681
2000,422,Lebanon,Jordan,1012,393,619
2000,512,Oman,Jordan,10484,7021,3463
2000,634,Qatar,Jordan,13750,6968,6782
2000,682,Saudi Arabia,Jordan,95064,63536,31528
2000,275,State of Palestine,Jordan,52798,23628,29170
2000,792,Turkey,Jordan,836,535,301
2000,784,United Arab Emirates,Jordan,47494,30900,16594
2000,144,Sri Lanka,Jordan,67,45,22
2000,360,Indonesia,Jordan,1568,840,728
2000,608,Philippines,Jordan,51,37,14
2000,630,Puerto Rico,Jordan,196,93,103
2000,188,Costa Rica,Jordan,8,6,2
2000,340,Honduras,Jordan,30,15,15
2000,484,Mexico,Jordan,64,44,20
2000,558,Nicaragua,Jordan,17,12,5
2000,591,Panama,Jordan,84,58,26
2000,32,Argentina,Jordan,152,97,55
2000,68,Bolivia (Plurinational State of),Jordan,13,11,2
2000,152,Chile,Jordan,83,51,32
2000,170,Colombia,Jordan,180,133,47
2000,218,Ecuador,Jordan,30,24,6
2000,604,Peru,Jordan,29,21,8
2000,862,Venezuela (Bolivarian Republic of),Jordan,264,165,99
2000,36,Australia,Jordan,3480,1949,1531
2000,112,Belarus,Jordan,30,29,1
2000,100,Bulgaria,Jordan,105,90,15
2000,203,Czechia,Jordan,51,44,7
2000,348,Hungary,Jordan,270,201,69
2000,616,Poland,Jordan,163,141,22
2000,642,Romania,Jordan,809,651,158
2000,643,Russian Federation,Jordan,999,805,194
2000,703,Slovakia,Jordan,36,30,6
2000,804,Ukraine,Jordan,4247,4150,97
2000,208,Denmark,Jordan,967,582,385
2000,246,Finland,Jordan,118,95,23
2000,352,Iceland,Jordan,12,5,7
2000,372,Ireland,Jordan,131,74,57
2000,428,Latvia,Jordan,7,6,1
2000,578,Norway,Jordan,109,68,41
2000,752,Sweden,Jordan,1068,602,466
2000,826,United Kingdom,Jordan,3001,1849,1152
2000,300,Greece,Jordan,813,616,197
2000,380,Italy,Jordan,2973,2010,963
2000,470,Malta,Jordan,19,17,2
2000,620,Portugal,Jordan,11,10,1
2000,688,Serbia,Jordan,105,82,23
2000,705,Slovenia,Jordan,53,37,16
2000,724,Spain,Jordan,1689,1330,359
2000,40,Austria,Jordan,518,365,153
2000,56,Belgium,Jordan,66,34,32
2000,250,France,Jordan,1001,670,331
2000,276,Germany,Jordan,10558,7205,3353
2000,528,Netherlands,Jordan,777,485,292
2000,756,Switzerland,Jordan,456,288,168
2000,124,Canada,Jordan,5106,2463,2643
2000,840,United States of America,Jordan,47982,31030,16952
2005,710,South Africa,Jordan,31,19,12
2005,12,Algeria,Jordan,1782,973,809
2005,818,Egypt,Jordan,4567,2549,2018
2005,434,Libya,Jordan,16545,11779,4766
2005,48,Bahrain,Jordan,7772,4910,2862
2005,196,Cyprus,Jordan,294,182,112
2005,368,Iraq,Jordan,10208,6695,3513
2005,414,Kuwait,Jordan,24519,14830,9689
2005,422,Lebanon,Jordan,793,328,465
2005,512,Oman,Jordan,8331,5396,2935
2005,634,Qatar,Jordan,14466,8856,5610
2005,682,Saudi Arabia,Jordan,117432,80731,36701
2005,275,State of Palestine,Jordan,54528,23380,31148
2005,792,Turkey,Jordan,863,546,317
2005,784,United Arab Emirates,Jordan,63626,41156,22470
2005,144,Sri Lanka,Jordan,134,62,72
2005,360,Indonesia,Jordan,6000,3592,2408
2005,608,Philippines,Jordan,41,30,11
2005,630,Puerto Rico,Jordan,153,73,80
2005,188,Costa Rica,Jordan,5,4,1
2005,340,Honduras,Jordan,30,15,15
2005,484,Mexico,Jordan,49,36,13
2005,558,Nicaragua,Jordan,24,14,10
2005,591,Panama,Jordan,90,63,27
2005,32,Argentina,Jordan,113,73,40
2005,68,Bolivia (Plurinational State of),Jordan,14,12,2
2005,76,Brazil,Jordan,522,377,145
2005,152,Chile,Jordan,124,77,47
2005,170,Colombia,Jordan,160,123,37
2005,218,Ecuador,Jordan,35,28,7
2005,604,Peru,Jordan,35,25,10
2005,862,Venezuela (Bolivarian Republic of),Jordan,235,144,91
2005,36,Australia,Jordan,4160,2354,1806
2005,112,Belarus,Jordan,29,28,1
2005,100,Bulgaria,Jordan,133,114,19
2005,203,Czechia,Jordan,104,88,16
2005,348,Hungary,Jordan,333,249,84
2005,616,Poland,Jordan,150,131,19
2005,642,Romania,Jordan,858,682,176
2005,643,Russian Federation,Jordan,909,740,169
2005,703,Slovakia,Jordan,41,34,7
2005,804,Ukraine,Jordan,3880,3792,88
2005,208,Denmark,Jordan,1055,617,438
2005,246,Finland,Jordan,181,131,50
2005,352,Iceland,Jordan,12,5,7
2005,372,Ireland,Jordan,131,77,54
2005,428,Latvia,Jordan,7,6,1
2005,578,Norway,Jordan,148,84,64
2005,752,Sweden,Jordan,1556,869,687
2005,826,United Kingdom,Jordan,4145,2556,1589
2005,191,Croatia,Jordan,34,30,4
2005,300,Greece,Jordan,822,619,203
2005,380,Italy,Jordan,2982,2093,889
2005,470,Malta,Jordan,23,19,4
2005,620,Portugal,Jordan,19,14,5
2005,688,Serbia,Jordan,104,81,23
2005,705,Slovenia,Jordan,64,50,14
2005,724,Spain,Jordan,1976,1504,472
2005,40,Austria,Jordan,579,403,176
2005,56,Belgium,Jordan,566,371,195
2005,250,France,Jordan,1173,689,484
2005,276,Germany,Jordan,10407,6963,3444
2005,528,Netherlands,Jordan,899,541,358
2005,756,Switzerland,Jordan,515,319,196
2005,124,Canada,Jordan,7275,3835,3440
2005,840,United States of America,Jordan,55381,35923,19458
2010,710,South Africa,Jordan,48,30,18
2010,12,Algeria,Jordan,1958,1031,927
2010,818,Egypt,Jordan,4929,2668,2261
2010,434,Libya,Jordan,18101,12947,5154
2010,48,Bahrain,Jordan,12651,8060,4591
2010,196,Cyprus,Jordan,481,300,181
2010,368,Iraq,Jordan,10309,6974,3335
2010,414,Kuwait,Jordan,33444,20449,12995
2010,422,Lebanon,Jordan,573,262,311
2010,512,Oman,Jordan,7523,4775,2748
2010,634,Qatar,Jordan,26916,20955,5961
2010,682,Saudi Arabia,Jordan,152257,107164,45093
2010,275,State of Palestine,Jordan,56259,23133,33126
2010,792,Turkey,Jordan,891,556,335
2010,784,United Arab Emirates,Jordan,141838,94436,47402
2010,144,Sri Lanka,Jordan,271,127,144
2010,360,Indonesia,Jordan,10818,6314,4504
2010,608,Philippines,Jordan,175,126,49
2010,630,Puerto Rico,Jordan,92,43,49
2010,188,Costa Rica,Jordan,11,8,3
2010,340,Honduras,Jordan,29,15,14
2010,484,Mexico,Jordan,41,32,9
2010,558,Nicaragua,Jordan,25,15,10
2010,591,Panama,Jordan,101,72,29
2010,32,Argentina,Jordan,73,49,24
2010,68,Bolivia (Plurinational State of),Jordan,14,12,2
2010,76,Brazil,Jordan,1045,754,291
2010,152,Chile,Jordan,166,104,62
2010,170,Colombia,Jordan,167,135,32
2010,218,Ecuador,Jordan,49,40,9
2010,604,Peru,Jordan,38,26,12
2010,862,Venezuela (Bolivarian Republic of),Jordan,211,126,85
2010,36,Australia,Jordan,5250,2990,2260
2010,112,Belarus,Jordan,28,27,1
2010,100,Bulgaria,Jordan,156,133,23
2010,203,Czechia,Jordan,148,126,22
2010,348,Hungary,Jordan,396,297,99
2010,616,Poland,Jordan,142,125,17
2010,642,Romania,Jordan,1042,819,223
2010,643,Russian Federation,Jordan,801,660,141
2010,703,Slovakia,Jordan,46,38,8
2010,804,Ukraine,Jordan,3702,3619,83
2010,208,Denmark,Jordan,1122,641,481
2010,233,Estonia,Jordan,4,3,1
2010,246,Finland,Jordan,267,190,77
2010,352,Iceland,Jordan,12,5,7
2010,372,Ireland,Jordan,109,61,48
2010,428,Latvia,Jordan,7,6,1
2010,578,Norway,Jordan,301,170,131
2010,752,Sweden,Jordan,2848,1704,1144
2010,826,United Kingdom,Jordan,4366,2727,1639
2010,191,Croatia,Jordan,68,60,8
2010,300,Greece,Jordan,864,647,217
2010,380,Italy,Jordan,3324,2471,853
2010,470,Malta,Jordan,32,27,5
2010,620,Portugal,Jordan,25,16,9
2010,688,Serbia,Jordan,102,79,23
2010,705,Slovenia,Jordan,71,58,13
2010,724,Spain,Jordan,2099,1575,524
2010,40,Austria,Jordan,640,442,198
2010,56,Belgium,Jordan,788,507,281
2010,250,France,Jordan,1355,898,457
2010,276,Germany,Jordan,10244,6726,3518
2010,528,Netherlands,Jordan,891,527,364
2010,756,Switzerland,Jordan,603,356,247
2010,124,Canada,Jordan,9400,5182,4218
2010,840,United States of America,Jordan,64674,39335,25339
2015,710,South Africa,Jordan,85,52,33
2015,324,Guinea,Jordan,2,2,0
2015,12,Algeria,Jordan,2161,1137,1024
2015,818,Egypt,Jordan,3654,2195,1459
2015,434,Libya,Jordan,20408,14518,5890
2015,48,Bahrain,Jordan,14493,9155,5338
2015,196,Cyprus,Jordan,462,290,172
2015,368,Iraq,Jordan,10336,7507,2829
2015,414,Kuwait,Jordan,50399,28119,22280
2015,422,Lebanon,Jordan,482,231,251
2015,512,Oman,Jordan,17108,11800,5308
2015,634,Qatar,Jordan,32217,25552,6665
2015,682,Saudi Arabia,Jordan,192620,133432,59188
2015,275,State of Palestine,Jordan,55709,22830,32879
2015,792,Turkey,Jordan,918,565,353
2015,784,United Arab Emirates,Jordan,154989,101149,53840
2015,144,Sri Lanka,Jordan,275,127,148
2015,360,Indonesia,Jordan,11976,7098,4878
2015,608,Philippines,Jordan,177,128,49
2015,630,Puerto Rico,Jordan,90,43,47
2015,188,Costa Rica,Jordan,11,8,3
2015,340,Honduras,Jordan,40,21,19
2015,484,Mexico,Jordan,43,34,9
2015,558,Nicaragua,Jordan,26,16,10
2015,591,Panama,Jordan,119,84,35
2015,32,Argentina,Jordan,73,49,24
2015,68,Bolivia (Plurinational State of),Jordan,16,14,2
2015,76,Brazil,Jordan,1258,908,350
2015,152,Chile,Jordan,251,156,95
2015,170,Colombia,Jordan,186,151,35
2015,218,Ecuador,Jordan,71,58,13
2015,604,Peru,Jordan,39,29,10
2015,862,Venezuela (Bolivarian Republic of),Jordan,200,119,81
2015,36,Australia,Jordan,6530,3660,2870
2015,112,Belarus,Jordan,30,29,1
2015,100,Bulgaria,Jordan,229,172,57
2015,203,Czechia,Jordan,169,134,35
2015,348,Hungary,Jordan,514,409,105
2015,616,Poland,Jordan,136,120,16
2015,642,Romania,Jordan,120,95,25
2015,643,Russian Federation,Jordan,816,672,144
2015,703,Slovakia,Jordan,57,47,10
2015,804,Ukraine,Jordan,3714,3631,83
2015,208,Denmark,Jordan,1265,722,543
2015,233,Estonia,Jordan,10,9,1
2015,246,Finland,Jordan,345,210,135
2015,352,Iceland,Jordan,13,6,7
2015,372,Ireland,Jordan,111,61,50
2015,428,Latvia,Jordan,4,4,0
2015,578,Norway,Jordan,432,224,208
2015,752,Sweden,Jordan,3898,2262,1636
2015,826,United Kingdom,Jordan,5583,3425,2158
2015,191,Croatia,Jordan,68,60,8
2015,300,Greece,Jordan,810,598,212
2015,380,Italy,Jordan,2912,2069,843
2015,470,Malta,Jordan,54,47,7
2015,620,Portugal,Jordan,28,17,11
2015,688,Serbia,Jordan,99,77,22
2015,705,Slovenia,Jordan,60,49,11
2015,724,Spain,Jordan,2261,1637,624
2015,40,Austria,Jordan,749,519,230
2015,56,Belgium,Jordan,1061,669,392
2015,250,France,Jordan,1500,981,519
2015,276,Germany,Jordan,10674,7000,3674
2015,528,Netherlands,Jordan,923,530,393
2015,756,Switzerland,Jordan,769,435,334
2015,124,Canada,Jordan,13208,7049,6159
2015,840,United States of America,Jordan,75355,45681,29674
2019,710,South Africa,Jordan,95,59,36
2019,324,Guinea,Jordan,1,1,0
2019,12,Algeria,Jordan,2247,1182,1065
2019,818,Egypt,Jordan,5208,2883,2325
2019,434,Libya,Jordan,21653,15404,6249
2019,48,Bahrain,Jordan,15255,9637,5618
2019,196,Cyprus,Jordan,461,291,170
2019,368,Iraq,Jordan,10585,7688,2897
2019,414,Kuwait,Jordan,53365,29774,23591
2019,422,Lebanon,Jordan,455,218,237
2019,512,Oman,Jordan,21071,14534,6537
2019,634,Qatar,Jordan,32861,25578,7283
2019,682,Saudi Arabia,Jordan,234661,160966,73695
2019,275,State of Palestine,Jordan,55322,22672,32650
2019,792,Turkey,Jordan,1241,769,472
2019,784,United Arab Emirates,Jordan,166467,108630,57837
2019,144,Sri Lanka,Jordan,277,128,149
2019,360,Indonesia,Jordan,12507,7413,5094
2019,608,Philippines,Jordan,182,132,50
2019,630,Puerto Rico,Jordan,85,41,44
2019,188,Costa Rica,Jordan,11,8,3
2019,340,Honduras,Jordan,40,21,19
2019,484,Mexico,Jordan,44,35,9
2019,558,Nicaragua,Jordan,27,17,10
2019,591,Panama,Jordan,125,89,36
2019,32,Argentina,Jordan,74,50,24
2019,68,Bolivia (Plurinational State of),Jordan,17,15,2
2019,76,Brazil,Jordan,1416,1022,394
2019,152,Chile,Jordan,335,202,133
2019,170,Colombia,Jordan,190,155,35
2019,218,Ecuador,Jordan,69,57,12
2019,604,Peru,Jordan,45,35,10
2019,862,Venezuela (Bolivarian Republic of),Jordan,195,116,79
2019,36,Australia,Jordan,7871,4391,3480
2019,112,Belarus,Jordan,29,29,0
2019,100,Bulgaria,Jordan,294,216,78
2019,203,Czechia,Jordan,191,146,45
2019,348,Hungary,Jordan,543,400,143
2019,616,Poland,Jordan,144,128,16
2019,642,Romania,Jordan,362,273,89
2019,643,Russian Federation,Jordan,815,672,143
2019,703,Slovakia,Jordan,63,51,12
2019,804,Ukraine,Jordan,3751,3668,83
2019,208,Denmark,Jordan,1373,774,599
2019,233,Estonia,Jordan,17,12,5
2019,246,Finland,Jordan,397,241,156
2019,352,Iceland,Jordan,19,10,9
2019,372,Ireland,Jordan,121,67,54
2019,428,Latvia,Jordan,4,4,0
2019,578,Norway,Jordan,544,282,262
2019,752,Sweden,Jordan,5187,2855,2332
2019,826,United Kingdom,Jordan,6340,3896,2444
2019,191,Croatia,Jordan,62,55,7
2019,300,Greece,Jordan,791,592,199
2019,380,Italy,Jordan,3051,2159,892
2019,470,Malta,Jordan,87,76,11
2019,620,Portugal,Jordan,190,112,78
2019,688,Serbia,Jordan,100,78,22
2019,705,Slovenia,Jordan,58,47,11
2019,724,Spain,Jordan,2342,1680,662
2019,40,Austria,Jordan,884,618,266
2019,56,Belgium,Jordan,1228,760,468
2019,250,France,Jordan,1587,1037,550
2019,276,Germany,Jordan,11709,7437,4272
2019,528,Netherlands,Jordan,1323,745,578
2019,756,Switzerland,Jordan,836,475,361
2019,124,Canada,Jordan,14153,7553,6600
2019,840,United States of America,Jordan,81375,48986,32389
1990,818,Egypt,Kazakhstan,142,50,92
1990,434,Libya,Kazakhstan,403,141,262
1990,51,Armenia,Kazakhstan,787,179,608
1990,31,Azerbaijan,Kazakhstan,4940,1837,3103
1990,196,Cyprus,Kazakhstan,59,24,35
1990,268,Georgia,Kazakhstan,21017,9244,11773
1990,376,Israel,Kazakhstan,6279,2866,3413
1990,400,Jordan,Kazakhstan,3,1,2
1990,792,Turkey,Kazakhstan,1209,577,632
1990,417,Kyrgyzstan,Kazakhstan,38405,16118,22287
1990,762,Tajikistan,Kazakhstan,1101,484,617
1990,795,Turkmenistan,Kazakhstan,31076,14005,17071
1990,860,Uzbekistan,Kazakhstan,30344,13086,17258
1990,356,India,Kazakhstan,1408,73,1335
1990,496,Mongolia,Kazakhstan,528,247,281
1990,410,Republic of Korea,Kazakhstan,97,68,29
1990,214,Dominican Republic,Kazakhstan,3,3,0
1990,188,Costa Rica,Kazakhstan,5,0,5
1990,152,Chile,Kazakhstan,5,1,4
1990,36,Australia,Kazakhstan,297,132,165
1990,112,Belarus,Kazakhstan,81148,38716,42432
1990,100,Bulgaria,Kazakhstan,89,26,63
1990,203,Czechia,Kazakhstan,454,220,234
1990,348,Hungary,Kazakhstan,469,229,240
1990,616,Poland,Kazakhstan,4778,2252,2526
1990,498,Republic of Moldova,Kazakhstan,19736,9132,10604
1990,643,Russian Federation,Kazakhstan,2349697,1153024,1196673
1990,703,Slovakia,Kazakhstan,21,6,15
1990,804,Ukraine,Kazakhstan,330947,141810,189137
1990,208,Denmark,Kazakhstan,38,9,29
1990,233,Estonia,Kazakhstan,7616,3775,3841
1990,372,Ireland,Kazakhstan,50,23,27
1990,428,Latvia,Kazakhstan,528,331,197
1990,440,Lithuania,Kazakhstan,13109,6573,6536
1990,752,Sweden,Kazakhstan,135,43,92
1990,826,United Kingdom,Kazakhstan,121,61,60
1990,300,Greece,Kazakhstan,3531,1955,1576
1990,380,Italy,Kazakhstan,50,18,32
1990,620,Portugal,Kazakhstan,27,18,9
1990,688,Serbia,Kazakhstan,11,2,9
1990,705,Slovenia,Kazakhstan,4,2,2
1990,724,Spain,Kazakhstan,8,5,3
1990,40,Austria,Kazakhstan,608,230,378
1990,56,Belgium,Kazakhstan,16,8,8
1990,250,France,Kazakhstan,436,191,245
1990,276,Germany,Kazakhstan,10199,4980,5219
1990,528,Netherlands,Kazakhstan,4,4,0
1990,756,Switzerland,Kazakhstan,224,76,148
1990,124,Canada,Kazakhstan,3661,1782,1879
1990,840,United States of America,Kazakhstan,5816,2845,2971
1995,818,Egypt,Kazakhstan,143,64,79
1995,434,Libya,Kazakhstan,492,291,201
1995,51,Armenia,Kazakhstan,835,215,620
1995,31,Azerbaijan,Kazakhstan,4336,1777,2559
1995,196,Cyprus,Kazakhstan,84,32,52
1995,268,Georgia,Kazakhstan,3302,1866,1436
1995,376,Israel,Kazakhstan,8001,3607,4394
1995,400,Jordan,Kazakhstan,14,4,10
1995,792,Turkey,Kazakhstan,2926,1333,1593
1995,417,Kyrgyzstan,Kazakhstan,31791,13097,18694
1995,762,Tajikistan,Kazakhstan,951,450,501
1995,795,Turkmenistan,Kazakhstan,25385,12696,12689
1995,860,Uzbekistan,Kazakhstan,25111,10679,14432
1995,356,India,Kazakhstan,2052,88,1964
1995,496,Mongolia,Kazakhstan,583,288,295
1995,410,Republic of Korea,Kazakhstan,608,416,192
1995,214,Dominican Republic,Kazakhstan,4,4,0
1995,188,Costa Rica,Kazakhstan,4,0,4
1995,68,Bolivia (Plurinational State of),Kazakhstan,1,1,0
1995,152,Chile,Kazakhstan,6,4,2
1995,36,Australia,Kazakhstan,353,144,209
1995,112,Belarus,Kazakhstan,76868,36862,40006
1995,100,Bulgaria,Kazakhstan,271,80,191
1995,203,Czechia,Kazakhstan,682,341,341
1995,348,Hungary,Kazakhstan,416,199,217
1995,616,Poland,Kazakhstan,4087,1893,2194
1995,498,Republic of Moldova,Kazakhstan,13319,5977,7342
1995,643,Russian Federation,Kazakhstan,2506132,1209241,1296891
1995,703,Slovakia,Kazakhstan,78,32,46
1995,804,Ukraine,Kazakhstan,290731,127108,163623
1995,208,Denmark,Kazakhstan,41,10,31
1995,233,Estonia,Kazakhstan,5712,2714,2998
1995,246,Finland,Kazakhstan,22,10,12
1995,352,Iceland,Kazakhstan,1,0,1
1995,372,Ireland,Kazakhstan,138,61,77
1995,428,Latvia,Kazakhstan,4627,2205,2422
1995,440,Lithuania,Kazakhstan,8354,4205,4149
1995,578,Norway,Kazakhstan,6,3,3
1995,752,Sweden,Kazakhstan,161,51,110
1995,826,United Kingdom,Kazakhstan,480,176,304
1995,300,Greece,Kazakhstan,13744,6680,7064
1995,380,Italy,Kazakhstan,296,30,266
1995,620,Portugal,Kazakhstan,58,39,19
1995,688,Serbia,Kazakhstan,75,16,59
1995,705,Slovenia,Kazakhstan,7,3,4
1995,724,Spain,Kazakhstan,20,7,13
1995,40,Austria,Kazakhstan,686,266,420
1995,56,Belgium,Kazakhstan,14,7,7
1995,250,France,Kazakhstan,450,192,258
1995,276,Germany,Kazakhstan,248645,105848,142797
1995,528,Netherlands,Kazakhstan,5,5,0
1995,756,Switzerland,Kazakhstan,794,350,444
1995,124,Canada,Kazakhstan,3676,1781,1895
1995,840,United States of America,Kazakhstan,7585,3750,3835
2000,818,Egypt,Kazakhstan,155,82,73
2000,434,Libya,Kazakhstan,591,452,139
2000,51,Armenia,Kazakhstan,913,251,662
2000,31,Azerbaijan,Kazakhstan,4370,1754,2616
2000,196,Cyprus,Kazakhstan,108,40,68
2000,268,Georgia,Kazakhstan,1651,933,718
2000,376,Israel,Kazakhstan,9275,4193,5082
2000,400,Jordan,Kazakhstan,25,8,17
2000,792,Turkey,Kazakhstan,4654,2090,2564
2000,417,Kyrgyzstan,Kazakhstan,24298,9688,14610
2000,762,Tajikistan,Kazakhstan,889,426,463
2000,795,Turkmenistan,Kazakhstan,20579,9980,10599
2000,860,Uzbekistan,Kazakhstan,20868,8728,12140
2000,356,India,Kazakhstan,2696,103,2593
2000,496,Mongolia,Kazakhstan,644,333,311
2000,410,Republic of Korea,Kazakhstan,1314,910,404
2000,214,Dominican Republic,Kazakhstan,4,4,0
2000,188,Costa Rica,Kazakhstan,4,0,4
2000,68,Bolivia (Plurinational State of),Kazakhstan,2,2,0
2000,152,Chile,Kazakhstan,7,4,3
2000,36,Australia,Kazakhstan,380,156,224
2000,112,Belarus,Kazakhstan,72587,35008,37579
2000,100,Bulgaria,Kazakhstan,452,133,319
2000,203,Czechia,Kazakhstan,909,462,447
2000,348,Hungary,Kazakhstan,362,169,193
2000,616,Poland,Kazakhstan,3496,1590,1906
2000,498,Republic of Moldova,Kazakhstan,8989,3905,5084
2000,643,Russian Federation,Kazakhstan,2571681,1222091,1349590
2000,703,Slovakia,Kazakhstan,158,67,91
2000,804,Ukraine,Kazakhstan,254065,113958,140107
2000,208,Denmark,Kazakhstan,43,10,33
2000,233,Estonia,Kazakhstan,3808,1653,2155
2000,246,Finland,Kazakhstan,44,21,23
2000,352,Iceland,Kazakhstan,1,0,1
2000,372,Ireland,Kazakhstan,301,138,163
2000,428,Latvia,Kazakhstan,8726,4079,4647
2000,440,Lithuania,Kazakhstan,6544,3288,3256
2000,578,Norway,Kazakhstan,46,6,40
2000,752,Sweden,Kazakhstan,173,54,119
2000,826,United Kingdom,Kazakhstan,848,294,554
2000,300,Greece,Kazakhstan,24182,11386,12796
2000,380,Italy,Kazakhstan,542,42,500
2000,620,Portugal,Kazakhstan,92,61,31
2000,688,Serbia,Kazakhstan,103,21,82
2000,705,Slovenia,Kazakhstan,1,0,1
2000,724,Spain,Kazakhstan,43,13,30
2000,40,Austria,Kazakhstan,763,302,461
2000,56,Belgium,Kazakhstan,10,5,5
2000,250,France,Kazakhstan,464,194,270
2000,276,Germany,Kazakhstan,487090,206715,280375
2000,528,Netherlands,Kazakhstan,8,5,3
2000,756,Switzerland,Kazakhstan,1368,627,741
2000,124,Canada,Kazakhstan,3779,1823,1956
2000,840,United States of America,Kazakhstan,9386,4676,4710
2005,818,Egypt,Kazakhstan,185,103,82
2005,434,Libya,Kazakhstan,651,526,125
2005,51,Armenia,Kazakhstan,604,180,424
2005,31,Azerbaijan,Kazakhstan,4147,1588,2559
2005,196,Cyprus,Kazakhstan,158,58,100
2005,268,Georgia,Kazakhstan,1568,886,682
2005,376,Israel,Kazakhstan,11179,5076,6103
2005,400,Jordan,Kazakhstan,36,14,22
2005,792,Turkey,Kazakhstan,4795,2094,2701
2005,417,Kyrgyzstan,Kazakhstan,19645,7778,11867
2005,762,Tajikistan,Kazakhstan,857,410,447
2005,795,Turkmenistan,Kazakhstan,20410,10004,10406
2005,860,Uzbekistan,Kazakhstan,18166,7782,10384
2005,356,India,Kazakhstan,2491,89,2402
2005,496,Mongolia,Kazakhstan,384,189,195
2005,410,Republic of Korea,Kazakhstan,1027,651,376
2005,214,Dominican Republic,Kazakhstan,7,4,3
2005,188,Costa Rica,Kazakhstan,3,0,3
2005,68,Bolivia (Plurinational State of),Kazakhstan,11,5,6
2005,76,Brazil,Kazakhstan,12,0,12
2005,152,Chile,Kazakhstan,10,6,4
2005,36,Australia,Kazakhstan,670,252,418
2005,112,Belarus,Kazakhstan,71580,34514,37066
2005,100,Bulgaria,Kazakhstan,705,220,485
2005,203,Czechia,Kazakhstan,2909,1420,1489
2005,348,Hungary,Kazakhstan,447,213,234
2005,616,Poland,Kazakhstan,4071,1848,2223
2005,498,Republic of Moldova,Kazakhstan,6207,2631,3576
2005,643,Russian Federation,Kazakhstan,2568446,1204356,1364090
2005,703,Slovakia,Kazakhstan,178,77,101
2005,804,Ukraine,Kazakhstan,232148,104305,127843
2005,208,Denmark,Kazakhstan,96,30,66
2005,233,Estonia,Kazakhstan,3968,1741,2227
2005,246,Finland,Kazakhstan,108,46,62
2005,352,Iceland,Kazakhstan,8,1,7
2005,372,Ireland,Kazakhstan,302,149,153
2005,428,Latvia,Kazakhstan,7993,3711,4282
2005,440,Lithuania,Kazakhstan,6388,3157,3231
2005,578,Norway,Kazakhstan,292,96,196
2005,752,Sweden,Kazakhstan,605,224,381
2005,826,United Kingdom,Kazakhstan,2731,1017,1714
2005,191,Croatia,Kazakhstan,34,7,27
2005,300,Greece,Kazakhstan,25878,12064,13814
2005,380,Italy,Kazakhstan,2196,344,1852
2005,620,Portugal,Kazakhstan,469,258,211
2005,688,Serbia,Kazakhstan,102,20,82
2005,705,Slovenia,Kazakhstan,11,1,10
2005,724,Spain,Kazakhstan,420,186,234
2005,40,Austria,Kazakhstan,853,325,528
2005,56,Belgium,Kazakhstan,353,144,209
2005,250,France,Kazakhstan,1897,703,1194
2005,276,Germany,Kazakhstan,671031,315482,355549
2005,528,Netherlands,Kazakhstan,90,43,47
2005,756,Switzerland,Kazakhstan,1689,743,946
2005,124,Canada,Kazakhstan,6361,2993,3368
2005,840,United States of America,Kazakhstan,11168,5594,5574
2010,466,Mali,Kazakhstan,1501,864,637
2010,818,Egypt,Kazakhstan,200,108,92
2010,434,Libya,Kazakhstan,712,577,135
2010,51,Armenia,Kazakhstan,503,162,341
2010,31,Azerbaijan,Kazakhstan,3797,1539,2258
2010,196,Cyprus,Kazakhstan,258,97,161
2010,268,Georgia,Kazakhstan,1583,895,688
2010,376,Israel,Kazakhstan,13218,6008,7210
2010,400,Jordan,Kazakhstan,46,19,27
2010,792,Turkey,Kazakhstan,4941,2095,2846
2010,417,Kyrgyzstan,Kazakhstan,14692,5718,8974
2010,762,Tajikistan,Kazakhstan,854,410,444
2010,795,Turkmenistan,Kazakhstan,19806,9322,10484
2010,860,Uzbekistan,Kazakhstan,14700,6531,8169
2010,356,India,Kazakhstan,2286,76,2210
2010,496,Mongolia,Kazakhstan,170,88,82
2010,410,Republic of Korea,Kazakhstan,1145,624,521
2010,214,Dominican Republic,Kazakhstan,10,5,5
2010,188,Costa Rica,Kazakhstan,5,0,5
2010,68,Bolivia (Plurinational State of),Kazakhstan,20,8,12
2010,76,Brazil,Kazakhstan,24,0,24
2010,152,Chile,Kazakhstan,14,9,5
2010,36,Australia,Kazakhstan,1190,452,738
2010,112,Belarus,Kazakhstan,70573,34020,36553
2010,100,Bulgaria,Kazakhstan,929,298,631
2010,203,Czechia,Kazakhstan,4627,2303,2324
2010,348,Hungary,Kazakhstan,532,258,274
2010,616,Poland,Kazakhstan,4775,2149,2626
2010,498,Republic of Moldova,Kazakhstan,4973,2139,2834
2010,642,Romania,Kazakhstan,5,1,4
2010,643,Russian Federation,Kazakhstan,2512343,1162664,1349679
2010,703,Slovakia,Kazakhstan,199,88,111
2010,804,Ukraine,Kazakhstan,221504,99692,121812
2010,208,Denmark,Kazakhstan,145,48,97
2010,233,Estonia,Kazakhstan,4095,1806,2289
2010,246,Finland,Kazakhstan,202,78,124
2010,352,Iceland,Kazakhstan,15,2,13
2010,372,Ireland,Kazakhstan,254,116,138
2010,428,Latvia,Kazakhstan,7058,3185,3873
2010,440,Lithuania,Kazakhstan,5366,2434,2932
2010,578,Norway,Kazakhstan,649,238,411
2010,752,Sweden,Kazakhstan,1227,475,752
2010,826,United Kingdom,Kazakhstan,2876,1108,1768
2010,191,Croatia,Kazakhstan,67,13,54
2010,300,Greece,Kazakhstan,28689,13263,15426
2010,380,Italy,Kazakhstan,3586,582,3004
2010,620,Portugal,Kazakhstan,769,412,357
2010,688,Serbia,Kazakhstan,100,19,81
2010,705,Slovenia,Kazakhstan,45,10,35
2010,724,Spain,Kazakhstan,1184,496,688
2010,40,Austria,Kazakhstan,943,349,594
2010,56,Belgium,Kazakhstan,773,389,384
2010,250,France,Kazakhstan,2425,982,1443
2010,276,Germany,Kazakhstan,816137,403247,412890
2010,528,Netherlands,Kazakhstan,126,64,62
2010,756,Switzerland,Kazakhstan,1808,719,1089
2010,124,Canada,Kazakhstan,9360,4369,4991
2010,840,United States of America,Kazakhstan,13341,6592,6749
2015,466,Mali,Kazakhstan,1859,1070,789
2015,818,Egypt,Kazakhstan,148,89,59
2015,434,Libya,Kazakhstan,802,648,154
2015,51,Armenia,Kazakhstan,791,255,536
2015,31,Azerbaijan,Kazakhstan,3621,1514,2107
2015,196,Cyprus,Kazakhstan,247,94,153
2015,268,Georgia,Kazakhstan,1662,940,722
2015,376,Israel,Kazakhstan,13632,6160,7472
2015,400,Jordan,Kazakhstan,19,6,13
2015,792,Turkey,Kazakhstan,5015,2061,2954
2015,417,Kyrgyzstan,Kazakhstan,12940,4990,7950
2015,762,Tajikistan,Kazakhstan,839,400,439
2015,795,Turkmenistan,Kazakhstan,20145,9726,10419
2015,860,Uzbekistan,Kazakhstan,13194,5969,7225
2015,356,India,Kazakhstan,2202,71,2131
2015,496,Mongolia,Kazakhstan,210,81,129
2015,410,Republic of Korea,Kazakhstan,1422,760,662
2015,214,Dominican Republic,Kazakhstan,10,5,5
2015,188,Costa Rica,Kazakhstan,5,0,5
2015,68,Bolivia (Plurinational State of),Kazakhstan,23,9,14
2015,76,Brazil,Kazakhstan,29,0,29
2015,152,Chile,Kazakhstan,21,14,7
2015,36,Australia,Kazakhstan,1920,722,1198
2015,112,Belarus,Kazakhstan,69957,33739,36218
2015,100,Bulgaria,Kazakhstan,1515,516,999
2015,203,Czechia,Kazakhstan,6563,3369,3194
2015,348,Hungary,Kazakhstan,516,186,330
2015,616,Poland,Kazakhstan,4603,2119,2484
2015,498,Republic of Moldova,Kazakhstan,4452,1937,2515
2015,642,Romania,Kazakhstan,85,40,45
2015,643,Russian Federation,Kazakhstan,2560269,1177958,1382311
2015,703,Slovakia,Kazakhstan,246,118,128
2015,804,Ukraine,Kazakhstan,222245,100195,122050
2015,208,Denmark,Kazakhstan,219,75,144
2015,233,Estonia,Kazakhstan,3752,1621,2131
2015,246,Finland,Kazakhstan,316,119,197
2015,352,Iceland,Kazakhstan,21,5,16
2015,372,Ireland,Kazakhstan,259,116,143
2015,428,Latvia,Kazakhstan,5931,2659,3272
2015,440,Lithuania,Kazakhstan,4477,1958,2519
2015,578,Norway,Kazakhstan,941,344,597
2015,752,Sweden,Kazakhstan,1956,818,1138
2015,826,United Kingdom,Kazakhstan,3677,1349,2328
2015,191,Croatia,Kazakhstan,67,13,54
2015,300,Greece,Kazakhstan,26926,11831,15095
2015,380,Italy,Kazakhstan,4043,657,3386
2015,620,Portugal,Kazakhstan,872,447,425
2015,688,Serbia,Kazakhstan,97,18,79
2015,705,Slovenia,Kazakhstan,100,39,61
2015,724,Spain,Kazakhstan,1797,721,1076
2015,40,Austria,Kazakhstan,1103,412,691
2015,56,Belgium,Kazakhstan,1051,527,524
2015,250,France,Kazakhstan,2686,1044,1642
2015,276,Germany,Kazakhstan,848587,418239,430348
2015,528,Netherlands,Kazakhstan,228,112,116
2015,756,Switzerland,Kazakhstan,3287,1429,1858
2015,124,Canada,Kazakhstan,12373,5736,6637
2015,840,United States of America,Kazakhstan,28892,14202,14690
2019,466,Mali,Kazakhstan,2069,1191,878
2019,818,Egypt,Kazakhstan,210,116,94
2019,434,Libya,Kazakhstan,850,687,163
2019,51,Armenia,Kazakhstan,786,258,528
2019,31,Azerbaijan,Kazakhstan,3479,1455,2024
2019,196,Cyprus,Kazakhstan,246,95,151
2019,268,Georgia,Kazakhstan,1712,968,744
2019,376,Israel,Kazakhstan,13256,5990,7266
2019,400,Jordan,Kazakhstan,20,7,13
2019,792,Turkey,Kazakhstan,6781,2827,3954
2019,417,Kyrgyzstan,Kazakhstan,12679,4890,7789
2019,762,Tajikistan,Kazakhstan,835,398,437
2019,795,Turkmenistan,Kazakhstan,20016,9792,10224
2019,860,Uzbekistan,Kazakhstan,13165,5961,7204
2019,356,India,Kazakhstan,2165,71,2094
2019,496,Mongolia,Kazakhstan,223,86,137
2019,410,Republic of Korea,Kazakhstan,1447,773,674
2019,214,Dominican Republic,Kazakhstan,10,5,5
2019,188,Costa Rica,Kazakhstan,5,0,5
2019,68,Bolivia (Plurinational State of),Kazakhstan,25,10,15
2019,76,Brazil,Kazakhstan,32,0,32
2019,152,Chile,Kazakhstan,28,19,9
2019,36,Australia,Kazakhstan,2264,824,1440
2019,112,Belarus,Kazakhstan,69084,33318,35766
2019,100,Bulgaria,Kazakhstan,2101,727,1374
2019,203,Czechia,Kazakhstan,7798,4001,3797
2019,348,Hungary,Kazakhstan,638,226,412
2019,616,Poland,Kazakhstan,4874,2345,2529
2019,498,Republic of Moldova,Kazakhstan,4382,1909,2473
2019,642,Romania,Kazakhstan,256,114,142
2019,643,Russian Federation,Kazakhstan,2559711,1177693,1382018
2019,703,Slovakia,Kazakhstan,270,132,138
2019,804,Ukraine,Kazakhstan,224467,101197,123270
2019,208,Denmark,Kazakhstan,269,83,186
2019,233,Estonia,Kazakhstan,3682,1613,2069
2019,246,Finland,Kazakhstan,411,163,248
2019,352,Iceland,Kazakhstan,31,11,20
2019,372,Ireland,Kazakhstan,284,128,156
2019,428,Latvia,Kazakhstan,5467,2437,3030
2019,440,Lithuania,Kazakhstan,3774,1597,2177
2019,578,Norway,Kazakhstan,998,343,655
2019,752,Sweden,Kazakhstan,2520,1057,1463
2019,826,United Kingdom,Kazakhstan,4175,1538,2637
2019,191,Croatia,Kazakhstan,61,11,50
2019,300,Greece,Kazakhstan,26296,12113,14183
2019,380,Italy,Kazakhstan,4631,795,3836
2019,620,Portugal,Kazakhstan,886,455,431
2019,688,Serbia,Kazakhstan,98,18,80
2019,705,Slovenia,Kazakhstan,160,61,99
2019,724,Spain,Kazakhstan,1861,720,1141
2019,40,Austria,Kazakhstan,1302,501,801
2019,56,Belgium,Kazakhstan,1132,581,551
2019,250,France,Kazakhstan,2843,1101,1742
2019,276,Germany,Kazakhstan,940296,458894,481402
2019,528,Netherlands,Kazakhstan,382,188,194
2019,756,Switzerland,Kazakhstan,3735,1654,2081
2019,124,Canada,Kazakhstan,13259,6147,7112
2019,840,United States of America,Kazakhstan,31199,15165,16034
1990,108,Burundi,Kenya,186,104,82
1990,174,Comoros,Kenya,87,40,47
1990,232,Eritrea,Kenya,187,125,62
1990,508,Mozambique,Kenya,9087,4831,4256
1990,646,Rwanda,Kenya,955,555,400
1990,690,Seychelles,Kenya,25,8,17
1990,800,Uganda,Kenya,32265,14225,18040
1990,834,United Republic of Tanzania,Kenya,33613,14402,19211
1990,894,Zambia,Kenya,433,276,157
1990,72,Botswana,Kenya,122,68,54
1990,516,Namibia,Kenya,1641,822,819
1990,710,South Africa,Kenya,2140,1325,815
1990,288,Ghana,Kenya,8,6,2
1990,818,Egypt,Kenya,131,101,30
1990,434,Libya,Kenya,375,291,84
1990,729,Sudan,Kenya,6118,3145,2973
1990,196,Cyprus,Kenya,21,11,10
1990,792,Turkey,Kenya,42,28,14
1990,356,India,Kenya,8170,3855,4315
1990,608,Philippines,Kenya,4,3,1
1990,44,Bahamas,Kenya,6,3,3
1990,136,Cayman Islands,Kenya,10,3,7
1990,188,Costa Rica,Kenya,4,4,0
1990,484,Mexico,Kenya,69,11,58
1990,32,Argentina,Kenya,6,2,4
1990,68,Bolivia (Plurinational State of),Kenya,2,0,2
1990,152,Chile,Kenya,8,5,3
1990,36,Australia,Kenya,4680,2478,2202
1990,554,New Zealand,Kenya,270,129,141
1990,100,Bulgaria,Kenya,2,1,1
1990,203,Czechia,Kenya,11,7,4
1990,348,Hungary,Kenya,18,11,7
1990,616,Poland,Kenya,75,42,33
1990,643,Russian Federation,Kenya,394,193,201
1990,703,Slovakia,Kenya,1,1,0
1990,208,Denmark,Kenya,609,289,320
1990,234,Faroe Islands,Kenya,2,2,0
1990,246,Finland,Kenya,98,59,39
1990,352,Iceland,Kenya,10,4,6
1990,372,Ireland,Kenya,93,40,53
1990,578,Norway,Kenya,489,269,220
1990,752,Sweden,Kenya,995,445,550
1990,826,United Kingdom,Kenya,109722,56485,53237
1990,300,Greece,Kenya,480,388,92
1990,380,Italy,Kenya,134,46,88
1990,470,Malta,Kenya,18,8,10
1990,620,Portugal,Kenya,43,18,25
1990,705,Slovenia,Kenya,5,3,2
1990,724,Spain,Kenya,230,100,130
1990,40,Austria,Kenya,542,176,366
1990,56,Belgium,Kenya,536,222,314
1990,250,France,Kenya,947,315,632
1990,276,Germany,Kenya,1361,698,663
1990,528,Netherlands,Kenya,999,481,518
1990,756,Switzerland,Kenya,1576,726,850
1990,124,Canada,Kenya,15914,7748,8166
1990,840,United States of America,Kenya,14371,7416,6955
1995,108,Burundi,Kenya,216,122,94
1995,174,Comoros,Kenya,86,39,47
1995,232,Eritrea,Kenya,202,121,81
1995,508,Mozambique,Kenya,12499,6671,5828
1995,646,Rwanda,Kenya,1455,845,610
1995,690,Seychelles,Kenya,178,55,123
1995,800,Uganda,Kenya,30640,12926,17714
1995,834,United Republic of Tanzania,Kenya,31740,13607,18133
1995,894,Zambia,Kenya,328,210,118
1995,72,Botswana,Kenya,179,96,83
1995,516,Namibia,Kenya,1569,791,778
1995,710,South Africa,Kenya,3911,2022,1889
1995,288,Ghana,Kenya,8,6,2
1995,818,Egypt,Kenya,112,81,31
1995,434,Libya,Kenya,307,215,92
1995,729,Sudan,Kenya,6241,3215,3026
1995,196,Cyprus,Kenya,30,15,15
1995,792,Turkey,Kenya,101,66,35
1995,356,India,Kenya,5541,2625,2916
1995,608,Philippines,Kenya,5,4,1
1995,44,Bahamas,Kenya,5,2,3
1995,136,Cayman Islands,Kenya,21,6,15
1995,188,Costa Rica,Kenya,4,4,0
1995,484,Mexico,Kenya,46,10,36
1995,32,Argentina,Kenya,6,2,4
1995,68,Bolivia (Plurinational State of),Kenya,6,2,4
1995,152,Chile,Kenya,13,8,5
1995,36,Australia,Kenya,6121,3192,2929
1995,554,New Zealand,Kenya,327,159,168
1995,100,Bulgaria,Kenya,4,2,2
1995,203,Czechia,Kenya,16,10,6
1995,348,Hungary,Kenya,39,21,18
1995,616,Poland,Kenya,64,36,28
1995,643,Russian Federation,Kenya,381,203,178
1995,703,Slovakia,Kenya,7,4,3
1995,208,Denmark,Kenya,803,372,431
1995,234,Faroe Islands,Kenya,2,2,0
1995,246,Finland,Kenya,139,78,61
1995,352,Iceland,Kenya,17,7,10
1995,372,Ireland,Kenya,257,105,152
1995,578,Norway,Kenya,618,308,310
1995,752,Sweden,Kenya,1181,524,657
1995,826,United Kingdom,Kenya,116551,59323,57228
1995,300,Greece,Kenya,419,261,158
1995,380,Italy,Kenya,592,196,396
1995,470,Malta,Kenya,22,10,12
1995,620,Portugal,Kenya,94,40,54
1995,705,Slovenia,Kenya,10,5,5
1995,724,Spain,Kenya,303,134,169
1995,40,Austria,Kenya,611,205,406
1995,56,Belgium,Kenya,534,220,314
1995,250,France,Kenya,978,315,663
1995,276,Germany,Kenya,2966,1058,1908
1995,528,Netherlands,Kenya,1355,636,719
1995,756,Switzerland,Kenya,1939,906,1033
1995,124,Canada,Kenya,17967,8702,9265
1995,840,United States of America,Kenya,27894,14558,13336
2000,108,Burundi,Kenya,202,115,87
2000,174,Comoros,Kenya,85,38,47
2000,232,Eritrea,Kenya,217,117,100
2000,508,Mozambique,Kenya,14539,7539,7000
2000,646,Rwanda,Kenya,2218,1288,930
2000,690,Seychelles,Kenya,331,102,229
2000,800,Uganda,Kenya,37371,16601,20770
2000,834,United Republic of Tanzania,Kenya,30272,12971,17301
2000,894,Zambia,Kenya,249,159,90
2000,72,Botswana,Kenya,254,133,121
2000,516,Namibia,Kenya,1458,738,720
2000,710,South Africa,Kenya,6894,3253,3641
2000,288,Ghana,Kenya,9,7,2
2000,818,Egypt,Kenya,101,67,34
2000,434,Libya,Kenya,246,145,101
2000,729,Sudan,Kenya,6367,3287,3080
2000,196,Cyprus,Kenya,38,19,19
2000,792,Turkey,Kenya,162,104,58
2000,356,India,Kenya,2912,1396,1516
2000,608,Philippines,Kenya,275,125,150
2000,44,Bahamas,Kenya,5,3,2
2000,136,Cayman Islands,Kenya,37,10,27
2000,188,Costa Rica,Kenya,6,6,0
2000,484,Mexico,Kenya,26,10,16
2000,32,Argentina,Kenya,6,2,4
2000,68,Bolivia (Plurinational State of),Kenya,9,4,5
2000,152,Chile,Kenya,19,11,8
2000,36,Australia,Kenya,7190,3739,3451
2000,554,New Zealand,Kenya,1120,545,575
2000,100,Bulgaria,Kenya,6,3,3
2000,203,Czechia,Kenya,21,14,7
2000,348,Hungary,Kenya,60,32,28
2000,616,Poland,Kenya,55,30,25
2000,643,Russian Federation,Kenya,355,205,150
2000,703,Slovakia,Kenya,16,7,9
2000,208,Denmark,Kenya,996,454,542
2000,234,Faroe Islands,Kenya,2,2,0
2000,246,Finland,Kenya,180,97,83
2000,352,Iceland,Kenya,23,10,13
2000,372,Ireland,Kenya,562,239,323
2000,578,Norway,Kenya,827,398,429
2000,752,Sweden,Kenya,1267,557,710
2000,826,United Kingdom,Kenya,125340,63010,62330
2000,300,Greece,Kenya,365,136,229
2000,380,Italy,Kenya,1050,347,703
2000,470,Malta,Kenya,27,13,14
2000,620,Portugal,Kenya,150,63,87
2000,705,Slovenia,Kenya,19,7,12
2000,724,Spain,Kenya,507,230,277
2000,40,Austria,Kenya,680,234,446
2000,56,Belgium,Kenya,518,215,303
2000,250,France,Kenya,1008,314,694
2000,276,Germany,Kenya,4570,1418,3152
2000,528,Netherlands,Kenya,1759,812,947
2000,756,Switzerland,Kenya,2310,1092,1218
2000,124,Canada,Kenya,20447,9864,10583
2000,840,United States of America,Kenya,41715,21882,19833
2005,108,Burundi,Kenya,502,283,219
2005,174,Comoros,Kenya,81,36,45
2005,232,Eritrea,Kenya,281,157,124
2005,508,Mozambique,Kenya,19664,9316,10348
2005,646,Rwanda,Kenya,2617,1519,1098
2005,690,Seychelles,Kenya,348,113,235
2005,800,Uganda,Kenya,36105,15703,20402
2005,834,United Republic of Tanzania,Kenya,29010,12415,16595
2005,894,Zambia,Kenya,364,233,131
2005,72,Botswana,Kenya,395,204,191
2005,516,Namibia,Kenya,1152,580,572
2005,710,South Africa,Kenya,9085,4076,5009
2005,288,Ghana,Kenya,13,10,3
2005,818,Egypt,Kenya,120,82,38
2005,434,Libya,Kenya,271,180,91
2005,729,Sudan,Kenya,5860,3026,2834
2005,196,Cyprus,Kenya,56,28,28
2005,792,Turkey,Kenya,166,105,61
2005,356,India,Kenya,2691,1287,1404
2005,608,Philippines,Kenya,222,103,119
2005,44,Bahamas,Kenya,12,5,7
2005,136,Cayman Islands,Kenya,34,10,24
2005,188,Costa Rica,Kenya,4,4,0
2005,484,Mexico,Kenya,43,23,20
2005,32,Argentina,Kenya,4,1,3
2005,68,Bolivia (Plurinational State of),Kenya,11,4,7
2005,76,Brazil,Kenya,22,1,21
2005,152,Chile,Kenya,28,17,11
2005,36,Australia,Kenya,10850,5627,5223
2005,554,New Zealand,Kenya,1443,701,742
2005,100,Bulgaria,Kenya,9,4,5
2005,203,Czechia,Kenya,52,36,16
2005,348,Hungary,Kenya,74,40,34
2005,616,Poland,Kenya,58,32,26
2005,643,Russian Federation,Kenya,403,251,152
2005,703,Slovakia,Kenya,18,8,10
2005,208,Denmark,Kenya,1203,529,674
2005,234,Faroe Islands,Kenya,2,2,0
2005,246,Finland,Kenya,559,282,277
2005,352,Iceland,Kenya,38,11,27
2005,372,Ireland,Kenya,563,259,304
2005,428,Latvia,Kenya,1,0,1
2005,578,Norway,Kenya,1087,493,594
2005,752,Sweden,Kenya,1617,686,931
2005,826,United Kingdom,Kenya,124826,61326,63500
2005,300,Greece,Kenya,415,163,252
2005,380,Italy,Kenya,2345,907,1438
2005,470,Malta,Kenya,34,16,18
2005,620,Portugal,Kenya,130,59,71
2005,705,Slovenia,Kenya,19,8,11
2005,724,Spain,Kenya,787,302,485
2005,40,Austria,Kenya,760,249,511
2005,56,Belgium,Kenya,775,310,465
2005,250,France,Kenya,1328,568,760
2005,276,Germany,Kenya,8720,2554,6166
2005,528,Netherlands,Kenya,2122,945,1177
2005,756,Switzerland,Kenya,2581,1143,1438
2005,124,Canada,Kenya,22057,10448,11609
2005,840,United States of America,Kenya,64484,33996,30488
2010,108,Burundi,Kenya,847,477,370
2010,174,Comoros,Kenya,77,34,43
2010,232,Eritrea,Kenya,345,197,148
2010,508,Mozambique,Kenya,22769,10787,11982
2010,646,Rwanda,Kenya,2598,1508,1090
2010,690,Seychelles,Kenya,366,125,241
2010,728,South Sudan,Kenya,9821,5648,4173
2010,800,Uganda,Kenya,38271,16577,21694
2010,834,United Republic of Tanzania,Kenya,27864,11899,15965
2010,894,Zambia,Kenya,536,294,242
2010,72,Botswana,Kenya,1040,700,340
2010,516,Namibia,Kenya,1110,560,550
2010,710,South Africa,Kenya,14230,6354,7876
2010,288,Ghana,Kenya,13,10,3
2010,818,Egypt,Kenya,130,87,43
2010,434,Libya,Kenya,298,199,99
2010,729,Sudan,Kenya,2814,1453,1361
2010,196,Cyprus,Kenya,91,46,45
2010,792,Turkey,Kenya,171,107,64
2010,356,India,Kenya,2469,1177,1292
2010,608,Philippines,Kenya,53,24,29
2010,44,Bahamas,Kenya,19,7,12
2010,136,Cayman Islands,Kenya,34,9,25
2010,188,Costa Rica,Kenya,8,8,0
2010,484,Mexico,Kenya,65,38,27
2010,32,Argentina,Kenya,2,0,2
2010,68,Bolivia (Plurinational State of),Kenya,12,4,8
2010,76,Brazil,Kenya,45,3,42
2010,152,Chile,Kenya,38,23,15
2010,36,Australia,Kenya,15370,7754,7616
2010,554,New Zealand,Kenya,1591,772,819
2010,100,Bulgaria,Kenya,11,5,6
2010,203,Czechia,Kenya,77,54,23
2010,348,Hungary,Kenya,88,48,40
2010,616,Poland,Kenya,63,33,30
2010,643,Russian Federation,Kenya,443,292,151
2010,703,Slovakia,Kenya,20,9,11
2010,208,Denmark,Kenya,1385,594,791
2010,233,Estonia,Kenya,2,2,0
2010,234,Faroe Islands,Kenya,5,3,2
2010,246,Finland,Kenya,1073,494,579
2010,352,Iceland,Kenya,52,13,39
2010,372,Ireland,Kenya,472,198,274
2010,428,Latvia,Kenya,3,1,2
2010,578,Norway,Kenya,1504,652,852
2010,752,Sweden,Kenya,2424,1026,1398
2010,826,United Kingdom,Kenya,146627,74540,72087
2010,300,Greece,Kenya,482,198,284
2010,380,Italy,Kenya,3528,1431,2097
2010,470,Malta,Kenya,27,10,17
2010,620,Portugal,Kenya,90,46,44
2010,705,Slovenia,Kenya,16,6,10
2010,724,Spain,Kenya,1327,437,890
2010,40,Austria,Kenya,840,265,575
2010,56,Belgium,Kenya,1095,422,673
2010,250,France,Kenya,1641,486,1155
2010,276,Germany,Kenya,12163,3557,8606
2010,528,Netherlands,Kenya,2531,1102,1429
2010,756,Switzerland,Kenya,3052,1264,1788
2010,124,Canada,Kenya,24515,11467,13048
2010,840,United States of America,Kenya,89826,46772,43054
2015,108,Burundi,Kenya,1032,582,450
2015,174,Comoros,Kenya,76,34,42
2015,232,Eritrea,Kenya,351,203,148
2015,508,Mozambique,Kenya,23907,11327,12580
2015,646,Rwanda,Kenya,2581,1498,1083
2015,690,Seychelles,Kenya,409,154,255
2015,728,South Sudan,Kenya,9558,5757,3801
2015,800,Uganda,Kenya,38254,16315,21939
2015,834,United Republic of Tanzania,Kenya,27247,11734,15513
2015,894,Zambia,Kenya,472,259,213
2015,72,Botswana,Kenya,1135,764,371
2015,516,Namibia,Kenya,1086,550,536
2015,710,South Africa,Kenya,25668,10739,14929
2015,288,Ghana,Kenya,15,12,3
2015,324,Guinea,Kenya,1999,1166,833
2015,694,Sierra Leone,Kenya,27,17,10
2015,818,Egypt,Kenya,96,69,27
2015,434,Libya,Kenya,335,222,113
2015,729,Sudan,Kenya,2575,1327,1248
2015,196,Cyprus,Kenya,87,45,42
2015,792,Turkey,Kenya,173,107,66
2015,356,India,Kenya,2378,1133,1245
2015,608,Philippines,Kenya,53,24,29
2015,44,Bahamas,Kenya,21,8,13
2015,136,Cayman Islands,Kenya,36,10,26
2015,188,Costa Rica,Kenya,8,8,0
2015,484,Mexico,Kenya,68,40,28
2015,32,Argentina,Kenya,2,0,2
2015,68,Bolivia (Plurinational State of),Kenya,14,5,9
2015,76,Brazil,Kenya,54,3,51
2015,152,Chile,Kenya,57,35,22
2015,36,Australia,Kenya,19720,9876,9844
2015,554,New Zealand,Kenya,1714,829,885
2015,100,Bulgaria,Kenya,18,8,10
2015,203,Czechia,Kenya,93,64,29
2015,348,Hungary,Kenya,101,51,50
2015,616,Poland,Kenya,60,32,28
2015,643,Russian Federation,Kenya,451,297,154
2015,703,Slovakia,Kenya,25,11,14
2015,208,Denmark,Kenya,1668,711,957
2015,233,Estonia,Kenya,7,5,2
2015,234,Faroe Islands,Kenya,15,7,8
2015,246,Finland,Kenya,1599,710,889
2015,352,Iceland,Kenya,90,29,61
2015,372,Ireland,Kenya,482,199,283
2015,428,Latvia,Kenya,3,2,1
2015,578,Norway,Kenya,1985,809,1176
2015,752,Sweden,Kenya,3803,1631,2172
2015,826,United Kingdom,Kenya,131910,61910,70000
2015,300,Greece,Kenya,452,175,277
2015,380,Italy,Kenya,3663,1454,2209
2015,470,Malta,Kenya,45,18,27
2015,620,Portugal,Kenya,101,48,53
2015,705,Slovenia,Kenya,25,11,14
2015,724,Spain,Kenya,1555,466,1089
2015,40,Austria,Kenya,982,313,669
2015,56,Belgium,Kenya,1420,521,899
2015,250,France,Kenya,1818,503,1315
2015,276,Germany,Kenya,12673,3685,8988
2015,528,Netherlands,Kenya,2971,1279,1692
2015,756,Switzerland,Kenya,3463,1348,2115
2015,124,Canada,Kenya,26988,12730,14258
2015,840,United States of America,Kenya,125185,64876,60309
2019,108,Burundi,Kenya,1143,645,498
2019,174,Comoros,Kenya,75,34,41
2019,232,Eritrea,Kenya,354,205,149
2019,508,Mozambique,Kenya,24863,11780,13083
2019,646,Rwanda,Kenya,2707,1575,1132
2019,690,Seychelles,Kenya,413,156,257
2019,728,South Sudan,Kenya,9800,5901,3899
2019,800,Uganda,Kenya,36822,15504,21318
2019,834,United Republic of Tanzania,Kenya,24434,10445,13989
2019,894,Zambia,Kenya,608,335,273
2019,72,Botswana,Kenya,1215,818,397
2019,516,Namibia,Kenya,1149,582,567
2019,710,South Africa,Kenya,28769,12052,16717
2019,288,Ghana,Kenya,16,13,3
2019,324,Guinea,Kenya,1908,1113,795
2019,694,Sierra Leone,Kenya,27,17,10
2019,818,Egypt,Kenya,136,93,43
2019,434,Libya,Kenya,355,236,119
2019,729,Sudan,Kenya,3175,1613,1562
2019,196,Cyprus,Kenya,86,45,41
2019,792,Turkey,Kenya,233,145,88
2019,356,India,Kenya,2338,1114,1224
2019,608,Philippines,Kenya,54,25,29
2019,44,Bahamas,Kenya,22,9,13
2019,136,Cayman Islands,Kenya,39,11,28
2019,188,Costa Rica,Kenya,8,8,0
2019,484,Mexico,Kenya,70,42,28
2019,32,Argentina,Kenya,2,0,2
2019,68,Bolivia (Plurinational State of),Kenya,15,6,9
2019,76,Brazil,Kenya,60,3,57
2019,152,Chile,Kenya,76,45,31
2019,36,Australia,Kenya,24122,11864,12258
2019,554,New Zealand,Kenya,1761,852,909
2019,100,Bulgaria,Kenya,24,12,12
2019,203,Czechia,Kenya,119,76,43
2019,348,Hungary,Kenya,144,75,69
2019,616,Poland,Kenya,63,35,28
2019,643,Russian Federation,Kenya,450,297,153
2019,703,Slovakia,Kenya,29,14,15
2019,208,Denmark,Kenya,1930,783,1147
2019,233,Estonia,Kenya,9,8,1
2019,234,Faroe Islands,Kenya,20,8,12
2019,246,Finland,Kenya,1942,848,1094
2019,352,Iceland,Kenya,101,32,69
2019,372,Ireland,Kenya,529,220,309
2019,428,Latvia,Kenya,2,2,0
2019,578,Norway,Kenya,2347,951,1396
2019,752,Sweden,Kenya,4881,2033,2848
2019,826,United Kingdom,Kenya,149797,70506,79291
2019,300,Greece,Kenya,441,181,260
2019,380,Italy,Kenya,4144,1626,2518
2019,470,Malta,Kenya,72,29,43
2019,620,Portugal,Kenya,102,49,53
2019,705,Slovenia,Kenya,28,10,18
2019,724,Spain,Kenya,1611,456,1155
2019,40,Austria,Kenya,1159,383,776
2019,56,Belgium,Kenya,1626,594,1032
2019,250,France,Kenya,1924,529,1395
2019,276,Germany,Kenya,13901,4283,9618
2019,528,Netherlands,Kenya,3463,1502,1961
2019,756,Switzerland,Kenya,3723,1462,2261
2019,124,Canada,Kenya,28920,13641,15279
2019,840,United States of America,Kenya,135187,69359,65828
1990,36,Australia,Kiribati,428,181,247
1990,554,New Zealand,Kiribati,510,238,272
1990,242,Fiji,Kiribati,710,378,332
1990,90,Solomon Islands,Kiribati,991,470,521
1990,584,Marshall Islands,Kiribati,94,67,27
1990,520,Nauru,Kiribati,1184,557,627
1990,882,Samoa,Kiribati,22,8,14
1990,798,Tuvalu,Kiribati,63,13,50
1990,100,Bulgaria,Kiribati,1,1,0
1990,203,Czechia,Kiribati,1,1,0
1990,208,Denmark,Kiribati,3,1,2
1990,826,United Kingdom,Kiribati,24,15,9
1990,380,Italy,Kiribati,21,7,14
1990,250,France,Kiribati,1,0,1
1995,36,Australia,Kiribati,462,190,272
1995,554,New Zealand,Kiribati,687,324,363
1995,242,Fiji,Kiribati,700,370,330
1995,90,Solomon Islands,Kiribati,980,466,514
1995,584,Marshall Islands,Kiribati,123,88,35
1995,520,Nauru,Kiribati,1095,516,579
1995,882,Samoa,Kiribati,20,7,13
1995,798,Tuvalu,Kiribati,61,19,42
1995,100,Bulgaria,Kiribati,2,1,1
1995,203,Czechia,Kiribati,1,1,0
1995,208,Denmark,Kiribati,3,1,2
1995,826,United Kingdom,Kiribati,95,46,49
1995,380,Italy,Kiribati,16,4,12
1995,250,France,Kiribati,1,0,1
2000,36,Australia,Kiribati,440,162,278
2000,554,New Zealand,Kiribati,492,240,252
2000,242,Fiji,Kiribati,698,368,330
2000,90,Solomon Islands,Kiribati,934,445,489
2000,584,Marshall Islands,Kiribati,158,107,51
2000,520,Nauru,Kiribati,1006,474,532
2000,882,Samoa,Kiribati,19,6,13
2000,798,Tuvalu,Kiribati,54,13,41
2000,100,Bulgaria,Kiribati,3,2,1
2000,203,Czechia,Kiribati,1,1,0
2000,208,Denmark,Kiribati,2,0,2
2000,752,Sweden,Kiribati,4,2,2
2000,826,United Kingdom,Kiribati,168,77,91
2000,380,Italy,Kiribati,11,1,10
2000,250,France,Kiribati,1,0,1
2005,76,Brazil,Kiribati,42,27,15
2005,36,Australia,Kiribati,490,192,298
2005,554,New Zealand,Kiribati,786,382,404
2005,242,Fiji,Kiribati,701,370,331
2005,90,Solomon Islands,Kiribati,590,293,297
2005,584,Marshall Islands,Kiribati,202,128,74
2005,520,Nauru,Kiribati,949,449,500
2005,882,Samoa,Kiribati,18,6,12
2005,798,Tuvalu,Kiribati,53,13,40
2005,100,Bulgaria,Kiribati,4,2,2
2005,203,Czechia,Kiribati,1,0,1
2005,208,Denmark,Kiribati,2,0,2
2005,752,Sweden,Kiribati,4,2,2
2005,826,United Kingdom,Kiribati,159,66,93
2005,380,Italy,Kiribati,8,1,7
2005,250,France,Kiribati,12,9,3
2010,76,Brazil,Kiribati,85,54,31
2010,36,Australia,Kiribati,610,233,377
2010,554,New Zealand,Kiribati,1168,566,602
2010,242,Fiji,Kiribati,753,403,350
2010,90,Solomon Islands,Kiribati,283,159,124
2010,584,Marshall Islands,Kiribati,259,159,100
2010,520,Nauru,Kiribati,132,63,69
2010,882,Samoa,Kiribati,16,5,11
2010,798,Tuvalu,Kiribati,59,15,44
2010,100,Bulgaria,Kiribati,5,3,2
2010,203,Czechia,Kiribati,1,0,1
2010,233,Estonia,Kiribati,1,1,0
2010,752,Sweden,Kiribati,4,2,2
2010,826,United Kingdom,Kiribati,167,72,95
2010,380,Italy,Kiribati,5,1,4
2010,250,France,Kiribati,8,0,8
2015,324,Guinea,Kiribati,3,3,0
2015,76,Brazil,Kiribati,102,65,37
2015,36,Australia,Kiribati,650,250,400
2015,554,New Zealand,Kiribati,1533,742,791
2015,242,Fiji,Kiribati,775,419,356
2015,90,Solomon Islands,Kiribati,265,150,115
2015,584,Marshall Islands,Kiribati,275,169,106
2015,520,Nauru,Kiribati,209,104,105
2015,882,Samoa,Kiribati,12,4,8
2015,798,Tuvalu,Kiribati,61,16,45
2015,100,Bulgaria,Kiribati,4,2,2
2015,203,Czechia,Kiribati,1,0,1
2015,208,Denmark,Kiribati,1,0,1
2015,233,Estonia,Kiribati,1,1,0
2015,752,Sweden,Kiribati,3,1,2
2015,826,United Kingdom,Kiribati,213,88,125
2015,380,Italy,Kiribati,5,2,3
2015,250,France,Kiribati,9,0,9
2019,324,Guinea,Kiribati,2,2,0
2019,76,Brazil,Kiribati,114,73,41
2019,36,Australia,Kiribati,782,314,468
2019,554,New Zealand,Kiribati,1575,762,813
2019,242,Fiji,Kiribati,791,428,363
2019,90,Solomon Islands,Kiribati,259,147,112
2019,584,Marshall Islands,Kiribati,276,170,106
2019,520,Nauru,Kiribati,232,116,116
2019,882,Samoa,Kiribati,11,4,7
2019,798,Tuvalu,Kiribati,63,17,46
2019,100,Bulgaria,Kiribati,4,2,2
2019,203,Czechia,Kiribati,1,0,1
2019,208,Denmark,Kiribati,3,2,1
2019,752,Sweden,Kiribati,4,0,4
2019,826,United Kingdom,Kiribati,241,100,141
2019,380,Italy,Kiribati,3,1,2
2019,250,France,Kiribati,9,0,9
1990,710,South Africa,Kuwait,90,57,33
1990,478,Mauritania,Kuwait,29,9,20
1990,12,Algeria,Kuwait,1420,841,579
1990,818,Egypt,Kuwait,2103,1211,892
1990,434,Libya,Kuwait,6005,3471,2534
1990,48,Bahrain,Kuwait,1728,1231,497
1990,196,Cyprus,Kuwait,58,34,24
1990,368,Iraq,Kuwait,309,205,104
1990,400,Jordan,Kuwait,233,96,137
1990,422,Lebanon,Kuwait,106,43,63
1990,512,Oman,Kuwait,64,42,22
1990,634,Qatar,Kuwait,6155,3827,2328
1990,275,State of Palestine,Kuwait,16702,8128,8574
1990,792,Turkey,Kuwait,69,46,23
1990,784,United Arab Emirates,Kuwait,13095,9293,3802
1990,356,India,Kuwait,16860,8100,8760
1990,144,Sri Lanka,Kuwait,20,10,10
1990,608,Philippines,Kuwait,47,35,12
1990,68,Bolivia (Plurinational State of),Kuwait,2,1,1
1990,152,Chile,Kuwait,5,2,3
1990,170,Colombia,Kuwait,23,14,9
1990,862,Venezuela (Bolivarian Republic of),Kuwait,63,37,26
1990,36,Australia,Kuwait,919,472,447
1990,100,Bulgaria,Kuwait,9,8,1
1990,203,Czechia,Kuwait,14,9,5
1990,348,Hungary,Kuwait,154,103,51
1990,616,Poland,Kuwait,194,120,74
1990,643,Russian Federation,Kuwait,248,122,126
1990,703,Slovakia,Kuwait,10,7,3
1990,208,Denmark,Kuwait,96,55,41
1990,246,Finland,Kuwait,17,12,5
1990,372,Ireland,Kuwait,39,24,15
1990,428,Latvia,Kuwait,1,0,1
1990,578,Norway,Kuwait,24,13,11
1990,752,Sweden,Kuwait,635,341,294
1990,826,United Kingdom,Kuwait,820,533,287
1990,300,Greece,Kuwait,29,17,12
1990,380,Italy,Kuwait,49,17,32
1990,470,Malta,Kuwait,8,8,0
1990,688,Serbia,Kuwait,8,5,3
1990,724,Spain,Kuwait,41,24,17
1990,40,Austria,Kuwait,140,90,50
1990,56,Belgium,Kuwait,136,78,58
1990,250,France,Kuwait,680,414,266
1990,528,Netherlands,Kuwait,647,391,256
1990,756,Switzerland,Kuwait,176,102,74
1990,124,Canada,Kuwait,2442,1189,1253
1990,840,United States of America,Kuwait,8889,4348,4541
1995,710,South Africa,Kuwait,56,38,18
1995,478,Mauritania,Kuwait,30,11,19
1995,12,Algeria,Kuwait,1308,820,488
1995,818,Egypt,Kuwait,2064,1233,831
1995,434,Libya,Kuwait,6919,4623,2296
1995,48,Bahrain,Kuwait,1913,1340,573
1995,196,Cyprus,Kuwait,82,46,36
1995,368,Iraq,Kuwait,364,212,152
1995,400,Jordan,Kuwait,573,371,202
1995,422,Lebanon,Kuwait,260,162,98
1995,512,Oman,Kuwait,177,115,62
1995,634,Qatar,Kuwait,7067,4708,2359
1995,275,State of Palestine,Kuwait,16322,7901,8421
1995,792,Turkey,Kuwait,167,110,57
1995,784,United Arab Emirates,Kuwait,16904,12061,4843
1995,356,India,Kuwait,12149,5857,6292
1995,144,Sri Lanka,Kuwait,224,175,49
1995,608,Philippines,Kuwait,63,47,16
1995,68,Bolivia (Plurinational State of),Kuwait,4,2,2
1995,152,Chile,Kuwait,7,5,2
1995,170,Colombia,Kuwait,23,14,9
1995,862,Venezuela (Bolivarian Republic of),Kuwait,62,37,25
1995,36,Australia,Kuwait,1761,937,824
1995,100,Bulgaria,Kuwait,28,21,7
1995,203,Czechia,Kuwait,21,14,7
1995,348,Hungary,Kuwait,137,91,46
1995,616,Poland,Kuwait,165,102,63
1995,643,Russian Federation,Kuwait,212,127,85
1995,703,Slovakia,Kuwait,25,18,7
1995,208,Denmark,Kuwait,529,300,229
1995,246,Finland,Kuwait,39,26,13
1995,352,Iceland,Kuwait,1,1,0
1995,372,Ireland,Kuwait,107,63,44
1995,428,Latvia,Kuwait,1,0,1
1995,578,Norway,Kuwait,94,59,35
1995,752,Sweden,Kuwait,754,402,352
1995,826,United Kingdom,Kuwait,3223,1783,1440
1995,300,Greece,Kuwait,87,52,35
1995,380,Italy,Kuwait,78,42,36
1995,470,Malta,Kuwait,10,9,1
1995,688,Serbia,Kuwait,51,31,20
1995,724,Spain,Kuwait,63,38,25
1995,40,Austria,Kuwait,158,102,56
1995,56,Belgium,Kuwait,136,78,58
1995,250,France,Kuwait,702,423,279
1995,528,Netherlands,Kuwait,952,567,385
1995,756,Switzerland,Kuwait,237,140,97
1995,124,Canada,Kuwait,5907,2854,3053
1995,840,United States of America,Kuwait,14823,7337,7486
2000,710,South Africa,Kuwait,38,28,10
2000,478,Mauritania,Kuwait,31,14,17
2000,12,Algeria,Kuwait,1196,799,397
2000,818,Egypt,Kuwait,2188,1353,835
2000,434,Libya,Kuwait,7947,5905,2042
2000,48,Bahrain,Kuwait,2105,1447,658
2000,196,Cyprus,Kuwait,106,59,47
2000,368,Iraq,Kuwait,345,166,179
2000,400,Jordan,Kuwait,912,647,265
2000,422,Lebanon,Kuwait,414,282,132
2000,512,Oman,Kuwait,241,163,78
2000,634,Qatar,Kuwait,6926,4899,2027
2000,275,State of Palestine,Kuwait,15942,7674,8268
2000,792,Turkey,Kuwait,266,173,93
2000,784,United Arab Emirates,Kuwait,21687,15466,6221
2000,356,India,Kuwait,7437,3614,3823
2000,144,Sri Lanka,Kuwait,430,288,142
2000,608,Philippines,Kuwait,56,30,26
2000,68,Bolivia (Plurinational State of),Kuwait,5,3,2
2000,152,Chile,Kuwait,9,6,3
2000,170,Colombia,Kuwait,22,13,9
2000,862,Venezuela (Bolivarian Republic of),Kuwait,61,36,25
2000,36,Australia,Kuwait,2510,1352,1158
2000,100,Bulgaria,Kuwait,47,35,12
2000,203,Czechia,Kuwait,27,18,9
2000,348,Hungary,Kuwait,119,78,41
2000,616,Poland,Kuwait,142,87,55
2000,643,Russian Federation,Kuwait,170,129,41
2000,703,Slovakia,Kuwait,47,33,14
2000,208,Denmark,Kuwait,962,545,417
2000,246,Finland,Kuwait,61,41,20
2000,352,Iceland,Kuwait,1,1,0
2000,372,Ireland,Kuwait,235,141,94
2000,428,Latvia,Kuwait,2,1,1
2000,578,Norway,Kuwait,142,79,63
2000,752,Sweden,Kuwait,809,429,380
2000,826,United Kingdom,Kuwait,5682,3060,2622
2000,300,Greece,Kuwait,147,87,60
2000,380,Italy,Kuwait,106,67,39
2000,470,Malta,Kuwait,12,11,1
2000,688,Serbia,Kuwait,70,42,28
2000,705,Slovenia,Kuwait,2,2,0
2000,724,Spain,Kuwait,767,483,284
2000,40,Austria,Kuwait,175,114,61
2000,56,Belgium,Kuwait,136,78,58
2000,250,France,Kuwait,724,432,292
2000,528,Netherlands,Kuwait,1290,761,529
2000,756,Switzerland,Kuwait,300,179,121
2000,124,Canada,Kuwait,9513,4589,4924
2000,840,United States of America,Kuwait,20884,10404,10480
2005,710,South Africa,Kuwait,50,36,14
2005,478,Mauritania,Kuwait,31,15,16
2005,12,Algeria,Kuwait,944,631,313
2005,818,Egypt,Kuwait,2605,1672,933
2005,434,Libya,Kuwait,8756,6908,1848
2005,48,Bahrain,Kuwait,3223,2180,1043
2005,196,Cyprus,Kuwait,155,86,69
2005,368,Iraq,Kuwait,395,247,148
2005,400,Jordan,Kuwait,1318,982,336
2005,422,Lebanon,Kuwait,324,225,99
2005,512,Oman,Kuwait,247,183,64
2005,634,Qatar,Kuwait,5450,3818,1632
2005,275,State of Palestine,Kuwait,16611,7953,8658
2005,792,Turkey,Kuwait,274,176,98
2005,784,United Arab Emirates,Kuwait,26337,18142,8195
2005,356,India,Kuwait,6872,3331,3541
2005,144,Sri Lanka,Kuwait,849,401,448
2005,608,Philippines,Kuwait,45,25,20
2005,68,Bolivia (Plurinational State of),Kuwait,5,3,2
2005,76,Brazil,Kuwait,10,0,10
2005,152,Chile,Kuwait,13,9,4
2005,170,Colombia,Kuwait,21,13,8
2005,862,Venezuela (Bolivarian Republic of),Kuwait,63,37,26
2005,36,Australia,Kuwait,3120,1709,1411
2005,100,Bulgaria,Kuwait,74,56,18
2005,203,Czechia,Kuwait,59,46,13
2005,348,Hungary,Kuwait,147,97,50
2005,616,Poland,Kuwait,167,114,53
2005,643,Russian Federation,Kuwait,128,93,35
2005,703,Slovakia,Kuwait,53,37,16
2005,208,Denmark,Kuwait,1160,661,499
2005,246,Finland,Kuwait,87,58,29
2005,352,Iceland,Kuwait,2,2,0
2005,372,Ireland,Kuwait,235,146,89
2005,428,Latvia,Kuwait,2,2,0
2005,578,Norway,Kuwait,200,118,82
2005,752,Sweden,Kuwait,1039,590,449
2005,826,United Kingdom,Kuwait,8740,4983,3757
2005,300,Greece,Kuwait,145,84,61
2005,380,Italy,Kuwait,325,193,132
2005,470,Malta,Kuwait,16,14,2
2005,688,Serbia,Kuwait,70,42,28
2005,705,Slovenia,Kuwait,3,3,0
2005,724,Spain,Kuwait,369,230,139
2005,40,Austria,Kuwait,196,126,70
2005,56,Belgium,Kuwait,116,78,38
2005,250,France,Kuwait,651,357,294
2005,528,Netherlands,Kuwait,1328,783,545
2005,756,Switzerland,Kuwait,346,196,150
2005,124,Canada,Kuwait,10982,5527,5455
2005,840,United States of America,Kuwait,22048,11045,11003
2010,710,South Africa,Kuwait,78,57,21
2010,478,Mauritania,Kuwait,31,16,15
2010,12,Algeria,Kuwait,1037,679,358
2010,818,Egypt,Kuwait,2811,1766,1045
2010,434,Libya,Kuwait,9579,7580,1999
2010,48,Bahrain,Kuwait,5054,3397,1657
2010,196,Cyprus,Kuwait,253,142,111
2010,368,Iraq,Kuwait,399,258,141
2010,400,Jordan,Kuwait,1695,1288,407
2010,422,Lebanon,Kuwait,234,168,66
2010,512,Oman,Kuwait,294,236,58
2010,634,Qatar,Kuwait,8395,6715,1680
2010,275,State of Palestine,Kuwait,17280,8231,9049
2010,792,Turkey,Kuwait,282,179,103
2010,784,United Arab Emirates,Kuwait,56684,39564,17120
2010,356,India,Kuwait,6306,3048,3258
2010,144,Sri Lanka,Kuwait,1711,824,887
2010,608,Philippines,Kuwait,168,88,80
2010,68,Bolivia (Plurinational State of),Kuwait,4,3,1
2010,76,Brazil,Kuwait,20,0,20
2010,152,Chile,Kuwait,18,13,5
2010,170,Colombia,Kuwait,24,15,9
2010,862,Venezuela (Bolivarian Republic of),Kuwait,67,39,28
2010,36,Australia,Kuwait,4320,2494,1826
2010,100,Bulgaria,Kuwait,97,73,24
2010,203,Czechia,Kuwait,86,71,15
2010,348,Hungary,Kuwait,175,116,59
2010,616,Poland,Kuwait,199,145,54
2010,643,Russian Federation,Kuwait,84,55,29
2010,703,Slovakia,Kuwait,59,41,18
2010,208,Denmark,Kuwait,1333,763,570
2010,233,Estonia,Kuwait,6,6,0
2010,246,Finland,Kuwait,130,84,46
2010,352,Iceland,Kuwait,2,2,0
2010,372,Ireland,Kuwait,197,117,80
2010,428,Latvia,Kuwait,3,3,0
2010,578,Norway,Kuwait,317,193,124
2010,752,Sweden,Kuwait,1459,849,610
2010,826,United Kingdom,Kuwait,9207,5331,3876
2010,300,Greece,Kuwait,148,85,63
2010,380,Italy,Kuwait,578,344,234
2010,470,Malta,Kuwait,47,31,16
2010,688,Serbia,Kuwait,69,41,28
2010,705,Slovenia,Kuwait,9,8,1
2010,724,Spain,Kuwait,405,258,147
2010,40,Austria,Kuwait,216,137,79
2010,56,Belgium,Kuwait,175,115,60
2010,250,France,Kuwait,689,405,284
2010,528,Netherlands,Kuwait,1112,640,472
2010,756,Switzerland,Kuwait,397,219,178
2010,124,Canada,Kuwait,12860,6682,6178
2010,840,United States of America,Kuwait,23921,11820,12101
2015,710,South Africa,Kuwait,139,101,38
2015,478,Mauritania,Kuwait,31,17,14
2015,12,Algeria,Kuwait,1144,749,395
2015,818,Egypt,Kuwait,2084,1410,674
2015,434,Libya,Kuwait,10800,8516,2284
2015,48,Bahrain,Kuwait,5409,3609,1800
2015,196,Cyprus,Kuwait,243,138,105
2015,368,Iraq,Kuwait,400,280,120
2015,400,Jordan,Kuwait,729,515,214
2015,422,Lebanon,Kuwait,197,95,102
2015,512,Oman,Kuwait,668,556,112
2015,634,Qatar,Kuwait,6494,5280,1214
2015,275,State of Palestine,Kuwait,17111,8130,8981
2015,792,Turkey,Kuwait,286,180,106
2015,784,United Arab Emirates,Kuwait,61939,42494,19445
2015,356,India,Kuwait,6075,2933,3142
2015,144,Sri Lanka,Kuwait,1742,822,920
2015,608,Philippines,Kuwait,171,90,81
2015,68,Bolivia (Plurinational State of),Kuwait,5,4,1
2015,76,Brazil,Kuwait,24,0,24
2015,152,Chile,Kuwait,27,20,7
2015,170,Colombia,Kuwait,26,17,9
2015,862,Venezuela (Bolivarian Republic of),Kuwait,71,41,30
2015,36,Australia,Kuwait,6580,3928,2652
2015,100,Bulgaria,Kuwait,114,78,36
2015,203,Czechia,Kuwait,103,79,24
2015,348,Hungary,Kuwait,259,169,90
2015,616,Poland,Kuwait,191,140,51
2015,643,Russian Federation,Kuwait,85,56,29
2015,703,Slovakia,Kuwait,75,54,21
2015,208,Denmark,Kuwait,1467,865,602
2015,233,Estonia,Kuwait,9,7,2
2015,246,Finland,Kuwait,155,96,59
2015,352,Iceland,Kuwait,2,2,0
2015,372,Ireland,Kuwait,201,118,83
2015,428,Latvia,Kuwait,3,3,0
2015,578,Norway,Kuwait,403,238,165
2015,752,Sweden,Kuwait,2268,1306,962
2015,826,United Kingdom,Kuwait,11774,6671,5103
2015,300,Greece,Kuwait,138,77,61
2015,380,Italy,Kuwait,538,319,219
2015,470,Malta,Kuwait,79,55,24
2015,688,Serbia,Kuwait,67,40,27
2015,705,Slovenia,Kuwait,11,8,3
2015,724,Spain,Kuwait,483,321,162
2015,40,Austria,Kuwait,253,161,92
2015,56,Belgium,Kuwait,258,180,78
2015,250,France,Kuwait,762,440,322
2015,528,Netherlands,Kuwait,1143,655,488
2015,756,Switzerland,Kuwait,513,276,237
2015,124,Canada,Kuwait,15141,7878,7263
2015,840,United States of America,Kuwait,29826,14661,15165
2019,710,South Africa,Kuwait,154,112,42
2019,478,Mauritania,Kuwait,32,18,14
2019,12,Algeria,Kuwait,1189,779,410
2019,818,Egypt,Kuwait,2970,1896,1074
2019,434,Libya,Kuwait,11459,9036,2423
2019,48,Bahrain,Kuwait,5693,3799,1894
2019,196,Cyprus,Kuwait,242,139,103
2019,368,Iraq,Kuwait,409,287,122
2019,400,Jordan,Kuwait,783,553,230
2019,422,Lebanon,Kuwait,186,90,96
2019,512,Oman,Kuwait,822,685,137
2019,634,Qatar,Kuwait,6623,5297,1326
2019,275,State of Palestine,Kuwait,16992,8074,8918
2019,792,Turkey,Kuwait,386,245,141
2019,784,United Arab Emirates,Kuwait,66526,45638,20888
2019,356,India,Kuwait,5975,2886,3089
2019,144,Sri Lanka,Kuwait,1755,828,927
2019,608,Philippines,Kuwait,176,93,83
2019,68,Bolivia (Plurinational State of),Kuwait,5,4,1
2019,76,Brazil,Kuwait,27,0,27
2019,152,Chile,Kuwait,36,27,9
2019,170,Colombia,Kuwait,26,17,9
2019,862,Venezuela (Bolivarian Republic of),Kuwait,69,40,29
2019,36,Australia,Kuwait,7617,4548,3069
2019,100,Bulgaria,Kuwait,177,121,56
2019,203,Czechia,Kuwait,125,94,31
2019,348,Hungary,Kuwait,300,195,105
2019,616,Poland,Kuwait,202,151,51
2019,643,Russian Federation,Kuwait,84,56,28
2019,703,Slovakia,Kuwait,82,59,23
2019,208,Denmark,Kuwait,1514,878,636
2019,233,Estonia,Kuwait,11,10,1
2019,246,Finland,Kuwait,221,133,88
2019,352,Iceland,Kuwait,3,2,1
2019,372,Ireland,Kuwait,220,130,90
2019,578,Norway,Kuwait,456,278,178
2019,752,Sweden,Kuwait,4830,2812,2018
2019,826,United Kingdom,Kuwait,13370,7590,5780
2019,300,Greece,Kuwait,252,123,129
2019,380,Italy,Kuwait,646,381,265
2019,470,Malta,Kuwait,127,89,38
2019,688,Serbia,Kuwait,68,41,27
2019,705,Slovenia,Kuwait,13,10,3
2019,724,Spain,Kuwait,500,329,171
2019,40,Austria,Kuwait,298,192,106
2019,56,Belgium,Kuwait,374,251,123
2019,250,France,Kuwait,806,465,341
2019,528,Netherlands,Kuwait,1630,946,684
2019,756,Switzerland,Kuwait,547,301,246
2019,124,Canada,Kuwait,16225,8442,7783
2019,840,United States of America,Kuwait,32208,15655,16553
1990,818,Egypt,Kyrgyzstan,48,37,11
1990,31,Azerbaijan,Kyrgyzstan,3487,1547,1940
1990,196,Cyprus,Kyrgyzstan,6,3,3
1990,268,Georgia,Kyrgyzstan,3360,1476,1884
1990,376,Israel,Kyrgyzstan,1078,486,592
1990,792,Turkey,Kyrgyzstan,423,249,174
1990,398,Kazakhstan,Kyrgyzstan,5606,2843,2763
1990,762,Tajikistan,Kyrgyzstan,20042,8800,11242
1990,860,Uzbekistan,Kyrgyzstan,5481,2688,2793
1990,152,Chile,Kyrgyzstan,4,1,3
1990,36,Australia,Kyrgyzstan,101,39,62
1990,112,Belarus,Kyrgyzstan,6071,2906,3165
1990,100,Bulgaria,Kyrgyzstan,10,3,7
1990,203,Czechia,Kyrgyzstan,37,18,19
1990,348,Hungary,Kyrgyzstan,116,27,89
1990,616,Poland,Kyrgyzstan,106,46,60
1990,643,Russian Federation,Kyrgyzstan,433625,212785,220840
1990,703,Slovakia,Kyrgyzstan,3,1,2
1990,804,Ukraine,Kyrgyzstan,37304,15985,21319
1990,208,Denmark,Kyrgyzstan,2,1,1
1990,233,Estonia,Kyrgyzstan,1120,575,545
1990,372,Ireland,Kyrgyzstan,6,3,3
1990,428,Latvia,Kyrgyzstan,593,265,328
1990,440,Lithuania,Kyrgyzstan,1006,498,508
1990,752,Sweden,Kyrgyzstan,36,9,27
1990,826,United Kingdom,Kyrgyzstan,18,10,8
1990,300,Greece,Kyrgyzstan,74,41,33
1990,380,Italy,Kyrgyzstan,3,1,2
1990,724,Spain,Kyrgyzstan,17,6,11
1990,40,Austria,Kyrgyzstan,357,121,236
1990,56,Belgium,Kyrgyzstan,8,4,4
1990,250,France,Kyrgyzstan,103,35,68
1990,276,Germany,Kyrgyzstan,199,97,102
1990,756,Switzerland,Kyrgyzstan,39,11,28
1990,124,Canada,Kyrgyzstan,580,282,298
1990,840,United States of America,Kyrgyzstan,1509,739,770
1995,818,Egypt,Kyrgyzstan,45,34,11
1995,31,Azerbaijan,Kyrgyzstan,3061,1461,1600
1995,196,Cyprus,Kyrgyzstan,9,4,5
1995,268,Georgia,Kyrgyzstan,484,158,326
1995,376,Israel,Kyrgyzstan,1407,622,785
1995,792,Turkey,Kyrgyzstan,1025,586,439
1995,398,Kazakhstan,Kyrgyzstan,5276,2520,2756
1995,762,Tajikistan,Kyrgyzstan,15292,7509,7783
1995,860,Uzbekistan,Kyrgyzstan,5238,2395,2843
1995,152,Chile,Kyrgyzstan,4,2,2
1995,36,Australia,Kyrgyzstan,88,25,63
1995,112,Belarus,Kyrgyzstan,5751,2767,2984
1995,100,Bulgaria,Kyrgyzstan,26,10,16
1995,203,Czechia,Kyrgyzstan,56,29,27
1995,348,Hungary,Kyrgyzstan,103,22,81
1995,616,Poland,Kyrgyzstan,90,39,51
1995,643,Russian Federation,Kyrgyzstan,455644,223132,232512
1995,703,Slovakia,Kyrgyzstan,7,3,4
1995,804,Ukraine,Kyrgyzstan,33724,14889,18835
1995,208,Denmark,Kyrgyzstan,2,1,1
1995,233,Estonia,Kyrgyzstan,843,412,431
1995,246,Finland,Kyrgyzstan,1,0,1
1995,352,Iceland,Kyrgyzstan,1,0,1
1995,372,Ireland,Kyrgyzstan,17,7,10
1995,428,Latvia,Kyrgyzstan,913,410,503
1995,440,Lithuania,Kyrgyzstan,774,384,390
1995,752,Sweden,Kyrgyzstan,42,9,33
1995,826,United Kingdom,Kyrgyzstan,72,25,47
1995,300,Greece,Kyrgyzstan,141,65,76
1995,380,Italy,Kyrgyzstan,41,6,35
1995,724,Spain,Kyrgyzstan,26,9,17
1995,40,Austria,Kyrgyzstan,403,141,262
1995,56,Belgium,Kyrgyzstan,7,4,3
1995,250,France,Kyrgyzstan,106,34,72
1995,276,Germany,Kyrgyzstan,16588,7009,9579
1995,756,Switzerland,Kyrgyzstan,169,65,104
1995,124,Canada,Kyrgyzstan,583,283,300
1995,840,United States of America,Kyrgyzstan,1967,974,993
2000,818,Egypt,Kyrgyzstan,46,35,11
2000,31,Azerbaijan,Kyrgyzstan,3084,1448,1636
2000,196,Cyprus,Kyrgyzstan,11,5,6
2000,268,Georgia,Kyrgyzstan,242,79,163
2000,376,Israel,Kyrgyzstan,1657,731,926
2000,792,Turkey,Kyrgyzstan,1632,924,708
2000,398,Kazakhstan,Kyrgyzstan,4946,2197,2749
2000,762,Tajikistan,Kyrgyzstan,11944,6081,5863
2000,860,Uzbekistan,Kyrgyzstan,5110,2142,2968
2000,152,Chile,Kyrgyzstan,4,1,3
2000,36,Australia,Kyrgyzstan,100,50,50
2000,112,Belarus,Kyrgyzstan,5430,2627,2803
2000,100,Bulgaria,Kyrgyzstan,41,16,25
2000,203,Czechia,Kyrgyzstan,75,40,35
2000,348,Hungary,Kyrgyzstan,90,18,72
2000,616,Poland,Kyrgyzstan,78,33,45
2000,643,Russian Federation,Kyrgyzstan,461140,225474,235666
2000,703,Slovakia,Kyrgyzstan,15,7,8
2000,804,Ukraine,Kyrgyzstan,30557,13976,16581
2000,208,Denmark,Kyrgyzstan,2,1,1
2000,233,Estonia,Kyrgyzstan,565,248,317
2000,246,Finland,Kyrgyzstan,2,0,2
2000,352,Iceland,Kyrgyzstan,1,0,1
2000,372,Ireland,Kyrgyzstan,37,16,21
2000,428,Latvia,Kyrgyzstan,1233,554,679
2000,440,Lithuania,Kyrgyzstan,606,300,306
2000,578,Norway,Kyrgyzstan,6,3,3
2000,752,Sweden,Kyrgyzstan,46,10,36
2000,826,United Kingdom,Kyrgyzstan,129,42,87
2000,300,Greece,Kyrgyzstan,211,89,122
2000,380,Italy,Kyrgyzstan,79,11,68
2000,724,Spain,Kyrgyzstan,324,134,190
2000,40,Austria,Kyrgyzstan,449,161,288
2000,56,Belgium,Kyrgyzstan,5,3,2
2000,250,France,Kyrgyzstan,109,34,75
2000,276,Germany,Kyrgyzstan,32977,13921,19056
2000,756,Switzerland,Kyrgyzstan,300,119,181
2000,124,Canada,Kyrgyzstan,600,290,310
2000,840,United States of America,Kyrgyzstan,2436,1215,1221
2005,710,South Africa,Kyrgyzstan,20,8,12
2005,818,Egypt,Kyrgyzstan,55,43,12
2005,31,Azerbaijan,Kyrgyzstan,2927,1327,1600
2005,196,Cyprus,Kyrgyzstan,16,7,9
2005,268,Georgia,Kyrgyzstan,229,75,154
2005,376,Israel,Kyrgyzstan,2037,898,1139
2005,792,Turkey,Kyrgyzstan,1685,938,747
2005,398,Kazakhstan,Kyrgyzstan,5639,2588,3051
2005,762,Tajikistan,Kyrgyzstan,11502,5875,5627
2005,860,Uzbekistan,Kyrgyzstan,5201,2248,2953
2005,410,Republic of Korea,Kyrgyzstan,635,375,260
2005,68,Bolivia (Plurinational State of),Kyrgyzstan,2,1,1
2005,152,Chile,Kyrgyzstan,6,2,4
2005,36,Australia,Kyrgyzstan,240,99,141
2005,112,Belarus,Kyrgyzstan,5355,2590,2765
2005,100,Bulgaria,Kyrgyzstan,63,25,38
2005,203,Czechia,Kyrgyzstan,415,196,219
2005,348,Hungary,Kyrgyzstan,111,24,87
2005,616,Poland,Kyrgyzstan,102,60,42
2005,643,Russian Federation,Kyrgyzstan,526124,256976,269148
2005,703,Slovakia,Kyrgyzstan,17,8,9
2005,804,Ukraine,Kyrgyzstan,27921,12792,15129
2005,208,Denmark,Kyrgyzstan,18,5,13
2005,233,Estonia,Kyrgyzstan,581,257,324
2005,246,Finland,Kyrgyzstan,19,8,11
2005,352,Iceland,Kyrgyzstan,1,0,1
2005,372,Ireland,Kyrgyzstan,37,18,19
2005,428,Latvia,Kyrgyzstan,1124,500,624
2005,440,Lithuania,Kyrgyzstan,569,277,292
2005,578,Norway,Kyrgyzstan,53,11,42
2005,752,Sweden,Kyrgyzstan,244,94,150
2005,826,United Kingdom,Kyrgyzstan,546,187,359
2005,300,Greece,Kyrgyzstan,386,170,216
2005,380,Italy,Kyrgyzstan,703,117,586
2005,705,Slovenia,Kyrgyzstan,3,1,2
2005,724,Spain,Kyrgyzstan,156,63,93
2005,40,Austria,Kyrgyzstan,502,172,330
2005,56,Belgium,Kyrgyzstan,94,42,52
2005,250,France,Kyrgyzstan,454,135,319
2005,276,Germany,Kyrgyzstan,51974,24244,27730
2005,528,Netherlands,Kyrgyzstan,37,21,16
2005,756,Switzerland,Kyrgyzstan,359,134,225
2005,124,Canada,Kyrgyzstan,1119,522,597
2005,840,United States of America,Kyrgyzstan,3581,1797,1784
2010,710,South Africa,Kyrgyzstan,31,13,18
2010,818,Egypt,Kyrgyzstan,59,46,13
2010,31,Azerbaijan,Kyrgyzstan,2680,1268,1412
2010,196,Cyprus,Kyrgyzstan,26,12,14
2010,268,Georgia,Kyrgyzstan,231,76,155
2010,376,Israel,Kyrgyzstan,2442,1073,1369
2010,792,Turkey,Kyrgyzstan,1732,946,786
2010,398,Kazakhstan,Kyrgyzstan,6331,2978,3353
2010,762,Tajikistan,Kyrgyzstan,11495,5905,5590
2010,860,Uzbekistan,Kyrgyzstan,5085,2264,2821
2010,410,Republic of Korea,Kyrgyzstan,1524,885,639
2010,68,Bolivia (Plurinational State of),Kyrgyzstan,4,2,2
2010,152,Chile,Kyrgyzstan,8,3,5
2010,36,Australia,Kyrgyzstan,360,148,212
2010,112,Belarus,Kyrgyzstan,5279,2552,2727
2010,100,Bulgaria,Kyrgyzstan,82,33,49
2010,203,Czechia,Kyrgyzstan,714,342,372
2010,348,Hungary,Kyrgyzstan,132,31,101
2010,616,Poland,Kyrgyzstan,130,88,42
2010,643,Russian Federation,Kyrgyzstan,580279,283353,296926
2010,703,Slovakia,Kyrgyzstan,19,9,10
2010,804,Ukraine,Kyrgyzstan,26640,12225,14415
2010,208,Denmark,Kyrgyzstan,32,8,24
2010,233,Estonia,Kyrgyzstan,593,263,330
2010,246,Finland,Kyrgyzstan,35,16,19
2010,352,Iceland,Kyrgyzstan,1,0,1
2010,372,Ireland,Kyrgyzstan,31,14,17
2010,428,Latvia,Kyrgyzstan,987,424,563
2010,440,Lithuania,Kyrgyzstan,455,200,255
2010,578,Norway,Kyrgyzstan,141,39,102
2010,752,Sweden,Kyrgyzstan,559,237,322
2010,826,United Kingdom,Kyrgyzstan,575,205,370
2010,300,Greece,Kyrgyzstan,582,260,322
2010,380,Italy,Kyrgyzstan,1188,186,1002
2010,705,Slovenia,Kyrgyzstan,5,1,4
2010,724,Spain,Kyrgyzstan,255,87,168
2010,40,Austria,Kyrgyzstan,554,183,371
2010,56,Belgium,Kyrgyzstan,223,122,101
2010,250,France,Kyrgyzstan,677,200,477
2010,276,Germany,Kyrgyzstan,67694,32941,34753
2010,528,Netherlands,Kyrgyzstan,42,25,17
2010,756,Switzerland,Kyrgyzstan,397,131,266
2010,124,Canada,Kyrgyzstan,1740,804,936
2010,840,United States of America,Kyrgyzstan,4868,2410,2458
2015,710,South Africa,Kyrgyzstan,54,21,33
2015,818,Egypt,Kyrgyzstan,43,35,8
2015,31,Azerbaijan,Kyrgyzstan,2556,1239,1317
2015,196,Cyprus,Kyrgyzstan,24,11,13
2015,268,Georgia,Kyrgyzstan,242,80,162
2015,376,Israel,Kyrgyzstan,2519,1100,1419
2015,792,Turkey,Kyrgyzstan,1969,1063,906
2015,398,Kazakhstan,Kyrgyzstan,6734,3226,3508
2015,762,Tajikistan,Kyrgyzstan,11301,5767,5534
2015,860,Uzbekistan,Kyrgyzstan,4894,2221,2673
2015,410,Republic of Korea,Kyrgyzstan,1893,1081,812
2015,68,Bolivia (Plurinational State of),Kyrgyzstan,5,3,2
2015,152,Chile,Kyrgyzstan,12,5,7
2015,36,Australia,Kyrgyzstan,490,190,300
2015,112,Belarus,Kyrgyzstan,5234,2532,2702
2015,100,Bulgaria,Kyrgyzstan,165,54,111
2015,203,Czechia,Kyrgyzstan,810,400,410
2015,348,Hungary,Kyrgyzstan,134,32,102
2015,616,Poland,Kyrgyzstan,125,86,39
2015,643,Russian Federation,Kyrgyzstan,591349,287245,304104
2015,703,Slovakia,Kyrgyzstan,25,14,11
2015,804,Ukraine,Kyrgyzstan,26729,12286,14443
2015,208,Denmark,Kyrgyzstan,50,15,35
2015,233,Estonia,Kyrgyzstan,537,232,305
2015,246,Finland,Kyrgyzstan,54,19,35
2015,352,Iceland,Kyrgyzstan,1,1,0
2015,372,Ireland,Kyrgyzstan,32,14,18
2015,428,Latvia,Kyrgyzstan,809,353,456
2015,440,Lithuania,Kyrgyzstan,380,162,218
2015,578,Norway,Kyrgyzstan,194,56,138
2015,752,Sweden,Kyrgyzstan,990,412,578
2015,826,United Kingdom,Kyrgyzstan,735,248,487
2015,300,Greece,Kyrgyzstan,546,231,315
2015,380,Italy,Kyrgyzstan,1423,234,1189
2015,705,Slovenia,Kyrgyzstan,7,1,6
2015,724,Spain,Kyrgyzstan,333,102,231
2015,40,Austria,Kyrgyzstan,648,217,431
2015,56,Belgium,Kyrgyzstan,334,172,162
2015,250,France,Kyrgyzstan,749,206,543
2015,276,Germany,Kyrgyzstan,70534,34238,36296
2015,528,Netherlands,Kyrgyzstan,71,36,35
2015,756,Switzerland,Kyrgyzstan,618,213,405
2015,124,Canada,Kyrgyzstan,2956,1361,1595
2015,840,United States of America,Kyrgyzstan,6119,3015,3104
2019,710,South Africa,Kyrgyzstan,59,23,36
2019,818,Egypt,Kyrgyzstan,61,49,12
2019,31,Azerbaijan,Kyrgyzstan,2455,1190,1265
2019,196,Cyprus,Kyrgyzstan,23,11,12
2019,268,Georgia,Kyrgyzstan,249,82,167
2019,376,Israel,Kyrgyzstan,2449,1070,1379
2019,792,Turkey,Kyrgyzstan,2662,1450,1212
2019,398,Kazakhstan,Kyrgyzstan,7036,3371,3665
2019,762,Tajikistan,Kyrgyzstan,11261,5734,5527
2019,860,Uzbekistan,Kyrgyzstan,4883,2218,2665
2019,410,Republic of Korea,Kyrgyzstan,1927,1101,826
2019,68,Bolivia (Plurinational State of),Kyrgyzstan,5,3,2
2019,152,Chile,Kyrgyzstan,16,7,9
2019,36,Australia,Kyrgyzstan,592,221,371
2019,112,Belarus,Kyrgyzstan,5168,2500,2668
2019,100,Bulgaria,Kyrgyzstan,241,94,147
2019,203,Czechia,Kyrgyzstan,900,461,439
2019,348,Hungary,Kyrgyzstan,149,36,113
2019,616,Poland,Kyrgyzstan,132,93,39
2019,643,Russian Federation,Kyrgyzstan,591211,287179,304032
2019,703,Slovakia,Kyrgyzstan,29,17,12
2019,804,Ukraine,Kyrgyzstan,26996,12409,14587
2019,208,Denmark,Kyrgyzstan,73,20,53
2019,233,Estonia,Kyrgyzstan,533,233,300
2019,246,Finland,Kyrgyzstan,76,30,46
2019,352,Iceland,Kyrgyzstan,5,3,2
2019,372,Ireland,Kyrgyzstan,35,16,19
2019,428,Latvia,Kyrgyzstan,742,324,418
2019,440,Lithuania,Kyrgyzstan,299,123,176
2019,578,Norway,Kyrgyzstan,239,71,168
2019,752,Sweden,Kyrgyzstan,1237,524,713
2019,826,United Kingdom,Kyrgyzstan,834,283,551
2019,300,Greece,Kyrgyzstan,533,238,295
2019,380,Italy,Kyrgyzstan,1689,309,1380
2019,705,Slovenia,Kyrgyzstan,15,5,10
2019,724,Spain,Kyrgyzstan,345,100,245
2019,40,Austria,Kyrgyzstan,764,264,500
2019,56,Belgium,Kyrgyzstan,356,180,176
2019,250,France,Kyrgyzstan,792,216,576
2019,276,Germany,Kyrgyzstan,77373,34809,42564
2019,528,Netherlands,Kyrgyzstan,92,46,46
2019,756,Switzerland,Kyrgyzstan,671,237,434
2019,124,Canada,Kyrgyzstan,3167,1458,1709
2019,840,United States of America,Kyrgyzstan,6607,3221,3386
1990,710,South Africa,Lao People's Democratic Republic,33,8,25
1990,196,Cyprus,Lao People's Democratic Republic,1,0,1
1990,50,Bangladesh,Lao People's Democratic Republic,58722,31710,27012
1990,496,Mongolia,Lao People's Democratic Republic,4,3,1
1990,116,Cambodia,Lao People's Democratic Republic,121,67,54
1990,608,Philippines,Lao People's Democratic Republic,4321,2204,2117
1990,764,Thailand,Lao People's Democratic Republic,165019,75232,89787
1990,704,Viet Nam,Lao People's Democratic Republic,1033,457,576
1990,188,Costa Rica,Lao People's Democratic Republic,3,1,2
1990,32,Argentina,Lao People's Democratic Republic,539,239,300
1990,152,Chile,Lao People's Democratic Republic,13,6,7
1990,254,French Guiana,Lao People's Democratic Republic,920,490,430
1990,36,Australia,Lao People's Democratic Republic,11172,5757,5415
1990,540,New Caledonia,Lao People's Democratic Republic,515,247,268
1990,203,Czechia,Lao People's Democratic Republic,2,2,0
1990,348,Hungary,Lao People's Democratic Republic,40,24,16
1990,643,Russian Federation,Lao People's Democratic Republic,100,49,51
1990,208,Denmark,Lao People's Democratic Republic,18,10,8
1990,372,Ireland,Lao People's Democratic Republic,6,2,4
1990,578,Norway,Lao People's Democratic Republic,56,28,28
1990,752,Sweden,Lao People's Democratic Republic,284,143,141
1990,826,United Kingdom,Lao People's Democratic Republic,64,37,27
1990,300,Greece,Lao People's Democratic Republic,6,3,3
1990,380,Italy,Lao People's Democratic Republic,77,27,50
1990,724,Spain,Lao People's Democratic Republic,20,9,11
1990,40,Austria,Lao People's Democratic Republic,69,31,38
1990,56,Belgium,Lao People's Democratic Republic,1032,482,550
1990,250,France,Lao People's Democratic Republic,50300,25717,24583
1990,276,Germany,Lao People's Democratic Republic,2315,1358,957
1990,528,Netherlands,Lao People's Democratic Republic,55,31,24
1990,756,Switzerland,Lao People's Democratic Republic,724,354,370
1990,124,Canada,Lao People's Democratic Republic,13860,6748,7112
1990,840,United States of America,Lao People's Democratic Republic,171577,85842,85735
1995,710,South Africa,Lao People's Democratic Republic,20,7,13
1995,196,Cyprus,Lao People's Democratic Republic,2,0,2
1995,50,Bangladesh,Lao People's Democratic Republic,59555,32160,27395
1995,496,Mongolia,Lao People's Democratic Republic,4,4,0
1995,116,Cambodia,Lao People's Democratic Republic,317,175,142
1995,608,Philippines,Lao People's Democratic Republic,5815,2910,2905
1995,764,Thailand,Lao People's Democratic Republic,205957,95882,110075
1995,704,Viet Nam,Lao People's Democratic Republic,1889,921,968
1995,188,Costa Rica,Lao People's Democratic Republic,2,0,2
1995,32,Argentina,Lao People's Democratic Republic,566,270,296
1995,68,Bolivia (Plurinational State of),Lao People's Democratic Republic,8,4,4
1995,152,Chile,Lao People's Democratic Republic,7,7,0
1995,254,French Guiana,Lao People's Democratic Republic,910,467,443
1995,36,Australia,Lao People's Democratic Republic,11315,5778,5537
1995,540,New Caledonia,Lao People's Democratic Republic,597,282,315
1995,203,Czechia,Lao People's Democratic Republic,3,2,1
1995,348,Hungary,Lao People's Democratic Republic,35,20,15
1995,643,Russian Federation,Lao People's Democratic Republic,85,51,34
1995,208,Denmark,Lao People's Democratic Republic,21,11,10
1995,246,Finland,Lao People's Democratic Republic,3,1,2
1995,372,Ireland,Lao People's Democratic Republic,18,7,11
1995,578,Norway,Lao People's Democratic Republic,64,32,32
1995,752,Sweden,Lao People's Democratic Republic,337,168,169
1995,826,United Kingdom,Lao People's Democratic Republic,254,118,136
1995,300,Greece,Lao People's Democratic Republic,6,3,3
1995,380,Italy,Lao People's Democratic Republic,128,52,76
1995,724,Spain,Lao People's Democratic Republic,31,14,17
1995,40,Austria,Lao People's Democratic Republic,78,36,42
1995,56,Belgium,Lao People's Democratic Republic,1032,482,550
1995,250,France,Lao People's Democratic Republic,51926,26121,25805
1995,276,Germany,Lao People's Democratic Republic,1709,984,725
1995,528,Netherlands,Lao People's Democratic Republic,80,44,36
1995,756,Switzerland,Lao People's Democratic Republic,720,363,357
1995,124,Canada,Lao People's Democratic Republic,13854,6713,7141
1995,840,United States of America,Lao People's Democratic Republic,190445,96133,94312
2000,710,South Africa,Lao People's Democratic Republic,14,8,6
2000,196,Cyprus,Lao People's Democratic Republic,2,0,2
2000,50,Bangladesh,Lao People's Democratic Republic,60387,32609,27778
2000,496,Mongolia,Lao People's Democratic Republic,5,4,1
2000,116,Cambodia,Lao People's Democratic Republic,513,283,230
2000,608,Philippines,Lao People's Democratic Republic,532,272,260
2000,764,Thailand,Lao People's Democratic Republic,289386,133655,155731
2000,704,Viet Nam,Lao People's Democratic Republic,3994,2130,1864
2000,188,Costa Rica,Lao People's Democratic Republic,3,1,2
2000,32,Argentina,Lao People's Democratic Republic,593,301,292
2000,68,Bolivia (Plurinational State of),Lao People's Democratic Republic,15,8,7
2000,152,Chile,Lao People's Democratic Republic,1,1,0
2000,254,French Guiana,Lao People's Democratic Republic,900,445,455
2000,36,Australia,Lao People's Democratic Republic,10450,5197,5253
2000,540,New Caledonia,Lao People's Democratic Republic,679,316,363
2000,203,Czechia,Lao People's Democratic Republic,4,3,1
2000,348,Hungary,Lao People's Democratic Republic,30,17,13
2000,643,Russian Federation,Lao People's Democratic Republic,68,52,16
2000,208,Denmark,Lao People's Democratic Republic,24,12,12
2000,246,Finland,Lao People's Democratic Republic,5,1,4
2000,372,Ireland,Lao People's Democratic Republic,39,17,22
2000,578,Norway,Lao People's Democratic Republic,50,24,26
2000,752,Sweden,Lao People's Democratic Republic,362,179,183
2000,826,United Kingdom,Lao People's Democratic Republic,450,201,249
2000,300,Greece,Lao People's Democratic Republic,6,3,3
2000,380,Italy,Lao People's Democratic Republic,179,77,102
2000,724,Spain,Lao People's Democratic Republic,376,188,188
2000,40,Austria,Lao People's Democratic Republic,86,40,46
2000,56,Belgium,Lao People's Democratic Republic,1002,472,530
2000,250,France,Lao People's Democratic Republic,53552,26525,27027
2000,276,Germany,Lao People's Democratic Republic,1102,610,492
2000,438,Liechtenstein,Lao People's Democratic Republic,1,1,0
2000,528,Netherlands,Lao People's Democratic Republic,109,58,51
2000,756,Switzerland,Lao People's Democratic Republic,720,375,345
2000,124,Canada,Lao People's Democratic Republic,14178,6840,7338
2000,840,United States of America,Lao People's Democratic Republic,209471,106640,102831
2005,710,South Africa,Lao People's Democratic Republic,17,10,7
2005,196,Cyprus,Lao People's Democratic Republic,3,0,3
2005,50,Bangladesh,Lao People's Democratic Republic,71878,38815,33063
2005,496,Mongolia,Lao People's Democratic Republic,2,2,0
2005,116,Cambodia,Lao People's Democratic Republic,400,225,175
2005,608,Philippines,Lao People's Democratic Republic,430,223,207
2005,764,Thailand,Lao People's Democratic Republic,539966,237953,302013
2005,704,Viet Nam,Lao People's Democratic Republic,4941,2742,2199
2005,188,Costa Rica,Lao People's Democratic Republic,2,1,1
2005,32,Argentina,Lao People's Democratic Republic,438,225,213
2005,68,Bolivia (Plurinational State of),Lao People's Democratic Republic,8,4,4
2005,76,Brazil,Lao People's Democratic Republic,2,2,0
2005,152,Chile,Lao People's Democratic Republic,1,1,0
2005,254,French Guiana,Lao People's Democratic Republic,848,409,439
2005,36,Australia,Lao People's Democratic Republic,10600,5187,5413
2005,540,New Caledonia,Lao People's Democratic Republic,723,339,384
2005,100,Bulgaria,Lao People's Democratic Republic,1,0,1
2005,203,Czechia,Lao People's Democratic Republic,16,9,7
2005,348,Hungary,Lao People's Democratic Republic,38,22,16
2005,643,Russian Federation,Lao People's Democratic Republic,94,77,17
2005,208,Denmark,Lao People's Democratic Republic,38,15,23
2005,246,Finland,Lao People's Democratic Republic,13,2,11
2005,372,Ireland,Lao People's Democratic Republic,39,18,21
2005,578,Norway,Lao People's Democratic Republic,53,20,33
2005,752,Sweden,Lao People's Democratic Republic,416,190,226
2005,826,United Kingdom,Lao People's Democratic Republic,523,203,320
2005,300,Greece,Lao People's Democratic Republic,24,11,13
2005,380,Italy,Lao People's Democratic Republic,220,97,123
2005,724,Spain,Lao People's Democratic Republic,181,89,92
2005,40,Austria,Lao People's Democratic Republic,96,43,53
2005,56,Belgium,Lao People's Democratic Republic,1208,511,697
2005,250,France,Lao People's Democratic Republic,41673,20696,20977
2005,276,Germany,Lao People's Democratic Republic,2089,1063,1026
2005,438,Liechtenstein,Lao People's Democratic Republic,17,7,10
2005,528,Netherlands,Lao People's Democratic Republic,133,61,72
2005,756,Switzerland,Lao People's Democratic Republic,796,398,398
2005,124,Canada,Lao People's Democratic Republic,13739,6698,7041
2005,840,United States of America,Lao People's Democratic Republic,204193,104508,99685
2010,710,South Africa,Lao People's Democratic Republic,26,16,10
2010,196,Cyprus,Lao People's Democratic Republic,4,0,4
2010,50,Bangladesh,Lao People's Democratic Republic,83217,44938,38279
2010,496,Mongolia,Lao People's Democratic Republic,1,1,0
2010,116,Cambodia,Lao People's Democratic Republic,288,169,119
2010,608,Philippines,Lao People's Democratic Republic,372,190,182
2010,764,Thailand,Lao People's Democratic Republic,829240,365571,463669
2010,704,Viet Nam,Lao People's Democratic Republic,5981,3202,2779
2010,188,Costa Rica,Lao People's Democratic Republic,4,1,3
2010,32,Argentina,Lao People's Democratic Republic,282,149,133
2010,76,Brazil,Lao People's Democratic Republic,5,5,0
2010,152,Chile,Lao People's Democratic Republic,2,2,0
2010,254,French Guiana,Lao People's Democratic Republic,796,374,422
2010,36,Australia,Lao People's Democratic Republic,11110,5300,5810
2010,540,New Caledonia,Lao People's Democratic Republic,768,362,406
2010,100,Bulgaria,Lao People's Democratic Republic,1,0,1
2010,203,Czechia,Lao People's Democratic Republic,27,14,13
2010,348,Hungary,Lao People's Democratic Republic,45,26,19
2010,643,Russian Federation,Lao People's Democratic Republic,119,101,18
2010,208,Denmark,Lao People's Democratic Republic,50,17,33
2010,246,Finland,Lao People's Democratic Republic,19,1,18
2010,372,Ireland,Lao People's Democratic Republic,33,14,19
2010,578,Norway,Lao People's Democratic Republic,85,24,61
2010,752,Sweden,Lao People's Democratic Republic,482,206,276
2010,826,United Kingdom,Lao People's Democratic Republic,550,220,330
2010,300,Greece,Lao People's Democratic Republic,43,21,22
2010,380,Italy,Lao People's Democratic Republic,268,123,145
2010,724,Spain,Lao People's Democratic Republic,203,97,106
2010,40,Austria,Lao People's Democratic Republic,106,46,60
2010,56,Belgium,Lao People's Democratic Republic,1150,554,596
2010,250,France,Lao People's Democratic Republic,40025,19371,20654
2010,276,Germany,Lao People's Democratic Republic,2908,1450,1458
2010,438,Liechtenstein,Lao People's Democratic Republic,35,14,21
2010,528,Netherlands,Lao People's Democratic Republic,162,65,97
2010,756,Switzerland,Lao People's Democratic Republic,952,445,507
2010,124,Canada,Lao People's Democratic Republic,14305,7065,7240
2010,840,United States of America,Lao People's Democratic Republic,205051,103570,101481
2015,710,South Africa,Lao People's Democratic Republic,45,28,17
2015,196,Cyprus,Lao People's Democratic Republic,3,0,3
2015,50,Bangladesh,Lao People's Democratic Republic,88155,47604,40551
2015,496,Mongolia,Lao People's Democratic Republic,1,1,0
2015,116,Cambodia,Lao People's Democratic Republic,260,155,105
2015,608,Philippines,Lao People's Democratic Republic,287,147,140
2015,764,Thailand,Lao People's Democratic Republic,896727,393642,503085
2015,704,Viet Nam,Lao People's Democratic Republic,6956,3965,2991
2015,188,Costa Rica,Lao People's Democratic Republic,4,1,3
2015,32,Argentina,Lao People's Democratic Republic,283,149,134
2015,76,Brazil,Lao People's Democratic Republic,6,6,0
2015,152,Chile,Lao People's Democratic Republic,3,3,0
2015,254,French Guiana,Lao People's Democratic Republic,801,371,430
2015,36,Australia,Lao People's Democratic Republic,11030,5232,5798
2015,540,New Caledonia,Lao People's Democratic Republic,590,242,348
2015,100,Bulgaria,Lao People's Democratic Republic,1,0,1
2015,203,Czechia,Lao People's Democratic Republic,25,12,13
2015,348,Hungary,Lao People's Democratic Republic,49,30,19
2015,643,Russian Federation,Lao People's Democratic Republic,122,104,18
2015,208,Denmark,Lao People's Democratic Republic,65,23,42
2015,246,Finland,Lao People's Democratic Republic,53,1,52
2015,372,Ireland,Lao People's Democratic Republic,34,14,20
2015,578,Norway,Lao People's Democratic Republic,100,24,76
2015,752,Sweden,Lao People's Democratic Republic,490,194,296
2015,826,United Kingdom,Lao People's Democratic Republic,703,269,434
2015,300,Greece,Lao People's Democratic Republic,40,19,21
2015,380,Italy,Lao People's Democratic Republic,250,114,136
2015,724,Spain,Lao People's Democratic Republic,188,89,99
2015,40,Austria,Lao People's Democratic Republic,124,54,70
2015,56,Belgium,Lao People's Democratic Republic,1149,542,607
2015,250,France,Lao People's Democratic Republic,44338,20828,23510
2015,276,Germany,Lao People's Democratic Republic,3030,1508,1522
2015,438,Liechtenstein,Lao People's Democratic Republic,36,14,22
2015,528,Netherlands,Lao People's Democratic Republic,210,84,126
2015,756,Switzerland,Lao People's Democratic Republic,958,427,531
2015,124,Canada,Lao People's Democratic Republic,14386,7078,7308
2015,840,United States of America,Lao People's Democratic Republic,213777,107435,106342
2019,710,South Africa,Lao People's Democratic Republic,49,31,18
2019,196,Cyprus,Lao People's Democratic Republic,2,0,2
2019,50,Bangladesh,Lao People's Democratic Republic,89317,27237,62080
2019,496,Mongolia,Lao People's Democratic Republic,1,1,0
2019,116,Cambodia,Lao People's Democratic Republic,276,165,111
2019,608,Philippines,Lao People's Democratic Republic,296,152,144
2019,764,Thailand,Lao People's Democratic Republic,934936,410329,524607
2019,704,Viet Nam,Lao People's Democratic Republic,7272,4146,3126
2019,188,Costa Rica,Lao People's Democratic Republic,4,1,3
2019,32,Argentina,Lao People's Democratic Republic,287,151,136
2019,76,Brazil,Lao People's Democratic Republic,6,6,0
2019,152,Chile,Lao People's Democratic Republic,4,4,0
2019,254,French Guiana,Lao People's Democratic Republic,886,411,475
2019,36,Australia,Lao People's Democratic Republic,11701,5477,6224
2019,540,New Caledonia,Lao People's Democratic Republic,621,254,367
2019,100,Bulgaria,Lao People's Democratic Republic,1,0,1
2019,203,Czechia,Lao People's Democratic Republic,35,20,15
2019,348,Hungary,Lao People's Democratic Republic,57,34,23
2019,643,Russian Federation,Lao People's Democratic Republic,121,104,17
2019,208,Denmark,Lao People's Democratic Republic,69,17,52
2019,246,Finland,Lao People's Democratic Republic,63,1,62
2019,372,Ireland,Lao People's Democratic Republic,37,16,21
2019,578,Norway,Lao People's Democratic Republic,121,31,90
2019,752,Sweden,Lao People's Democratic Republic,490,190,300
2019,826,United Kingdom,Lao People's Democratic Republic,798,307,491
2019,300,Greece,Lao People's Democratic Republic,39,20,19
2019,380,Italy,Lao People's Democratic Republic,260,115,145
2019,724,Spain,Lao People's Democratic Republic,194,89,105
2019,40,Austria,Lao People's Democratic Republic,146,65,81
2019,56,Belgium,Lao People's Democratic Republic,1203,563,640
2019,250,France,Lao People's Democratic Republic,46932,21990,24942
2019,276,Germany,Lao People's Democratic Republic,3323,1406,1917
2019,438,Liechtenstein,Lao People's Democratic Republic,41,16,25
2019,528,Netherlands,Lao People's Democratic Republic,219,86,133
2019,756,Switzerland,Lao People's Democratic Republic,1010,446,564
2019,124,Canada,Lao People's Democratic Republic,15416,7585,7831
2019,840,United States of America,Lao People's Democratic Republic,230858,114784,116074
1990,710,South Africa,Latvia,199,135,64
1990,196,Cyprus,Latvia,41,13,28
1990,268,Georgia,Latvia,1382,612,770
1990,376,Israel,Latvia,9479,4348,5131
1990,792,Turkey,Latvia,15,5,10
1990,398,Kazakhstan,Latvia,358,174,184
1990,417,Kyrgyzstan,Latvia,2526,1069,1457
1990,188,Costa Rica,Latvia,1,0,1
1990,484,Mexico,Latvia,21,11,10
1990,32,Argentina,Latvia,270,89,181
1990,152,Chile,Latvia,47,20,27
1990,170,Colombia,Latvia,17,7,10
1990,862,Venezuela (Bolivarian Republic of),Latvia,124,61,63
1990,36,Australia,Latvia,10144,5154,4990
1990,112,Belarus,Latvia,11085,5137,5948
1990,100,Bulgaria,Latvia,10,1,9
1990,203,Czechia,Latvia,32,12,20
1990,348,Hungary,Latvia,21,3,18
1990,616,Poland,Latvia,3167,1298,1869
1990,643,Russian Federation,Latvia,95730,46976,48754
1990,703,Slovakia,Latvia,5,1,4
1990,804,Ukraine,Latvia,20185,8649,11536
1990,208,Denmark,Latvia,15,6,9
1990,233,Estonia,Latvia,6102,2819,3283
1990,372,Ireland,Latvia,703,346,357
1990,440,Lithuania,Latvia,11157,5423,5734
1990,578,Norway,Latvia,15,11,4
1990,752,Sweden,Latvia,1811,746,1065
1990,826,United Kingdom,Latvia,1160,857,303
1990,300,Greece,Latvia,75,42,33
1990,380,Italy,Latvia,38,13,25
1990,470,Malta,Latvia,4,3,1
1990,620,Portugal,Latvia,20,14,6
1990,705,Slovenia,Latvia,3,2,1
1990,724,Spain,Latvia,50,22,28
1990,40,Austria,Latvia,445,138,307
1990,56,Belgium,Latvia,75,28,47
1990,250,France,Latvia,1310,598,712
1990,276,Germany,Latvia,3143,1221,1922
1990,442,Luxembourg,Latvia,8,1,7
1990,528,Netherlands,Latvia,128,44,84
1990,756,Switzerland,Latvia,422,122,300
1990,124,Canada,Latvia,7412,3608,3804
1990,840,United States of America,Latvia,26179,10105,16074
1995,710,South Africa,Latvia,163,112,51
1995,196,Cyprus,Latvia,58,17,41
1995,268,Georgia,Latvia,398,138,260
1995,376,Israel,Latvia,8948,4032,4916
1995,792,Turkey,Latvia,37,13,24
1995,398,Kazakhstan,Latvia,588,290,298
1995,417,Kyrgyzstan,Latvia,2122,903,1219
1995,188,Costa Rica,Latvia,1,0,1
1995,484,Mexico,Latvia,23,11,12
1995,32,Argentina,Latvia,264,89,175
1995,68,Bolivia (Plurinational State of),Latvia,1,0,1
1995,152,Chile,Latvia,40,15,25
1995,170,Colombia,Latvia,17,7,10
1995,862,Venezuela (Bolivarian Republic of),Latvia,122,60,62
1995,36,Australia,Latvia,9573,4728,4845
1995,112,Belarus,Latvia,10983,4170,6813
1995,100,Bulgaria,Latvia,34,7,27
1995,203,Czechia,Latvia,49,20,29
1995,348,Hungary,Latvia,59,13,46
1995,616,Poland,Latvia,2708,1086,1622
1995,643,Russian Federation,Latvia,100686,49261,51425
1995,703,Slovakia,Latvia,40,14,26
1995,804,Ukraine,Latvia,21108,9830,11278
1995,208,Denmark,Latvia,341,133,208
1995,233,Estonia,Latvia,5196,2318,2878
1995,246,Finland,Latvia,117,51,66
1995,352,Iceland,Latvia,10,7,3
1995,372,Ireland,Latvia,3814,1818,1996
1995,440,Lithuania,Latvia,10638,5192,5446
1995,578,Norway,Latvia,130,45,85
1995,752,Sweden,Latvia,2149,876,1273
1995,826,United Kingdom,Latvia,2623,1592,1031
1995,191,Croatia,Latvia,11,2,9
1995,300,Greece,Latvia,65,27,38
1995,380,Italy,Latvia,337,21,316
1995,470,Malta,Latvia,5,3,2
1995,620,Portugal,Latvia,44,30,14
1995,705,Slovenia,Latvia,6,2,4
1995,724,Spain,Latvia,98,45,53
1995,40,Austria,Latvia,502,161,341
1995,56,Belgium,Latvia,75,28,47
1995,250,France,Latvia,1353,606,747
1995,276,Germany,Latvia,8067,3154,4913
1995,442,Luxembourg,Latvia,7,1,6
1995,528,Netherlands,Latvia,188,61,127
1995,756,Switzerland,Latvia,712,221,491
1995,124,Canada,Latvia,7443,3606,3837
1995,840,United States of America,Latvia,27062,10586,16476
2000,710,South Africa,Latvia,176,120,56
2000,196,Cyprus,Latvia,75,21,54
2000,268,Georgia,Latvia,199,69,130
2000,376,Israel,Latvia,7916,3544,4372
2000,792,Turkey,Latvia,61,21,40
2000,398,Kazakhstan,Latvia,817,405,412
2000,417,Kyrgyzstan,Latvia,1658,709,949
2000,188,Costa Rica,Latvia,1,0,1
2000,484,Mexico,Latvia,26,11,15
2000,32,Argentina,Latvia,258,90,168
2000,68,Bolivia (Plurinational State of),Latvia,1,0,1
2000,152,Chile,Latvia,34,12,22
2000,170,Colombia,Latvia,16,6,10
2000,862,Venezuela (Bolivarian Republic of),Latvia,121,60,61
2000,36,Australia,Latvia,7370,3463,3907
2000,112,Belarus,Latvia,10880,3203,7677
2000,100,Bulgaria,Latvia,58,13,45
2000,203,Czechia,Latvia,65,27,38
2000,348,Hungary,Latvia,96,23,73
2000,616,Poland,Latvia,2317,909,1408
2000,643,Russian Federation,Latvia,101991,49778,52213
2000,703,Slovakia,Latvia,88,32,56
2000,804,Ukraine,Latvia,22289,11131,11158
2000,208,Denmark,Latvia,667,260,407
2000,233,Estonia,Latvia,4289,1816,2473
2000,246,Finland,Latvia,234,103,131
2000,352,Iceland,Latvia,19,13,6
2000,372,Ireland,Latvia,9021,4448,4573
2000,440,Lithuania,Latvia,8333,4059,4274
2000,578,Norway,Latvia,326,78,248
2000,752,Sweden,Latvia,2305,930,1375
2000,826,United Kingdom,Latvia,4132,2352,1780
2000,191,Croatia,Latvia,21,4,17
2000,300,Greece,Latvia,56,12,44
2000,380,Italy,Latvia,636,29,607
2000,470,Malta,Latvia,13,8,5
2000,620,Portugal,Latvia,70,47,23
2000,705,Slovenia,Latvia,8,1,7
2000,724,Spain,Latvia,190,89,101
2000,40,Austria,Latvia,559,185,374
2000,56,Belgium,Latvia,72,26,46
2000,250,France,Latvia,1395,613,782
2000,276,Germany,Latvia,12990,5086,7904
2000,442,Luxembourg,Latvia,7,1,6
2000,528,Netherlands,Latvia,255,79,176
2000,756,Switzerland,Latvia,1006,322,684
2000,124,Canada,Latvia,7651,3691,3960
2000,840,United States of America,Latvia,27923,11080,16843
2005,710,South Africa,Latvia,232,156,76
2005,196,Cyprus,Latvia,109,29,80
2005,268,Georgia,Latvia,189,66,123
2005,376,Israel,Latvia,5829,2594,3235
2005,792,Turkey,Latvia,62,20,42
2005,398,Kazakhstan,Latvia,932,475,457
2005,417,Kyrgyzstan,Latvia,1351,574,777
2005,188,Costa Rica,Latvia,1,0,1
2005,484,Mexico,Latvia,27,10,17
2005,32,Argentina,Latvia,191,68,123
2005,68,Bolivia (Plurinational State of),Latvia,1,0,1
2005,76,Brazil,Latvia,70,15,55
2005,152,Chile,Latvia,51,19,32
2005,170,Colombia,Latvia,16,7,9
2005,862,Venezuela (Bolivarian Republic of),Latvia,125,61,64
2005,36,Australia,Latvia,6310,2870,3440
2005,112,Belarus,Latvia,10450,3075,7375
2005,100,Bulgaria,Latvia,91,23,68
2005,203,Czechia,Latvia,153,57,96
2005,348,Hungary,Latvia,119,30,89
2005,616,Poland,Latvia,1932,752,1180
2005,643,Russian Federation,Latvia,95839,45868,49971
2005,703,Slovakia,Latvia,99,37,62
2005,804,Ukraine,Latvia,20366,10185,10181
2005,208,Denmark,Latvia,1689,690,999
2005,233,Estonia,Latvia,4292,1808,2484
2005,246,Finland,Latvia,666,286,380
2005,352,Iceland,Latvia,339,178,161
2005,372,Ireland,Latvia,16717,8472,8245
2005,440,Lithuania,Latvia,8048,3865,4183
2005,578,Norway,Latvia,697,186,511
2005,752,Sweden,Latvia,2715,991,1724
2005,826,United Kingdom,Latvia,30230,13832,16398
2005,191,Croatia,Latvia,24,3,21
2005,300,Greece,Latvia,208,40,168
2005,380,Italy,Latvia,1918,356,1562
2005,470,Malta,Latvia,22,12,10
2005,620,Portugal,Latvia,137,51,86
2005,705,Slovenia,Latvia,5,0,5
2005,724,Spain,Latvia,1318,560,758
2005,40,Austria,Latvia,625,196,429
2005,56,Belgium,Latvia,297,84,213
2005,250,France,Latvia,1852,848,1004
2005,276,Germany,Latvia,19481,8100,11381
2005,442,Luxembourg,Latvia,162,23,139
2005,528,Netherlands,Latvia,496,147,349
2005,756,Switzerland,Latvia,1204,345,859
2005,124,Canada,Latvia,6814,3220,3594
2005,840,United States of America,Latvia,26669,10672,15997
2010,710,South Africa,Latvia,363,244,119
2010,196,Cyprus,Latvia,178,49,129
2010,268,Georgia,Latvia,190,66,124
2010,376,Israel,Latvia,3812,1669,2143
2010,792,Turkey,Latvia,63,19,44
2010,398,Kazakhstan,Latvia,1046,544,502
2010,417,Kyrgyzstan,Latvia,1024,429,595
2010,188,Costa Rica,Latvia,1,0,1
2010,484,Mexico,Latvia,33,12,21
2010,32,Argentina,Latvia,124,47,77
2010,76,Brazil,Latvia,140,29,111
2010,152,Chile,Latvia,68,26,42
2010,170,Colombia,Latvia,18,8,10
2010,862,Venezuela (Bolivarian Republic of),Latvia,133,66,67
2010,36,Australia,Latvia,5590,2352,3238
2010,112,Belarus,Latvia,10019,2946,7073
2010,100,Bulgaria,Latvia,121,32,89
2010,203,Czechia,Latvia,226,85,141
2010,348,Hungary,Latvia,142,37,105
2010,616,Poland,Latvia,1608,610,998
2010,643,Russian Federation,Latvia,87715,41044,46671
2010,703,Slovakia,Latvia,111,42,69
2010,804,Ukraine,Latvia,19432,9732,9700
2010,208,Denmark,Latvia,2663,1102,1561
2010,233,Estonia,Latvia,4259,1775,2484
2010,246,Finland,Latvia,1142,420,722
2010,352,Iceland,Latvia,657,343,314
2010,372,Ireland,Latvia,21660,10056,11604
2010,440,Lithuania,Latvia,6670,2934,3736
2010,578,Norway,Latvia,2748,1458,1290
2010,752,Sweden,Latvia,4686,1890,2796
2010,826,United Kingdom,Latvia,31846,14927,16919
2010,191,Croatia,Latvia,27,3,24
2010,300,Greece,Latvia,374,72,302
2010,380,Italy,Latvia,3078,621,2457
2010,470,Malta,Latvia,63,31,32
2010,620,Portugal,Latvia,182,47,135
2010,705,Slovenia,Latvia,22,5,17
2010,724,Spain,Latvia,3129,1328,1801
2010,40,Austria,Latvia,690,207,483
2010,56,Belgium,Latvia,676,221,455
2010,250,France,Latvia,2620,1120,1500
2010,276,Germany,Latvia,24847,10651,14196
2010,442,Luxembourg,Latvia,320,46,274
2010,528,Netherlands,Latvia,1195,435,760
2010,756,Switzerland,Latvia,1330,325,1005
2010,124,Canada,Latvia,6125,2832,3293
2010,840,United States of America,Latvia,26202,10269,15933
2015,710,South Africa,Latvia,654,430,224
2015,324,Guinea,Latvia,23,12,11
2015,196,Cyprus,Latvia,171,48,123
2015,268,Georgia,Latvia,199,69,130
2015,376,Israel,Latvia,3931,1710,2221
2015,792,Turkey,Latvia,63,18,45
2015,398,Kazakhstan,Latvia,1113,588,525
2015,417,Kyrgyzstan,Latvia,902,375,527
2015,188,Costa Rica,Latvia,1,0,1
2015,484,Mexico,Latvia,35,13,22
2015,32,Argentina,Latvia,124,47,77
2015,76,Brazil,Latvia,169,35,134
2015,152,Chile,Latvia,103,39,64
2015,170,Colombia,Latvia,20,9,11
2015,862,Venezuela (Bolivarian Republic of),Latvia,140,68,72
2015,36,Australia,Latvia,4990,2020,2970
2015,112,Belarus,Latvia,10486,3087,7399
2015,100,Bulgaria,Latvia,169,43,126
2015,203,Czechia,Latvia,450,209,241
2015,348,Hungary,Latvia,176,56,120
2015,616,Poland,Latvia,1550,606,944
2015,643,Russian Federation,Latvia,89389,41590,47799
2015,703,Slovakia,Latvia,144,61,83
2015,804,Ukraine,Latvia,19497,9779,9718
2015,208,Denmark,Latvia,4623,2082,2541
2015,233,Estonia,Latvia,4703,2131,2572
2015,246,Finland,Latvia,2044,843,1201
2015,352,Iceland,Latvia,735,352,383
2015,372,Ireland,Latvia,22126,10126,12000
2015,440,Lithuania,Latvia,5630,2407,3223
2015,578,Norway,Latvia,9647,5634,4013
2015,752,Sweden,Latvia,7026,3167,3859
2015,826,United Kingdom,Latvia,40726,18448,22278
2015,191,Croatia,Latvia,27,3,24
2015,300,Greece,Latvia,351,56,295
2015,380,Italy,Latvia,3226,653,2573
2015,470,Malta,Latvia,106,56,50
2015,620,Portugal,Latvia,206,45,161
2015,705,Slovenia,Latvia,38,6,32
2015,724,Spain,Latvia,3987,1532,2455
2015,40,Austria,Latvia,806,244,562
2015,56,Belgium,Latvia,1218,448,770
2015,250,France,Latvia,3498,1472,2026
2015,276,Germany,Latvia,25889,11063,14826
2015,442,Luxembourg,Latvia,488,77,411
2015,528,Netherlands,Latvia,3202,1332,1870
2015,756,Switzerland,Latvia,2133,598,1535
2015,124,Canada,Latvia,5843,2652,3191
2015,840,United States of America,Latvia,25163,9784,15379
2019,710,South Africa,Latvia,732,482,250
2019,324,Guinea,Latvia,21,11,10
2019,196,Cyprus,Latvia,170,49,121
2019,268,Georgia,Latvia,205,71,134
2019,376,Israel,Latvia,3822,1663,2159
2019,792,Turkey,Latvia,85,25,60
2019,398,Kazakhstan,Latvia,1163,615,548
2019,417,Kyrgyzstan,Latvia,883,367,516
2019,188,Costa Rica,Latvia,1,0,1
2019,484,Mexico,Latvia,36,14,22
2019,32,Argentina,Latvia,126,48,78
2019,76,Brazil,Latvia,190,40,150
2019,152,Chile,Latvia,137,47,90
2019,170,Colombia,Latvia,20,9,11
2019,862,Venezuela (Bolivarian Republic of),Latvia,137,67,70
2019,36,Australia,Latvia,4983,2031,2952
2019,112,Belarus,Latvia,10355,3049,7306
2019,100,Bulgaria,Latvia,216,57,159
2019,203,Czechia,Latvia,518,243,275
2019,348,Hungary,Latvia,192,64,128
2019,616,Poland,Latvia,1641,680,961
2019,643,Russian Federation,Latvia,89368,41581,47787
2019,703,Slovakia,Latvia,182,77,105
2019,804,Ukraine,Latvia,19691,9876,9815
2019,208,Denmark,Latvia,5423,2502,2921
2019,233,Estonia,Latvia,4855,2246,2609
2019,246,Finland,Latvia,2588,1133,1455
2019,352,Iceland,Latvia,998,533,465
2019,372,Ireland,Latvia,24291,11157,13134
2019,440,Lithuania,Latvia,5058,2154,2904
2019,578,Norway,Latvia,10958,6294,4664
2019,752,Sweden,Latvia,9026,4537,4489
2019,826,United Kingdom,Latvia,46248,21013,25235
2019,191,Croatia,Latvia,24,2,22
2019,300,Greece,Latvia,342,65,277
2019,380,Italy,Latvia,3634,811,2823
2019,470,Malta,Latvia,171,91,80
2019,620,Portugal,Latvia,209,46,163
2019,705,Slovenia,Latvia,49,10,39
2019,724,Spain,Latvia,4131,1527,2604
2019,40,Austria,Latvia,951,299,652
2019,56,Belgium,Latvia,1762,623,1139
2019,250,France,Latvia,3702,1553,2149
2019,276,Germany,Latvia,32305,15220,17085
2019,442,Luxembourg,Latvia,678,198,480
2019,528,Netherlands,Latvia,4068,1807,2261
2019,756,Switzerland,Latvia,2465,746,1719
2019,124,Canada,Latvia,6261,2842,3419
2019,840,United States of America,Latvia,27172,10386,16786
1990,178,Congo,Lebanon,358,220,138
1990,266,Gabon,Lebanon,773,536,237
1990,516,Namibia,Lebanon,68,41,27
1990,710,South Africa,Lebanon,903,386,517
1990,288,Ghana,Lebanon,525,297,228
1990,430,Liberia,Lebanon,4230,2719,1511
1990,478,Mauritania,Lebanon,106,41,65
1990,686,Senegal,Lebanon,911,587,324
1990,694,Sierra Leone,Lebanon,2090,1051,1039
1990,12,Algeria,Lebanon,1564,720,844
1990,818,Egypt,Lebanon,2317,1016,1301
1990,434,Libya,Lebanon,6615,2919,3696
1990,504,Morocco,Lebanon,923,489,434
1990,51,Armenia,Lebanon,1129,440,689
1990,48,Bahrain,Lebanon,728,521,207
1990,196,Cyprus,Lebanon,685,387,298
1990,368,Iraq,Lebanon,1173,668,505
1990,376,Israel,Lebanon,3924,1547,2377
1990,400,Jordan,Lebanon,3021,1213,1808
1990,414,Kuwait,Lebanon,4513,2733,1780
1990,634,Qatar,Lebanon,3090,2247,843
1990,682,Saudi Arabia,Lebanon,57203,38051,19152
1990,275,State of Palestine,Lebanon,2342,1125,1217
1990,792,Turkey,Lebanon,273,143,130
1990,784,United Arab Emirates,Lebanon,5513,3925,1588
1990,462,Maldives,Lebanon,7,4,3
1990,144,Sri Lanka,Lebanon,8,4,4
1990,608,Philippines,Lebanon,30,16,14
1990,28,Antigua and Barbuda,Lebanon,46,22,24
1990,92,British Virgin Islands,Lebanon,12,9,3
1990,535,"Bonaire, Sint Eustatius and Saba",Lebanon,312,190,122
1990,192,Cuba,Lebanon,123,69,54
1990,212,Dominica,Lebanon,12,9,3
1990,214,Dominican Republic,Lebanon,717,450,267
1990,312,Guadeloupe,Lebanon,121,58,63
1990,630,Puerto Rico,Lebanon,35,17,18
1990,662,Saint Lucia,Lebanon,4,1,3
1990,84,Belize,Lebanon,35,26,9
1990,188,Costa Rica,Lebanon,86,54,32
1990,320,Guatemala,Lebanon,27,14,13
1990,484,Mexico,Lebanon,1542,838,704
1990,591,Panama,Lebanon,282,176,106
1990,32,Argentina,Lebanon,3248,1632,1616
1990,68,Bolivia (Plurinational State of),Lebanon,64,48,16
1990,76,Brazil,Lebanon,17987,10880,7107
1990,152,Chile,Lebanon,211,117,94
1990,170,Colombia,Lebanon,1078,692,386
1990,218,Ecuador,Lebanon,148,96,52
1990,604,Peru,Lebanon,42,25,17
1990,862,Venezuela (Bolivarian Republic of),Lebanon,7601,4669,2932
1990,36,Australia,Lebanon,81858,43397,38461
1990,112,Belarus,Lebanon,32,32,0
1990,100,Bulgaria,Lebanon,266,207,59
1990,203,Czechia,Lebanon,51,42,9
1990,348,Hungary,Lebanon,304,235,69
1990,616,Poland,Lebanon,467,378,89
1990,642,Romania,Lebanon,306,245,61
1990,643,Russian Federation,Lebanon,2133,1047,1086
1990,703,Slovakia,Lebanon,14,11,3
1990,804,Ukraine,Lebanon,2132,2007,125
1990,208,Denmark,Lebanon,7758,4631,3127
1990,246,Finland,Lebanon,142,108,34
1990,352,Iceland,Lebanon,14,10,4
1990,372,Ireland,Lebanon,26,15,11
1990,428,Latvia,Lebanon,45,20,25
1990,440,Lithuania,Lebanon,118,108,10
1990,578,Norway,Lebanon,590,400,190
1990,752,Sweden,Lebanon,15745,8778,6967
1990,826,United Kingdom,Lebanon,8712,5128,3584
1990,300,Greece,Lebanon,5775,3579,2196
1990,380,Italy,Lebanon,9128,6024,3104
1990,470,Malta,Lebanon,30,16,14
1990,620,Portugal,Lebanon,17,10,7
1990,688,Serbia,Lebanon,5,3,2
1990,705,Slovenia,Lebanon,4,2,2
1990,724,Spain,Lebanon,1282,952,330
1990,40,Austria,Lebanon,1015,609,406
1990,56,Belgium,Lebanon,4357,2895,1462
1990,250,France,Lebanon,38599,22664,15935
1990,276,Germany,Lebanon,45648,29234,16414
1990,442,Luxembourg,Lebanon,34,13,21
1990,528,Netherlands,Lebanon,1682,1015,667
1990,756,Switzerland,Lebanon,3516,2460,1056
1990,124,Canada,Lebanon,52394,25506,26888
1990,840,United States of America,Lebanon,86369,46758,39611
1995,178,Congo,Lebanon,414,247,167
1995,266,Gabon,Lebanon,1034,717,317
1995,516,Namibia,Lebanon,65,40,25
1995,710,South Africa,Lebanon,563,267,296
1995,288,Ghana,Lebanon,523,318,205
1995,430,Liberia,Lebanon,4133,2454,1679
1995,478,Mauritania,Lebanon,113,51,62
1995,686,Senegal,Lebanon,952,612,340
1995,694,Sierra Leone,Lebanon,2066,1064,1002
1995,12,Algeria,Lebanon,1395,612,783
1995,818,Egypt,Lebanon,2232,956,1276
1995,434,Libya,Lebanon,7318,3607,3711
1995,504,Morocco,Lebanon,847,442,405
1995,51,Armenia,Lebanon,1198,495,703
1995,48,Bahrain,Lebanon,800,564,236
1995,196,Cyprus,Lebanon,969,530,439
1995,368,Iraq,Lebanon,1383,639,744
1995,376,Israel,Lebanon,4570,1820,2750
1995,400,Jordan,Lebanon,2625,1098,1527
1995,414,Kuwait,Lebanon,3616,2304,1312
1995,634,Qatar,Lebanon,3377,2509,868
1995,682,Saudi Arabia,Lebanon,58626,39100,19526
1995,275,State of Palestine,Lebanon,2288,1093,1195
1995,792,Turkey,Lebanon,662,334,328
1995,784,United Arab Emirates,Lebanon,7065,5061,2004
1995,462,Maldives,Lebanon,7,4,3
1995,144,Sri Lanka,Lebanon,94,74,20
1995,608,Philippines,Lebanon,40,21,19
1995,28,Antigua and Barbuda,Lebanon,46,22,24
1995,92,British Virgin Islands,Lebanon,14,10,4
1995,535,"Bonaire, Sint Eustatius and Saba",Lebanon,651,396,255
1995,192,Cuba,Lebanon,94,51,43
1995,212,Dominica,Lebanon,16,12,4
1995,214,Dominican Republic,Lebanon,797,493,304
1995,312,Guadeloupe,Lebanon,162,76,86
1995,630,Puerto Rico,Lebanon,36,18,18
1995,662,Saint Lucia,Lebanon,5,2,3
1995,84,Belize,Lebanon,37,27,10
1995,188,Costa Rica,Lebanon,62,41,21
1995,320,Guatemala,Lebanon,21,12,9
1995,484,Mexico,Lebanon,1585,862,723
1995,591,Panama,Lebanon,303,189,114
1995,32,Argentina,Lebanon,2409,1214,1195
1995,68,Bolivia (Plurinational State of),Lebanon,56,41,15
1995,76,Brazil,Lebanon,17058,10393,6665
1995,152,Chile,Lebanon,206,126,80
1995,170,Colombia,Lebanon,1049,674,375
1995,218,Ecuador,Lebanon,166,107,59
1995,604,Peru,Lebanon,43,25,18
1995,862,Venezuela (Bolivarian Republic of),Lebanon,7179,4308,2871
1995,36,Australia,Lebanon,79925,41939,37986
1995,112,Belarus,Lebanon,50,50,0
1995,100,Bulgaria,Lebanon,323,250,73
1995,203,Czechia,Lebanon,76,63,13
1995,348,Hungary,Lebanon,270,208,62
1995,616,Poland,Lebanon,399,322,77
1995,642,Romania,Lebanon,642,522,120
1995,643,Russian Federation,Lebanon,1710,1096,614
1995,703,Slovakia,Lebanon,36,31,5
1995,804,Ukraine,Lebanon,2062,1945,117
1995,208,Denmark,Lebanon,10077,5704,4373
1995,246,Finland,Lebanon,196,143,53
1995,352,Iceland,Lebanon,17,12,5
1995,372,Ireland,Lebanon,71,40,31
1995,428,Latvia,Lebanon,42,28,14
1995,440,Lithuania,Lebanon,133,121,12
1995,578,Norway,Lebanon,997,624,373
1995,752,Sweden,Lebanon,18685,10355,8330
1995,826,United Kingdom,Lebanon,9330,5405,3925
1995,300,Greece,Lebanon,3958,2441,1517
1995,380,Italy,Lebanon,6639,4259,2380
1995,470,Malta,Lebanon,36,19,17
1995,620,Portugal,Lebanon,36,20,16
1995,688,Serbia,Lebanon,35,20,15
1995,705,Slovenia,Lebanon,8,4,4
1995,724,Spain,Lebanon,1482,1094,388
1995,40,Austria,Lebanon,1145,694,451
1995,56,Belgium,Lebanon,3592,2309,1283
1995,250,France,Lebanon,39847,23120,16727
1995,276,Germany,Lebanon,47656,28745,18911
1995,442,Luxembourg,Lebanon,31,12,19
1995,528,Netherlands,Lebanon,2263,1346,917
1995,756,Switzerland,Lebanon,3861,2656,1205
1995,124,Canada,Lebanon,59419,28775,30644
1995,840,United States of America,Lebanon,97425,53149,44276
2000,178,Congo,Lebanon,580,339,241
2000,266,Gabon,Lebanon,1293,900,393
2000,516,Namibia,Lebanon,61,37,24
2000,710,South Africa,Lebanon,389,215,174
2000,288,Ghana,Lebanon,585,334,251
2000,430,Liberia,Lebanon,4056,2194,1862
2000,478,Mauritania,Lebanon,116,59,57
2000,686,Senegal,Lebanon,862,539,323
2000,694,Sierra Leone,Lebanon,2083,1038,1045
2000,12,Algeria,Lebanon,1225,504,721
2000,818,Egypt,Lebanon,2324,971,1353
2000,434,Libya,Lebanon,8143,4443,3700
2000,504,Morocco,Lebanon,892,459,433
2000,51,Armenia,Lebanon,1310,559,751
2000,48,Bahrain,Lebanon,875,605,270
2000,196,Cyprus,Lebanon,1252,673,579
2000,268,Georgia,Lebanon,10,4,6
2000,368,Iraq,Lebanon,1311,433,878
2000,376,Israel,Lebanon,4960,2020,2940
2000,400,Jordan,Lebanon,2230,990,1240
2000,414,Kuwait,Lebanon,4125,2786,1339
2000,634,Qatar,Lebanon,3162,2402,760
2000,682,Saudi Arabia,Lebanon,60237,40260,19977
2000,275,State of Palestine,Lebanon,2235,1062,1173
2000,792,Turkey,Lebanon,1054,526,528
2000,784,United Arab Emirates,Lebanon,9024,6464,2560
2000,462,Maldives,Lebanon,8,5,3
2000,144,Sri Lanka,Lebanon,181,122,59
2000,608,Philippines,Lebanon,140,71,69
2000,28,Antigua and Barbuda,Lebanon,45,22,23
2000,92,British Virgin Islands,Lebanon,16,12,4
2000,535,"Bonaire, Sint Eustatius and Saba",Lebanon,991,602,389
2000,192,Cuba,Lebanon,64,33,31
2000,212,Dominica,Lebanon,19,14,5
2000,214,Dominican Republic,Lebanon,876,536,340
2000,312,Guadeloupe,Lebanon,202,94,108
2000,630,Puerto Rico,Lebanon,39,19,20
2000,662,Saint Lucia,Lebanon,8,3,5
2000,84,Belize,Lebanon,38,28,10
2000,188,Costa Rica,Lebanon,68,46,22
2000,320,Guatemala,Lebanon,15,11,4
2000,484,Mexico,Lebanon,1698,928,770
2000,591,Panama,Lebanon,344,214,130
2000,32,Argentina,Lebanon,1570,796,774
2000,68,Bolivia (Plurinational State of),Lebanon,48,34,14
2000,76,Brazil,Lebanon,16128,9906,6222
2000,152,Chile,Lebanon,201,122,79
2000,170,Colombia,Lebanon,1020,657,363
2000,218,Ecuador,Lebanon,184,119,65
2000,604,Peru,Lebanon,51,30,21
2000,862,Venezuela (Bolivarian Republic of),Lebanon,6718,3928,2790
2000,36,Australia,Lebanon,79070,41310,37760
2000,112,Belarus,Lebanon,67,67,0
2000,100,Bulgaria,Lebanon,379,292,87
2000,203,Czechia,Lebanon,101,85,16
2000,348,Hungary,Lebanon,235,180,55
2000,616,Poland,Lebanon,341,274,67
2000,642,Romania,Lebanon,999,816,183
2000,643,Russian Federation,Lebanon,1225,1105,120
2000,703,Slovakia,Lebanon,68,59,9
2000,804,Ukraine,Lebanon,2019,1907,112
2000,208,Denmark,Lebanon,12396,6777,5619
2000,246,Finland,Lebanon,249,177,72
2000,352,Iceland,Lebanon,19,13,6
2000,372,Ireland,Lebanon,154,88,66
2000,428,Latvia,Lebanon,40,36,4
2000,440,Lithuania,Lebanon,104,95,9
2000,578,Norway,Lebanon,1189,696,493
2000,752,Sweden,Lebanon,20038,11046,8992
2000,826,United Kingdom,Lebanon,10106,5762,4344
2000,300,Greece,Lebanon,2207,1317,890
2000,380,Italy,Lebanon,4149,2493,1656
2000,470,Malta,Lebanon,44,23,21
2000,620,Portugal,Lebanon,58,32,26
2000,688,Serbia,Lebanon,48,27,21
2000,705,Slovenia,Lebanon,25,19,6
2000,724,Spain,Lebanon,2320,1717,603
2000,40,Austria,Lebanon,1275,780,495
2000,56,Belgium,Lebanon,2725,1662,1063
2000,250,France,Lebanon,41094,23575,17519
2000,276,Germany,Lebanon,49663,28256,21407
2000,442,Luxembourg,Lebanon,30,11,19
2000,528,Netherlands,Lebanon,2922,1719,1203
2000,756,Switzerland,Lebanon,4222,2866,1356
2000,124,Canada,Lebanon,67856,32735,35121
2000,840,United States of America,Lebanon,108599,59668,48931
2005,178,Congo,Lebanon,369,252,117
2005,266,Gabon,Lebanon,1410,986,424
2005,516,Namibia,Lebanon,48,29,19
2005,710,South Africa,Lebanon,512,273,239
2005,288,Ghana,Lebanon,823,491,332
2005,430,Liberia,Lebanon,1852,1297,555
2005,478,Mauritania,Lebanon,117,62,55
2005,686,Senegal,Lebanon,927,592,335
2005,694,Sierra Leone,Lebanon,749,460,289
2005,12,Algeria,Lebanon,966,397,569
2005,818,Egypt,Lebanon,2767,1256,1511
2005,434,Libya,Lebanon,8972,5624,3348
2005,504,Morocco,Lebanon,915,464,451
2005,51,Armenia,Lebanon,867,387,480
2005,48,Bahrain,Lebanon,1808,1226,582
2005,196,Cyprus,Lebanon,1832,979,853
2005,268,Georgia,Lebanon,9,4,5
2005,368,Iraq,Lebanon,1503,779,724
2005,376,Israel,Lebanon,5468,2308,3160
2005,400,Jordan,Lebanon,3221,1647,1574
2005,414,Kuwait,Lebanon,4455,2939,1516
2005,634,Qatar,Lebanon,3211,2364,847
2005,682,Saudi Arabia,Lebanon,74411,51156,23255
2005,275,State of Palestine,Lebanon,2789,1188,1601
2005,792,Turkey,Lebanon,1086,530,556
2005,784,United Arab Emirates,Lebanon,14856,10255,4601
2005,462,Maldives,Lebanon,8,5,3
2005,144,Sri Lanka,Lebanon,358,169,189
2005,608,Philippines,Lebanon,113,59,54
2005,28,Antigua and Barbuda,Lebanon,49,24,25
2005,92,British Virgin Islands,Lebanon,19,14,5
2005,535,"Bonaire, Sint Eustatius and Saba",Lebanon,1056,642,414
2005,192,Cuba,Lebanon,42,22,20
2005,212,Dominica,Lebanon,23,18,5
2005,214,Dominican Republic,Lebanon,511,317,194
2005,312,Guadeloupe,Lebanon,224,103,121
2005,630,Puerto Rico,Lebanon,30,15,15
2005,662,Saint Lucia,Lebanon,4,2,2
2005,534,Sint Maarten (Dutch part),Lebanon,154,93,61
2005,84,Belize,Lebanon,42,30,12
2005,188,Costa Rica,Lebanon,44,29,15
2005,320,Guatemala,Lebanon,19,15,4
2005,484,Mexico,Lebanon,1262,709,553
2005,591,Panama,Lebanon,386,232,154
2005,32,Argentina,Lebanon,1179,579,600
2005,68,Bolivia (Plurinational State of),Lebanon,40,29,11
2005,76,Brazil,Lebanon,14281,8894,5387
2005,152,Chile,Lebanon,301,185,116
2005,170,Colombia,Lebanon,973,630,343
2005,218,Ecuador,Lebanon,217,142,75
2005,604,Peru,Lebanon,60,35,25
2005,862,Venezuela (Bolivarian Republic of),Lebanon,6927,4157,2770
2005,36,Australia,Lebanon,84900,44530,40370
2005,112,Belarus,Lebanon,64,64,0
2005,100,Bulgaria,Lebanon,496,384,112
2005,203,Czechia,Lebanon,221,181,40
2005,348,Hungary,Lebanon,290,222,68
2005,616,Poland,Lebanon,363,292,71
2005,642,Romania,Lebanon,1032,840,192
2005,643,Russian Federation,Lebanon,1098,959,139
2005,703,Slovakia,Lebanon,77,66,11
2005,804,Ukraine,Lebanon,1844,1742,102
2005,208,Denmark,Lebanon,12571,6863,5708
2005,246,Finland,Lebanon,382,257,125
2005,352,Iceland,Lebanon,25,17,8
2005,372,Ireland,Lebanon,155,93,62
2005,428,Latvia,Lebanon,44,40,4
2005,440,Lithuania,Lebanon,83,76,7
2005,578,Norway,Lebanon,1413,798,615
2005,752,Sweden,Lebanon,21441,11805,9636
2005,826,United Kingdom,Lebanon,12180,7006,5174
2005,191,Croatia,Lebanon,33,25,8
2005,300,Greece,Lebanon,2152,1263,889
2005,380,Italy,Lebanon,5617,3497,2120
2005,470,Malta,Lebanon,54,29,25
2005,620,Portugal,Lebanon,67,40,27
2005,688,Serbia,Lebanon,48,27,21
2005,705,Slovenia,Lebanon,20,17,3
2005,724,Spain,Lebanon,2596,1826,770
2005,40,Austria,Lebanon,1425,858,567
2005,56,Belgium,Lebanon,3644,2224,1420
2005,250,France,Lebanon,42108,23989,18119
2005,276,Germany,Lebanon,57764,34393,23371
2005,442,Luxembourg,Lebanon,26,11,15
2005,528,Netherlands,Lebanon,3271,1878,1393
2005,756,Switzerland,Lebanon,4695,3105,1590
2005,124,Canada,Lebanon,72255,36911,35344
2005,840,United States of America,Lebanon,114895,63415,51480
2010,178,Congo,Lebanon,878,560,318
2010,266,Gabon,Lebanon,1633,1152,481
2010,516,Namibia,Lebanon,46,28,18
2010,710,South Africa,Lebanon,801,426,375
2010,288,Ghana,Lebanon,818,499,319
2010,430,Liberia,Lebanon,871,623,248
2010,478,Mauritania,Lebanon,118,64,54
2010,686,Senegal,Lebanon,1037,678,359
2010,694,Sierra Leone,Lebanon,679,418,261
2010,12,Algeria,Lebanon,1061,409,652
2010,818,Egypt,Lebanon,2986,1293,1693
2010,434,Libya,Lebanon,9816,6195,3621
2010,504,Morocco,Lebanon,1024,517,507
2010,51,Armenia,Lebanon,722,336,386
2010,48,Bahrain,Lebanon,3142,2120,1022
2010,196,Cyprus,Lebanon,3000,1621,1379
2010,268,Georgia,Lebanon,9,4,5
2010,368,Iraq,Lebanon,1518,831,687
2010,376,Israel,Lebanon,6043,2618,3425
2010,400,Jordan,Lebanon,4143,2232,1911
2010,414,Kuwait,Lebanon,5897,3843,2054
2010,634,Qatar,Lebanon,5865,4701,1164
2010,682,Saudi Arabia,Lebanon,96479,67906,28573
2010,275,State of Palestine,Lebanon,3344,1314,2030
2010,792,Turkey,Lebanon,1120,535,585
2010,784,United Arab Emirates,Lebanon,35184,24639,10545
2010,462,Maldives,Lebanon,9,7,2
2010,144,Sri Lanka,Lebanon,723,348,375
2010,608,Philippines,Lebanon,131,66,65
2010,28,Antigua and Barbuda,Lebanon,52,26,26
2010,92,British Virgin Islands,Lebanon,21,16,5
2010,535,"Bonaire, Sint Eustatius and Saba",Lebanon,57,45,12
2010,192,Cuba,Lebanon,23,12,11
2010,531,Curaçao,Lebanon,232,153,79
2010,212,Dominica,Lebanon,29,23,6
2010,214,Dominican Republic,Lebanon,142,96,46
2010,312,Guadeloupe,Lebanon,245,112,133
2010,630,Puerto Rico,Lebanon,18,8,10
2010,534,Sint Maarten (Dutch part),Lebanon,308,186,122
2010,84,Belize,Lebanon,46,33,13
2010,188,Costa Rica,Lebanon,87,58,29
2010,320,Guatemala,Lebanon,22,19,3
2010,484,Mexico,Lebanon,973,572,401
2010,591,Panama,Lebanon,448,264,184
2010,32,Argentina,Lebanon,788,363,425
2010,68,Bolivia (Plurinational State of),Lebanon,32,25,7
2010,76,Brazil,Lebanon,12229,7747,4482
2010,152,Chile,Lebanon,402,248,154
2010,170,Colombia,Lebanon,1095,718,377
2010,218,Ecuador,Lebanon,305,197,108
2010,604,Peru,Lebanon,67,40,27
2010,862,Venezuela (Bolivarian Republic of),Lebanon,7215,4439,2776
2010,36,Australia,Lebanon,89640,47157,42483
2010,112,Belarus,Lebanon,61,61,0
2010,100,Bulgaria,Lebanon,592,459,133
2010,203,Czechia,Lebanon,319,260,59
2010,348,Hungary,Lebanon,345,265,80
2010,616,Poland,Lebanon,397,319,78
2010,642,Romania,Lebanon,1256,1013,243
2010,643,Russian Federation,Lebanon,949,792,157
2010,703,Slovakia,Lebanon,86,74,12
2010,804,Ukraine,Lebanon,1759,1662,97
2010,208,Denmark,Lebanon,12520,6830,5690
2010,233,Estonia,Lebanon,10,10,0
2010,246,Finland,Lebanon,637,399,238
2010,352,Iceland,Lebanon,30,20,10
2010,372,Ireland,Lebanon,130,74,56
2010,428,Latvia,Lebanon,48,43,5
2010,440,Lithuania,Lebanon,52,46,6
2010,578,Norway,Lebanon,1680,938,742
2010,752,Sweden,Lebanon,24116,13356,10760
2010,826,United Kingdom,Lebanon,12831,7493,5338
2010,191,Croatia,Lebanon,65,50,15
2010,300,Greece,Lebanon,2181,1259,922
2010,380,Italy,Lebanon,7206,4608,2598
2010,470,Malta,Lebanon,52,36,16
2010,620,Portugal,Lebanon,65,40,25
2010,688,Serbia,Lebanon,47,26,21
2010,705,Slovenia,Lebanon,24,20,4
2010,724,Spain,Lebanon,3125,2133,992
2010,40,Austria,Lebanon,1575,937,638
2010,56,Belgium,Lebanon,5221,3218,2003
2010,250,France,Lebanon,44287,24982,19305
2010,276,Germany,Lebanon,64346,39377,24969
2010,442,Luxembourg,Lebanon,23,11,12
2010,528,Netherlands,Lebanon,3387,1934,1453
2010,756,Switzerland,Lebanon,5579,3588,1991
2010,124,Canada,Lebanon,81105,43460,37645
2010,840,United States of America,Lebanon,124883,68157,56726
2015,178,Congo,Lebanon,1167,726,441
2015,266,Gabon,Lebanon,2284,1705,579
2015,516,Namibia,Lebanon,45,28,17
2015,710,South Africa,Lebanon,1444,734,710
2015,288,Ghana,Lebanon,1006,614,392
2015,324,Guinea,Lebanon,156,126,30
2015,430,Liberia,Lebanon,999,712,287
2015,478,Mauritania,Lebanon,118,65,53
2015,686,Senegal,Lebanon,1106,723,383
2015,694,Sierra Leone,Lebanon,617,378,239
2015,12,Algeria,Lebanon,1171,451,720
2015,818,Egypt,Lebanon,2214,1122,1092
2015,434,Libya,Lebanon,11067,6929,4138
2015,504,Morocco,Lebanon,1334,671,663
2015,51,Armenia,Lebanon,853,397,456
2015,48,Bahrain,Lebanon,4508,3020,1488
2015,196,Cyprus,Lebanon,2882,1566,1316
2015,268,Georgia,Lebanon,9,4,5
2015,368,Iraq,Lebanon,1522,939,583
2015,376,Israel,Lebanon,6232,2682,3550
2015,400,Jordan,Lebanon,1783,775,1008
2015,414,Kuwait,Lebanon,11532,6962,4570
2015,634,Qatar,Lebanon,8274,6740,1534
2015,682,Saudi Arabia,Lebanon,123277,85397,37880
2015,275,State of Palestine,Lebanon,3311,1297,2014
2015,792,Turkey,Lebanon,1135,528,607
2015,784,United Arab Emirates,Lebanon,38446,26469,11977
2015,462,Maldives,Lebanon,10,9,1
2015,144,Sri Lanka,Lebanon,736,347,389
2015,608,Philippines,Lebanon,134,68,66
2015,28,Antigua and Barbuda,Lebanon,55,27,28
2015,92,British Virgin Islands,Lebanon,23,18,5
2015,535,"Bonaire, Sint Eustatius and Saba",Lebanon,64,51,13
2015,192,Cuba,Lebanon,18,10,8
2015,531,Curaçao,Lebanon,252,167,85
2015,212,Dominica,Lebanon,34,27,7
2015,214,Dominican Republic,Lebanon,149,101,48
2015,312,Guadeloupe,Lebanon,254,115,139
2015,630,Puerto Rico,Lebanon,18,9,9
2015,534,Sint Maarten (Dutch part),Lebanon,321,194,127
2015,84,Belize,Lebanon,54,39,15
2015,188,Costa Rica,Lebanon,88,59,29
2015,320,Guatemala,Lebanon,25,22,3
2015,484,Mexico,Lebanon,534,320,214
2015,591,Panama,Lebanon,526,310,216
2015,32,Argentina,Lebanon,791,364,427
2015,68,Bolivia (Plurinational State of),Lebanon,37,29,8
2015,76,Brazil,Lebanon,14726,9329,5397
2015,152,Chile,Lebanon,609,371,238
2015,170,Colombia,Lebanon,1225,808,417
2015,218,Ecuador,Lebanon,443,285,158
2015,604,Peru,Lebanon,71,44,27
2015,862,Venezuela (Bolivarian Republic of),Lebanon,7486,4566,2920
2015,36,Australia,Lebanon,93290,49037,44253
2015,112,Belarus,Lebanon,65,65,0
2015,100,Bulgaria,Lebanon,755,557,198
2015,203,Czechia,Lebanon,345,274,71
2015,348,Hungary,Lebanon,394,291,103
2015,616,Poland,Lebanon,382,309,73
2015,642,Romania,Lebanon,806,638,168
2015,643,Russian Federation,Lebanon,968,807,161
2015,703,Slovakia,Lebanon,111,95,16
2015,804,Ukraine,Lebanon,1764,1667,97
2015,208,Denmark,Lebanon,13593,7447,6146
2015,233,Estonia,Lebanon,18,16,2
2015,246,Finland,Lebanon,672,405,267
2015,352,Iceland,Lebanon,30,20,10
2015,372,Ireland,Lebanon,133,75,58
2015,428,Latvia,Lebanon,29,26,3
2015,440,Lithuania,Lebanon,31,23,8
2015,578,Norway,Lebanon,1866,1035,831
2015,752,Sweden,Lebanon,26159,14496,11663
2015,826,United Kingdom,Lebanon,16408,9380,7028
2015,191,Croatia,Lebanon,65,50,15
2015,300,Greece,Lebanon,2047,1145,902
2015,380,Italy,Lebanon,6946,4358,2588
2015,470,Malta,Lebanon,89,65,24
2015,620,Portugal,Lebanon,73,43,30
2015,688,Serbia,Lebanon,45,25,20
2015,705,Slovenia,Lebanon,23,21,2
2015,724,Spain,Lebanon,3341,2218,1123
2015,40,Austria,Lebanon,1841,1099,742
2015,56,Belgium,Lebanon,6349,3896,2453
2015,250,France,Lebanon,49060,27087,21973
2015,276,Germany,Lebanon,67045,40967,26078
2015,442,Luxembourg,Lebanon,35,17,18
2015,528,Netherlands,Lebanon,3475,1957,1518
2015,756,Switzerland,Lebanon,6332,3958,2374
2015,124,Canada,Lebanon,88200,46986,41214
2015,840,United States of America,Lebanon,119613,64873,54740
2019,178,Congo,Lebanon,1202,748,454
2019,266,Gabon,Lebanon,2481,1852,629
2019,516,Namibia,Lebanon,47,30,17
2019,710,South Africa,Lebanon,1618,824,794
2019,288,Ghana,Lebanon,1132,692,440
2019,324,Guinea,Lebanon,148,120,28
2019,430,Liberia,Lebanon,829,591,238
2019,478,Mauritania,Lebanon,122,67,55
2019,686,Senegal,Lebanon,1142,747,395
2019,694,Sierra Leone,Lebanon,593,363,230
2019,12,Algeria,Lebanon,1217,469,748
2019,818,Egypt,Lebanon,3155,1415,1740
2019,434,Libya,Lebanon,11742,7352,4390
2019,504,Morocco,Lebanon,1422,715,707
2019,51,Armenia,Lebanon,848,399,449
2019,48,Bahrain,Lebanon,4745,3179,1566
2019,196,Cyprus,Lebanon,2880,1579,1301
2019,268,Georgia,Lebanon,9,4,5
2019,368,Iraq,Lebanon,1558,961,597
2019,376,Israel,Lebanon,6060,2608,3452
2019,400,Jordan,Lebanon,1917,833,1084
2019,414,Kuwait,Lebanon,12210,7371,4839
2019,634,Qatar,Lebanon,8439,6763,1676
2019,682,Saudi Arabia,Lebanon,150183,103019,47164
2019,275,State of Palestine,Lebanon,3288,1288,2000
2019,792,Turkey,Lebanon,1534,722,812
2019,784,United Arab Emirates,Lebanon,41293,28427,12866
2019,462,Maldives,Lebanon,10,9,1
2019,144,Sri Lanka,Lebanon,741,349,392
2019,608,Philippines,Lebanon,138,70,68
2019,28,Antigua and Barbuda,Lebanon,57,28,29
2019,92,British Virgin Islands,Lebanon,24,19,5
2019,535,"Bonaire, Sint Eustatius and Saba",Lebanon,76,61,15
2019,192,Cuba,Lebanon,16,9,7
2019,531,Curaçao,Lebanon,273,181,92
2019,212,Dominica,Lebanon,34,27,7
2019,214,Dominican Republic,Lebanon,153,104,49
2019,312,Guadeloupe,Lebanon,257,116,141
2019,630,Puerto Rico,Lebanon,17,9,8
2019,534,Sint Maarten (Dutch part),Lebanon,332,201,131
2019,84,Belize,Lebanon,59,43,16
2019,188,Costa Rica,Lebanon,89,60,29
2019,320,Guatemala,Lebanon,25,22,3
2019,484,Mexico,Lebanon,550,330,220
2019,591,Panama,Lebanon,559,330,229
2019,32,Argentina,Lebanon,804,369,435
2019,68,Bolivia (Plurinational State of),Lebanon,40,32,8
2019,76,Brazil,Lebanon,16584,10506,6078
2019,152,Chile,Lebanon,813,478,335
2019,170,Colombia,Lebanon,1253,827,426
2019,218,Ecuador,Lebanon,436,281,155
2019,604,Peru,Lebanon,84,54,30
2019,862,Venezuela (Bolivarian Republic of),Lebanon,7332,4459,2873
2019,36,Australia,Lebanon,99705,52500,47205
2019,112,Belarus,Lebanon,64,64,0
2019,100,Bulgaria,Lebanon,989,710,279
2019,203,Czechia,Lebanon,382,296,86
2019,348,Hungary,Lebanon,459,317,142
2019,616,Poland,Lebanon,404,330,74
2019,642,Romania,Lebanon,580,443,137
2019,643,Russian Federation,Lebanon,967,807,160
2019,703,Slovakia,Lebanon,142,118,24
2019,804,Ukraine,Lebanon,1781,1684,97
2019,208,Denmark,Lebanon,13667,7371,6296
2019,233,Estonia,Lebanon,36,29,7
2019,246,Finland,Lebanon,874,517,357
2019,352,Iceland,Lebanon,45,31,14
2019,372,Ireland,Lebanon,146,83,63
2019,428,Latvia,Lebanon,31,28,3
2019,440,Lithuania,Lebanon,11,1,10
2019,578,Norway,Lebanon,2465,1331,1134
2019,752,Sweden,Lebanon,28815,15827,12988
2019,826,United Kingdom,Lebanon,18633,10673,7960
2019,191,Croatia,Lebanon,60,47,13
2019,300,Greece,Lebanon,1999,1152,847
2019,380,Italy,Lebanon,7469,4732,2737
2019,470,Malta,Lebanon,143,105,38
2019,620,Portugal,Lebanon,219,132,87
2019,688,Serbia,Lebanon,45,25,20
2019,705,Slovenia,Lebanon,25,23,2
2019,724,Spain,Lebanon,3461,2270,1191
2019,40,Austria,Lebanon,2173,1313,860
2019,56,Belgium,Lebanon,7371,4488,2883
2019,250,France,Lebanon,51930,28619,23311
2019,276,Germany,Lebanon,73546,45318,28228
2019,442,Luxembourg,Lebanon,325,212,113
2019,528,Netherlands,Lebanon,4250,2367,1883
2019,756,Switzerland,Lebanon,6925,4282,2643
2019,124,Canada,Lebanon,94516,50351,44165
2019,840,United States of America,Lebanon,127280,68922,58358
1990,508,Mozambique,Lesotho,2875,1420,1455
1990,834,United Republic of Tanzania,Lesotho,79,53,26
1990,72,Botswana,Lesotho,505,249,256
1990,748,Eswatini,Lesotho,293,178,115
1990,516,Namibia,Lesotho,186,89,97
1990,710,South Africa,Lesotho,187019,143738,43281
1990,68,Bolivia (Plurinational State of),Lesotho,6,4,2
1990,152,Chile,Lesotho,11,6,5
1990,36,Australia,Lesotho,43,26,17
1990,203,Czechia,Lesotho,1,1,0
1990,208,Denmark,Lesotho,31,11,20
1990,372,Ireland,Lesotho,7,3,4
1990,752,Sweden,Lesotho,16,5,11
1990,826,United Kingdom,Lesotho,45,25,20
1990,300,Greece,Lesotho,3,1,2
1990,40,Austria,Lesotho,3,0,3
1990,56,Belgium,Lesotho,8,3,5
1990,250,France,Lesotho,10,6,4
1990,528,Netherlands,Lesotho,41,22,19
1990,756,Switzerland,Lesotho,80,39,41
1990,124,Canada,Lesotho,77,37,40
1995,508,Mozambique,Lesotho,3955,1962,1993
1995,834,United Republic of Tanzania,Lesotho,106,72,34
1995,72,Botswana,Lesotho,816,431,385
1995,748,Eswatini,Lesotho,111,59,52
1995,516,Namibia,Lesotho,177,85,92
1995,710,South Africa,Lesotho,130897,91247,39650
1995,68,Bolivia (Plurinational State of),Lesotho,4,2,2
1995,152,Chile,Lesotho,10,7,3
1995,36,Australia,Lesotho,32,24,8
1995,203,Czechia,Lesotho,2,2,0
1995,348,Hungary,Lesotho,2,1,1
1995,208,Denmark,Lesotho,36,12,24
1995,372,Ireland,Lesotho,20,8,12
1995,752,Sweden,Lesotho,19,6,13
1995,826,United Kingdom,Lesotho,180,76,104
1995,300,Greece,Lesotho,2,0,2
1995,380,Italy,Lesotho,3,2,1
1995,40,Austria,Lesotho,3,0,3
1995,56,Belgium,Lesotho,8,3,5
1995,250,France,Lesotho,10,6,4
1995,528,Netherlands,Lesotho,60,32,28
1995,756,Switzerland,Lesotho,66,32,34
1995,124,Canada,Lesotho,84,40,44
2000,508,Mozambique,Lesotho,4601,2207,2394
2000,834,United Republic of Tanzania,Lesotho,113,76,37
2000,72,Botswana,Lesotho,1212,657,555
2000,748,Eswatini,Lesotho,131,33,98
2000,516,Namibia,Lesotho,166,80,86
2000,710,South Africa,Lesotho,113578,63824,49754
2000,68,Bolivia (Plurinational State of),Lesotho,1,0,1
2000,152,Chile,Lesotho,10,6,4
2000,36,Australia,Lesotho,70,35,35
2000,203,Czechia,Lesotho,3,3,0
2000,348,Hungary,Lesotho,4,3,1
2000,208,Denmark,Lesotho,40,12,28
2000,372,Ireland,Lesotho,45,20,25
2000,752,Sweden,Lesotho,21,6,15
2000,826,United Kingdom,Lesotho,320,129,191
2000,300,Greece,Lesotho,2,0,2
2000,380,Italy,Lesotho,6,4,2
2000,40,Austria,Lesotho,3,0,3
2000,56,Belgium,Lesotho,8,3,5
2000,250,France,Lesotho,10,6,4
2000,528,Netherlands,Lesotho,83,42,41
2000,756,Switzerland,Lesotho,54,26,28
2000,124,Canada,Lesotho,94,45,49
2005,508,Mozambique,Lesotho,6224,2684,3540
2005,834,United Republic of Tanzania,Lesotho,134,93,41
2005,72,Botswana,Lesotho,1829,981,848
2005,748,Eswatini,Lesotho,167,30,137
2005,516,Namibia,Lesotho,131,63,68
2005,710,South Africa,Lesotho,149432,81104,68328
2005,68,Bolivia (Plurinational State of),Lesotho,1,0,1
2005,152,Chile,Lesotho,15,10,5
2005,36,Australia,Lesotho,90,45,45
2005,203,Czechia,Lesotho,3,3,0
2005,348,Hungary,Lesotho,5,4,1
2005,208,Denmark,Lesotho,42,13,29
2005,372,Ireland,Lesotho,45,22,23
2005,752,Sweden,Lesotho,20,5,15
2005,826,United Kingdom,Lesotho,517,206,311
2005,300,Greece,Lesotho,1,0,1
2005,380,Italy,Lesotho,19,10,9
2005,40,Austria,Lesotho,4,0,4
2005,56,Belgium,Lesotho,10,3,7
2005,250,France,Lesotho,60,33,27
2005,528,Netherlands,Lesotho,89,43,46
2005,756,Switzerland,Lesotho,62,27,35
2005,124,Canada,Lesotho,95,43,52
2010,508,Mozambique,Lesotho,7207,3107,4100
2010,834,United Republic of Tanzania,Lesotho,140,98,42
2010,72,Botswana,Lesotho,240,70,170
2010,748,Eswatini,Lesotho,198,24,174
2010,516,Namibia,Lesotho,126,61,65
2010,710,South Africa,Lesotho,234089,126646,107443
2010,152,Chile,Lesotho,20,13,7
2010,36,Australia,Lesotho,110,57,53
2010,203,Czechia,Lesotho,3,3,0
2010,348,Hungary,Lesotho,6,5,1
2010,208,Denmark,Lesotho,43,15,28
2010,372,Ireland,Lesotho,38,17,21
2010,752,Sweden,Lesotho,26,11,15
2010,826,United Kingdom,Lesotho,544,224,320
2010,380,Italy,Lesotho,29,13,16
2010,40,Austria,Lesotho,4,0,4
2010,56,Belgium,Lesotho,16,3,13
2010,250,France,Lesotho,45,27,18
2010,528,Netherlands,Lesotho,104,53,51
2010,756,Switzerland,Lesotho,72,30,42
2010,124,Canada,Lesotho,90,39,51
2015,508,Mozambique,Lesotho,7567,3263,4304
2015,834,United Republic of Tanzania,Lesotho,149,74,75
2015,72,Botswana,Lesotho,261,76,185
2015,748,Eswatini,Lesotho,221,23,198
2015,516,Namibia,Lesotho,123,60,63
2015,710,South Africa,Lesotho,295581,153005,142576
2015,324,Guinea,Lesotho,32,22,10
2015,152,Chile,Lesotho,30,20,10
2015,36,Australia,Lesotho,150,83,67
2015,203,Czechia,Lesotho,2,2,0
2015,348,Hungary,Lesotho,3,3,0
2015,208,Denmark,Lesotho,50,15,35
2015,372,Ireland,Lesotho,39,17,22
2015,752,Sweden,Lesotho,57,26,31
2015,826,United Kingdom,Lesotho,695,274,421
2015,380,Italy,Lesotho,24,12,12
2015,40,Austria,Lesotho,4,0,4
2015,56,Belgium,Lesotho,17,3,14
2015,250,France,Lesotho,50,30,20
2015,528,Netherlands,Lesotho,134,81,53
2015,756,Switzerland,Lesotho,72,30,42
2015,124,Canada,Lesotho,104,60,44
2019,508,Mozambique,Lesotho,7869,3393,4476
2019,834,United Republic of Tanzania,Lesotho,133,66,67
2019,72,Botswana,Lesotho,279,81,198
2019,748,Eswatini,Lesotho,220,22,198
2019,516,Namibia,Lesotho,130,64,66
2019,710,South Africa,Lesotho,331312,171654,159658
2019,324,Guinea,Lesotho,30,21,9
2019,152,Chile,Lesotho,40,26,14
2019,36,Australia,Lesotho,158,82,76
2019,203,Czechia,Lesotho,2,2,0
2019,348,Hungary,Lesotho,3,2,1
2019,208,Denmark,Lesotho,50,20,30
2019,372,Ireland,Lesotho,42,18,24
2019,752,Sweden,Lesotho,77,40,37
2019,826,United Kingdom,Lesotho,789,313,476
2019,380,Italy,Lesotho,26,12,14
2019,40,Austria,Lesotho,4,0,4
2019,56,Belgium,Lesotho,15,3,12
2019,250,France,Lesotho,52,31,21
2019,528,Netherlands,Lesotho,154,94,60
2019,756,Switzerland,Lesotho,85,35,50
2019,124,Canada,Lesotho,111,64,47
1990,748,Eswatini,Liberia,2,1,1
1990,710,South Africa,Liberia,308,94,214
1990,384,Côte d'Ivoire,Liberia,2793,1249,1544
1990,270,Gambia,Liberia,153,86,67
1990,288,Ghana,Liberia,9824,5296,4528
1990,324,Guinea,Liberia,342691,167772,174919
1990,624,Guinea-Bissau,Liberia,3906,2367,1539
1990,466,Mali,Liberia,586,296,290
1990,566,Nigeria,Liberia,7823,4389,3434
1990,694,Sierra Leone,Liberia,130316,68943,61373
1990,768,Togo,Liberia,81,39,42
1990,818,Egypt,Liberia,40,37,3
1990,68,Bolivia (Plurinational State of),Liberia,1,0,1
1990,152,Chile,Liberia,8,6,2
1990,36,Australia,Liberia,63,39,24
1990,100,Bulgaria,Liberia,1,1,0
1990,203,Czechia,Liberia,2,1,1
1990,348,Hungary,Liberia,1,1,0
1990,208,Denmark,Liberia,50,20,30
1990,246,Finland,Liberia,4,3,1
1990,372,Ireland,Liberia,21,12,9
1990,578,Norway,Liberia,66,33,33
1990,752,Sweden,Liberia,438,212,226
1990,826,United Kingdom,Liberia,219,148,71
1990,300,Greece,Liberia,35,20,15
1990,380,Italy,Liberia,4,2,2
1990,620,Portugal,Liberia,8,7,1
1990,724,Spain,Liberia,620,474,146
1990,40,Austria,Liberia,150,125,25
1990,56,Belgium,Liberia,371,260,111
1990,250,France,Liberia,803,493,310
1990,276,Germany,Liberia,2666,1863,803
1990,528,Netherlands,Liberia,980,697,283
1990,756,Switzerland,Liberia,272,166,106
1990,124,Canada,Liberia,125,61,64
1990,840,United States of America,Liberia,11455,5432,6023
1995,748,Eswatini,Liberia,5,3,2
1995,710,South Africa,Liberia,192,70,122
1995,384,Côte d'Ivoire,Liberia,22779,10049,12730
1995,270,Gambia,Liberia,286,156,130
1995,288,Ghana,Liberia,14538,7838,6700
1995,324,Guinea,Liberia,449575,220292,229283
1995,624,Guinea-Bissau,Liberia,2407,1469,938
1995,466,Mali,Liberia,612,309,303
1995,566,Nigeria,Liberia,7931,4422,3509
1995,686,Senegal,Liberia,220,97,123
1995,694,Sierra Leone,Liberia,8925,4282,4643
1995,768,Togo,Liberia,91,44,47
1995,818,Egypt,Liberia,36,27,9
1995,68,Bolivia (Plurinational State of),Liberia,1,0,1
1995,152,Chile,Liberia,6,4,2
1995,36,Australia,Liberia,83,56,27
1995,100,Bulgaria,Liberia,2,1,1
1995,203,Czechia,Liberia,3,1,2
1995,348,Hungary,Liberia,12,8,4
1995,208,Denmark,Liberia,78,39,39
1995,246,Finland,Liberia,19,16,3
1995,372,Ireland,Liberia,57,31,26
1995,578,Norway,Liberia,71,37,34
1995,752,Sweden,Liberia,520,250,270
1995,826,United Kingdom,Liberia,864,501,363
1995,300,Greece,Liberia,28,16,12
1995,380,Italy,Liberia,108,53,55
1995,620,Portugal,Liberia,18,16,2
1995,724,Spain,Liberia,870,674,196
1995,40,Austria,Liberia,170,142,28
1995,56,Belgium,Liberia,369,258,111
1995,250,France,Liberia,829,503,326
1995,276,Germany,Liberia,2891,2249,642
1995,528,Netherlands,Liberia,1443,1017,426
1995,756,Switzerland,Liberia,286,172,114
1995,124,Canada,Liberia,397,192,205
1995,840,United States of America,Liberia,25579,12300,13279
2000,748,Eswatini,Liberia,18,9,9
2000,710,South Africa,Liberia,254,130,124
2000,384,Côte d'Ivoire,Liberia,23736,10464,13272
2000,270,Gambia,Liberia,173,93,80
2000,288,Ghana,Liberia,13084,7054,6030
2000,324,Guinea,Liberia,138141,66999,71142
2000,624,Guinea-Bissau,Liberia,908,572,336
2000,466,Mali,Liberia,562,285,277
2000,566,Nigeria,Liberia,8358,4630,3728
2000,686,Senegal,Liberia,436,192,244
2000,694,Sierra Leone,Liberia,10813,5291,5522
2000,768,Togo,Liberia,102,50,52
2000,818,Egypt,Liberia,35,20,15
2000,764,Thailand,Liberia,1,0,1
2000,68,Bolivia (Plurinational State of),Liberia,1,0,1
2000,152,Chile,Liberia,5,3,2
2000,36,Australia,Liberia,110,74,36
2000,100,Bulgaria,Liberia,3,2,1
2000,203,Czechia,Liberia,4,1,3
2000,348,Hungary,Liberia,23,16,7
2000,208,Denmark,Liberia,106,58,48
2000,246,Finland,Liberia,34,29,5
2000,372,Ireland,Liberia,125,71,54
2000,578,Norway,Liberia,70,34,36
2000,752,Sweden,Liberia,558,266,292
2000,826,United Kingdom,Liberia,1524,861,663
2000,300,Greece,Liberia,21,12,9
2000,380,Italy,Liberia,212,105,107
2000,620,Portugal,Liberia,30,25,5
2000,724,Spain,Liberia,1495,1168,327
2000,40,Austria,Liberia,189,159,30
2000,56,Belgium,Liberia,358,251,107
2000,250,France,Liberia,855,514,341
2000,276,Germany,Liberia,3116,2635,481
2000,528,Netherlands,Liberia,1955,1369,586
2000,756,Switzerland,Liberia,303,180,123
2000,124,Canada,Liberia,679,328,351
2000,840,United States of America,Liberia,40020,19348,20672
2005,120,Cameroon,Liberia,4281,2045,2236
2005,748,Eswatini,Liberia,29,15,14
2005,710,South Africa,Liberia,415,154,261
2005,384,Côte d'Ivoire,Liberia,24848,10954,13894
2005,270,Gambia,Liberia,968,513,455
2005,288,Ghana,Liberia,50459,27205,23254
2005,324,Guinea,Liberia,98658,44397,54261
2005,624,Guinea-Bissau,Liberia,878,554,324
2005,466,Mali,Liberia,2292,1127,1165
2005,566,Nigeria,Liberia,16603,9668,6935
2005,686,Senegal,Liberia,663,297,366
2005,694,Sierra Leone,Liberia,79156,38163,40993
2005,768,Togo,Liberia,114,56,58
2005,818,Egypt,Liberia,42,25,17
2005,68,Bolivia (Plurinational State of),Liberia,2,1,1
2005,152,Chile,Liberia,7,5,2
2005,36,Australia,Liberia,1360,675,685
2005,100,Bulgaria,Liberia,4,2,2
2005,203,Czechia,Liberia,7,4,3
2005,348,Hungary,Liberia,28,20,8
2005,208,Denmark,Liberia,130,63,67
2005,246,Finland,Liberia,71,51,20
2005,372,Ireland,Liberia,125,74,51
2005,578,Norway,Liberia,854,405,449
2005,752,Sweden,Liberia,737,361,376
2005,826,United Kingdom,Liberia,2376,1348,1028
2005,300,Greece,Liberia,27,15,12
2005,380,Italy,Liberia,1109,880,229
2005,620,Portugal,Liberia,29,27,2
2005,724,Spain,Liberia,1255,911,344
2005,40,Austria,Liberia,212,178,34
2005,56,Belgium,Liberia,524,350,174
2005,250,France,Liberia,645,362,283
2005,276,Germany,Liberia,2291,1795,496
2005,528,Netherlands,Liberia,2368,1575,793
2005,756,Switzerland,Liberia,336,194,142
2005,124,Canada,Liberia,1372,717,655
2005,840,United States of America,Liberia,55724,27099,28625
2010,120,Cameroon,Liberia,3407,1707,1700
2010,748,Eswatini,Liberia,40,21,19
2010,710,South Africa,Liberia,649,240,409
2010,384,Côte d'Ivoire,Liberia,25960,11438,14522
2010,270,Gambia,Liberia,853,451,402
2010,288,Ghana,Liberia,24718,13176,11542
2010,324,Guinea,Liberia,29367,13216,16151
2010,624,Guinea-Bissau,Liberia,847,536,311
2010,466,Mali,Liberia,918,400,518
2010,566,Nigeria,Liberia,16936,9862,7074
2010,686,Senegal,Liberia,592,306,286
2010,694,Sierra Leone,Liberia,22552,11159,11393
2010,768,Togo,Liberia,150,76,74
2010,818,Egypt,Liberia,45,26,19
2010,764,Thailand,Liberia,1,1,0
2010,68,Bolivia (Plurinational State of),Liberia,2,1,1
2010,76,Brazil,Liberia,34,19,15
2010,152,Chile,Liberia,10,7,3
2010,36,Australia,Liberia,2930,1399,1531
2010,100,Bulgaria,Liberia,5,3,2
2010,203,Czechia,Liberia,9,6,3
2010,348,Hungary,Liberia,33,24,9
2010,208,Denmark,Liberia,151,67,84
2010,246,Finland,Liberia,135,88,47
2010,372,Ireland,Liberia,105,59,46
2010,578,Norway,Liberia,897,433,464
2010,752,Sweden,Liberia,873,420,453
2010,826,United Kingdom,Liberia,2503,1443,1060
2010,300,Greece,Liberia,33,19,14
2010,380,Italy,Liberia,2160,1791,369
2010,620,Portugal,Liberia,25,25,0
2010,705,Slovenia,Liberia,3,2,1
2010,724,Spain,Liberia,914,640,274
2010,40,Austria,Liberia,234,196,38
2010,56,Belgium,Liberia,692,460,232
2010,250,France,Liberia,737,436,301
2010,276,Germany,Liberia,1593,1085,508
2010,528,Netherlands,Liberia,2070,1279,791
2010,756,Switzerland,Liberia,401,220,181
2010,124,Canada,Liberia,2125,1140,985
2010,840,United States of America,Liberia,73547,35247,38300
2015,120,Cameroon,Liberia,4351,1887,2464
2015,748,Eswatini,Liberia,46,22,24
2015,710,South Africa,Liberia,1170,395,775
2015,384,Côte d'Ivoire,Liberia,27072,11928,15144
2015,270,Gambia,Liberia,968,511,457
2015,288,Ghana,Liberia,30418,16211,14207
2015,324,Guinea,Liberia,2765,1537,1228
2015,624,Guinea-Bissau,Liberia,898,565,333
2015,466,Mali,Liberia,1137,496,641
2015,566,Nigeria,Liberia,20541,11270,9271
2015,686,Senegal,Liberia,439,226,213
2015,694,Sierra Leone,Liberia,10917,5765,5152
2015,768,Togo,Liberia,168,85,83
2015,818,Egypt,Liberia,33,21,12
2015,764,Thailand,Liberia,1,1,0
2015,68,Bolivia (Plurinational State of),Liberia,2,1,1
2015,76,Brazil,Liberia,41,23,18
2015,152,Chile,Liberia,15,11,4
2015,36,Australia,Liberia,3520,1699,1821
2015,100,Bulgaria,Liberia,5,4,1
2015,203,Czechia,Liberia,10,8,2
2015,348,Hungary,Liberia,35,25,10
2015,208,Denmark,Liberia,181,79,102
2015,246,Finland,Liberia,131,83,48
2015,352,Iceland,Liberia,1,0,1
2015,372,Ireland,Liberia,107,59,48
2015,578,Norway,Liberia,932,449,483
2015,752,Sweden,Liberia,954,474,480
2015,826,United Kingdom,Liberia,3200,1805,1395
2015,300,Greece,Liberia,30,17,13
2015,380,Italy,Liberia,1808,1481,327
2015,620,Portugal,Liberia,28,27,1
2015,705,Slovenia,Liberia,4,4,0
2015,724,Spain,Liberia,819,551,268
2015,40,Austria,Liberia,274,229,45
2015,56,Belgium,Liberia,916,582,334
2015,250,France,Liberia,816,474,342
2015,276,Germany,Liberia,1660,1129,531
2015,528,Netherlands,Liberia,1937,1172,765
2015,756,Switzerland,Liberia,424,235,189
2015,124,Canada,Liberia,2459,1142,1317
2015,840,United States of America,Liberia,85482,40739,44743
2019,120,Cameroon,Liberia,4328,1879,2449
2019,748,Eswatini,Liberia,45,21,24
2019,710,South Africa,Liberia,1310,444,866
2019,384,Côte d'Ivoire,Liberia,27962,12321,15641
2019,270,Gambia,Liberia,1082,571,511
2019,288,Ghana,Liberia,34234,18279,15955
2019,324,Guinea,Liberia,2639,1467,1172
2019,624,Guinea-Bissau,Liberia,952,605,347
2019,466,Mali,Liberia,1266,553,713
2019,566,Nigeria,Liberia,21522,11809,9713
2019,686,Senegal,Liberia,452,233,219
2019,694,Sierra Leone,Liberia,9393,5153,4240
2019,768,Togo,Liberia,169,86,83
2019,818,Egypt,Liberia,47,28,19
2019,764,Thailand,Liberia,1,1,0
2019,68,Bolivia (Plurinational State of),Liberia,2,1,1
2019,76,Brazil,Liberia,46,26,20
2019,152,Chile,Liberia,20,15,5
2019,36,Australia,Liberia,3904,1864,2040
2019,100,Bulgaria,Liberia,6,5,1
2019,203,Czechia,Liberia,12,9,3
2019,348,Hungary,Liberia,29,21,8
2019,208,Denmark,Liberia,169,76,93
2019,246,Finland,Liberia,143,90,53
2019,352,Iceland,Liberia,2,1,1
2019,372,Ireland,Liberia,117,65,52
2019,578,Norway,Liberia,1020,495,525
2019,752,Sweden,Liberia,1001,505,496
2019,826,United Kingdom,Liberia,3633,2053,1580
2019,300,Greece,Liberia,29,17,12
2019,380,Italy,Liberia,1677,1359,318
2019,620,Portugal,Liberia,28,27,1
2019,705,Slovenia,Liberia,10,7,3
2019,724,Spain,Liberia,848,564,284
2019,40,Austria,Liberia,323,271,52
2019,56,Belgium,Liberia,983,621,362
2019,250,France,Liberia,863,501,362
2019,276,Germany,Liberia,1820,1332,488
2019,528,Netherlands,Liberia,1893,1141,752
2019,756,Switzerland,Liberia,422,235,187
2019,124,Canada,Liberia,2635,1224,1411
2019,840,United States of America,Liberia,92311,43473,48838
1990,800,Uganda,Libya,49,20,29
1990,148,Chad,Libya,1096,592,504
1990,516,Namibia,Libya,52,25,27
1990,710,South Africa,Libya,158,120,38
1990,384,Côte d'Ivoire,Libya,5379,3192,2187
1990,478,Mauritania,Libya,124,55,69
1990,562,Niger,Libya,100,59,41
1990,12,Algeria,Libya,1982,1123,859
1990,818,Egypt,Libya,2936,1611,1325
1990,504,Morocco,Libya,803,425,378
1990,729,Sudan,Libya,2388,1228,1160
1990,788,Tunisia,Libya,1224,609,615
1990,196,Cyprus,Libya,57,34,23
1990,376,Israel,Libya,19180,9295,9885
1990,400,Jordan,Libya,338,181,157
1990,422,Lebanon,Libya,154,82,72
1990,792,Turkey,Libya,743,440,303
1990,360,Indonesia,Libya,13860,6657,7203
1990,608,Philippines,Libya,32,21,11
1990,188,Costa Rica,Libya,12,6,6
1990,591,Panama,Libya,11,6,5
1990,32,Argentina,Libya,113,68,45
1990,68,Bolivia (Plurinational State of),Libya,2,2,0
1990,152,Chile,Libya,17,7,10
1990,862,Venezuela (Bolivarian Republic of),Libya,124,77,47
1990,36,Australia,Libya,1268,689,579
1990,100,Bulgaria,Libya,34,22,12
1990,203,Czechia,Libya,25,18,7
1990,348,Hungary,Libya,332,148,184
1990,616,Poland,Libya,433,265,168
1990,643,Russian Federation,Libya,373,183,190
1990,703,Slovakia,Libya,7,6,1
1990,208,Denmark,Libya,71,46,25
1990,246,Finland,Libya,29,27,2
1990,372,Ireland,Libya,84,48,36
1990,428,Latvia,Libya,2,1,1
1990,578,Norway,Libya,57,51,6
1990,752,Sweden,Libya,293,188,105
1990,826,United Kingdom,Libya,6468,3716,2752
1990,300,Greece,Libya,1123,830,293
1990,380,Italy,Libya,5450,2738,2712
1990,470,Malta,Libya,435,231,204
1990,620,Portugal,Libya,2,2,0
1990,688,Serbia,Libya,45,27,18
1990,705,Slovenia,Libya,8,4,4
1990,724,Spain,Libya,78,49,29
1990,40,Austria,Libya,254,150,104
1990,56,Belgium,Libya,216,132,84
1990,250,France,Libya,1354,729,625
1990,276,Germany,Libya,1438,1076,362
1990,528,Netherlands,Libya,199,130,69
1990,756,Switzerland,Libya,636,394,242
1990,124,Canada,Libya,571,278,293
1990,840,United States of America,Libya,4037,1975,2062
1995,800,Uganda,Libya,46,18,28
1995,148,Chad,Libya,1191,642,549
1995,516,Namibia,Libya,49,24,25
1995,710,South Africa,Libya,98,77,21
1995,384,Côte d'Ivoire,Libya,5397,3187,2210
1995,478,Mauritania,Libya,132,66,66
1995,562,Niger,Libya,123,69,54
1995,12,Algeria,Libya,2154,1195,959
1995,818,Egypt,Libya,3176,1726,1450
1995,504,Morocco,Libya,737,385,352
1995,729,Sudan,Libya,2439,1255,1184
1995,788,Tunisia,Libya,1215,611,604
1995,196,Cyprus,Libya,81,47,34
1995,376,Israel,Libya,19857,9406,10451
1995,400,Jordan,Libya,761,430,331
1995,422,Lebanon,Libya,345,184,161
1995,792,Turkey,Libya,1798,1035,763
1995,144,Sri Lanka,Libya,4,4,0
1995,360,Indonesia,Libya,9170,4529,4641
1995,608,Philippines,Libya,43,28,15
1995,188,Costa Rica,Libya,8,4,4
1995,591,Panama,Libya,15,9,6
1995,32,Argentina,Libya,110,66,44
1995,68,Bolivia (Plurinational State of),Libya,4,3,1
1995,152,Chile,Libya,19,13,6
1995,862,Venezuela (Bolivarian Republic of),Libya,122,83,39
1995,36,Australia,Libya,1390,756,634
1995,100,Bulgaria,Libya,67,38,29
1995,203,Czechia,Libya,37,27,10
1995,348,Hungary,Libya,275,144,131
1995,616,Poland,Libya,369,224,145
1995,643,Russian Federation,Libya,362,192,170
1995,703,Slovakia,Libya,18,15,3
1995,208,Denmark,Libya,121,77,44
1995,246,Finland,Libya,45,34,11
1995,372,Ireland,Libya,233,131,102
1995,428,Latvia,Libya,2,1,1
1995,578,Norway,Libya,54,46,8
1995,752,Sweden,Libya,348,223,125
1995,826,United Kingdom,Libya,7588,4361,3227
1995,300,Greece,Libya,848,580,268
1995,380,Italy,Libya,4411,2101,2310
1995,470,Malta,Libya,509,274,235
1995,620,Portugal,Libya,5,5,0
1995,688,Serbia,Libya,291,172,119
1995,705,Slovenia,Libya,16,9,7
1995,724,Spain,Libya,118,75,43
1995,40,Austria,Libya,287,172,115
1995,56,Belgium,Libya,216,132,84
1995,250,France,Libya,1398,742,656
1995,276,Germany,Libya,2068,1467,601
1995,528,Netherlands,Libya,293,188,105
1995,756,Switzerland,Libya,683,423,260
1995,124,Canada,Libya,1508,729,779
1995,840,United States of America,Libya,4763,2354,2409
2000,800,Uganda,Libya,1,1,0
2000,148,Chad,Libya,1286,693,593
2000,516,Namibia,Libya,48,24,24
2000,710,South Africa,Libya,69,57,12
2000,384,Côte d'Ivoire,Libya,5623,3319,2304
2000,478,Mauritania,Libya,136,75,61
2000,562,Niger,Libya,149,80,69
2000,12,Algeria,Libya,2325,1267,1058
2000,818,Egypt,Libya,3669,1979,1690
2000,504,Morocco,Libya,777,399,378
2000,729,Sudan,Libya,2492,1283,1209
2000,788,Tunisia,Libya,1804,918,886
2000,196,Cyprus,Libya,104,59,45
2000,376,Israel,Libya,19423,9103,10320
2000,400,Jordan,Libya,1182,681,501
2000,422,Lebanon,Libya,536,286,250
2000,792,Turkey,Libya,2861,1632,1229
2000,144,Sri Lanka,Libya,9,7,2
2000,360,Indonesia,Libya,4480,2401,2079
2000,608,Philippines,Libya,44,28,16
2000,188,Costa Rica,Libya,8,4,4
2000,591,Panama,Libya,22,14,8
2000,32,Argentina,Libya,107,65,42
2000,68,Bolivia (Plurinational State of),Libya,5,4,1
2000,152,Chile,Libya,22,14,8
2000,862,Venezuela (Bolivarian Republic of),Libya,119,86,33
2000,36,Australia,Libya,1400,765,635
2000,100,Bulgaria,Libya,99,53,46
2000,203,Czechia,Libya,49,36,13
2000,348,Hungary,Libya,217,140,77
2000,616,Poland,Libya,316,190,126
2000,643,Russian Federation,Libya,339,194,145
2000,703,Slovakia,Libya,35,27,8
2000,208,Denmark,Libya,170,108,62
2000,246,Finland,Libya,61,41,20
2000,372,Ireland,Libya,511,294,217
2000,428,Latvia,Libya,3,1,2
2000,578,Norway,Libya,70,50,20
2000,752,Sweden,Libya,374,238,136
2000,826,United Kingdom,Libya,8836,5070,3766
2000,300,Greece,Libya,587,334,253
2000,380,Italy,Libya,3371,1463,1908
2000,470,Malta,Libya,645,397,248
2000,620,Portugal,Libya,10,8,2
2000,688,Serbia,Libya,396,230,166
2000,705,Slovenia,Libya,38,19,19
2000,724,Spain,Libya,1428,945,483
2000,40,Austria,Libya,319,193,126
2000,56,Belgium,Libya,208,127,81
2000,250,France,Libya,1441,754,687
2000,276,Germany,Libya,2698,1859,839
2000,528,Netherlands,Libya,399,253,146
2000,756,Switzerland,Libya,734,455,279
2000,124,Canada,Libya,2481,1197,1284
2000,840,United States of America,Libya,5500,2741,2759
2005,148,Chad,Libya,890,404,486
2005,516,Namibia,Libya,37,18,19
2005,710,South Africa,Libya,90,73,17
2005,384,Côte d'Ivoire,Libya,5886,3474,2412
2005,478,Mauritania,Libya,137,78,59
2005,562,Niger,Libya,152,84,68
2005,12,Algeria,Libya,1835,1000,835
2005,818,Egypt,Libya,4368,2480,1888
2005,504,Morocco,Libya,797,404,393
2005,729,Sudan,Libya,2676,1379,1297
2005,788,Tunisia,Libya,1725,885,840
2005,196,Cyprus,Libya,152,86,66
2005,376,Israel,Libya,17977,8298,9679
2005,400,Jordan,Libya,1707,1070,637
2005,422,Lebanon,Libya,420,232,188
2005,792,Turkey,Libya,2948,1653,1295
2005,144,Sri Lanka,Libya,19,12,7
2005,360,Indonesia,Libya,3161,1812,1349
2005,608,Philippines,Libya,35,23,12
2005,188,Costa Rica,Libya,5,2,3
2005,591,Panama,Libya,26,19,7
2005,32,Argentina,Libya,79,49,30
2005,68,Bolivia (Plurinational State of),Libya,4,2,2
2005,152,Chile,Libya,33,22,11
2005,862,Venezuela (Bolivarian Republic of),Libya,124,84,40
2005,36,Australia,Libya,1570,842,728
2005,100,Bulgaria,Libya,147,79,68
2005,203,Czechia,Libya,102,77,25
2005,348,Hungary,Libya,269,174,95
2005,616,Poland,Libya,278,177,101
2005,643,Russian Federation,Libya,304,182,122
2005,703,Slovakia,Libya,40,31,9
2005,208,Denmark,Libya,194,123,71
2005,246,Finland,Libya,106,71,35
2005,352,Iceland,Libya,1,1,0
2005,372,Ireland,Libya,513,308,205
2005,428,Latvia,Libya,4,2,2
2005,578,Norway,Libya,197,145,52
2005,752,Sweden,Libya,625,430,195
2005,826,United Kingdom,Libya,11808,6718,5090
2005,191,Croatia,Libya,75,39,36
2005,300,Greece,Libya,621,363,258
2005,380,Italy,Libya,19794,9544,10250
2005,470,Malta,Libya,755,505,250
2005,620,Portugal,Libya,19,16,3
2005,688,Serbia,Libya,391,225,166
2005,705,Slovenia,Libya,35,19,16
2005,724,Spain,Libya,687,451,236
2005,40,Austria,Libya,356,212,144
2005,56,Belgium,Libya,303,187,116
2005,250,France,Libya,1800,995,805
2005,276,Germany,Libya,3204,2051,1153
2005,528,Netherlands,Libya,588,398,190
2005,756,Switzerland,Libya,826,497,329
2005,124,Canada,Libya,3961,2096,1865
2005,840,United States of America,Libya,6250,3132,3118
2010,728,South Sudan,Libya,177,99,78
2010,148,Chad,Libya,1054,472,582
2010,516,Namibia,Libya,35,17,18
2010,710,South Africa,Libya,140,114,26
2010,384,Côte d'Ivoire,Libya,6149,3628,2521
2010,466,Mali,Libya,886,552,334
2010,478,Mauritania,Libya,138,80,58
2010,562,Niger,Libya,155,88,67
2010,12,Algeria,Libya,2016,1059,957
2010,818,Egypt,Libya,4714,2599,2115
2010,504,Morocco,Libya,892,450,442
2010,729,Sudan,Libya,1701,878,823
2010,788,Tunisia,Libya,7062,3636,3426
2010,196,Cyprus,Libya,248,142,106
2010,376,Israel,Libya,16748,7573,9175
2010,400,Jordan,Libya,2195,1422,773
2010,422,Lebanon,Libya,303,177,126
2010,792,Turkey,Libya,3037,1673,1364
2010,144,Sri Lanka,Libya,40,25,15
2010,360,Indonesia,Libya,2045,1192,853
2010,608,Philippines,Libya,47,29,18
2010,188,Costa Rica,Libya,11,6,5
2010,591,Panama,Libya,33,26,7
2010,32,Argentina,Libya,51,33,18
2010,68,Bolivia (Plurinational State of),Libya,3,1,2
2010,76,Brazil,Libya,95,50,45
2010,152,Chile,Libya,44,29,15
2010,862,Venezuela (Bolivarian Republic of),Libya,131,82,49
2010,36,Australia,Libya,2370,1315,1055
2010,100,Bulgaria,Libya,189,101,88
2010,203,Czechia,Libya,146,113,33
2010,348,Hungary,Libya,320,208,112
2010,616,Poland,Libya,249,169,80
2010,643,Russian Federation,Libya,264,167,97
2010,703,Slovakia,Libya,45,35,10
2010,208,Denmark,Libya,214,136,78
2010,233,Estonia,Libya,4,2,2
2010,246,Finland,Libya,179,115,64
2010,352,Iceland,Libya,4,2,2
2010,372,Ireland,Libya,430,245,185
2010,428,Latvia,Libya,6,3,3
2010,578,Norway,Libya,287,195,92
2010,752,Sweden,Libya,1364,1014,350
2010,826,United Kingdom,Libya,12439,7187,5252
2010,191,Croatia,Libya,149,77,72
2010,300,Greece,Libya,681,408,273
2010,380,Italy,Libya,36492,17686,18806
2010,470,Malta,Libya,655,460,195
2010,620,Portugal,Libya,25,21,4
2010,688,Serbia,Libya,383,220,163
2010,705,Slovenia,Libya,46,24,22
2010,724,Spain,Libya,749,484,265
2010,40,Austria,Libya,393,231,162
2010,56,Belgium,Libya,461,261,200
2010,250,France,Libya,2207,1131,1076
2010,276,Germany,Libya,3617,2209,1408
2010,528,Netherlands,Libya,697,477,220
2010,756,Switzerland,Libya,971,561,410
2010,124,Canada,Libya,4705,2589,2116
2010,840,United States of America,Libya,7213,3566,3647
2015,728,South Sudan,Libya,153,86,67
2015,148,Chad,Libya,1307,602,705
2015,516,Namibia,Libya,34,17,17
2015,710,South Africa,Libya,251,203,48
2015,384,Côte d'Ivoire,Libya,6412,3783,2629
2015,324,Guinea,Libya,44,29,15
2015,466,Mali,Libya,1097,684,413
2015,478,Mauritania,Libya,138,81,57
2015,562,Niger,Libya,157,90,67
2015,12,Algeria,Libya,2225,1168,1057
2015,818,Egypt,Libya,3495,2130,1365
2015,504,Morocco,Libya,1162,584,578
2015,729,Sudan,Libya,1557,804,753
2015,788,Tunisia,Libya,9119,4709,4410
2015,196,Cyprus,Libya,238,137,101
2015,376,Israel,Libya,17273,7764,9509
2015,400,Jordan,Libya,18866,12263,6603
2015,422,Lebanon,Libya,255,122,133
2015,792,Turkey,Libya,3082,1667,1415
2015,144,Sri Lanka,Libya,40,25,15
2015,360,Indonesia,Libya,2263,1340,923
2015,608,Philippines,Libya,48,29,19
2015,188,Costa Rica,Libya,11,6,5
2015,591,Panama,Libya,38,29,9
2015,32,Argentina,Libya,51,33,18
2015,68,Bolivia (Plurinational State of),Libya,3,1,2
2015,76,Brazil,Libya,114,60,54
2015,152,Chile,Libya,66,44,22
2015,862,Venezuela (Bolivarian Republic of),Libya,135,83,52
2015,36,Australia,Libya,2790,1500,1290
2015,100,Bulgaria,Libya,239,129,110
2015,203,Czechia,Libya,188,145,43
2015,348,Hungary,Libya,434,270,164
2015,616,Poland,Libya,240,165,75
2015,643,Russian Federation,Libya,270,170,100
2015,703,Slovakia,Libya,59,46,13
2015,208,Denmark,Libya,256,158,98
2015,233,Estonia,Libya,5,3,2
2015,246,Finland,Libya,247,155,92
2015,352,Iceland,Libya,4,2,2
2015,372,Ireland,Libya,439,248,191
2015,428,Latvia,Libya,3,1,2
2015,578,Norway,Libya,545,324,221
2015,752,Sweden,Libya,2689,1819,870
2015,826,United Kingdom,Libya,15907,8992,6915
2015,191,Croatia,Libya,150,77,73
2015,300,Greece,Libya,639,372,267
2015,380,Italy,Libya,35087,16853,18234
2015,470,Malta,Libya,1745,887,858
2015,620,Portugal,Libya,28,23,5
2015,688,Serbia,Libya,374,215,159
2015,705,Slovenia,Libya,40,24,16
2015,724,Spain,Libya,966,596,370
2015,40,Austria,Libya,459,270,189
2015,56,Belgium,Libya,737,441,296
2015,250,France,Libya,2445,1221,1224
2015,276,Germany,Libya,3768,2298,1470
2015,528,Netherlands,Libya,908,623,285
2015,756,Switzerland,Libya,1366,795,571
2015,124,Canada,Libya,6261,3293,2968
2015,840,United States of America,Libya,9676,4759,4917
2019,728,South Sudan,Libya,156,88,68
2019,148,Chad,Libya,1433,660,773
2019,516,Namibia,Libya,35,18,17
2019,710,South Africa,Libya,280,227,53
2019,384,Côte d'Ivoire,Libya,6622,3907,2715
2019,324,Guinea,Libya,42,28,14
2019,466,Mali,Libya,1221,762,459
2019,478,Mauritania,Libya,143,84,59
2019,562,Niger,Libya,169,97,72
2019,12,Algeria,Libya,2314,1215,1099
2019,818,Egypt,Libya,4981,2806,2175
2019,504,Morocco,Libya,1239,623,616
2019,729,Sudan,Libya,1920,977,943
2019,788,Tunisia,Libya,9267,4788,4479
2019,196,Cyprus,Libya,237,138,99
2019,376,Israel,Libya,16797,7550,9247
2019,400,Jordan,Libya,20288,13188,7100
2019,422,Lebanon,Libya,240,115,125
2019,792,Turkey,Libya,4167,2273,1894
2019,144,Sri Lanka,Libya,40,25,15
2019,360,Indonesia,Libya,2363,1400,963
2019,608,Philippines,Libya,49,30,19
2019,188,Costa Rica,Libya,11,6,5
2019,591,Panama,Libya,39,31,8
2019,32,Argentina,Libya,51,33,18
2019,68,Bolivia (Plurinational State of),Libya,3,1,2
2019,76,Brazil,Libya,128,68,60
2019,152,Chile,Libya,88,57,31
2019,862,Venezuela (Bolivarian Republic of),Libya,132,81,51
2019,36,Australia,Libya,3025,1620,1405
2019,100,Bulgaria,Libya,293,167,126
2019,203,Czechia,Libya,208,155,53
2019,348,Hungary,Libya,457,286,171
2019,616,Poland,Libya,254,178,76
2019,643,Russian Federation,Libya,269,170,99
2019,703,Slovakia,Libya,68,56,12
2019,208,Denmark,Libya,316,193,123
2019,233,Estonia,Libya,5,2,3
2019,246,Finland,Libya,327,214,113
2019,352,Iceland,Libya,10,7,3
2019,372,Ireland,Libya,481,272,209
2019,428,Latvia,Libya,1,1,0
2019,578,Norway,Libya,723,448,275
2019,752,Sweden,Libya,4744,2878,1866
2019,826,United Kingdom,Libya,18064,10232,7832
2019,191,Croatia,Libya,138,71,67
2019,300,Greece,Libya,624,374,250
2019,380,Italy,Libya,35852,17426,18426
2019,470,Malta,Libya,2815,1440,1375
2019,620,Portugal,Libya,96,54,42
2019,688,Serbia,Libya,379,218,161
2019,705,Slovenia,Libya,45,27,18
2019,724,Spain,Libya,1000,608,392
2019,40,Austria,Libya,541,322,219
2019,56,Belgium,Libya,1016,603,413
2019,250,France,Libya,2588,1290,1298
2019,276,Germany,Libya,11493,7507,3986
2019,528,Netherlands,Libya,1765,1070,695
2019,756,Switzerland,Libya,1402,832,570
2019,124,Canada,Libya,6709,3529,3180
2019,840,United States of America,Libya,10448,5083,5365
1990,188,Costa Rica,Liechtenstein,3,2,1
1990,32,Argentina,Liechtenstein,170,108,62
1990,68,Bolivia (Plurinational State of),Liechtenstein,2,1,1
1990,152,Chile,Liechtenstein,3,1,2
1990,36,Australia,Liechtenstein,16,13,3
1990,100,Bulgaria,Liechtenstein,1,1,0
1990,208,Denmark,Liechtenstein,10,5,5
1990,578,Norway,Liechtenstein,3,3,0
1990,826,United Kingdom,Liechtenstein,7,5,2
1990,300,Greece,Liechtenstein,12,6,6
1990,380,Italy,Liechtenstein,3,1,2
1990,620,Portugal,Liechtenstein,1,1,0
1990,724,Spain,Liechtenstein,58,25,33
1990,40,Austria,Liechtenstein,208,81,127
1990,56,Belgium,Liechtenstein,3,1,2
1990,250,France,Liechtenstein,103,56,47
1990,276,Germany,Liechtenstein,35,16,19
1990,756,Switzerland,Liechtenstein,2790,1121,1669
1995,188,Costa Rica,Liechtenstein,2,1,1
1995,32,Argentina,Liechtenstein,166,106,60
1995,68,Bolivia (Plurinational State of),Liechtenstein,2,1,1
1995,152,Chile,Liechtenstein,2,2,0
1995,36,Australia,Liechtenstein,8,7,1
1995,100,Bulgaria,Liechtenstein,2,2,0
1995,348,Hungary,Liechtenstein,3,1,2
1995,208,Denmark,Liechtenstein,11,5,6
1995,372,Ireland,Liechtenstein,1,1,0
1995,578,Norway,Liechtenstein,6,3,3
1995,826,United Kingdom,Liechtenstein,16,5,11
1995,300,Greece,Liechtenstein,9,5,4
1995,380,Italy,Liechtenstein,21,8,13
1995,620,Portugal,Liechtenstein,2,2,0
1995,724,Spain,Liechtenstein,78,31,47
1995,40,Austria,Liechtenstein,235,94,141
1995,56,Belgium,Liechtenstein,3,1,2
1995,250,France,Liechtenstein,106,56,50
1995,276,Germany,Liechtenstein,99,37,62
1995,756,Switzerland,Liechtenstein,2248,938,1310
2000,188,Costa Rica,Liechtenstein,3,2,1
2000,32,Argentina,Liechtenstein,162,105,57
2000,68,Bolivia (Plurinational State of),Liechtenstein,1,1,0
2000,152,Chile,Liechtenstein,2,1,1
2000,36,Australia,Liechtenstein,20,10,10
2000,100,Bulgaria,Liechtenstein,2,2,0
2000,348,Hungary,Liechtenstein,5,2,3
2000,208,Denmark,Liechtenstein,11,5,6
2000,372,Ireland,Liechtenstein,3,2,1
2000,578,Norway,Liechtenstein,6,3,3
2000,752,Sweden,Liechtenstein,2,0,2
2000,826,United Kingdom,Liechtenstein,27,6,21
2000,300,Greece,Liechtenstein,6,3,3
2000,380,Italy,Liechtenstein,38,14,24
2000,620,Portugal,Liechtenstein,4,3,1
2000,705,Slovenia,Liechtenstein,14,6,8
2000,724,Spain,Liechtenstein,133,53,80
2000,40,Austria,Liechtenstein,261,106,155
2000,56,Belgium,Liechtenstein,3,1,2
2000,250,France,Liechtenstein,109,57,52
2000,276,Germany,Liechtenstein,163,59,104
2000,756,Switzerland,Liechtenstein,1715,762,953
2005,188,Costa Rica,Liechtenstein,2,1,1
2005,32,Argentina,Liechtenstein,120,78,42
2005,68,Bolivia (Plurinational State of),Liechtenstein,1,1,0
2005,152,Chile,Liechtenstein,3,2,1
2005,36,Australia,Liechtenstein,20,10,10
2005,100,Bulgaria,Liechtenstein,3,2,1
2005,203,Czechia,Liechtenstein,1,1,0
2005,348,Hungary,Liechtenstein,6,2,4
2005,208,Denmark,Liechtenstein,16,6,10
2005,372,Ireland,Liechtenstein,3,2,1
2005,578,Norway,Liechtenstein,4,4,0
2005,752,Sweden,Liechtenstein,2,0,2
2005,826,United Kingdom,Liechtenstein,26,7,19
2005,300,Greece,Liechtenstein,8,3,5
2005,380,Italy,Liechtenstein,85,39,46
2005,620,Portugal,Liechtenstein,99,99,0
2005,705,Slovenia,Liechtenstein,15,7,8
2005,724,Spain,Liechtenstein,87,35,52
2005,40,Austria,Liechtenstein,292,114,178
2005,56,Belgium,Liechtenstein,6,2,4
2005,250,France,Liechtenstein,32,19,13
2005,276,Germany,Liechtenstein,209,83,126
2005,756,Switzerland,Liechtenstein,1899,793,1106
2010,188,Costa Rica,Liechtenstein,4,3,1
2010,32,Argentina,Liechtenstein,78,51,27
2010,76,Brazil,Liechtenstein,16,16,0
2010,152,Chile,Liechtenstein,4,3,1
2010,36,Australia,Liechtenstein,30,15,15
2010,100,Bulgaria,Liechtenstein,3,2,1
2010,203,Czechia,Liechtenstein,1,1,0
2010,348,Hungary,Liechtenstein,7,2,5
2010,208,Denmark,Liechtenstein,20,7,13
2010,233,Estonia,Liechtenstein,1,1,0
2010,372,Ireland,Liechtenstein,2,1,1
2010,578,Norway,Liechtenstein,26,13,13
2010,752,Sweden,Liechtenstein,2,0,2
2010,826,United Kingdom,Liechtenstein,27,8,19
2010,300,Greece,Liechtenstein,10,3,7
2010,380,Italy,Liechtenstein,179,85,94
2010,620,Portugal,Liechtenstein,179,179,0
2010,705,Slovenia,Liechtenstein,14,7,7
2010,724,Spain,Liechtenstein,116,59,57
2010,40,Austria,Liechtenstein,323,123,200
2010,56,Belgium,Liechtenstein,11,5,6
2010,250,France,Liechtenstein,26,14,12
2010,276,Germany,Liechtenstein,248,105,143
2010,756,Switzerland,Liechtenstein,2267,868,1399
2015,324,Guinea,Liechtenstein,4,1,3
2015,188,Costa Rica,Liechtenstein,4,3,1
2015,32,Argentina,Liechtenstein,78,51,27
2015,76,Brazil,Liechtenstein,19,19,0
2015,152,Chile,Liechtenstein,6,5,1
2015,36,Australia,Liechtenstein,20,12,8
2015,100,Bulgaria,Liechtenstein,2,1,1
2015,203,Czechia,Liechtenstein,1,1,0
2015,348,Hungary,Liechtenstein,4,3,1
2015,208,Denmark,Liechtenstein,21,5,16
2015,233,Estonia,Liechtenstein,1,1,0
2015,372,Ireland,Liechtenstein,2,1,1
2015,428,Latvia,Liechtenstein,1,1,0
2015,578,Norway,Liechtenstein,27,16,11
2015,752,Sweden,Liechtenstein,3,2,1
2015,826,United Kingdom,Liechtenstein,34,9,25
2015,300,Greece,Liechtenstein,9,3,6
2015,380,Italy,Liechtenstein,113,56,57
2015,620,Portugal,Liechtenstein,202,201,1
2015,705,Slovenia,Liechtenstein,11,7,4
2015,724,Spain,Liechtenstein,115,53,62
2015,40,Austria,Liechtenstein,378,146,232
2015,56,Belgium,Liechtenstein,5,1,4
2015,250,France,Liechtenstein,28,15,13
2015,276,Germany,Liechtenstein,258,108,150
2015,756,Switzerland,Liechtenstein,2228,840,1388
2019,324,Guinea,Liechtenstein,3,1,2
2019,188,Costa Rica,Liechtenstein,4,3,1
2019,32,Argentina,Liechtenstein,79,52,27
2019,76,Brazil,Liechtenstein,21,21,0
2019,152,Chile,Liechtenstein,8,7,1
2019,36,Australia,Liechtenstein,21,12,9
2019,100,Bulgaria,Liechtenstein,2,1,1
2019,203,Czechia,Liechtenstein,1,1,0
2019,348,Hungary,Liechtenstein,3,2,1
2019,208,Denmark,Liechtenstein,26,10,16
2019,372,Ireland,Liechtenstein,2,1,1
2019,578,Norway,Liechtenstein,24,15,9
2019,752,Sweden,Liechtenstein,2,1,1
2019,826,United Kingdom,Liechtenstein,38,10,28
2019,300,Greece,Liechtenstein,8,3,5
2019,380,Italy,Liechtenstein,126,60,66
2019,620,Portugal,Liechtenstein,205,204,1
2019,705,Slovenia,Liechtenstein,8,5,3
2019,724,Spain,Liechtenstein,119,54,65
2019,40,Austria,Liechtenstein,446,177,269
2019,56,Belgium,Liechtenstein,7,3,4
2019,250,France,Liechtenstein,29,16,13
2019,276,Germany,Liechtenstein,283,130,153
2019,756,Switzerland,Liechtenstein,2248,870,1378
1990,710,South Africa,Lithuania,192,84,108
1990,196,Cyprus,Lithuania,23,5,18
1990,268,Georgia,Lithuania,3623,1607,2016
1990,376,Israel,Lithuania,13594,6248,7346
1990,792,Turkey,Lithuania,63,27,36
1990,398,Kazakhstan,Lithuania,4347,2450,1897
1990,417,Kyrgyzstan,Lithuania,6622,2805,3817
1990,188,Costa Rica,Lithuania,8,5,3
1990,484,Mexico,Lithuania,78,28,50
1990,591,Panama,Lithuania,15,11,4
1990,32,Argentina,Lithuania,1980,692,1288
1990,152,Chile,Lithuania,36,17,19
1990,170,Colombia,Lithuania,41,19,22
1990,862,Venezuela (Bolivarian Republic of),Lithuania,130,61,69
1990,36,Australia,Lithuania,4818,2592,2226
1990,112,Belarus,Lithuania,18380,8096,10284
1990,100,Bulgaria,Lithuania,9,1,8
1990,203,Czechia,Lithuania,41,18,23
1990,348,Hungary,Lithuania,42,21,21
1990,616,Poland,Lithuania,113201,46949,66252
1990,643,Russian Federation,Lithuania,82889,40675,42214
1990,703,Slovakia,Lithuania,9,2,7
1990,804,Ukraine,Lithuania,25282,10834,14448
1990,208,Denmark,Lithuania,13,5,8
1990,233,Estonia,Lithuania,3195,1625,1570
1990,372,Ireland,Lithuania,1246,612,634
1990,428,Latvia,Lithuania,17512,8077,9435
1990,578,Norway,Lithuania,8,3,5
1990,752,Sweden,Lithuania,616,255,361
1990,826,United Kingdom,Lithuania,1182,819,363
1990,300,Greece,Lithuania,293,162,131
1990,380,Italy,Lithuania,16,6,10
1990,470,Malta,Lithuania,3,2,1
1990,620,Portugal,Lithuania,38,30,8
1990,688,Serbia,Lithuania,3,1,2
1990,705,Slovenia,Lithuania,2,1,1
1990,724,Spain,Lithuania,37,17,20
1990,40,Austria,Lithuania,501,169,332
1990,56,Belgium,Lithuania,76,27,49
1990,250,France,Lithuania,1547,667,880
1990,276,Germany,Lithuania,2386,797,1589
1990,442,Luxembourg,Lithuania,13,4,9
1990,528,Netherlands,Lithuania,172,41,131
1990,756,Switzerland,Lithuania,383,127,256
1990,124,Canada,Lithuania,6640,3233,3407
1990,840,United States of America,Lithuania,29745,12677,17068
1995,710,South Africa,Lithuania,157,71,86
1995,196,Cyprus,Lithuania,33,6,27
1995,268,Georgia,Lithuania,410,96,314
1995,376,Israel,Lithuania,12500,5636,6864
1995,792,Turkey,Lithuania,152,61,91
1995,398,Kazakhstan,Lithuania,3785,2057,1728
1995,417,Kyrgyzstan,Lithuania,5736,2436,3300
1995,188,Costa Rica,Lithuania,6,4,2
1995,484,Mexico,Lithuania,87,30,57
1995,591,Panama,Lithuania,20,15,5
1995,32,Argentina,Lithuania,1400,495,905
1995,68,Bolivia (Plurinational State of),Lithuania,3,1,2
1995,152,Chile,Lithuania,26,11,15
1995,170,Colombia,Lithuania,40,18,22
1995,862,Venezuela (Bolivarian Republic of),Lithuania,128,60,68
1995,36,Australia,Lithuania,4843,2519,2324
1995,112,Belarus,Lithuania,18210,6431,11779
1995,100,Bulgaria,Lithuania,30,4,26
1995,203,Czechia,Lithuania,61,27,34
1995,348,Hungary,Lithuania,71,32,39
1995,616,Poland,Lithuania,96834,39297,57537
1995,643,Russian Federation,Lithuania,85879,42648,43231
1995,703,Slovakia,Lithuania,42,14,28
1995,804,Ukraine,Lithuania,26437,12312,14125
1995,208,Denmark,Lithuania,479,183,296
1995,233,Estonia,Lithuania,2639,1259,1380
1995,246,Finland,Lithuania,68,27,41
1995,352,Iceland,Lithuania,16,9,7
1995,372,Ireland,Lithuania,6758,3220,3538
1995,428,Latvia,Lithuania,22699,9854,12845
1995,578,Norway,Lithuania,75,20,55
1995,752,Sweden,Lithuania,731,300,431
1995,826,United Kingdom,Lithuania,2675,1440,1235
1995,191,Croatia,Lithuania,9,2,7
1995,300,Greece,Lithuania,228,99,129
1995,380,Italy,Lithuania,298,26,272
1995,470,Malta,Lithuania,4,2,2
1995,620,Portugal,Lithuania,82,64,18
1995,688,Serbia,Lithuania,21,6,15
1995,705,Slovenia,Lithuania,3,2,1
1995,724,Spain,Lithuania,104,49,55
1995,40,Austria,Lithuania,565,196,369
1995,56,Belgium,Lithuania,76,27,49
1995,250,France,Lithuania,1597,673,924
1995,276,Germany,Lithuania,9451,2861,6590
1995,442,Luxembourg,Lithuania,12,4,8
1995,528,Netherlands,Lithuania,253,55,198
1995,756,Switzerland,Lithuania,548,188,360
1995,124,Canada,Lithuania,6668,3231,3437
1995,840,United States of America,Lithuania,29506,12713,16793
2000,710,South Africa,Lithuania,169,77,92
2000,196,Cyprus,Lithuania,42,7,35
2000,268,Georgia,Lithuania,205,48,157
2000,376,Israel,Lithuania,10706,4783,5923
2000,792,Turkey,Lithuania,243,96,147
2000,398,Kazakhstan,Lithuania,3222,1664,1558
2000,417,Kyrgyzstan,Lithuania,4686,1991,2695
2000,188,Costa Rica,Lithuania,7,4,3
2000,484,Mexico,Lithuania,101,33,68
2000,591,Panama,Lithuania,28,20,8
2000,32,Argentina,Lithuania,821,300,521
2000,68,Bolivia (Plurinational State of),Lithuania,6,2,4
2000,152,Chile,Lithuania,17,7,10
2000,170,Colombia,Lithuania,39,18,21
2000,862,Venezuela (Bolivarian Republic of),Lithuania,126,59,67
2000,36,Australia,Lithuania,3850,1898,1952
2000,112,Belarus,Lithuania,18039,4766,13273
2000,100,Bulgaria,Lithuania,50,6,44
2000,203,Czechia,Lithuania,81,36,45
2000,348,Hungary,Lithuania,99,42,57
2000,616,Poland,Lithuania,82835,32866,49969
2000,643,Russian Federation,Lithuania,85756,43091,42665
2000,703,Slovakia,Lithuania,87,29,58
2000,804,Ukraine,Lithuania,27916,13940,13976
2000,208,Denmark,Lithuania,944,361,583
2000,233,Estonia,Lithuania,2083,894,1189
2000,246,Finland,Lithuania,135,54,81
2000,352,Iceland,Lithuania,32,19,13
2000,372,Ireland,Lithuania,15984,7878,8106
2000,428,Latvia,Lithuania,27884,11629,16255
2000,578,Norway,Lithuania,274,53,221
2000,752,Sweden,Lithuania,785,319,466
2000,826,United Kingdom,Lithuania,4214,2083,2131
2000,191,Croatia,Lithuania,17,3,14
2000,300,Greece,Lithuania,167,35,132
2000,380,Italy,Lithuania,580,46,534
2000,470,Malta,Lithuania,10,5,5
2000,620,Portugal,Lithuania,131,101,30
2000,688,Serbia,Lithuania,29,7,22
2000,705,Slovenia,Lithuania,2,1,1
2000,724,Spain,Lithuania,217,103,114
2000,40,Austria,Lithuania,629,224,405
2000,56,Belgium,Lithuania,73,26,47
2000,250,France,Lithuania,1647,680,967
2000,276,Germany,Lithuania,16516,4925,11591
2000,442,Luxembourg,Lithuania,12,4,8
2000,528,Netherlands,Lithuania,342,69,273
2000,756,Switzerland,Lithuania,715,249,466
2000,124,Canada,Lithuania,6854,3306,3548
2000,840,United States of America,Lithuania,29213,12746,16467
2005,710,South Africa,Lithuania,222,95,127
2005,196,Cyprus,Lithuania,62,11,51
2005,268,Georgia,Lithuania,194,45,149
2005,376,Israel,Lithuania,7185,3166,4019
2005,792,Turkey,Lithuania,250,96,154
2005,398,Kazakhstan,Lithuania,3673,1944,1729
2005,417,Kyrgyzstan,Lithuania,3875,1635,2240
2005,188,Costa Rica,Lithuania,5,3,2
2005,484,Mexico,Lithuania,75,24,51
2005,591,Panama,Lithuania,32,24,8
2005,32,Argentina,Lithuania,606,227,379
2005,68,Bolivia (Plurinational State of),Lithuania,7,2,5
2005,152,Chile,Lithuania,25,11,14
2005,170,Colombia,Lithuania,37,18,19
2005,862,Venezuela (Bolivarian Republic of),Lithuania,132,62,70
2005,36,Australia,Lithuania,3300,1516,1784
2005,112,Belarus,Lithuania,17326,4575,12751
2005,100,Bulgaria,Lithuania,78,11,67
2005,203,Czechia,Lithuania,285,131,154
2005,348,Hungary,Lithuania,122,53,69
2005,616,Poland,Lithuania,66534,25488,41046
2005,643,Russian Federation,Lithuania,78560,38309,40251
2005,703,Slovakia,Lithuania,98,33,65
2005,804,Ukraine,Lithuania,25507,12755,12752
2005,208,Denmark,Lithuania,3153,1469,1684
2005,233,Estonia,Lithuania,2052,869,1183
2005,234,Faroe Islands,Lithuania,11,3,8
2005,246,Finland,Lithuania,390,156,234
2005,352,Iceland,Lithuania,753,425,328
2005,372,Ireland,Lithuania,29282,15299,13983
2005,428,Latvia,Lithuania,24365,10126,14239
2005,578,Norway,Lithuania,1325,413,912
2005,752,Sweden,Lithuania,2315,912,1403
2005,826,United Kingdom,Lithuania,52001,23860,28141
2005,191,Croatia,Lithuania,22,4,18
2005,300,Greece,Lithuania,362,59,303
2005,380,Italy,Lithuania,3113,701,2412
2005,470,Malta,Lithuania,18,8,10
2005,620,Portugal,Lithuania,247,119,128
2005,688,Serbia,Lithuania,29,7,22
2005,705,Slovenia,Lithuania,7,2,5
2005,724,Spain,Lithuania,11395,5855,5540
2005,40,Austria,Lithuania,703,240,463
2005,56,Belgium,Lithuania,420,146,274
2005,250,France,Lithuania,2048,796,1252
2005,276,Germany,Lithuania,29529,10204,19325
2005,442,Luxembourg,Lithuania,201,68,133
2005,528,Netherlands,Lithuania,928,234,694
2005,756,Switzerland,Lithuania,885,287,598
2005,124,Canada,Lithuania,5937,2874,3063
2005,840,United States of America,Lithuania,32931,14471,18460
2010,710,South Africa,Lithuania,347,148,199
2010,196,Cyprus,Lithuania,101,19,82
2010,268,Georgia,Lithuania,195,45,150
2010,376,Israel,Lithuania,3751,1579,2172
2010,792,Turkey,Lithuania,257,95,162
2010,398,Kazakhstan,Lithuania,4124,2224,1900
2010,417,Kyrgyzstan,Lithuania,3008,1249,1759
2010,188,Costa Rica,Lithuania,9,5,4
2010,484,Mexico,Lithuania,58,17,41
2010,591,Panama,Lithuania,39,30,9
2010,32,Argentina,Lithuania,391,155,236
2010,68,Bolivia (Plurinational State of),Lithuania,8,2,6
2010,76,Brazil,Lithuania,626,146,480
2010,152,Chile,Lithuania,34,15,19
2010,170,Colombia,Lithuania,42,21,21
2010,862,Venezuela (Bolivarian Republic of),Lithuania,140,66,74
2010,36,Australia,Lithuania,3090,1314,1776
2010,112,Belarus,Lithuania,16612,4384,12228
2010,100,Bulgaria,Lithuania,103,15,88
2010,203,Czechia,Lithuania,462,220,242
2010,348,Hungary,Lithuania,145,64,81
2010,616,Poland,Lithuania,52319,18637,33682
2010,642,Romania,Lithuania,4,2,2
2010,643,Russian Federation,Lithuania,69747,32763,36984
2010,703,Slovakia,Lithuania,110,38,72
2010,804,Ukraine,Lithuania,24337,12187,12150
2010,208,Denmark,Lithuania,5267,2534,2733
2010,233,Estonia,Lithuania,2004,833,1171
2010,234,Faroe Islands,Lithuania,14,6,8
2010,246,Finland,Lithuania,655,220,435
2010,352,Iceland,Lithuania,1471,831,640
2010,372,Ireland,Lithuania,37759,18429,19330
2010,428,Latvia,Lithuania,20226,8155,12071
2010,578,Norway,Lithuania,9869,5774,4095
2010,752,Sweden,Lithuania,6735,3268,3467
2010,826,United Kingdom,Lithuania,139497,63261,76236
2010,191,Croatia,Lithuania,26,5,21
2010,300,Greece,Lithuania,579,86,493
2010,380,Italy,Lithuania,5537,1336,4201
2010,470,Malta,Lithuania,36,10,26
2010,620,Portugal,Lithuania,322,117,205
2010,688,Serbia,Lithuania,29,7,22
2010,705,Slovenia,Lithuania,33,15,18
2010,724,Spain,Lithuania,18531,9507,9024
2010,40,Austria,Lithuania,777,256,521
2010,56,Belgium,Lithuania,989,340,649
2010,250,France,Lithuania,2457,982,1475
2010,276,Germany,Lithuania,40319,14734,25585
2010,442,Luxembourg,Lithuania,393,133,260
2010,528,Netherlands,Lithuania,2042,656,1386
2010,756,Switzerland,Lithuania,945,260,685
2010,124,Canada,Lithuania,5335,2603,2732
2010,840,United States of America,Lithuania,37759,16302,21457
2015,710,South Africa,Lithuania,625,249,376
2015,196,Cyprus,Lithuania,97,19,78
2015,268,Georgia,Lithuania,204,47,157
2015,376,Israel,Lithuania,3869,1618,2251
2015,792,Turkey,Lithuania,260,92,168
2015,398,Kazakhstan,Lithuania,4386,2398,1988
2015,417,Kyrgyzstan,Lithuania,2649,1090,1559
2015,188,Costa Rica,Lithuania,9,5,4
2015,484,Mexico,Lithuania,61,18,43
2015,591,Panama,Lithuania,46,36,10
2015,32,Argentina,Lithuania,392,155,237
2015,68,Bolivia (Plurinational State of),Lithuania,9,2,7
2015,76,Brazil,Lithuania,754,176,578
2015,152,Chile,Lithuania,51,22,29
2015,170,Colombia,Lithuania,47,24,23
2015,862,Venezuela (Bolivarian Republic of),Lithuania,147,68,79
2015,36,Australia,Lithuania,3370,1392,1978
2015,112,Belarus,Lithuania,17385,4592,12793
2015,100,Bulgaria,Lithuania,134,31,103
2015,203,Czechia,Lithuania,610,284,326
2015,348,Hungary,Lithuania,193,86,107
2015,616,Poland,Lithuania,50444,18582,31862
2015,642,Romania,Lithuania,12,3,9
2015,643,Russian Federation,Lithuania,71078,33200,37878
2015,703,Slovakia,Lithuania,142,58,84
2015,804,Ukraine,Lithuania,24418,12245,12173
2015,208,Denmark,Lithuania,9274,4662,4612
2015,233,Estonia,Lithuania,2028,853,1175
2015,234,Faroe Islands,Lithuania,13,4,9
2015,246,Finland,Lithuania,1250,509,741
2015,352,Iceland,Lithuania,1499,736,763
2015,372,Ireland,Lithuania,38572,18582,19990
2015,428,Latvia,Lithuania,16668,6447,10221
2015,578,Norway,Lithuania,35963,21274,14689
2015,752,Sweden,Lithuania,11345,5852,5493
2015,826,United Kingdom,Lithuania,139497,63261,76236
2015,191,Croatia,Lithuania,26,5,21
2015,300,Greece,Lithuania,543,61,482
2015,380,Italy,Lithuania,5661,1278,4383
2015,470,Malta,Lithuania,61,20,41
2015,620,Portugal,Lithuania,364,121,243
2015,688,Serbia,Lithuania,28,7,21
2015,705,Slovenia,Lithuania,33,6,27
2015,724,Spain,Lithuania,16284,7547,8737
2015,40,Austria,Lithuania,909,304,605
2015,56,Belgium,Lithuania,1512,553,959
2015,250,France,Lithuania,3462,1297,2165
2015,276,Germany,Lithuania,42010,15289,26721
2015,442,Luxembourg,Lithuania,599,209,390
2015,528,Netherlands,Lithuania,4433,1761,2672
2015,756,Switzerland,Lithuania,1927,579,1348
2015,124,Canada,Lithuania,4949,2111,2838
2015,840,United States of America,Lithuania,39449,16918,22531
2019,710,South Africa,Lithuania,699,279,420
2019,196,Cyprus,Lithuania,96,19,77
2019,268,Georgia,Lithuania,210,49,161
2019,376,Israel,Lithuania,3762,1573,2189
2019,792,Turkey,Lithuania,351,127,224
2019,398,Kazakhstan,Lithuania,4583,2506,2077
2019,417,Kyrgyzstan,Lithuania,2595,1068,1527
2019,188,Costa Rica,Lithuania,9,5,4
2019,484,Mexico,Lithuania,62,18,44
2019,591,Panama,Lithuania,47,39,8
2019,32,Argentina,Lithuania,398,157,241
2019,68,Bolivia (Plurinational State of),Lithuania,9,2,7
2019,76,Brazil,Lithuania,849,199,650
2019,152,Chile,Lithuania,68,28,40
2019,170,Colombia,Lithuania,48,25,23
2019,862,Venezuela (Bolivarian Republic of),Lithuania,143,66,77
2019,36,Australia,Lithuania,3755,1533,2222
2019,112,Belarus,Lithuania,17168,4535,12633
2019,100,Bulgaria,Lithuania,162,44,118
2019,203,Czechia,Lithuania,662,313,349
2019,348,Hungary,Lithuania,231,95,136
2019,616,Poland,Lithuania,53423,20975,32448
2019,642,Romania,Lithuania,89,37,52
2019,643,Russian Federation,Lithuania,71061,33192,37869
2019,703,Slovakia,Lithuania,174,75,99
2019,804,Ukraine,Lithuania,24662,12368,12294
2019,208,Denmark,Lithuania,13224,6906,6318
2019,233,Estonia,Lithuania,2034,893,1141
2019,234,Faroe Islands,Lithuania,13,9,4
2019,246,Finland,Lithuania,1553,666,887
2019,352,Iceland,Lithuania,2141,1248,893
2019,372,Ireland,Lithuania,42347,20468,21879
2019,428,Latvia,Lithuania,14554,5580,8974
2019,578,Norway,Lithuania,40888,23834,17054
2019,752,Sweden,Lithuania,16406,8907,7499
2019,826,United Kingdom,Lithuania,158413,72058,86355
2019,191,Croatia,Lithuania,24,5,19
2019,300,Greece,Lithuania,530,78,452
2019,380,Italy,Lithuania,6170,1425,4745
2019,470,Malta,Lithuania,98,33,65
2019,620,Portugal,Lithuania,370,124,246
2019,688,Serbia,Lithuania,28,7,21
2019,705,Slovenia,Lithuania,45,9,36
2019,724,Spain,Lithuania,15971,7022,8949
2019,40,Austria,Lithuania,1073,372,701
2019,56,Belgium,Lithuania,2277,784,1493
2019,250,France,Lithuania,3664,1368,2296
2019,276,Germany,Lithuania,46083,18932,27151
2019,442,Luxembourg,Lithuania,893,300,593
2019,528,Netherlands,Lithuania,5806,2347,3459
2019,756,Switzerland,Lithuania,2418,781,1637
2019,124,Canada,Lithuania,5303,2262,3041
2019,840,United States of America,Lithuania,42600,18007,24593
1990,516,Namibia,Luxembourg,64,29,35
1990,710,South Africa,Luxembourg,14,6,8
1990,132,Cabo Verde,Luxembourg,5,1,4
1990,196,Cyprus,Luxembourg,3,1,2
1990,792,Turkey,Luxembourg,11,6,5
1990,188,Costa Rica,Luxembourg,9,3,6
1990,32,Argentina,Luxembourg,213,54,159
1990,68,Bolivia (Plurinational State of),Luxembourg,2,2,0
1990,152,Chile,Luxembourg,12,9,3
1990,170,Colombia,Luxembourg,21,11,10
1990,604,Peru,Luxembourg,8,5,3
1990,36,Australia,Luxembourg,125,63,62
1990,100,Bulgaria,Luxembourg,2,1,1
1990,203,Czechia,Luxembourg,4,3,1
1990,348,Hungary,Luxembourg,4,2,2
1990,616,Poland,Luxembourg,177,80,97
1990,642,Romania,Luxembourg,7,5,2
1990,643,Russian Federation,Luxembourg,92,45,47
1990,703,Slovakia,Luxembourg,14,8,6
1990,208,Denmark,Luxembourg,64,32,32
1990,246,Finland,Luxembourg,19,10,9
1990,352,Iceland,Luxembourg,53,26,27
1990,372,Ireland,Luxembourg,19,8,11
1990,428,Latvia,Luxembourg,1,0,1
1990,578,Norway,Luxembourg,58,30,28
1990,752,Sweden,Luxembourg,94,45,49
1990,826,United Kingdom,Luxembourg,691,299,392
1990,300,Greece,Luxembourg,146,53,93
1990,380,Italy,Luxembourg,929,285,644
1990,620,Portugal,Luxembourg,1485,754,731
1990,688,Serbia,Luxembourg,11,7,4
1990,705,Slovenia,Luxembourg,29,13,16
1990,724,Spain,Luxembourg,658,300,358
1990,40,Austria,Luxembourg,420,224,196
1990,56,Belgium,Luxembourg,12908,7495,5413
1990,250,France,Luxembourg,8016,3433,4583
1990,276,Germany,Luxembourg,5470,3171,2299
1990,438,Liechtenstein,Luxembourg,8,5,3
1990,528,Netherlands,Luxembourg,399,188,211
1990,756,Switzerland,Luxembourg,1272,577,695
1990,124,Canada,Luxembourg,551,268,283
1990,840,United States of America,Luxembourg,2053,1005,1048
1995,516,Namibia,Luxembourg,61,28,33
1995,710,South Africa,Luxembourg,11,5,6
1995,132,Cabo Verde,Luxembourg,8,2,6
1995,196,Cyprus,Luxembourg,4,1,3
1995,792,Turkey,Luxembourg,26,13,13
1995,188,Costa Rica,Luxembourg,8,2,6
1995,32,Argentina,Luxembourg,208,54,154
1995,68,Bolivia (Plurinational State of),Luxembourg,5,2,3
1995,152,Chile,Luxembourg,13,7,6
1995,170,Colombia,Luxembourg,21,11,10
1995,604,Peru,Luxembourg,9,5,4
1995,36,Australia,Luxembourg,151,73,78
1995,100,Bulgaria,Luxembourg,3,1,2
1995,203,Czechia,Luxembourg,6,4,2
1995,348,Hungary,Luxembourg,49,26,23
1995,616,Poland,Luxembourg,151,67,84
1995,642,Romania,Luxembourg,20,14,6
1995,643,Russian Federation,Luxembourg,91,48,43
1995,703,Slovakia,Luxembourg,20,10,10
1995,208,Denmark,Luxembourg,145,76,69
1995,246,Finland,Luxembourg,23,13,10
1995,352,Iceland,Luxembourg,64,32,32
1995,372,Ireland,Luxembourg,36,15,21
1995,428,Latvia,Luxembourg,1,0,1
1995,578,Norway,Luxembourg,67,41,26
1995,752,Sweden,Luxembourg,111,52,59
1995,826,United Kingdom,Luxembourg,926,430,496
1995,191,Croatia,Luxembourg,7,2,5
1995,300,Greece,Luxembourg,121,48,73
1995,380,Italy,Luxembourg,779,259,520
1995,620,Portugal,Luxembourg,2341,1161,1180
1995,688,Serbia,Luxembourg,70,44,26
1995,705,Slovenia,Luxembourg,25,11,14
1995,724,Spain,Luxembourg,783,370,413
1995,40,Austria,Luxembourg,474,256,218
1995,56,Belgium,Luxembourg,12473,7237,5236
1995,250,France,Luxembourg,8275,3464,4811
1995,276,Germany,Luxembourg,5626,3090,2536
1995,438,Liechtenstein,Luxembourg,7,5,2
1995,528,Netherlands,Luxembourg,587,269,318
1995,756,Switzerland,Luxembourg,1442,700,742
1995,124,Canada,Luxembourg,532,258,274
1995,840,United States of America,Luxembourg,2129,1052,1077
2000,516,Namibia,Luxembourg,58,26,32
2000,710,South Africa,Luxembourg,12,4,8
2000,132,Cabo Verde,Luxembourg,10,3,7
2000,196,Cyprus,Luxembourg,5,1,4
2000,792,Turkey,Luxembourg,42,19,23
2000,188,Costa Rica,Luxembourg,11,3,8
2000,32,Argentina,Luxembourg,203,55,148
2000,68,Bolivia (Plurinational State of),Luxembourg,8,3,5
2000,152,Chile,Luxembourg,15,7,8
2000,170,Colombia,Luxembourg,20,10,10
2000,604,Peru,Luxembourg,11,6,5
2000,36,Australia,Luxembourg,150,78,72
2000,100,Bulgaria,Luxembourg,4,2,2
2000,203,Czechia,Luxembourg,8,5,3
2000,348,Hungary,Luxembourg,94,50,44
2000,616,Poland,Luxembourg,130,57,73
2000,642,Romania,Luxembourg,35,23,12
2000,643,Russian Federation,Luxembourg,87,48,39
2000,703,Slovakia,Luxembourg,32,15,17
2000,208,Denmark,Luxembourg,226,121,105
2000,246,Finland,Luxembourg,27,17,10
2000,352,Iceland,Luxembourg,75,38,37
2000,372,Ireland,Luxembourg,73,31,42
2000,428,Latvia,Luxembourg,1,0,1
2000,578,Norway,Luxembourg,89,55,34
2000,752,Sweden,Luxembourg,120,56,64
2000,826,United Kingdom,Luxembourg,1177,566,611
2000,191,Croatia,Luxembourg,13,4,9
2000,300,Greece,Luxembourg,98,42,56
2000,380,Italy,Luxembourg,628,233,395
2000,620,Portugal,Luxembourg,3293,1620,1673
2000,688,Serbia,Luxembourg,96,59,37
2000,705,Slovenia,Luxembourg,28,11,17
2000,724,Spain,Luxembourg,1245,610,635
2000,40,Austria,Luxembourg,528,289,239
2000,56,Belgium,Luxembourg,11679,6794,4885
2000,250,France,Luxembourg,8534,3496,5038
2000,276,Germany,Luxembourg,5782,3009,2773
2000,438,Liechtenstein,Luxembourg,6,4,2
2000,528,Netherlands,Luxembourg,796,358,438
2000,756,Switzerland,Luxembourg,1619,828,791
2000,124,Canada,Luxembourg,525,253,272
2000,840,United States of America,Luxembourg,2204,1099,1105
2005,516,Namibia,Luxembourg,45,20,25
2005,710,South Africa,Luxembourg,14,4,10
2005,132,Cabo Verde,Luxembourg,7,2,5
2005,196,Cyprus,Luxembourg,7,1,6
2005,792,Turkey,Luxembourg,43,19,24
2005,188,Costa Rica,Luxembourg,7,2,5
2005,32,Argentina,Luxembourg,150,42,108
2005,68,Bolivia (Plurinational State of),Luxembourg,7,4,3
2005,152,Chile,Luxembourg,22,11,11
2005,170,Colombia,Luxembourg,19,10,9
2005,604,Peru,Luxembourg,13,7,6
2005,36,Australia,Luxembourg,170,79,91
2005,100,Bulgaria,Luxembourg,6,3,3
2005,203,Czechia,Luxembourg,13,9,4
2005,348,Hungary,Luxembourg,116,63,53
2005,616,Poland,Luxembourg,181,70,111
2005,642,Romania,Luxembourg,25,17,8
2005,643,Russian Federation,Luxembourg,61,35,26
2005,703,Slovakia,Luxembourg,36,17,19
2005,208,Denmark,Luxembourg,334,171,163
2005,246,Finland,Luxembourg,53,27,26
2005,352,Iceland,Luxembourg,94,46,48
2005,372,Ireland,Luxembourg,123,64,59
2005,428,Latvia,Luxembourg,7,4,3
2005,578,Norway,Luxembourg,105,64,41
2005,752,Sweden,Luxembourg,157,74,83
2005,826,United Kingdom,Luxembourg,1460,691,769
2005,191,Croatia,Luxembourg,22,8,14
2005,300,Greece,Luxembourg,120,54,66
2005,380,Italy,Luxembourg,2713,1202,1511
2005,620,Portugal,Luxembourg,3683,1820,1863
2005,688,Serbia,Luxembourg,95,58,37
2005,705,Slovenia,Luxembourg,29,12,17
2005,724,Spain,Luxembourg,1178,561,617
2005,40,Austria,Luxembourg,590,316,274
2005,56,Belgium,Luxembourg,11603,6625,4978
2005,250,France,Luxembourg,12062,5373,6689
2005,276,Germany,Luxembourg,11880,6015,5865
2005,438,Liechtenstein,Luxembourg,5,3,2
2005,528,Netherlands,Luxembourg,871,397,474
2005,756,Switzerland,Luxembourg,1819,896,923
2005,124,Canada,Luxembourg,488,233,255
2005,840,United States of America,Luxembourg,2470,1239,1231
2010,516,Namibia,Luxembourg,43,19,24
2010,710,South Africa,Luxembourg,21,6,15
2010,132,Cabo Verde,Luxembourg,4,1,3
2010,196,Cyprus,Luxembourg,11,2,9
2010,792,Turkey,Luxembourg,44,19,25
2010,188,Costa Rica,Luxembourg,15,4,11
2010,32,Argentina,Luxembourg,96,29,67
2010,68,Bolivia (Plurinational State of),Luxembourg,5,4,1
2010,76,Brazil,Luxembourg,53,39,14
2010,152,Chile,Luxembourg,30,15,15
2010,170,Colombia,Luxembourg,21,11,10
2010,604,Peru,Luxembourg,14,8,6
2010,36,Australia,Luxembourg,210,104,106
2010,100,Bulgaria,Luxembourg,8,5,3
2010,203,Czechia,Luxembourg,17,12,5
2010,348,Hungary,Luxembourg,138,76,62
2010,616,Poland,Luxembourg,239,85,154
2010,642,Romania,Luxembourg,19,13,6
2010,643,Russian Federation,Luxembourg,35,21,14
2010,703,Slovakia,Luxembourg,40,19,21
2010,208,Denmark,Luxembourg,434,218,216
2010,233,Estonia,Luxembourg,14,7,7
2010,246,Finland,Luxembourg,91,42,49
2010,352,Iceland,Luxembourg,112,53,59
2010,372,Ireland,Luxembourg,153,80,73
2010,428,Latvia,Luxembourg,13,8,5
2010,578,Norway,Luxembourg,123,75,48
2010,752,Sweden,Luxembourg,238,124,114
2010,826,United Kingdom,Luxembourg,1538,745,793
2010,191,Croatia,Luxembourg,31,12,19
2010,300,Greece,Luxembourg,147,68,79
2010,380,Italy,Luxembourg,4782,2139,2643
2010,499,Montenegro,Luxembourg,96,36,60
2010,620,Portugal,Luxembourg,3463,1723,1740
2010,688,Serbia,Luxembourg,93,56,37
2010,705,Slovenia,Luxembourg,50,25,25
2010,724,Spain,Luxembourg,1398,686,712
2010,40,Austria,Luxembourg,652,344,308
2010,56,Belgium,Luxembourg,12322,5650,6672
2010,250,France,Luxembourg,12102,4796,7306
2010,276,Germany,Luxembourg,16941,8575,8366
2010,438,Liechtenstein,Luxembourg,5,2,3
2010,528,Netherlands,Luxembourg,1000,456,544
2010,756,Switzerland,Luxembourg,2140,979,1161
2010,124,Canada,Luxembourg,420,200,220
2010,840,United States of America,Luxembourg,2820,1396,1424
2015,516,Namibia,Luxembourg,42,19,23
2015,710,South Africa,Luxembourg,36,9,27
2015,132,Cabo Verde,Luxembourg,4,1,3
2015,196,Cyprus,Luxembourg,10,2,8
2015,792,Turkey,Luxembourg,44,19,25
2015,188,Costa Rica,Luxembourg,15,4,11
2015,32,Argentina,Luxembourg,96,29,67
2015,68,Bolivia (Plurinational State of),Luxembourg,6,5,1
2015,76,Brazil,Luxembourg,64,47,17
2015,152,Chile,Luxembourg,45,23,22
2015,170,Colombia,Luxembourg,23,12,11
2015,604,Peru,Luxembourg,15,9,6
2015,36,Australia,Luxembourg,250,115,135
2015,100,Bulgaria,Luxembourg,73,35,38
2015,203,Czechia,Luxembourg,22,16,6
2015,348,Hungary,Luxembourg,178,100,78
2015,616,Poland,Luxembourg,230,85,145
2015,642,Romania,Luxembourg,30,18,12
2015,643,Russian Federation,Luxembourg,36,21,15
2015,703,Slovakia,Luxembourg,57,29,28
2015,208,Denmark,Luxembourg,523,268,255
2015,233,Estonia,Luxembourg,11,5,6
2015,246,Finland,Luxembourg,118,53,65
2015,352,Iceland,Luxembourg,142,68,74
2015,372,Ireland,Luxembourg,156,81,75
2015,428,Latvia,Luxembourg,7,2,5
2015,578,Norway,Luxembourg,141,90,51
2015,752,Sweden,Luxembourg,319,152,167
2015,826,United Kingdom,Luxembourg,1966,922,1044
2015,191,Croatia,Luxembourg,31,12,19
2015,300,Greece,Luxembourg,137,60,77
2015,380,Italy,Luxembourg,4717,2115,2602
2015,499,Montenegro,Luxembourg,100,38,62
2015,620,Portugal,Luxembourg,3926,1853,2073
2015,688,Serbia,Luxembourg,90,54,36
2015,705,Slovenia,Luxembourg,39,24,15
2015,724,Spain,Luxembourg,1425,705,720
2015,40,Austria,Luxembourg,763,406,357
2015,56,Belgium,Luxembourg,13351,6287,7064
2015,250,France,Luxembourg,16092,7678,8414
2015,276,Germany,Luxembourg,17652,8914,8738
2015,438,Liechtenstein,Luxembourg,3,1,2
2015,528,Netherlands,Luxembourg,1139,523,616
2015,756,Switzerland,Luxembourg,2381,1153,1228
2015,124,Canada,Luxembourg,670,352,318
2015,840,United States of America,Luxembourg,2669,1316,1353
2019,516,Namibia,Luxembourg,44,20,24
2019,710,South Africa,Luxembourg,39,10,29
2019,132,Cabo Verde,Luxembourg,4,1,3
2019,196,Cyprus,Luxembourg,9,2,7
2019,792,Turkey,Luxembourg,59,26,33
2019,188,Costa Rica,Luxembourg,15,4,11
2019,32,Argentina,Luxembourg,97,29,68
2019,68,Bolivia (Plurinational State of),Luxembourg,6,5,1
2019,76,Brazil,Luxembourg,72,53,19
2019,152,Chile,Luxembourg,60,29,31
2019,170,Colombia,Luxembourg,23,12,11
2019,604,Peru,Luxembourg,17,11,6
2019,36,Australia,Luxembourg,296,142,154
2019,100,Bulgaria,Luxembourg,99,52,47
2019,203,Czechia,Luxembourg,27,19,8
2019,348,Hungary,Luxembourg,217,121,96
2019,616,Poland,Luxembourg,243,96,147
2019,642,Romania,Luxembourg,137,72,65
2019,643,Russian Federation,Luxembourg,35,21,14
2019,703,Slovakia,Luxembourg,69,34,35
2019,208,Denmark,Luxembourg,626,314,312
2019,233,Estonia,Luxembourg,14,10,4
2019,246,Finland,Luxembourg,130,61,69
2019,352,Iceland,Luxembourg,161,84,77
2019,372,Ireland,Luxembourg,171,89,82
2019,428,Latvia,Luxembourg,8,3,5
2019,578,Norway,Luxembourg,156,99,57
2019,752,Sweden,Luxembourg,387,196,191
2019,826,United Kingdom,Luxembourg,2232,1050,1182
2019,191,Croatia,Luxembourg,28,11,17
2019,300,Greece,Luxembourg,133,61,72
2019,380,Italy,Luxembourg,4815,2185,2630
2019,499,Montenegro,Luxembourg,100,39,61
2019,620,Portugal,Luxembourg,3992,1889,2103
2019,688,Serbia,Luxembourg,91,55,36
2019,705,Slovenia,Luxembourg,37,21,16
2019,724,Spain,Luxembourg,1476,713,763
2019,40,Austria,Luxembourg,900,486,414
2019,56,Belgium,Luxembourg,14529,6949,7580
2019,250,France,Luxembourg,17033,8107,8926
2019,276,Germany,Luxembourg,19363,10288,9075
2019,438,Liechtenstein,Luxembourg,3,1,2
2019,528,Netherlands,Luxembourg,1475,731,744
2019,756,Switzerland,Luxembourg,2446,1182,1264
2019,124,Canada,Luxembourg,717,377,340
2019,840,United States of America,Luxembourg,2881,1404,1477
1990,174,Comoros,Madagascar,10810,5007,5803
1990,480,Mauritius,Madagascar,56,22,34
1990,175,Mayotte,Madagascar,1086,507,579
1990,638,Réunion,Madagascar,3339,1793,1546
1990,690,Seychelles,Madagascar,34,4,30
1990,72,Botswana,Madagascar,100,60,40
1990,710,South Africa,Madagascar,422,122,300
1990,818,Egypt,Madagascar,48,48,0
1990,196,Cyprus,Madagascar,2,1,1
1990,188,Costa Rica,Madagascar,2,0,2
1990,32,Argentina,Madagascar,14,0,14
1990,68,Bolivia (Plurinational State of),Madagascar,2,1,1
1990,152,Chile,Madagascar,9,3,6
1990,36,Australia,Madagascar,137,73,64
1990,203,Czechia,Madagascar,6,4,2
1990,348,Hungary,Madagascar,8,7,1
1990,643,Russian Federation,Madagascar,144,71,73
1990,208,Denmark,Madagascar,14,10,4
1990,372,Ireland,Madagascar,2,1,1
1990,428,Latvia,Madagascar,1,1,0
1990,578,Norway,Madagascar,337,179,158
1990,752,Sweden,Madagascar,57,19,38
1990,826,United Kingdom,Madagascar,110,56,54
1990,300,Greece,Madagascar,63,34,29
1990,380,Italy,Madagascar,193,67,126
1990,620,Portugal,Madagascar,10,7,3
1990,724,Spain,Madagascar,39,11,28
1990,40,Austria,Madagascar,42,12,30
1990,56,Belgium,Madagascar,1049,277,772
1990,250,France,Madagascar,38740,15999,22741
1990,276,Germany,Madagascar,430,239,191
1990,528,Netherlands,Madagascar,68,30,38
1990,756,Switzerland,Madagascar,870,355,515
1990,124,Canada,Madagascar,1180,574,606
1995,174,Comoros,Madagascar,10701,4929,5772
1995,480,Mauritius,Madagascar,242,174,68
1995,175,Mayotte,Madagascar,2061,1053,1008
1995,638,Réunion,Madagascar,7218,3561,3657
1995,690,Seychelles,Madagascar,279,22,257
1995,72,Botswana,Madagascar,161,95,66
1995,710,South Africa,Madagascar,263,92,171
1995,818,Egypt,Madagascar,38,37,1
1995,196,Cyprus,Madagascar,3,1,2
1995,188,Costa Rica,Madagascar,2,0,2
1995,32,Argentina,Madagascar,14,0,14
1995,68,Bolivia (Plurinational State of),Madagascar,4,1,3
1995,152,Chile,Madagascar,9,6,3
1995,36,Australia,Madagascar,153,79,74
1995,100,Bulgaria,Madagascar,1,1,0
1995,203,Czechia,Madagascar,9,6,3
1995,348,Hungary,Madagascar,15,8,7
1995,643,Russian Federation,Madagascar,139,74,65
1995,208,Denmark,Madagascar,18,11,7
1995,246,Finland,Madagascar,2,1,1
1995,352,Iceland,Madagascar,1,1,0
1995,372,Ireland,Madagascar,6,2,4
1995,428,Latvia,Madagascar,1,1,0
1995,578,Norway,Madagascar,365,184,181
1995,752,Sweden,Madagascar,68,22,46
1995,826,United Kingdom,Madagascar,433,161,272
1995,300,Greece,Madagascar,101,48,53
1995,380,Italy,Madagascar,645,125,520
1995,620,Portugal,Madagascar,22,15,7
1995,724,Spain,Madagascar,60,18,42
1995,40,Austria,Madagascar,47,13,34
1995,56,Belgium,Madagascar,1049,277,772
1995,250,France,Madagascar,39993,16121,23872
1995,276,Germany,Madagascar,538,249,289
1995,528,Netherlands,Madagascar,100,43,57
1995,756,Switzerland,Madagascar,1034,442,592
1995,124,Canada,Madagascar,1538,744,794
2000,174,Comoros,Madagascar,10595,4851,5744
2000,480,Mauritius,Madagascar,563,409,154
2000,175,Mayotte,Madagascar,3669,1789,1880
2000,638,Réunion,Madagascar,11431,5468,5963
2000,690,Seychelles,Madagascar,525,40,485
2000,72,Botswana,Madagascar,238,140,98
2000,710,South Africa,Madagascar,181,81,100
2000,818,Egypt,Madagascar,30,28,2
2000,196,Cyprus,Madagascar,4,2,2
2000,188,Costa Rica,Madagascar,2,0,2
2000,32,Argentina,Madagascar,14,1,13
2000,68,Bolivia (Plurinational State of),Madagascar,5,0,5
2000,152,Chile,Madagascar,9,5,4
2000,36,Australia,Madagascar,180,83,97
2000,100,Bulgaria,Madagascar,1,1,0
2000,203,Czechia,Madagascar,12,8,4
2000,348,Hungary,Madagascar,22,9,13
2000,643,Russian Federation,Madagascar,130,75,55
2000,208,Denmark,Madagascar,22,12,10
2000,246,Finland,Madagascar,3,1,2
2000,352,Iceland,Madagascar,1,1,0
2000,372,Ireland,Madagascar,14,5,9
2000,428,Latvia,Madagascar,1,1,0
2000,578,Norway,Madagascar,371,186,185
2000,752,Sweden,Madagascar,73,23,50
2000,826,United Kingdom,Madagascar,765,268,497
2000,300,Greece,Madagascar,140,62,78
2000,380,Italy,Madagascar,1097,184,913
2000,620,Portugal,Madagascar,35,22,13
2000,705,Slovenia,Madagascar,1,0,1
2000,724,Spain,Madagascar,734,263,471
2000,40,Austria,Madagascar,52,15,37
2000,56,Belgium,Madagascar,1016,268,748
2000,250,France,Madagascar,41245,16243,25002
2000,276,Germany,Madagascar,646,260,386
2000,528,Netherlands,Madagascar,137,56,81
2000,756,Switzerland,Madagascar,1202,531,671
2000,124,Canada,Madagascar,1932,932,1000
2005,174,Comoros,Madagascar,10142,4688,5454
2005,480,Mauritius,Madagascar,1236,691,545
2005,175,Mayotte,Madagascar,4755,2308,2447
2005,638,Réunion,Madagascar,14218,6769,7449
2005,690,Seychelles,Madagascar,620,305,315
2005,72,Botswana,Madagascar,359,209,150
2005,710,South Africa,Madagascar,237,100,137
2005,818,Egypt,Madagascar,36,34,2
2005,196,Cyprus,Madagascar,6,3,3
2005,188,Costa Rica,Madagascar,1,0,1
2005,32,Argentina,Madagascar,11,2,9
2005,68,Bolivia (Plurinational State of),Madagascar,5,1,4
2005,152,Chile,Madagascar,13,8,5
2005,36,Australia,Madagascar,220,105,115
2005,100,Bulgaria,Madagascar,2,2,0
2005,203,Czechia,Madagascar,20,13,7
2005,348,Hungary,Madagascar,27,11,16
2005,643,Russian Federation,Madagascar,107,67,40
2005,208,Denmark,Madagascar,38,16,22
2005,246,Finland,Madagascar,8,2,6
2005,352,Iceland,Madagascar,2,1,1
2005,372,Ireland,Madagascar,14,5,9
2005,578,Norway,Madagascar,423,202,221
2005,752,Sweden,Madagascar,81,26,55
2005,826,United Kingdom,Madagascar,847,285,562
2005,300,Greece,Madagascar,137,59,78
2005,380,Italy,Madagascar,1740,454,1286
2005,620,Portugal,Madagascar,31,19,12
2005,705,Slovenia,Madagascar,1,0,1
2005,724,Spain,Madagascar,353,123,230
2005,40,Austria,Madagascar,58,16,42
2005,56,Belgium,Madagascar,1390,341,1049
2005,250,France,Madagascar,106558,45345,61213
2005,276,Germany,Madagascar,997,351,646
2005,528,Netherlands,Madagascar,158,58,100
2005,756,Switzerland,Madagascar,1341,548,793
2005,124,Canada,Madagascar,2635,1247,1388
2010,174,Comoros,Madagascar,9689,4521,5168
2010,480,Mauritius,Madagascar,1979,1038,941
2010,175,Mayotte,Madagascar,5230,2480,2750
2010,638,Réunion,Madagascar,16210,7678,8532
2010,690,Seychelles,Madagascar,716,570,146
2010,72,Botswana,Madagascar,482,279,203
2010,710,South Africa,Madagascar,370,155,215
2010,818,Egypt,Madagascar,39,37,2
2010,196,Cyprus,Madagascar,9,5,4
2010,188,Costa Rica,Madagascar,3,0,3
2010,32,Argentina,Madagascar,7,2,5
2010,68,Bolivia (Plurinational State of),Madagascar,4,2,2
2010,76,Brazil,Madagascar,35,4,31
2010,152,Chile,Madagascar,18,11,7
2010,36,Australia,Madagascar,260,117,143
2010,100,Bulgaria,Madagascar,2,2,0
2010,203,Czechia,Madagascar,27,17,10
2010,348,Hungary,Madagascar,32,13,19
2010,643,Russian Federation,Madagascar,82,56,26
2010,208,Denmark,Madagascar,53,20,33
2010,233,Estonia,Madagascar,1,0,1
2010,246,Finland,Madagascar,11,0,11
2010,352,Iceland,Madagascar,2,1,1
2010,372,Ireland,Madagascar,12,4,8
2010,578,Norway,Madagascar,444,212,232
2010,752,Sweden,Madagascar,89,33,56
2010,826,United Kingdom,Madagascar,892,313,579
2010,300,Greece,Madagascar,138,57,81
2010,380,Italy,Madagascar,2348,695,1653
2010,620,Portugal,Madagascar,23,14,9
2010,705,Slovenia,Madagascar,8,2,6
2010,724,Spain,Madagascar,383,126,257
2010,40,Austria,Madagascar,64,17,47
2010,56,Belgium,Madagascar,1773,491,1282
2010,250,France,Madagascar,113062,42986,70076
2010,276,Germany,Madagascar,1288,432,856
2010,528,Netherlands,Madagascar,162,67,95
2010,756,Switzerland,Madagascar,1589,604,985
2010,124,Canada,Madagascar,3335,1566,1769
2015,174,Comoros,Madagascar,9651,4539,5112
2015,480,Mauritius,Madagascar,2277,1247,1030
2015,175,Mayotte,Madagascar,5318,2461,2857
2015,638,Réunion,Madagascar,16763,7899,8864
2015,690,Seychelles,Madagascar,801,647,154
2015,72,Botswana,Madagascar,526,305,221
2015,710,South Africa,Madagascar,666,260,406
2015,324,Guinea,Madagascar,10,5,5
2015,818,Egypt,Madagascar,28,27,1
2015,196,Cyprus,Madagascar,8,5,3
2015,188,Costa Rica,Madagascar,3,0,3
2015,32,Argentina,Madagascar,7,2,5
2015,68,Bolivia (Plurinational State of),Madagascar,5,3,2
2015,76,Brazil,Madagascar,42,5,37
2015,152,Chile,Madagascar,27,17,10
2015,36,Australia,Madagascar,290,116,174
2015,100,Bulgaria,Madagascar,2,2,0
2015,203,Czechia,Madagascar,24,15,9
2015,348,Hungary,Madagascar,34,18,16
2015,643,Russian Federation,Madagascar,84,58,26
2015,208,Denmark,Madagascar,62,23,39
2015,233,Estonia,Madagascar,1,0,1
2015,246,Finland,Madagascar,17,6,11
2015,352,Iceland,Madagascar,2,2,0
2015,372,Ireland,Madagascar,12,4,8
2015,578,Norway,Madagascar,476,224,252
2015,752,Sweden,Madagascar,119,38,81
2015,826,United Kingdom,Madagascar,1140,378,762
2015,300,Greece,Madagascar,129,50,79
2015,380,Italy,Madagascar,2342,692,1650
2015,620,Portugal,Madagascar,26,15,11
2015,705,Slovenia,Madagascar,15,4,11
2015,724,Spain,Madagascar,462,152,310
2015,40,Austria,Madagascar,75,20,55
2015,56,Belgium,Madagascar,2079,584,1495
2015,250,France,Madagascar,125247,45480,79767
2015,276,Germany,Madagascar,1342,448,894
2015,528,Netherlands,Madagascar,174,77,97
2015,756,Switzerland,Madagascar,1836,649,1187
2015,124,Canada,Madagascar,3528,1600,1928
2019,174,Comoros,Madagascar,9611,4521,5090
2019,480,Mauritius,Madagascar,2298,1259,1039
2019,175,Mayotte,Madagascar,5364,2482,2882
2019,638,Réunion,Madagascar,17019,8020,8999
2019,690,Seychelles,Madagascar,809,654,155
2019,72,Botswana,Madagascar,563,327,236
2019,710,South Africa,Madagascar,746,293,453
2019,324,Guinea,Madagascar,9,5,4
2019,818,Egypt,Madagascar,39,38,1
2019,196,Cyprus,Madagascar,7,5,2
2019,188,Costa Rica,Madagascar,3,0,3
2019,32,Argentina,Madagascar,7,2,5
2019,68,Bolivia (Plurinational State of),Madagascar,5,3,2
2019,76,Brazil,Madagascar,47,6,41
2019,152,Chile,Madagascar,36,22,14
2019,36,Australia,Madagascar,338,132,206
2019,100,Bulgaria,Madagascar,2,2,0
2019,203,Czechia,Madagascar,25,15,10
2019,348,Hungary,Madagascar,34,17,17
2019,643,Russian Federation,Madagascar,83,58,25
2019,208,Denmark,Madagascar,76,32,44
2019,246,Finland,Madagascar,22,8,14
2019,352,Iceland,Madagascar,2,2,0
2019,372,Ireland,Madagascar,13,5,8
2019,578,Norway,Madagascar,530,246,284
2019,752,Sweden,Madagascar,141,50,91
2019,826,United Kingdom,Madagascar,1294,431,863
2019,300,Greece,Madagascar,125,51,74
2019,380,Italy,Madagascar,2602,773,1829
2019,620,Portugal,Madagascar,26,15,11
2019,705,Slovenia,Madagascar,17,4,13
2019,724,Spain,Madagascar,478,150,328
2019,40,Austria,Madagascar,88,25,63
2019,56,Belgium,Madagascar,2314,663,1651
2019,250,France,Madagascar,132574,47948,84626
2019,276,Germany,Madagascar,1472,429,1043
2019,528,Netherlands,Madagascar,210,91,119
2019,756,Switzerland,Madagascar,1967,708,1259
2019,124,Canada,Madagascar,3780,1714,2066
1990,232,Eritrea,Malawi,114,39,75
1990,508,Mozambique,Malawi,22975,12624,10351
1990,800,Uganda,Malawi,184,97,87
1990,834,United Republic of Tanzania,Malawi,7218,3913,3305
1990,894,Zambia,Malawi,17073,10441,6632
1990,716,Zimbabwe,Malawi,69618,40140,29478
1990,72,Botswana,Malawi,713,444,269
1990,426,Lesotho,Malawi,51,31,20
1990,516,Namibia,Malawi,545,289,256
1990,710,South Africa,Malawi,13336,10401,2935
1990,818,Egypt,Malawi,23,18,5
1990,196,Cyprus,Malawi,2,1,1
1990,152,Chile,Malawi,1,0,1
1990,36,Australia,Malawi,360,199,161
1990,203,Czechia,Malawi,5,2,3
1990,643,Russian Federation,Malawi,12,6,6
1990,208,Denmark,Malawi,38,19,19
1990,246,Finland,Malawi,2,2,0
1990,372,Ireland,Malawi,14,7,7
1990,428,Latvia,Malawi,1,0,1
1990,578,Norway,Malawi,8,5,3
1990,752,Sweden,Malawi,31,17,14
1990,826,United Kingdom,Malawi,10474,5432,5042
1990,380,Italy,Malawi,8,2,6
1990,620,Portugal,Malawi,55,21,34
1990,724,Spain,Malawi,3,1,2
1990,40,Austria,Malawi,21,11,10
1990,56,Belgium,Malawi,29,18,11
1990,250,France,Malawi,77,39,38
1990,528,Netherlands,Malawi,110,58,52
1990,756,Switzerland,Malawi,43,22,21
1990,124,Canada,Malawi,293,143,150
1995,232,Eritrea,Malawi,228,101,127
1995,508,Mozambique,Malawi,31600,17427,14173
1995,800,Uganda,Malawi,174,89,85
1995,834,United Republic of Tanzania,Malawi,7121,3861,3260
1995,894,Zambia,Malawi,12382,7573,4809
1995,716,Zimbabwe,Malawi,67945,38762,29183
1995,72,Botswana,Malawi,1150,686,464
1995,426,Lesotho,Malawi,44,27,17
1995,516,Namibia,Malawi,521,278,243
1995,710,South Africa,Malawi,17067,13670,3397
1995,818,Egypt,Malawi,21,17,4
1995,196,Cyprus,Malawi,3,1,2
1995,68,Bolivia (Plurinational State of),Malawi,3,1,2
1995,152,Chile,Malawi,1,1,0
1995,36,Australia,Malawi,468,246,222
1995,203,Czechia,Malawi,7,3,4
1995,643,Russian Federation,Malawi,9,6,3
1995,208,Denmark,Malawi,43,19,24
1995,246,Finland,Malawi,2,2,0
1995,352,Iceland,Malawi,1,1,0
1995,372,Ireland,Malawi,40,20,20
1995,428,Latvia,Malawi,1,0,1
1995,578,Norway,Malawi,3,0,3
1995,752,Sweden,Malawi,37,20,17
1995,826,United Kingdom,Malawi,11110,5652,5458
1995,380,Italy,Malawi,29,10,19
1995,620,Portugal,Malawi,119,46,73
1995,724,Spain,Malawi,6,3,3
1995,40,Austria,Malawi,24,13,11
1995,56,Belgium,Malawi,29,18,11
1995,250,France,Malawi,80,40,40
1995,528,Netherlands,Malawi,161,83,78
1995,756,Switzerland,Malawi,59,33,26
1995,124,Canada,Malawi,338,164,174
2000,232,Eritrea,Malawi,343,163,180
2000,508,Mozambique,Malawi,36755,19734,17021
2000,800,Uganda,Malawi,7,5,2
2000,834,United Republic of Tanzania,Malawi,7098,3848,3250
2000,894,Zambia,Malawi,6937,4273,2664
2000,716,Zimbabwe,Malawi,92989,53031,39958
2000,72,Botswana,Malawi,1709,1002,707
2000,426,Lesotho,Malawi,36,22,14
2000,516,Namibia,Malawi,485,259,226
2000,710,South Africa,Malawi,26025,20974,5051
2000,818,Egypt,Malawi,21,17,4
2000,196,Cyprus,Malawi,4,2,2
2000,68,Bolivia (Plurinational State of),Malawi,5,2,3
2000,152,Chile,Malawi,2,1,1
2000,36,Australia,Malawi,540,284,256
2000,203,Czechia,Malawi,9,4,5
2000,643,Russian Federation,Malawi,7,6,1
2000,208,Denmark,Malawi,47,19,28
2000,246,Finland,Malawi,2,2,0
2000,352,Iceland,Malawi,1,1,0
2000,372,Ireland,Malawi,88,46,42
2000,428,Latvia,Malawi,1,0,1
2000,578,Norway,Malawi,12,5,7
2000,752,Sweden,Malawi,40,21,19
2000,826,United Kingdom,Malawi,11934,5953,5981
2000,380,Italy,Malawi,49,18,31
2000,620,Portugal,Malawi,189,73,116
2000,705,Slovenia,Malawi,2,0,2
2000,724,Spain,Malawi,72,38,34
2000,40,Austria,Malawi,27,15,12
2000,56,Belgium,Malawi,27,16,11
2000,250,France,Malawi,82,40,42
2000,528,Netherlands,Malawi,218,110,108
2000,756,Switzerland,Malawi,77,45,32
2000,124,Canada,Malawi,391,189,202
2005,232,Eritrea,Malawi,551,291,260
2005,508,Mozambique,Malawi,49710,24550,25160
2005,800,Uganda,Malawi,6,5,1
2005,834,United Republic of Tanzania,Malawi,7048,3822,3226
2005,894,Zambia,Malawi,9665,5954,3711
2005,716,Zimbabwe,Malawi,102211,58125,44086
2005,72,Botswana,Malawi,1489,896,593
2005,426,Lesotho,Malawi,36,22,14
2005,516,Namibia,Malawi,383,204,179
2005,710,South Africa,Malawi,34248,27305,6943
2005,818,Egypt,Malawi,25,21,4
2005,196,Cyprus,Malawi,6,3,3
2005,68,Bolivia (Plurinational State of),Malawi,6,1,5
2005,152,Chile,Malawi,3,2,1
2005,36,Australia,Malawi,760,370,390
2005,203,Czechia,Malawi,5,2,3
2005,643,Russian Federation,Malawi,17,11,6
2005,208,Denmark,Malawi,64,30,34
2005,246,Finland,Malawi,8,5,3
2005,352,Iceland,Malawi,2,1,1
2005,372,Ireland,Malawi,88,49,39
2005,578,Norway,Malawi,55,27,28
2005,752,Sweden,Malawi,54,26,28
2005,826,United Kingdom,Malawi,13376,6480,6896
2005,380,Italy,Malawi,110,48,62
2005,620,Portugal,Malawi,322,125,197
2005,705,Slovenia,Malawi,1,0,1
2005,724,Spain,Malawi,35,18,17
2005,40,Austria,Malawi,30,16,14
2005,56,Belgium,Malawi,55,30,25
2005,250,France,Malawi,133,68,65
2005,528,Netherlands,Malawi,253,124,129
2005,756,Switzerland,Malawi,84,45,39
2005,124,Canada,Malawi,529,306,223
2010,232,Eritrea,Malawi,759,418,341
2010,508,Mozambique,Malawi,57560,28427,29133
2010,800,Uganda,Malawi,6,5,1
2010,834,United Republic of Tanzania,Malawi,7011,3802,3209
2010,894,Zambia,Malawi,13467,6627,6840
2010,716,Zimbabwe,Malawi,103681,59314,44367
2010,72,Botswana,Malawi,1270,790,480
2010,426,Lesotho,Malawi,36,22,14
2010,516,Namibia,Malawi,369,197,172
2010,710,South Africa,Malawi,53650,42734,10916
2010,818,Egypt,Malawi,27,23,4
2010,196,Cyprus,Malawi,9,5,4
2010,68,Bolivia (Plurinational State of),Malawi,6,0,6
2010,76,Brazil,Malawi,9,9,0
2010,152,Chile,Malawi,4,3,1
2010,36,Australia,Malawi,1020,512,508
2010,203,Czechia,Malawi,5,2,3
2010,643,Russian Federation,Malawi,28,17,11
2010,208,Denmark,Malawi,78,39,39
2010,246,Finland,Malawi,18,11,7
2010,352,Iceland,Malawi,3,2,1
2010,372,Ireland,Malawi,74,39,35
2010,578,Norway,Malawi,97,43,54
2010,752,Sweden,Malawi,79,34,45
2010,826,United Kingdom,Malawi,14091,6976,7115
2010,380,Italy,Malawi,173,81,92
2010,620,Portugal,Malawi,403,158,245
2010,724,Spain,Malawi,43,19,24
2010,40,Austria,Malawi,33,17,16
2010,56,Belgium,Malawi,62,32,30
2010,250,France,Malawi,100,48,52
2010,528,Netherlands,Malawi,281,143,138
2010,756,Switzerland,Malawi,102,54,48
2010,124,Canada,Malawi,610,386,224
2015,232,Eritrea,Malawi,772,429,343
2015,508,Mozambique,Malawi,60437,29848,30589
2015,800,Uganda,Malawi,6,5,1
2015,834,United Republic of Tanzania,Malawi,6907,3751,3156
2015,894,Zambia,Malawi,10363,5115,5248
2015,716,Zimbabwe,Malawi,104247,58915,45332
2015,72,Botswana,Malawi,1386,862,524
2015,426,Lesotho,Malawi,36,22,14
2015,516,Namibia,Malawi,361,194,167
2015,710,South Africa,Malawi,96776,76083,20693
2015,324,Guinea,Malawi,17,12,5
2015,818,Egypt,Malawi,20,18,2
2015,196,Cyprus,Malawi,8,5,3
2015,68,Bolivia (Plurinational State of),Malawi,7,0,7
2015,76,Brazil,Malawi,11,11,0
2015,152,Chile,Malawi,6,5,1
2015,36,Australia,Malawi,1400,698,702
2015,203,Czechia,Malawi,5,5,0
2015,643,Russian Federation,Malawi,29,17,12
2015,208,Denmark,Malawi,92,45,47
2015,246,Finland,Malawi,64,37,27
2015,352,Iceland,Malawi,4,3,1
2015,372,Ireland,Malawi,76,40,36
2015,578,Norway,Malawi,120,55,65
2015,752,Sweden,Malawi,74,30,44
2015,826,United Kingdom,Malawi,18020,8652,9368
2015,380,Italy,Malawi,168,74,94
2015,620,Portugal,Malawi,457,166,291
2015,705,Slovenia,Malawi,2,2,0
2015,724,Spain,Malawi,65,31,34
2015,40,Austria,Malawi,38,19,19
2015,56,Belgium,Malawi,95,48,47
2015,250,France,Malawi,110,51,59
2015,528,Netherlands,Malawi,293,153,140
2015,756,Switzerland,Malawi,138,69,69
2015,124,Canada,Malawi,665,352,313
2019,232,Eritrea,Malawi,779,433,346
2019,508,Mozambique,Malawi,62854,31042,31812
2019,800,Uganda,Malawi,6,5,1
2019,834,United Republic of Tanzania,Malawi,6194,3348,2846
2019,894,Zambia,Malawi,12355,6109,6246
2019,716,Zimbabwe,Malawi,107051,61000,46051
2019,72,Botswana,Malawi,1484,923,561
2019,426,Lesotho,Malawi,37,23,14
2019,516,Namibia,Malawi,382,206,176
2019,710,South Africa,Malawi,108474,85303,23171
2019,324,Guinea,Malawi,16,12,4
2019,818,Egypt,Malawi,28,25,3
2019,196,Cyprus,Malawi,7,5,2
2019,68,Bolivia (Plurinational State of),Malawi,7,0,7
2019,76,Brazil,Malawi,12,12,0
2019,152,Chile,Malawi,8,7,1
2019,36,Australia,Malawi,1629,812,817
2019,203,Czechia,Malawi,6,5,1
2019,643,Russian Federation,Malawi,28,17,11
2019,208,Denmark,Malawi,91,47,44
2019,246,Finland,Malawi,129,66,63
2019,352,Iceland,Malawi,3,2,1
2019,372,Ireland,Malawi,83,44,39
2019,578,Norway,Malawi,121,53,68
2019,752,Sweden,Malawi,101,55,46
2019,826,United Kingdom,Malawi,20463,9852,10611
2019,380,Italy,Malawi,190,86,104
2019,620,Portugal,Malawi,464,169,295
2019,705,Slovenia,Malawi,2,2,0
2019,724,Spain,Malawi,67,31,36
2019,40,Austria,Malawi,44,22,22
2019,56,Belgium,Malawi,96,50,46
2019,250,France,Malawi,116,54,62
2019,528,Netherlands,Malawi,336,166,170
2019,756,Switzerland,Malawi,168,85,83
2019,124,Canada,Malawi,712,377,335
1990,480,Mauritius,Malaysia,36,15,21
1990,710,South Africa,Malaysia,889,63,826
1990,12,Algeria,Malaysia,1651,1070,581
1990,818,Egypt,Malaysia,2445,1550,895
1990,434,Libya,Malaysia,6980,4439,2541
1990,196,Cyprus,Malaysia,11,4,7
1990,400,Jordan,Malaysia,983,520,463
1990,792,Turkey,Malaysia,64,37,27
1990,50,Bangladesh,Malaysia,92533,49968,42565
1990,356,India,Malaysia,12295,5101,7194
1990,462,Maldives,Malaysia,46,25,21
1990,144,Sri Lanka,Malaysia,22,13,9
1990,156,China,Malaysia,3195,1777,1418
1990,344,"China, Hong Kong SAR",Malaysia,10234,5269,4965
1990,408,Dem. People's Republic of Korea,Malaysia,127,65,62
1990,392,Japan,Malaysia,4684,2386,2298
1990,410,Republic of Korea,Malaysia,51,28,23
1990,96,Brunei Darussalam,Malaysia,40306,21991,18315
1990,116,Cambodia,Malaysia,80,62,18
1990,360,Indonesia,Malaysia,5406,3216,2190
1990,608,Philippines,Malaysia,245,137,108
1990,702,Singapore,Malaysia,195072,87993,107079
1990,764,Thailand,Malaysia,1293,897,396
1990,626,Timor-Leste,Malaysia,134,71,63
1990,704,Viet Nam,Malaysia,13,11,2
1990,136,Cayman Islands,Malaysia,5,4,1
1990,214,Dominican Republic,Malaysia,36,7,29
1990,662,Saint Lucia,Malaysia,6,4,2
1990,188,Costa Rica,Malaysia,3,3,0
1990,484,Mexico,Malaysia,23,0,23
1990,591,Panama,Malaysia,12,9,3
1990,32,Argentina,Malaysia,6,1,5
1990,68,Bolivia (Plurinational State of),Malaysia,5,1,4
1990,152,Chile,Malaysia,22,12,10
1990,218,Ecuador,Malaysia,12,7,5
1990,604,Peru,Malaysia,26,14,12
1990,862,Venezuela (Bolivarian Republic of),Malaysia,30,15,15
1990,36,Australia,Malaysia,72135,34914,37221
1990,554,New Zealand,Malaysia,8661,4392,4269
1990,598,Papua New Guinea,Malaysia,115,63,52
1990,90,Solomon Islands,Malaysia,133,127,6
1990,203,Czechia,Malaysia,3,2,1
1990,616,Poland,Malaysia,11,7,4
1990,643,Russian Federation,Malaysia,557,273,284
1990,208,Denmark,Malaysia,298,135,163
1990,246,Finland,Malaysia,142,83,59
1990,352,Iceland,Malaysia,5,3,2
1990,372,Ireland,Malaysia,171,84,87
1990,428,Latvia,Malaysia,7,5,2
1990,578,Norway,Malaysia,182,87,95
1990,752,Sweden,Malaysia,755,387,368
1990,826,United Kingdom,Malaysia,42754,19432,23322
1990,300,Greece,Malaysia,63,34,29
1990,380,Italy,Malaysia,67,23,44
1990,470,Malta,Malaysia,16,5,11
1990,620,Portugal,Malaysia,10,4,6
1990,724,Spain,Malaysia,41,18,23
1990,40,Austria,Malaysia,266,126,140
1990,56,Belgium,Malaysia,334,142,192
1990,250,France,Malaysia,1901,837,1064
1990,276,Germany,Malaysia,2616,1499,1117
1990,442,Luxembourg,Malaysia,26,10,16
1990,528,Netherlands,Malaysia,2091,1050,1041
1990,756,Switzerland,Malaysia,1121,545,576
1990,60,Bermuda,Malaysia,13,9,4
1990,124,Canada,Malaysia,15453,7522,7931
1990,840,United States of America,Malaysia,33834,18084,15750
1995,480,Mauritius,Malaysia,33,16,17
1995,710,South Africa,Malaysia,554,81,473
1995,12,Algeria,Malaysia,1264,841,423
1995,818,Egypt,Malaysia,2168,1397,771
1995,434,Libya,Malaysia,6351,4394,1957
1995,196,Cyprus,Malaysia,16,5,11
1995,400,Jordan,Malaysia,664,351,313
1995,792,Turkey,Malaysia,155,87,68
1995,50,Bangladesh,Malaysia,126263,68183,58080
1995,356,India,Malaysia,13758,4605,9153
1995,462,Maldives,Malaysia,53,26,27
1995,144,Sri Lanka,Malaysia,128,95,33
1995,156,China,Malaysia,3805,2121,1684
1995,344,"China, Hong Kong SAR",Malaysia,11422,5844,5578
1995,408,Dem. People's Republic of Korea,Malaysia,138,70,68
1995,392,Japan,Malaysia,5428,2605,2823
1995,410,Republic of Korea,Malaysia,149,84,65
1995,96,Brunei Darussalam,Malaysia,42782,23525,19257
1995,116,Cambodia,Malaysia,210,162,48
1995,360,Indonesia,Malaysia,3577,2166,1411
1995,608,Philippines,Malaysia,329,181,148
1995,702,Singapore,Malaysia,431854,182690,249164
1995,764,Thailand,Malaysia,1170,815,355
1995,626,Timor-Leste,Malaysia,145,76,69
1995,704,Viet Nam,Malaysia,33,27,6
1995,136,Cayman Islands,Malaysia,11,8,3
1995,214,Dominican Republic,Malaysia,40,7,33
1995,662,Saint Lucia,Malaysia,6,3,3
1995,188,Costa Rica,Malaysia,2,2,0
1995,484,Mexico,Malaysia,41,15,26
1995,591,Panama,Malaysia,17,14,3
1995,32,Argentina,Malaysia,6,0,6
1995,68,Bolivia (Plurinational State of),Malaysia,6,1,5
1995,152,Chile,Malaysia,23,13,10
1995,218,Ecuador,Malaysia,14,8,6
1995,604,Peru,Malaysia,27,14,13
1995,862,Venezuela (Bolivarian Republic of),Malaysia,29,15,14
1995,36,Australia,Malaysia,80793,38360,42433
1995,554,New Zealand,Malaysia,11569,5493,6076
1995,598,Papua New Guinea,Malaysia,117,63,54
1995,90,Solomon Islands,Malaysia,132,126,6
1995,100,Bulgaria,Malaysia,1,1,0
1995,203,Czechia,Malaysia,5,4,1
1995,348,Hungary,Malaysia,40,18,22
1995,616,Poland,Malaysia,9,6,3
1995,643,Russian Federation,Malaysia,533,286,247
1995,208,Denmark,Malaysia,351,155,196
1995,246,Finland,Malaysia,165,94,71
1995,352,Iceland,Malaysia,7,4,3
1995,372,Ireland,Malaysia,929,443,486
1995,428,Latvia,Malaysia,10,7,3
1995,578,Norway,Malaysia,230,97,133
1995,752,Sweden,Malaysia,896,456,440
1995,826,United Kingdom,Malaysia,45112,20137,24975
1995,300,Greece,Malaysia,55,28,27
1995,380,Italy,Malaysia,203,68,135
1995,470,Malta,Malaysia,19,6,13
1995,620,Portugal,Malaysia,23,9,14
1995,724,Spain,Malaysia,62,27,35
1995,40,Austria,Malaysia,300,145,155
1995,56,Belgium,Malaysia,334,142,192
1995,250,France,Malaysia,1962,845,1117
1995,276,Germany,Malaysia,3016,1567,1449
1995,442,Luxembourg,Malaysia,24,10,14
1995,528,Netherlands,Malaysia,2362,1164,1198
1995,756,Switzerland,Malaysia,1362,672,690
1995,60,Bermuda,Malaysia,18,11,7
1995,124,Canada,Malaysia,18151,8788,9363
1995,840,United States of America,Malaysia,42203,22750,19453
2000,480,Mauritius,Malaysia,49,21,28
2000,710,South Africa,Malaysia,382,104,278
2000,12,Algeria,Malaysia,877,613,264
2000,818,Egypt,Malaysia,2063,1355,708
2000,434,Libya,Malaysia,5828,4468,1360
2000,196,Cyprus,Malaysia,20,6,14
2000,400,Jordan,Malaysia,345,184,161
2000,792,Turkey,Malaysia,247,136,111
2000,50,Bangladesh,Malaysia,159993,86397,73596
2000,356,India,Malaysia,15220,4108,11112
2000,462,Maldives,Malaysia,58,32,26
2000,144,Sri Lanka,Malaysia,235,146,89
2000,156,China,Malaysia,4416,2466,1950
2000,344,"China, Hong Kong SAR",Malaysia,12609,6418,6191
2000,408,Dem. People's Republic of Korea,Malaysia,149,76,73
2000,392,Japan,Malaysia,8387,3875,4512
2000,410,Republic of Korea,Malaysia,294,169,125
2000,96,Brunei Darussalam,Malaysia,45258,25059,20199
2000,116,Cambodia,Malaysia,339,262,77
2000,360,Indonesia,Malaysia,1748,1116,632
2000,608,Philippines,Malaysia,316,170,146
2000,702,Singapore,Malaysia,710434,290654,419780
2000,764,Thailand,Malaysia,1290,893,397
2000,626,Timor-Leste,Malaysia,159,83,76
2000,704,Viet Nam,Malaysia,79,65,14
2000,136,Cayman Islands,Malaysia,19,13,6
2000,214,Dominican Republic,Malaysia,44,7,37
2000,662,Saint Lucia,Malaysia,11,6,5
2000,188,Costa Rica,Malaysia,3,3,0
2000,484,Mexico,Malaysia,61,31,30
2000,591,Panama,Malaysia,24,20,4
2000,32,Argentina,Malaysia,6,0,6
2000,68,Bolivia (Plurinational State of),Malaysia,7,2,5
2000,152,Chile,Malaysia,25,14,11
2000,218,Ecuador,Malaysia,15,9,6
2000,604,Peru,Malaysia,32,16,16
2000,862,Venezuela (Bolivarian Republic of),Malaysia,29,15,14
2000,36,Australia,Malaysia,84650,39743,44907
2000,554,New Zealand,Malaysia,11151,5421,5730
2000,598,Papua New Guinea,Malaysia,87,45,42
2000,90,Solomon Islands,Malaysia,126,120,6
2000,100,Bulgaria,Malaysia,1,1,0
2000,203,Czechia,Malaysia,7,6,1
2000,348,Hungary,Malaysia,79,35,44
2000,616,Poland,Malaysia,8,5,3
2000,643,Russian Federation,Malaysia,490,289,201
2000,208,Denmark,Malaysia,404,176,228
2000,246,Finland,Malaysia,188,106,82
2000,352,Iceland,Malaysia,9,6,3
2000,372,Ireland,Malaysia,2197,1083,1114
2000,428,Latvia,Malaysia,14,10,4
2000,578,Norway,Malaysia,304,134,170
2000,752,Sweden,Malaysia,961,486,475
2000,826,United Kingdom,Malaysia,48230,21117,27113
2000,300,Greece,Malaysia,47,22,25
2000,380,Italy,Malaysia,339,114,225
2000,470,Malta,Malaysia,24,8,16
2000,620,Portugal,Malaysia,37,14,23
2000,705,Slovenia,Malaysia,2,2,0
2000,724,Spain,Malaysia,752,367,385
2000,40,Austria,Malaysia,334,164,170
2000,56,Belgium,Malaysia,324,140,184
2000,250,France,Malaysia,2023,853,1170
2000,276,Germany,Malaysia,3415,1634,1781
2000,442,Luxembourg,Malaysia,23,9,14
2000,528,Netherlands,Malaysia,2716,1314,1402
2000,756,Switzerland,Malaysia,1609,803,806
2000,60,Bermuda,Malaysia,22,12,10
2000,124,Canada,Malaysia,21280,10265,11015
2000,840,United States of America,Malaysia,50714,27522,23192
2005,480,Mauritius,Malaysia,49,21,28
2005,710,South Africa,Malaysia,503,121,382
2005,12,Algeria,Malaysia,692,484,208
2005,818,Egypt,Malaysia,2456,1665,791
2005,434,Libya,Malaysia,6422,5191,1231
2005,196,Cyprus,Malaysia,30,10,20
2005,400,Jordan,Malaysia,497,293,204
2005,792,Turkey,Malaysia,254,138,116
2005,50,Bangladesh,Malaysia,190436,102836,87600
2005,356,India,Malaysia,14063,3772,10291
2005,462,Maldives,Malaysia,60,35,25
2005,144,Sri Lanka,Malaysia,453,181,272
2005,156,China,Malaysia,4871,2946,1925
2005,344,"China, Hong Kong SAR",Malaysia,13766,6667,7099
2005,408,Dem. People's Republic of Korea,Malaysia,164,84,80
2005,392,Japan,Malaysia,7889,3594,4295
2005,410,Republic of Korea,Malaysia,585,334,251
2005,96,Brunei Darussalam,Malaysia,46267,25742,20525
2005,116,Cambodia,Malaysia,265,207,58
2005,360,Indonesia,Malaysia,1837,1154,683
2005,608,Philippines,Malaysia,255,139,116
2005,702,Singapore,Malaysia,818337,346501,471836
2005,764,Thailand,Malaysia,1209,821,388
2005,626,Timor-Leste,Malaysia,169,92,77
2005,704,Viet Nam,Malaysia,90,75,15
2005,136,Cayman Islands,Malaysia,18,13,5
2005,214,Dominican Republic,Malaysia,31,7,24
2005,662,Saint Lucia,Malaysia,11,6,5
2005,188,Costa Rica,Malaysia,2,2,0
2005,484,Mexico,Malaysia,54,29,25
2005,591,Panama,Malaysia,23,15,8
2005,32,Argentina,Malaysia,4,0,4
2005,68,Bolivia (Plurinational State of),Malaysia,7,3,4
2005,152,Chile,Malaysia,37,21,16
2005,218,Ecuador,Malaysia,17,10,7
2005,604,Peru,Malaysia,38,19,19
2005,862,Venezuela (Bolivarian Republic of),Malaysia,30,16,14
2005,36,Australia,Malaysia,101390,46997,54393
2005,554,New Zealand,Malaysia,13911,6753,7158
2005,598,Papua New Guinea,Malaysia,93,53,40
2005,90,Solomon Islands,Malaysia,117,90,27
2005,100,Bulgaria,Malaysia,2,1,1
2005,203,Czechia,Malaysia,179,84,95
2005,348,Hungary,Malaysia,98,45,53
2005,616,Poland,Malaysia,24,11,13
2005,643,Russian Federation,Malaysia,1018,591,427
2005,208,Denmark,Malaysia,555,237,318
2005,246,Finland,Malaysia,289,145,144
2005,352,Iceland,Malaysia,19,10,9
2005,372,Ireland,Malaysia,3430,1783,1647
2005,428,Latvia,Malaysia,9,7,2
2005,578,Norway,Malaysia,369,152,217
2005,752,Sweden,Malaysia,1152,542,610
2005,826,United Kingdom,Malaysia,55324,24123,31201
2005,300,Greece,Malaysia,56,26,30
2005,380,Italy,Malaysia,476,185,291
2005,470,Malta,Malaysia,29,9,20
2005,620,Portugal,Malaysia,43,17,26
2005,705,Slovenia,Malaysia,2,2,0
2005,724,Spain,Malaysia,362,174,188
2005,40,Austria,Malaysia,373,178,195
2005,56,Belgium,Malaysia,502,214,288
2005,250,France,Malaysia,2262,1023,1239
2005,276,Germany,Malaysia,4267,2016,2251
2005,442,Luxembourg,Malaysia,19,8,11
2005,528,Netherlands,Malaysia,3085,1438,1647
2005,756,Switzerland,Malaysia,1802,848,954
2005,60,Bermuda,Malaysia,30,13,17
2005,124,Canada,Malaysia,21513,10027,11486
2005,840,United States of America,Malaysia,55746,30394,25352
2010,480,Mauritius,Malaysia,53,23,30
2010,710,South Africa,Malaysia,787,188,599
2010,12,Algeria,Malaysia,760,522,238
2010,818,Egypt,Malaysia,2651,1765,886
2010,434,Libya,Malaysia,7026,5694,1332
2010,196,Cyprus,Malaysia,49,17,32
2010,400,Jordan,Malaysia,639,391,248
2010,792,Turkey,Malaysia,261,139,122
2010,50,Bangladesh,Malaysia,204878,110635,94243
2010,356,India,Malaysia,12905,3436,9469
2010,462,Maldives,Malaysia,80,47,33
2010,144,Sri Lanka,Malaysia,901,365,536
2010,156,China,Malaysia,5327,3427,1900
2010,344,"China, Hong Kong SAR",Malaysia,14957,6933,8024
2010,408,Dem. People's Republic of Korea,Malaysia,178,92,86
2010,392,Japan,Malaysia,8364,3762,4602
2010,410,Republic of Korea,Malaysia,1108,616,492
2010,96,Brunei Darussalam,Malaysia,47276,26424,20852
2010,116,Cambodia,Malaysia,191,151,40
2010,360,Indonesia,Malaysia,2045,1192,853
2010,608,Philippines,Malaysia,781,409,372
2010,702,Singapore,Malaysia,971827,421024,550803
2010,764,Thailand,Malaysia,1216,816,400
2010,626,Timor-Leste,Malaysia,173,98,75
2010,704,Viet Nam,Malaysia,106,87,19
2010,136,Cayman Islands,Malaysia,18,12,6
2010,214,Dominican Republic,Malaysia,17,7,10
2010,662,Saint Lucia,Malaysia,11,6,5
2010,188,Costa Rica,Malaysia,4,4,0
2010,484,Mexico,Malaysia,54,30,24
2010,591,Panama,Malaysia,24,10,14
2010,32,Argentina,Malaysia,2,0,2
2010,68,Bolivia (Plurinational State of),Malaysia,7,4,3
2010,76,Brazil,Malaysia,120,56,64
2010,152,Chile,Malaysia,50,29,21
2010,218,Ecuador,Malaysia,24,15,9
2010,604,Peru,Malaysia,42,22,20
2010,862,Venezuela (Bolivarian Republic of),Malaysia,32,16,16
2010,36,Australia,Malaysia,129880,60389,69491
2010,554,New Zealand,Malaysia,15575,7547,8028
2010,598,Papua New Guinea,Malaysia,78,46,32
2010,90,Solomon Islands,Malaysia,116,65,51
2010,100,Bulgaria,Malaysia,2,1,1
2010,203,Czechia,Malaysia,333,158,175
2010,348,Hungary,Malaysia,117,55,62
2010,616,Poland,Malaysia,42,17,25
2010,643,Russian Federation,Malaysia,1527,882,645
2010,208,Denmark,Malaysia,692,293,399
2010,233,Estonia,Malaysia,2,2,0
2010,246,Finland,Malaysia,470,204,266
2010,352,Iceland,Malaysia,28,14,14
2010,372,Ireland,Malaysia,4098,1981,2117
2010,428,Latvia,Malaysia,4,3,1
2010,578,Norway,Malaysia,595,249,346
2010,752,Sweden,Malaysia,1384,627,757
2010,826,United Kingdom,Malaysia,58281,26087,32194
2010,300,Greece,Malaysia,66,30,36
2010,380,Italy,Malaysia,632,261,371
2010,470,Malta,Malaysia,32,12,20
2010,620,Portugal,Malaysia,43,18,25
2010,705,Slovenia,Malaysia,10,8,2
2010,724,Spain,Malaysia,515,236,279
2010,40,Austria,Malaysia,412,192,220
2010,56,Belgium,Malaysia,636,275,361
2010,250,France,Malaysia,2383,975,1408
2010,276,Germany,Malaysia,4967,2335,2632
2010,442,Luxembourg,Malaysia,17,8,9
2010,528,Netherlands,Malaysia,3480,1610,1870
2010,756,Switzerland,Malaysia,2126,942,1184
2010,60,Bermuda,Malaysia,37,14,23
2010,124,Canada,Malaysia,22365,10117,12248
2010,840,United States of America,Malaysia,62621,33751,28870
2015,480,Mauritius,Malaysia,61,29,32
2015,710,South Africa,Malaysia,1419,285,1134
2015,324,Guinea,Malaysia,1,1,0
2015,12,Algeria,Malaysia,838,576,262
2015,818,Egypt,Malaysia,1965,1394,571
2015,434,Libya,Malaysia,7921,6399,1522
2015,196,Cyprus,Malaysia,47,17,30
2015,400,Jordan,Malaysia,274,144,130
2015,792,Turkey,Malaysia,264,138,126
2015,50,Bangladesh,Malaysia,203561,109923,93638
2015,356,India,Malaysia,12433,3300,9133
2015,462,Maldives,Malaysia,101,60,41
2015,144,Sri Lanka,Malaysia,918,363,555
2015,156,China,Malaysia,6130,4044,2086
2015,344,"China, Hong Kong SAR",Malaysia,15273,6759,8514
2015,408,Dem. People's Republic of Korea,Malaysia,196,102,94
2015,392,Japan,Malaysia,8738,3899,4839
2015,410,Republic of Korea,Malaysia,1376,751,625
2015,96,Brunei Darussalam,Malaysia,48285,27106,21179
2015,116,Cambodia,Malaysia,172,137,35
2015,360,Indonesia,Malaysia,2263,1340,923
2015,608,Philippines,Malaysia,793,416,377
2015,702,Singapore,Malaysia,1123654,491391,632263
2015,764,Thailand,Malaysia,1314,880,434
2015,626,Timor-Leste,Malaysia,65,42,23
2015,704,Viet Nam,Malaysia,128,105,23
2015,136,Cayman Islands,Malaysia,18,13,5
2015,214,Dominican Republic,Malaysia,17,7,10
2015,662,Saint Lucia,Malaysia,10,6,4
2015,188,Costa Rica,Malaysia,4,4,0
2015,484,Mexico,Malaysia,57,32,25
2015,591,Panama,Malaysia,28,11,17
2015,32,Argentina,Malaysia,2,0,2
2015,68,Bolivia (Plurinational State of),Malaysia,8,5,3
2015,76,Brazil,Malaysia,145,68,77
2015,152,Chile,Malaysia,75,43,32
2015,218,Ecuador,Malaysia,34,21,13
2015,604,Peru,Malaysia,44,23,21
2015,862,Venezuela (Bolivarian Republic of),Malaysia,34,17,17
2015,36,Australia,Malaysia,143420,68296,75124
2015,554,New Zealand,Malaysia,16991,8217,8774
2015,598,Papua New Guinea,Malaysia,79,48,31
2015,90,Solomon Islands,Malaysia,108,61,47
2015,100,Bulgaria,Malaysia,3,2,1
2015,203,Czechia,Malaysia,356,147,209
2015,348,Hungary,Malaysia,99,46,53
2015,616,Poland,Malaysia,40,17,23
2015,643,Russian Federation,Malaysia,1556,896,660
2015,208,Denmark,Malaysia,891,386,505
2015,233,Estonia,Malaysia,8,6,2
2015,246,Finland,Malaysia,530,233,297
2015,352,Iceland,Malaysia,35,16,19
2015,372,Ireland,Malaysia,4186,1997,2189
2015,428,Latvia,Malaysia,7,5,2
2015,578,Norway,Malaysia,845,354,491
2015,752,Sweden,Malaysia,1510,649,861
2015,826,United Kingdom,Malaysia,74532,32140,42392
2015,300,Greece,Malaysia,61,26,35
2015,380,Italy,Malaysia,610,251,359
2015,470,Malta,Malaysia,54,23,31
2015,620,Portugal,Malaysia,49,19,30
2015,705,Slovenia,Malaysia,8,4,4
2015,724,Spain,Malaysia,602,263,339
2015,40,Austria,Malaysia,483,228,255
2015,56,Belgium,Malaysia,719,307,412
2015,250,France,Malaysia,2639,1037,1602
2015,276,Germany,Malaysia,5175,2427,2748
2015,442,Luxembourg,Malaysia,25,12,13
2015,528,Netherlands,Malaysia,3630,1639,1991
2015,756,Switzerland,Malaysia,2349,972,1377
2015,60,Bermuda,Malaysia,37,14,23
2015,124,Canada,Malaysia,23644,10733,12911
2015,840,United States of America,Malaysia,71903,35337,36566
2019,480,Mauritius,Malaysia,61,29,32
2019,710,South Africa,Malaysia,1590,322,1268
2019,12,Algeria,Malaysia,871,599,272
2019,818,Egypt,Malaysia,2800,1891,909
2019,434,Libya,Malaysia,8404,6790,1614
2019,196,Cyprus,Malaysia,46,17,29
2019,400,Jordan,Malaysia,294,155,139
2019,792,Turkey,Malaysia,356,188,168
2019,50,Bangladesh,Malaysia,206244,62893,143351
2019,356,India,Malaysia,12228,3246,8982
2019,462,Maldives,Malaysia,108,64,44
2019,144,Sri Lanka,Malaysia,925,366,559
2019,156,China,Malaysia,6461,4263,2198
2019,344,"China, Hong Kong SAR",Malaysia,19787,8425,11362
2019,408,Dem. People's Republic of Korea,Malaysia,199,104,95
2019,392,Japan,Malaysia,9526,4251,5275
2019,410,Republic of Korea,Malaysia,1400,764,636
2019,96,Brunei Darussalam,Malaysia,52001,29192,22809
2019,116,Cambodia,Malaysia,182,145,37
2019,360,Indonesia,Malaysia,2363,1400,963
2019,608,Philippines,Malaysia,817,429,388
2019,702,Singapore,Malaysia,952261,415770,536491
2019,764,Thailand,Malaysia,1369,917,452
2019,626,Timor-Leste,Malaysia,64,42,22
2019,704,Viet Nam,Malaysia,133,109,24
2019,136,Cayman Islands,Malaysia,20,15,5
2019,214,Dominican Republic,Malaysia,17,7,10
2019,662,Saint Lucia,Malaysia,9,6,3
2019,188,Costa Rica,Malaysia,4,4,0
2019,484,Mexico,Malaysia,58,33,25
2019,591,Panama,Malaysia,28,12,16
2019,32,Argentina,Malaysia,2,0,2
2019,68,Bolivia (Plurinational State of),Malaysia,8,5,3
2019,76,Brazil,Malaysia,163,77,86
2019,152,Chile,Malaysia,100,55,45
2019,218,Ecuador,Malaysia,33,21,12
2019,604,Peru,Malaysia,52,29,23
2019,862,Venezuela (Bolivarian Republic of),Malaysia,33,17,16
2019,36,Australia,Malaysia,174136,83212,90924
2019,554,New Zealand,Malaysia,17464,8446,9018
2019,598,Papua New Guinea,Malaysia,79,48,31
2019,90,Solomon Islands,Malaysia,105,59,46
2019,100,Bulgaria,Malaysia,13,9,4
2019,203,Czechia,Malaysia,291,125,166
2019,348,Hungary,Malaysia,117,45,72
2019,616,Poland,Malaysia,42,19,23
2019,643,Russian Federation,Malaysia,1555,896,659
2019,208,Denmark,Malaysia,941,374,567
2019,233,Estonia,Malaysia,11,7,4
2019,246,Finland,Malaysia,603,267,336
2019,352,Iceland,Malaysia,43,20,23
2019,372,Ireland,Malaysia,4595,2200,2395
2019,428,Latvia,Malaysia,8,5,3
2019,578,Norway,Malaysia,935,382,553
2019,752,Sweden,Malaysia,1708,721,987
2019,826,United Kingdom,Malaysia,84638,36620,48018
2019,300,Greece,Malaysia,59,27,32
2019,380,Italy,Malaysia,659,259,400
2019,470,Malta,Malaysia,87,38,49
2019,620,Portugal,Malaysia,49,19,30
2019,705,Slovenia,Malaysia,7,3,4
2019,724,Spain,Malaysia,623,264,359
2019,40,Austria,Malaysia,570,275,295
2019,56,Belgium,Malaysia,799,341,458
2019,250,France,Malaysia,2793,1094,1699
2019,276,Germany,Malaysia,5676,2771,2905
2019,442,Luxembourg,Malaysia,106,42,64
2019,528,Netherlands,Malaysia,4036,1794,2242
2019,756,Switzerland,Malaysia,2529,1041,1488
2019,60,Bermuda,Malaysia,37,14,23
2019,124,Canada,Malaysia,25337,11502,13835
2019,840,United States of America,Malaysia,77647,37735,39912
1990,690,Seychelles,Maldives,2,0,2
1990,710,South Africa,Maldives,54,29,25
1990,818,Egypt,Maldives,4,4,0
1990,356,India,Maldives,1810,1493,317
1990,144,Sri Lanka,Maldives,17,8,9
1990,188,Costa Rica,Maldives,1,0,1
1990,152,Chile,Maldives,1,1,0
1990,36,Australia,Maldives,80,39,41
1990,100,Bulgaria,Maldives,1,1,0
1990,643,Russian Federation,Maldives,135,66,69
1990,208,Denmark,Maldives,3,1,2
1990,246,Finland,Maldives,1,1,0
1990,372,Ireland,Maldives,1,1,0
1990,752,Sweden,Maldives,5,2,3
1990,826,United Kingdom,Maldives,27,17,10
1990,300,Greece,Maldives,8,5,3
1990,380,Italy,Maldives,1,0,1
1990,40,Austria,Maldives,5,4,1
1990,56,Belgium,Maldives,2,0,2
1990,250,France,Maldives,4,3,1
1990,756,Switzerland,Maldives,31,23,8
1995,690,Seychelles,Maldives,1,0,1
1995,710,South Africa,Maldives,34,20,14
1995,818,Egypt,Maldives,12,9,3
1995,356,India,Maldives,1027,812,215
1995,144,Sri Lanka,Maldives,193,149,44
1995,188,Costa Rica,Maldives,1,0,1
1995,152,Chile,Maldives,1,1,0
1995,36,Australia,Maldives,113,51,62
1995,100,Bulgaria,Maldives,1,1,0
1995,643,Russian Federation,Maldives,124,69,55
1995,208,Denmark,Maldives,3,1,2
1995,246,Finland,Maldives,1,1,0
1995,372,Ireland,Maldives,2,1,1
1995,752,Sweden,Maldives,6,3,3
1995,826,United Kingdom,Maldives,107,54,53
1995,300,Greece,Maldives,6,4,2
1995,380,Italy,Maldives,6,4,2
1995,40,Austria,Maldives,6,4,2
1995,56,Belgium,Maldives,2,0,2
1995,250,France,Maldives,4,3,1
1995,756,Switzerland,Maldives,38,29,9
2000,690,Seychelles,Maldives,1,0,1
2000,710,South Africa,Maldives,24,16,8
2000,818,Egypt,Maldives,21,15,6
2000,356,India,Maldives,243,131,112
2000,144,Sri Lanka,Maldives,370,240,130
2000,188,Costa Rica,Maldives,1,0,1
2000,152,Chile,Maldives,1,1,0
2000,36,Australia,Maldives,170,78,92
2000,100,Bulgaria,Maldives,1,1,0
2000,643,Russian Federation,Maldives,109,70,39
2000,208,Denmark,Maldives,2,0,2
2000,246,Finland,Maldives,1,1,0
2000,372,Ireland,Maldives,3,0,3
2000,752,Sweden,Maldives,7,3,4
2000,826,United Kingdom,Maldives,190,92,98
2000,300,Greece,Maldives,4,2,2
2000,380,Italy,Maldives,11,8,3
2000,40,Austria,Maldives,6,4,2
2000,56,Belgium,Maldives,2,0,2
2000,250,France,Maldives,4,3,1
2000,756,Switzerland,Maldives,46,34,12
2005,690,Seychelles,Maldives,17,10,7
2005,710,South Africa,Maldives,31,21,10
2005,818,Egypt,Maldives,25,18,7
2005,356,India,Maldives,225,121,104
2005,144,Sri Lanka,Maldives,731,317,414
2005,188,Costa Rica,Maldives,1,0,1
2005,152,Chile,Maldives,1,1,0
2005,36,Australia,Maldives,280,108,172
2005,100,Bulgaria,Maldives,2,1,1
2005,203,Czechia,Maldives,2,1,1
2005,643,Russian Federation,Maldives,77,44,33
2005,208,Denmark,Maldives,5,1,4
2005,246,Finland,Maldives,1,1,0
2005,372,Ireland,Maldives,3,0,3
2005,752,Sweden,Maldives,13,8,5
2005,826,United Kingdom,Maldives,263,133,130
2005,300,Greece,Maldives,4,2,2
2005,380,Italy,Maldives,23,18,5
2005,40,Austria,Maldives,7,5,2
2005,56,Belgium,Maldives,2,2,0
2005,250,France,Maldives,8,4,4
2005,756,Switzerland,Maldives,50,39,11
2010,690,Seychelles,Maldives,34,21,13
2010,710,South Africa,Maldives,48,33,15
2010,818,Egypt,Maldives,27,19,8
2010,356,India,Maldives,206,111,95
2010,144,Sri Lanka,Maldives,1474,654,820
2010,188,Costa Rica,Maldives,1,0,1
2010,76,Brazil,Maldives,9,0,9
2010,152,Chile,Maldives,2,2,0
2010,36,Australia,Maldives,430,194,236
2010,100,Bulgaria,Maldives,2,1,1
2010,203,Czechia,Maldives,3,2,1
2010,643,Russian Federation,Maldives,45,18,27
2010,208,Denmark,Maldives,6,1,5
2010,246,Finland,Maldives,2,2,0
2010,372,Ireland,Maldives,2,0,2
2010,752,Sweden,Maldives,12,5,7
2010,826,United Kingdom,Maldives,277,143,134
2010,300,Greece,Maldives,3,1,2
2010,380,Italy,Maldives,83,44,39
2010,40,Austria,Maldives,8,6,2
2010,56,Belgium,Maldives,4,2,2
2010,250,France,Maldives,6,4,2
2010,756,Switzerland,Maldives,62,44,18
2015,690,Seychelles,Maldives,38,25,13
2015,710,South Africa,Maldives,85,58,27
2015,818,Egypt,Maldives,20,15,5
2015,356,India,Maldives,198,107,91
2015,144,Sri Lanka,Maldives,1399,549,850
2015,188,Costa Rica,Maldives,1,0,1
2015,76,Brazil,Maldives,11,0,11
2015,152,Chile,Maldives,3,3,0
2015,36,Australia,Maldives,610,284,326
2015,100,Bulgaria,Maldives,1,0,1
2015,203,Czechia,Maldives,2,2,0
2015,643,Russian Federation,Maldives,45,18,27
2015,208,Denmark,Maldives,9,1,8
2015,246,Finland,Maldives,2,1,1
2015,372,Ireland,Maldives,2,0,2
2015,752,Sweden,Maldives,24,12,12
2015,826,United Kingdom,Maldives,354,178,176
2015,300,Greece,Maldives,2,1,1
2015,380,Italy,Maldives,33,26,7
2015,705,Slovenia,Maldives,1,1,0
2015,40,Austria,Maldives,9,7,2
2015,56,Belgium,Maldives,4,2,2
2015,250,France,Maldives,6,4,2
2015,756,Switzerland,Maldives,76,59,17
2019,690,Seychelles,Maldives,38,25,13
2019,710,South Africa,Maldives,95,66,29
2019,818,Egypt,Maldives,28,21,7
2019,356,India,Maldives,194,105,89
2019,144,Sri Lanka,Maldives,1409,553,856
2019,188,Costa Rica,Maldives,1,0,1
2019,76,Brazil,Maldives,12,0,12
2019,152,Chile,Maldives,4,4,0
2019,36,Australia,Maldives,645,300,345
2019,100,Bulgaria,Maldives,1,0,1
2019,203,Czechia,Maldives,4,4,0
2019,643,Russian Federation,Maldives,44,18,26
2019,208,Denmark,Maldives,11,1,10
2019,246,Finland,Maldives,1,1,0
2019,372,Ireland,Maldives,2,0,2
2019,752,Sweden,Maldives,25,13,12
2019,826,United Kingdom,Maldives,402,203,199
2019,300,Greece,Maldives,1,1,0
2019,380,Italy,Maldives,36,32,4
2019,40,Austria,Maldives,10,8,2
2019,56,Belgium,Maldives,4,2,2
2019,250,France,Maldives,6,4,2
2019,756,Switzerland,Maldives,80,59,21
1990,894,Zambia,Mali,220,166,54
1990,140,Central African Republic,Mali,351,183,168
1990,178,Congo,Mali,4678,2459,2219
1990,266,Gabon,Mali,17055,10919,6136
1990,710,South Africa,Mali,104,40,64
1990,204,Benin,Mali,265,138,127
1990,854,Burkina Faso,Mali,37576,16146,21430
1990,132,Cabo Verde,Mali,9,4,5
1990,384,Côte d'Ivoire,Mali,422476,235307,187169
1990,270,Gambia,Mali,5697,3753,1944
1990,288,Ghana,Mali,3592,2527,1065
1990,324,Guinea,Mali,15549,8350,7199
1990,430,Liberia,Mali,1970,1316,654
1990,478,Mauritania,Mali,6776,2664,4112
1990,562,Niger,Mali,31142,17044,14098
1990,566,Nigeria,Mali,14578,8179,6399
1990,686,Senegal,Mali,28161,14493,13668
1990,694,Sierra Leone,Mali,1953,1082,871
1990,768,Togo,Mali,1539,872,667
1990,818,Egypt,Mali,241,195,46
1990,434,Libya,Mali,688,559,129
1990,729,Sudan,Mali,1058,544,514
1990,788,Tunisia,Mali,200,100,100
1990,732,Western Sahara,Mali,194,120,74
1990,152,Chile,Mali,10,4,6
1990,36,Australia,Mali,24,7,17
1990,203,Czechia,Mali,4,3,1
1990,348,Hungary,Mali,8,6,2
1990,616,Poland,Mali,35,35,0
1990,643,Russian Federation,Mali,196,96,100
1990,208,Denmark,Mali,5,4,1
1990,246,Finland,Mali,3,3,0
1990,372,Ireland,Mali,6,3,3
1990,428,Latvia,Mali,2,2,0
1990,578,Norway,Mali,5,5,0
1990,752,Sweden,Mali,40,33,7
1990,826,United Kingdom,Mali,16,12,4
1990,300,Greece,Mali,15,7,8
1990,380,Italy,Mali,43,15,28
1990,620,Portugal,Mali,12,11,1
1990,724,Spain,Mali,351,298,53
1990,40,Austria,Mali,54,39,15
1990,56,Belgium,Mali,270,145,125
1990,250,France,Mali,49299,31926,17373
1990,276,Germany,Mali,634,525,109
1990,528,Netherlands,Mali,48,28,20
1990,756,Switzerland,Mali,173,124,49
1990,124,Canada,Mali,111,54,57
1995,894,Zambia,Mali,206,156,50
1995,140,Central African Republic,Mali,422,224,198
1995,178,Congo,Mali,9493,5820,3673
1995,266,Gabon,Mali,22807,14595,8212
1995,710,South Africa,Mali,65,29,36
1995,204,Benin,Mali,366,193,173
1995,854,Burkina Faso,Mali,75987,34165,41822
1995,132,Cabo Verde,Mali,12,6,6
1995,384,Côte d'Ivoire,Mali,445636,246817,198819
1995,270,Gambia,Mali,7028,4534,2494
1995,288,Ghana,Mali,3580,2620,960
1995,324,Guinea,Mali,17927,10529,7398
1995,430,Liberia,Mali,1924,1271,653
1995,478,Mauritania,Mali,41626,23200,18426
1995,562,Niger,Mali,64573,32284,32289
1995,566,Nigeria,Mali,39251,21880,17371
1995,686,Senegal,Mali,29450,15068,14382
1995,694,Sierra Leone,Mali,1904,1030,874
1995,768,Togo,Mali,2038,1155,883
1995,818,Egypt,Mali,192,153,39
1995,434,Libya,Mali,464,364,100
1995,729,Sudan,Mali,1079,556,523
1995,788,Tunisia,Mali,198,100,98
1995,732,Western Sahara,Mali,215,134,81
1995,152,Chile,Mali,49,22,27
1995,36,Australia,Mali,12,4,8
1995,203,Czechia,Mali,6,5,1
1995,348,Hungary,Mali,12,10,2
1995,616,Poland,Mali,30,30,0
1995,643,Russian Federation,Mali,167,101,66
1995,208,Denmark,Mali,16,10,6
1995,246,Finland,Mali,3,3,0
1995,372,Ireland,Mali,16,7,9
1995,428,Latvia,Mali,2,2,0
1995,578,Norway,Mali,14,9,5
1995,752,Sweden,Mali,47,38,9
1995,826,United Kingdom,Mali,65,38,27
1995,300,Greece,Mali,16,10,6
1995,380,Italy,Mali,272,139,133
1995,620,Portugal,Mali,26,23,3
1995,724,Spain,Mali,709,627,82
1995,40,Austria,Mali,61,44,17
1995,56,Belgium,Mali,270,145,125
1995,250,France,Mali,50893,32656,18237
1995,276,Germany,Mali,722,584,138
1995,528,Netherlands,Mali,70,40,30
1995,756,Switzerland,Mali,227,148,79
1995,124,Canada,Mali,465,224,241
2000,894,Zambia,Mali,194,147,47
2000,140,Central African Republic,Mali,457,246,211
2000,178,Congo,Mali,16851,10731,6120
2000,266,Gabon,Mali,28529,18329,10200
2000,710,South Africa,Mali,45,25,20
2000,204,Benin,Mali,467,248,219
2000,854,Burkina Faso,Mali,42260,18029,24231
2000,132,Cabo Verde,Mali,14,7,7
2000,384,Côte d'Ivoire,Mali,443223,245595,197628
2000,270,Gambia,Mali,8805,5601,3204
2000,288,Ghana,Mali,4004,2832,1172
2000,324,Guinea,Mali,19422,11243,8179
2000,430,Liberia,Mali,1889,1230,659
2000,478,Mauritania,Mali,7483,3787,3696
2000,562,Niger,Mali,43060,21142,21918
2000,566,Nigeria,Mali,65493,36273,29220
2000,686,Senegal,Mali,26917,14438,12479
2000,694,Sierra Leone,Mali,1857,980,877
2000,768,Togo,Mali,2699,1530,1169
2000,818,Egypt,Mali,158,122,36
2000,434,Libya,Mali,249,178,71
2000,729,Sudan,Mali,1101,568,533
2000,788,Tunisia,Mali,230,117,113
2000,732,Western Sahara,Mali,237,149,88
2000,152,Chile,Mali,88,39,49
2000,36,Australia,Mali,20,10,10
2000,203,Czechia,Mali,8,7,1
2000,348,Hungary,Mali,15,13,2
2000,616,Poland,Mali,26,26,0
2000,643,Russian Federation,Mali,132,102,30
2000,208,Denmark,Mali,26,16,10
2000,246,Finland,Mali,3,3,0
2000,372,Ireland,Mali,34,16,18
2000,428,Latvia,Mali,3,3,0
2000,578,Norway,Mali,17,12,5
2000,752,Sweden,Mali,51,41,10
2000,826,United Kingdom,Mali,117,65,52
2000,300,Greece,Mali,17,12,5
2000,380,Italy,Mali,501,264,237
2000,620,Portugal,Mali,43,37,6
2000,705,Slovenia,Mali,2,2,0
2000,724,Spain,Mali,1373,1227,146
2000,40,Austria,Mali,68,50,18
2000,56,Belgium,Mali,260,139,121
2000,250,France,Mali,52487,33387,19100
2000,276,Germany,Mali,809,642,167
2000,528,Netherlands,Mali,96,52,44
2000,756,Switzerland,Mali,283,172,111
2000,124,Canada,Mali,831,401,430
2005,894,Zambia,Mali,205,156,49
2005,120,Cameroon,Mali,8251,5760,2491
2005,140,Central African Republic,Mali,349,188,161
2005,178,Congo,Mali,10715,7741,2974
2005,266,Gabon,Mali,31109,20098,11011
2005,710,South Africa,Mali,59,31,28
2005,204,Benin,Mali,1464,849,615
2005,854,Burkina Faso,Mali,37118,15451,21667
2005,132,Cabo Verde,Mali,11,6,5
2005,384,Côte d'Ivoire,Mali,463993,257106,206887
2005,270,Gambia,Mali,8737,5536,3201
2005,288,Ghana,Mali,5631,4082,1549
2005,324,Guinea,Mali,35367,17113,18254
2005,430,Liberia,Mali,1186,920,266
2005,478,Mauritania,Mali,7547,3961,3586
2005,562,Niger,Mali,43840,21497,22343
2005,566,Nigeria,Mali,130115,75762,54353
2005,686,Senegal,Mali,28788,15727,13061
2005,694,Sierra Leone,Mali,682,525,157
2005,768,Togo,Mali,3674,1788,1886
2005,818,Egypt,Mali,188,148,40
2005,434,Libya,Mali,274,211,63
2005,729,Sudan,Mali,1171,605,566
2005,788,Tunisia,Mali,220,113,107
2005,732,Western Sahara,Mali,280,179,101
2005,68,Bolivia (Plurinational State of),Mali,1,0,1
2005,152,Chile,Mali,132,60,72
2005,36,Australia,Mali,40,20,20
2005,100,Bulgaria,Mali,1,0,1
2005,203,Czechia,Mali,19,14,5
2005,348,Hungary,Mali,18,16,2
2005,616,Poland,Mali,28,27,1
2005,643,Russian Federation,Mali,102,84,18
2005,208,Denmark,Mali,32,18,14
2005,246,Finland,Mali,4,4,0
2005,352,Iceland,Mali,1,1,0
2005,372,Ireland,Mali,34,17,17
2005,428,Latvia,Mali,2,2,0
2005,578,Norway,Mali,34,22,12
2005,752,Sweden,Mali,61,42,19
2005,826,United Kingdom,Mali,232,133,99
2005,300,Greece,Mali,24,15,9
2005,380,Italy,Mali,2339,1983,356
2005,620,Portugal,Mali,77,70,7
2005,705,Slovenia,Mali,2,1,1
2005,724,Spain,Mali,11131,10497,634
2005,40,Austria,Mali,77,56,21
2005,56,Belgium,Mali,418,222,196
2005,250,France,Mali,57153,34687,22466
2005,276,Germany,Mali,1009,671,338
2005,528,Netherlands,Mali,148,75,73
2005,756,Switzerland,Mali,329,193,136
2005,124,Canada,Mali,1188,599,589
2010,728,South Sudan,Mali,198,114,84
2010,894,Zambia,Mali,217,142,75
2010,120,Cameroon,Mali,6567,4674,1893
2010,140,Central African Republic,Mali,345,186,159
2010,178,Congo,Mali,25520,17427,8093
2010,266,Gabon,Mali,36033,23523,12510
2010,710,South Africa,Mali,92,49,43
2010,204,Benin,Mali,2490,1466,1024
2010,854,Burkina Faso,Mali,41902,17327,24575
2010,132,Cabo Verde,Mali,7,4,3
2010,384,Côte d'Ivoire,Mali,484763,268532,216231
2010,270,Gambia,Mali,8929,5651,3278
2010,288,Ghana,Mali,4175,2947,1228
2010,324,Guinea,Mali,54950,24777,30173
2010,430,Liberia,Mali,1267,913,354
2010,478,Mauritania,Mali,7612,4066,3546
2010,562,Niger,Mali,44537,21811,22726
2010,566,Nigeria,Mali,132718,77277,55441
2010,686,Senegal,Mali,32035,17952,14083
2010,694,Sierra Leone,Mali,472,332,140
2010,768,Togo,Mali,7641,4202,3439
2010,818,Egypt,Mali,203,158,45
2010,434,Libya,Mali,300,232,68
2010,729,Sudan,Mali,734,379,355
2010,788,Tunisia,Mali,771,397,374
2010,732,Western Sahara,Mali,324,210,114
2010,68,Bolivia (Plurinational State of),Mali,1,0,1
2010,76,Brazil,Mali,6,6,0
2010,152,Chile,Mali,176,81,95
2010,36,Australia,Mali,60,30,30
2010,100,Bulgaria,Mali,1,0,1
2010,203,Czechia,Mali,28,19,9
2010,348,Hungary,Mali,20,18,2
2010,616,Poland,Mali,31,27,4
2010,643,Russian Federation,Mali,71,65,6
2010,208,Denmark,Mali,36,20,16
2010,246,Finland,Mali,3,3,0
2010,352,Iceland,Mali,1,1,0
2010,372,Ireland,Mali,28,13,15
2010,428,Latvia,Mali,1,1,0
2010,578,Norway,Mali,39,25,14
2010,752,Sweden,Mali,102,54,48
2010,826,United Kingdom,Mali,244,142,102
2010,300,Greece,Mali,31,19,12
2010,380,Italy,Mali,2880,2455,425
2010,620,Portugal,Mali,100,93,7
2010,705,Slovenia,Mali,3,1,2
2010,724,Spain,Mali,23680,22034,1646
2010,40,Austria,Mali,85,62,23
2010,56,Belgium,Mali,617,330,287
2010,250,France,Mali,70950,42479,28471
2010,276,Germany,Mali,1173,696,477
2010,528,Netherlands,Mali,156,82,74
2010,756,Switzerland,Mali,375,211,164
2010,124,Canada,Mali,1435,742,693
2015,728,South Sudan,Mali,203,122,81
2015,894,Zambia,Mali,191,125,66
2015,120,Cameroon,Mali,8388,5644,2744
2015,140,Central African Republic,Mali,301,161,140
2015,178,Congo,Mali,33918,22703,11215
2015,266,Gabon,Mali,50384,35336,15048
2015,710,South Africa,Mali,165,85,80
2015,204,Benin,Mali,3260,1974,1286
2015,854,Burkina Faso,Mali,43815,18118,25697
2015,132,Cabo Verde,Mali,7,4,3
2015,384,Côte d'Ivoire,Mali,505532,280040,225492
2015,270,Gambia,Mali,9251,5849,3402
2015,288,Ghana,Mali,5137,3626,1511
2015,324,Guinea,Mali,46991,26278,20713
2015,430,Liberia,Mali,1454,1045,409
2015,478,Mauritania,Mali,104491,59758,44733
2015,562,Niger,Mali,94640,45793,48847
2015,566,Nigeria,Mali,160967,88314,72653
2015,686,Senegal,Mali,34245,19185,15060
2015,694,Sierra Leone,Mali,323,199,124
2015,768,Togo,Mali,8122,4567,3555
2015,818,Egypt,Mali,150,121,29
2015,434,Libya,Mali,338,261,77
2015,729,Sudan,Mali,678,347,331
2015,788,Tunisia,Mali,996,507,489
2015,732,Western Sahara,Mali,373,245,128
2015,68,Bolivia (Plurinational State of),Mali,1,0,1
2015,76,Brazil,Mali,7,7,0
2015,152,Chile,Mali,266,120,146
2015,36,Australia,Mali,80,45,35
2015,100,Bulgaria,Mali,5,3,2
2015,203,Czechia,Mali,27,19,8
2015,348,Hungary,Mali,21,17,4
2015,616,Poland,Mali,29,26,3
2015,642,Romania,Mali,57,54,3
2015,643,Russian Federation,Mali,73,66,7
2015,208,Denmark,Mali,54,32,22
2015,246,Finland,Mali,17,12,5
2015,352,Iceland,Mali,2,2,0
2015,372,Ireland,Mali,29,13,16
2015,428,Latvia,Mali,2,2,0
2015,578,Norway,Mali,53,32,21
2015,752,Sweden,Mali,139,85,54
2015,826,United Kingdom,Mali,312,178,134
2015,300,Greece,Mali,29,18,11
2015,380,Italy,Mali,5975,5466,509
2015,620,Portugal,Mali,113,104,9
2015,705,Slovenia,Mali,6,2,4
2015,724,Spain,Mali,17576,15208,2368
2015,40,Austria,Mali,99,73,26
2015,56,Belgium,Mali,940,508,432
2015,250,France,Mali,78597,46189,32408
2015,276,Germany,Mali,1222,724,498
2015,528,Netherlands,Mali,179,96,83
2015,756,Switzerland,Mali,515,320,195
2015,124,Canada,Mali,2082,1083,999
2019,728,South Sudan,Mali,208,125,83
2019,894,Zambia,Mali,246,162,84
2019,120,Cameroon,Mali,8344,5617,2727
2019,140,Central African Republic,Mali,334,179,155
2019,178,Congo,Mali,34961,23395,11566
2019,266,Gabon,Mali,54744,38381,16363
2019,710,South Africa,Mali,184,95,89
2019,204,Benin,Mali,3472,2105,1367
2019,854,Burkina Faso,Mali,36763,14672,22091
2019,132,Cabo Verde,Mali,7,4,3
2019,384,Côte d'Ivoire,Mali,522146,289249,232897
2019,270,Gambia,Mali,10349,6543,3806
2019,288,Ghana,Mali,5781,4085,1696
2019,324,Guinea,Mali,44855,25084,19771
2019,430,Liberia,Mali,1206,697,509
2019,478,Mauritania,Mali,108528,62105,46423
2019,562,Niger,Mali,92101,44565,47536
2019,566,Nigeria,Mali,168657,92533,76124
2019,686,Senegal,Mali,35383,19816,15567
2019,694,Sierra Leone,Mali,274,157,117
2019,768,Togo,Mali,8173,4618,3555
2019,818,Egypt,Mali,213,167,46
2019,434,Libya,Mali,358,277,81
2019,729,Sudan,Mali,836,422,414
2019,788,Tunisia,Mali,1012,516,496
2019,732,Western Sahara,Mali,387,254,133
2019,68,Bolivia (Plurinational State of),Mali,1,0,1
2019,76,Brazil,Mali,7,7,0
2019,152,Chile,Mali,355,150,205
2019,36,Australia,Mali,95,49,46
2019,100,Bulgaria,Mali,5,3,2
2019,203,Czechia,Mali,28,21,7
2019,348,Hungary,Mali,26,21,5
2019,616,Poland,Mali,30,27,3
2019,642,Romania,Mali,168,163,5
2019,643,Russian Federation,Mali,72,66,6
2019,208,Denmark,Mali,58,35,23
2019,246,Finland,Mali,28,23,5
2019,352,Iceland,Mali,4,4,0
2019,372,Ireland,Mali,31,14,17
2019,428,Latvia,Mali,1,1,0
2019,578,Norway,Mali,54,35,19
2019,752,Sweden,Mali,171,98,73
2019,826,United Kingdom,Mali,354,203,151
2019,300,Greece,Mali,100,49,51
2019,380,Italy,Mali,15181,14540,641
2019,620,Portugal,Mali,114,105,9
2019,705,Slovenia,Mali,4,2,2
2019,724,Spain,Mali,17645,14844,2801
2019,40,Austria,Mali,116,86,30
2019,56,Belgium,Mali,992,515,477
2019,250,France,Mali,83195,48813,34382
2019,276,Germany,Mali,3418,2601,817
2019,528,Netherlands,Mali,185,97,88
2019,756,Switzerland,Mali,518,308,210
2019,124,Canada,Mali,2231,1161,1070
1990,710,South Africa,Malta,163,52,111
1990,196,Cyprus,Malta,8,5,3
1990,792,Turkey,Malta,10,4,6
1990,214,Dominican Republic,Malta,33,13,20
1990,32,Argentina,Malta,4,1,3
1990,68,Bolivia (Plurinational State of),Malta,6,6,0
1990,152,Chile,Malta,8,7,1
1990,604,Peru,Malta,12,12,0
1990,36,Australia,Malta,57407,30665,26742
1990,100,Bulgaria,Malta,1,0,1
1990,203,Czechia,Malta,2,1,1
1990,643,Russian Federation,Malta,575,282,293
1990,703,Slovakia,Malta,1,0,1
1990,208,Denmark,Malta,48,27,21
1990,246,Finland,Malta,8,7,1
1990,372,Ireland,Malta,23,11,12
1990,428,Latvia,Malta,2,1,1
1990,578,Norway,Malta,37,21,16
1990,752,Sweden,Malta,68,37,31
1990,826,United Kingdom,Malta,30631,14667,15964
1990,300,Greece,Malta,227,126,101
1990,380,Italy,Malta,257,89,168
1990,620,Portugal,Malta,6,4,2
1990,688,Serbia,Malta,6,4,2
1990,724,Spain,Malta,95,39,56
1990,40,Austria,Malta,60,26,34
1990,56,Belgium,Malta,259,124,135
1990,250,France,Malta,910,417,493
1990,276,Germany,Malta,246,116,130
1990,442,Luxembourg,Malta,13,7,6
1990,528,Netherlands,Malta,106,45,61
1990,756,Switzerland,Malta,127,63,64
1990,124,Canada,Malta,9773,4758,5015
1990,840,United States of America,Malta,9614,4860,4754
1995,710,South Africa,Malta,133,46,87
1995,196,Cyprus,Malta,12,7,5
1995,792,Turkey,Malta,24,9,15
1995,214,Dominican Republic,Malta,37,14,23
1995,32,Argentina,Malta,4,1,3
1995,68,Bolivia (Plurinational State of),Malta,4,3,1
1995,152,Chile,Malta,11,8,3
1995,604,Peru,Malta,13,13,0
1995,36,Australia,Malta,57450,30363,27087
1995,100,Bulgaria,Malta,9,4,5
1995,203,Czechia,Malta,3,2,1
1995,348,Hungary,Malta,13,6,7
1995,643,Russian Federation,Malta,616,295,321
1995,703,Slovakia,Malta,6,4,2
1995,208,Denmark,Malta,53,30,23
1995,246,Finland,Malta,13,10,3
1995,352,Iceland,Malta,1,0,1
1995,372,Ireland,Malta,81,37,44
1995,428,Latvia,Malta,2,1,1
1995,578,Norway,Malta,35,17,18
1995,752,Sweden,Malta,81,44,37
1995,826,United Kingdom,Malta,29655,14197,15458
1995,300,Greece,Malta,162,80,82
1995,380,Italy,Malta,697,131,566
1995,620,Portugal,Malta,13,9,4
1995,688,Serbia,Malta,41,22,19
1995,724,Spain,Malta,119,52,67
1995,40,Austria,Malta,68,30,38
1995,56,Belgium,Malta,258,124,134
1995,250,France,Malta,940,422,518
1995,276,Germany,Malta,295,124,171
1995,442,Luxembourg,Malta,12,7,5
1995,528,Netherlands,Malta,155,63,92
1995,756,Switzerland,Malta,164,82,82
1995,124,Canada,Malta,9463,4585,4878
1995,840,United States of America,Malta,9207,4690,4517
2000,710,South Africa,Malta,144,50,94
2000,196,Cyprus,Malta,15,9,6
2000,792,Turkey,Malta,40,14,26
2000,214,Dominican Republic,Malta,40,14,26
2000,32,Argentina,Malta,4,1,3
2000,68,Bolivia (Plurinational State of),Malta,2,1,1
2000,152,Chile,Malta,15,10,5
2000,604,Peru,Malta,16,16,0
2000,36,Australia,Malta,52610,27462,25148
2000,100,Bulgaria,Malta,16,8,8
2000,203,Czechia,Malta,4,3,1
2000,348,Hungary,Malta,25,12,13
2000,643,Russian Federation,Malta,636,298,338
2000,703,Slovakia,Malta,14,9,5
2000,208,Denmark,Malta,58,33,25
2000,246,Finland,Malta,18,14,4
2000,352,Iceland,Malta,1,0,1
2000,372,Ireland,Malta,184,88,96
2000,428,Latvia,Malta,3,2,1
2000,578,Norway,Malta,46,26,20
2000,752,Sweden,Malta,87,46,41
2000,826,United Kingdom,Malta,29178,13926,15252
2000,300,Greece,Malta,99,33,66
2000,380,Italy,Malta,1137,173,964
2000,620,Portugal,Malta,22,14,8
2000,688,Serbia,Malta,56,29,27
2000,705,Slovenia,Malta,1,0,1
2000,724,Spain,Malta,195,88,107
2000,40,Austria,Malta,76,34,42
2000,56,Belgium,Malta,249,121,128
2000,250,France,Malta,969,427,542
2000,276,Germany,Malta,344,133,211
2000,442,Luxembourg,Malta,12,7,5
2000,528,Netherlands,Malta,210,82,128
2000,756,Switzerland,Malta,202,100,102
2000,124,Canada,Malta,9379,4524,4855
2000,840,United States of America,Malta,8777,4514,4263
2005,710,South Africa,Malta,188,60,128
2005,196,Cyprus,Malta,22,13,9
2005,792,Turkey,Malta,41,14,27
2005,214,Dominican Republic,Malta,32,13,19
2005,32,Argentina,Malta,3,0,3
2005,68,Bolivia (Plurinational State of),Malta,3,2,1
2005,152,Chile,Malta,22,15,7
2005,604,Peru,Malta,19,18,1
2005,36,Australia,Malta,51380,26547,24833
2005,100,Bulgaria,Malta,26,14,12
2005,203,Czechia,Malta,11,7,4
2005,348,Hungary,Malta,31,15,16
2005,643,Russian Federation,Malta,347,164,183
2005,703,Slovakia,Malta,16,10,6
2005,208,Denmark,Malta,79,48,31
2005,246,Finland,Malta,25,18,7
2005,352,Iceland,Malta,3,1,2
2005,372,Ireland,Malta,299,148,151
2005,428,Latvia,Malta,6,5,1
2005,578,Norway,Malta,51,28,23
2005,752,Sweden,Malta,104,54,50
2005,826,United Kingdom,Malta,27600,13093,14507
2005,300,Greece,Malta,96,29,67
2005,380,Italy,Malta,1533,351,1182
2005,620,Portugal,Malta,32,16,16
2005,688,Serbia,Malta,56,29,27
2005,705,Slovenia,Malta,2,1,1
2005,724,Spain,Malta,146,67,79
2005,40,Austria,Malta,85,37,48
2005,56,Belgium,Malta,166,81,85
2005,250,France,Malta,472,186,286
2005,276,Germany,Malta,489,212,277
2005,442,Luxembourg,Malta,93,55,38
2005,528,Netherlands,Malta,260,97,163
2005,756,Switzerland,Malta,225,105,120
2005,124,Canada,Malta,8099,4037,4062
2005,840,United States of America,Malta,8275,4278,3997
2010,710,South Africa,Malta,294,94,200
2010,196,Cyprus,Malta,36,22,14
2010,792,Turkey,Malta,42,14,28
2010,214,Dominican Republic,Malta,24,13,11
2010,32,Argentina,Malta,2,0,2
2010,68,Bolivia (Plurinational State of),Malta,4,4,0
2010,76,Brazil,Malta,27,27,0
2010,152,Chile,Malta,30,21,9
2010,604,Peru,Malta,20,19,1
2010,36,Australia,Malta,48660,24889,23771
2010,100,Bulgaria,Malta,34,19,15
2010,203,Czechia,Malta,17,11,6
2010,348,Hungary,Malta,37,18,19
2010,643,Russian Federation,Malta,52,27,25
2010,703,Slovakia,Malta,18,12,6
2010,208,Denmark,Malta,98,63,35
2010,246,Finland,Malta,40,28,12
2010,352,Iceland,Malta,4,2,2
2010,372,Ireland,Malta,364,163,201
2010,428,Latvia,Malta,10,8,2
2010,578,Norway,Malta,62,32,30
2010,752,Sweden,Malta,130,70,60
2010,826,United Kingdom,Malta,29075,14107,14968
2010,300,Greece,Malta,95,26,69
2010,380,Italy,Malta,2105,579,1526
2010,620,Portugal,Malta,38,15,23
2010,688,Serbia,Malta,55,28,27
2010,705,Slovenia,Malta,12,8,4
2010,724,Spain,Malta,263,138,125
2010,40,Austria,Malta,93,40,53
2010,56,Belgium,Malta,360,163,197
2010,250,France,Malta,460,197,263
2010,276,Germany,Malta,608,279,329
2010,442,Luxembourg,Malta,177,104,73
2010,528,Netherlands,Malta,298,121,177
2010,756,Switzerland,Malta,267,117,150
2010,124,Canada,Malta,7435,3871,3564
2010,840,United States of America,Malta,8016,4092,3924
2015,710,South Africa,Malta,529,151,378
2015,196,Cyprus,Malta,34,21,13
2015,792,Turkey,Malta,42,13,29
2015,214,Dominican Republic,Malta,25,14,11
2015,32,Argentina,Malta,2,0,2
2015,68,Bolivia (Plurinational State of),Malta,5,5,0
2015,76,Brazil,Malta,33,33,0
2015,152,Chile,Malta,45,32,13
2015,604,Peru,Malta,21,20,1
2015,36,Australia,Malta,44070,22558,21512
2015,100,Bulgaria,Malta,71,38,33
2015,203,Czechia,Malta,22,15,7
2015,348,Hungary,Malta,81,45,36
2015,643,Russian Federation,Malta,54,29,25
2015,703,Slovakia,Malta,27,16,11
2015,208,Denmark,Malta,105,68,37
2015,246,Finland,Malta,49,28,21
2015,352,Iceland,Malta,8,5,3
2015,372,Ireland,Malta,372,164,208
2015,428,Latvia,Malta,6,5,1
2015,578,Norway,Malta,100,49,51
2015,752,Sweden,Malta,176,93,83
2015,826,United Kingdom,Malta,37182,17473,19709
2015,300,Greece,Malta,89,22,67
2015,380,Italy,Malta,1859,496,1363
2015,620,Portugal,Malta,43,15,28
2015,688,Serbia,Malta,53,27,26
2015,705,Slovenia,Malta,8,4,4
2015,724,Spain,Malta,312,154,158
2015,40,Austria,Malta,108,47,61
2015,56,Belgium,Malta,435,196,239
2015,250,France,Malta,517,221,296
2015,276,Germany,Malta,633,289,344
2015,442,Luxembourg,Malta,270,161,109
2015,528,Netherlands,Malta,348,152,196
2015,756,Switzerland,Malta,288,115,173
2015,124,Canada,Malta,7419,3780,3639
2015,840,United States of America,Malta,8365,4250,4115
2019,710,South Africa,Malta,592,170,422
2019,196,Cyprus,Malta,33,21,12
2019,792,Turkey,Malta,56,18,38
2019,214,Dominican Republic,Malta,25,14,11
2019,32,Argentina,Malta,2,0,2
2019,68,Bolivia (Plurinational State of),Malta,5,5,0
2019,76,Brazil,Malta,37,37,0
2019,152,Chile,Malta,60,42,18
2019,604,Peru,Malta,24,24,0
2019,36,Australia,Malta,44552,22696,21856
2019,100,Bulgaria,Malta,119,66,53
2019,203,Czechia,Malta,24,18,6
2019,348,Hungary,Malta,104,54,50
2019,643,Russian Federation,Malta,53,29,24
2019,703,Slovakia,Malta,37,21,16
2019,208,Denmark,Malta,132,74,58
2019,246,Finland,Malta,60,34,26
2019,352,Iceland,Malta,5,3,2
2019,372,Ireland,Malta,408,181,227
2019,428,Latvia,Malta,11,7,4
2019,578,Norway,Malta,109,52,57
2019,752,Sweden,Malta,210,113,97
2019,826,United Kingdom,Malta,42224,19899,22325
2019,300,Greece,Malta,86,24,62
2019,380,Italy,Malta,1952,555,1397
2019,620,Portugal,Malta,43,15,28
2019,688,Serbia,Malta,53,27,26
2019,705,Slovenia,Malta,7,2,5
2019,724,Spain,Malta,323,156,167
2019,40,Austria,Malta,127,57,70
2019,56,Belgium,Malta,465,221,244
2019,250,France,Malta,547,233,314
2019,276,Germany,Malta,694,350,344
2019,442,Luxembourg,Malta,274,137,137
2019,528,Netherlands,Malta,415,180,235
2019,756,Switzerland,Malta,316,132,184
2019,124,Canada,Malta,7950,4051,3899
2019,840,United States of America,Malta,9032,4541,4491
1990,36,Australia,Marshall Islands,26,12,14
1990,316,Guam,Marshall Islands,88,48,40
1990,583,Micronesia (Fed. States of),Marshall Islands,126,72,54
1990,580,Northern Mariana Islands,Marshall Islands,97,40,57
1990,208,Denmark,Marshall Islands,1,1,0
1990,300,Greece,Marshall Islands,2,2,0
1990,840,United States of America,Marshall Islands,1086,532,554
1995,36,Australia,Marshall Islands,18,6,12
1995,316,Guam,Marshall Islands,169,93,76
1995,583,Micronesia (Fed. States of),Marshall Islands,114,73,41
1995,580,Northern Mariana Islands,Marshall Islands,101,42,59
1995,208,Denmark,Marshall Islands,1,1,0
1995,300,Greece,Marshall Islands,1,1,0
1995,840,United States of America,Marshall Islands,3750,1864,1886
2000,36,Australia,Marshall Islands,30,15,15
2000,316,Guam,Marshall Islands,250,139,111
2000,583,Micronesia (Fed. States of),Marshall Islands,106,60,46
2000,580,Northern Mariana Islands,Marshall Islands,112,42,70
2000,840,United States of America,Marshall Islands,6478,3233,3245
2005,36,Australia,Marshall Islands,40,20,20
2005,316,Guam,Marshall Islands,241,129,112
2005,583,Micronesia (Fed. States of),Marshall Islands,98,54,44
2005,580,Northern Mariana Islands,Marshall Islands,95,33,62
2005,100,Bulgaria,Marshall Islands,1,1,0
2005,840,United States of America,Marshall Islands,6179,3100,3079
2010,36,Australia,Marshall Islands,40,20,20
2010,316,Guam,Marshall Islands,232,120,112
2010,583,Micronesia (Fed. States of),Marshall Islands,94,52,42
2010,580,Northern Mariana Islands,Marshall Islands,52,15,37
2010,100,Bulgaria,Marshall Islands,1,1,0
2010,752,Sweden,Marshall Islands,1,1,0
2010,840,United States of America,Marshall Islands,6063,3001,3062
2015,324,Guinea,Marshall Islands,6,3,3
2015,36,Australia,Marshall Islands,50,29,21
2015,316,Guam,Marshall Islands,234,121,113
2015,583,Micronesia (Fed. States of),Marshall Islands,92,51,41
2015,580,Northern Mariana Islands,Marshall Islands,46,12,34
2015,100,Bulgaria,Marshall Islands,1,1,0
2015,752,Sweden,Marshall Islands,1,1,0
2015,840,United States of America,Marshall Islands,7188,3541,3647
2019,324,Guinea,Marshall Islands,5,3,2
2019,36,Australia,Marshall Islands,52,27,25
2019,316,Guam,Marshall Islands,245,127,118
2019,583,Micronesia (Fed. States of),Marshall Islands,94,53,41
2019,580,Northern Mariana Islands,Marshall Islands,46,12,34
2019,100,Bulgaria,Marshall Islands,1,1,0
2019,208,Denmark,Marshall Islands,1,1,0
2019,840,United States of America,Marshall Islands,7761,3781,3980
1990,28,Antigua and Barbuda,Martinique,5,2,3
1990,212,Dominica,Martinique,52,36,16
1990,214,Dominican Republic,Martinique,51,19,32
1990,312,Guadeloupe,Martinique,5803,2793,3010
1990,662,Saint Lucia,Martinique,198,110,88
1990,188,Costa Rica,Martinique,3,2,1
1990,152,Chile,Martinique,5,2,3
1990,254,French Guiana,Martinique,4570,2474,2096
1990,862,Venezuela (Bolivarian Republic of),Martinique,38,13,25
1990,36,Australia,Martinique,20,13,7
1990,208,Denmark,Martinique,8,4,4
1990,124,Canada,Martinique,288,141,147
1995,28,Antigua and Barbuda,Martinique,5,2,3
1995,535,"Bonaire, Sint Eustatius and Saba",Martinique,96,48,48
1995,212,Dominica,Martinique,69,48,21
1995,214,Dominican Republic,Martinique,57,20,37
1995,312,Guadeloupe,Martinique,6985,3167,3818
1995,662,Saint Lucia,Martinique,267,149,118
1995,188,Costa Rica,Martinique,2,1,1
1995,152,Chile,Martinique,5,3,2
1995,254,French Guiana,Martinique,4771,2486,2285
1995,862,Venezuela (Bolivarian Republic of),Martinique,37,13,24
1995,36,Australia,Martinique,20,17,3
1995,208,Denmark,Martinique,4,2,2
1995,124,Canada,Martinique,284,138,146
2000,28,Antigua and Barbuda,Martinique,4,2,2
2000,535,"Bonaire, Sint Eustatius and Saba",Martinique,193,96,97
2000,212,Dominica,Martinique,82,57,25
2000,214,Dominican Republic,Martinique,62,21,41
2000,312,Guadeloupe,Martinique,8167,3542,4625
2000,662,Saint Lucia,Martinique,367,206,161
2000,188,Costa Rica,Martinique,3,2,1
2000,152,Chile,Martinique,5,2,3
2000,254,French Guiana,Martinique,4971,2498,2473
2000,862,Venezuela (Bolivarian Republic of),Martinique,36,12,24
2000,36,Australia,Martinique,40,20,20
2000,124,Canada,Martinique,287,138,149
2005,28,Antigua and Barbuda,Martinique,5,3,2
2005,535,"Bonaire, Sint Eustatius and Saba",Martinique,205,102,103
2005,212,Dominica,Martinique,101,71,30
2005,214,Dominican Republic,Martinique,47,22,25
2005,312,Guadeloupe,Martinique,8636,3741,4895
2005,662,Saint Lucia,Martinique,345,191,154
2005,534,Sint Maarten (Dutch part),Martinique,36,17,19
2005,188,Costa Rica,Martinique,2,1,1
2005,152,Chile,Martinique,7,3,4
2005,254,French Guiana,Martinique,4685,2337,2348
2005,862,Venezuela (Bolivarian Republic of),Martinique,37,12,25
2005,36,Australia,Martinique,30,15,15
2005,124,Canada,Martinique,415,227,188
2010,28,Antigua and Barbuda,Martinique,5,3,2
2010,535,"Bonaire, Sint Eustatius and Saba",Martinique,24,21,3
2010,531,Curaçao,Martinique,29,12,17
2010,212,Dominica,Martinique,123,86,37
2010,214,Dominican Republic,Martinique,31,22,9
2010,312,Guadeloupe,Martinique,9104,3939,5165
2010,662,Saint Lucia,Martinique,298,163,135
2010,534,Sint Maarten (Dutch part),Martinique,72,34,38
2010,188,Costa Rica,Martinique,4,3,1
2010,152,Chile,Martinique,10,5,5
2010,254,French Guiana,Martinique,4398,2176,2222
2010,862,Venezuela (Bolivarian Republic of),Martinique,40,13,27
2010,36,Australia,Martinique,40,20,20
2010,124,Canada,Martinique,490,285,205
2015,28,Antigua and Barbuda,Martinique,5,3,2
2015,535,"Bonaire, Sint Eustatius and Saba",Martinique,27,24,3
2015,531,Curaçao,Martinique,31,13,18
2015,212,Dominica,Martinique,143,100,43
2015,214,Dominican Republic,Martinique,32,23,9
2015,312,Guadeloupe,Martinique,9446,4036,5410
2015,662,Saint Lucia,Martinique,285,156,129
2015,534,Sint Maarten (Dutch part),Martinique,75,36,39
2015,188,Costa Rica,Martinique,4,3,1
2015,152,Chile,Martinique,15,8,7
2015,254,French Guiana,Martinique,2654,1298,1356
2015,862,Venezuela (Bolivarian Republic of),Martinique,43,14,29
2015,36,Australia,Martinique,40,23,17
2015,124,Canada,Martinique,641,293,348
2019,28,Antigua and Barbuda,Martinique,5,3,2
2019,535,"Bonaire, Sint Eustatius and Saba",Martinique,32,29,3
2019,531,Curaçao,Martinique,33,14,19
2019,212,Dominica,Martinique,146,103,43
2019,214,Dominican Republic,Martinique,33,24,9
2019,312,Guadeloupe,Martinique,9592,4099,5493
2019,662,Saint Lucia,Martinique,275,151,124
2019,534,Sint Maarten (Dutch part),Martinique,77,37,40
2019,188,Costa Rica,Martinique,4,3,1
2019,152,Chile,Martinique,20,11,9
2019,254,French Guiana,Martinique,2935,1436,1499
2019,862,Venezuela (Bolivarian Republic of),Martinique,42,14,28
2019,36,Australia,Martinique,42,22,20
2019,124,Canada,Martinique,686,314,372
1990,800,Uganda,Mauritania,39,30,9
1990,178,Congo,Mauritania,965,739,226
1990,384,Côte d'Ivoire,Mauritania,9873,7662,2211
1990,270,Gambia,Mauritania,2005,1729,276
1990,288,Ghana,Mauritania,9,6,3
1990,324,Guinea,Mauritania,384,251,133
1990,624,Guinea-Bissau,Mauritania,359,173,186
1990,466,Mali,Mauritania,14942,6730,8212
1990,686,Senegal,Mauritania,89862,46775,43087
1990,694,Sierra Leone,Mauritania,142,108,34
1990,768,Togo,Mauritania,68,28,40
1990,818,Egypt,Mauritania,152,115,37
1990,434,Libya,Mauritania,433,327,106
1990,504,Morocco,Mauritania,1088,576,512
1990,788,Tunisia,Mauritania,376,187,189
1990,732,Western Sahara,Mauritania,282,210,72
1990,368,Iraq,Mauritania,154,113,41
1990,400,Jordan,Mauritania,90,77,13
1990,152,Chile,Mauritania,10,7,3
1990,36,Australia,Mauritania,16,2,14
1990,100,Bulgaria,Mauritania,1,1,0
1990,203,Czechia,Mauritania,1,1,0
1990,348,Hungary,Mauritania,9,4,5
1990,208,Denmark,Mauritania,4,2,2
1990,372,Ireland,Mauritania,2,1,1
1990,578,Norway,Mauritania,3,3,0
1990,752,Sweden,Mauritania,15,14,1
1990,826,United Kingdom,Mauritania,3,3,0
1990,300,Greece,Mauritania,3,1,2
1990,380,Italy,Mauritania,46,16,30
1990,620,Portugal,Mauritania,8,7,1
1990,724,Spain,Mauritania,702,542,160
1990,40,Austria,Mauritania,19,18,1
1990,56,Belgium,Mauritania,875,689,186
1990,250,France,Mauritania,11287,7803,3484
1990,528,Netherlands,Mauritania,163,159,4
1990,756,Switzerland,Mauritania,74,54,20
1990,124,Canada,Mauritania,24,11,13
1995,800,Uganda,Mauritania,36,28,8
1995,178,Congo,Mauritania,1115,841,274
1995,384,Côte d'Ivoire,Mauritania,10316,7990,2326
1995,270,Gambia,Mauritania,2474,2120,354
1995,288,Ghana,Mauritania,9,6,3
1995,324,Guinea,Mauritania,442,306,136
1995,624,Guinea-Bissau,Mauritania,461,227,234
1995,466,Mali,Mauritania,20955,10508,10447
1995,686,Senegal,Mauritania,98848,51453,47395
1995,694,Sierra Leone,Mauritania,138,104,34
1995,768,Togo,Mauritania,76,31,45
1995,818,Egypt,Mauritania,128,95,33
1995,434,Libya,Mauritania,345,258,87
1995,504,Morocco,Mauritania,999,522,477
1995,788,Tunisia,Mauritania,374,189,185
1995,732,Western Sahara,Mauritania,313,235,78
1995,368,Iraq,Mauritania,182,122,60
1995,400,Jordan,Mauritania,87,71,16
1995,152,Chile,Mauritania,5,5,0
1995,36,Australia,Mauritania,8,1,7
1995,100,Bulgaria,Mauritania,2,2,0
1995,203,Czechia,Mauritania,1,1,0
1995,348,Hungary,Mauritania,6,3,3
1995,208,Denmark,Mauritania,15,8,7
1995,372,Ireland,Mauritania,4,2,2
1995,578,Norway,Mauritania,7,7,0
1995,752,Sweden,Mauritania,18,17,1
1995,826,United Kingdom,Mauritania,15,10,5
1995,300,Greece,Mauritania,4,2,2
1995,380,Italy,Mauritania,216,139,77
1995,620,Portugal,Mauritania,18,15,3
1995,724,Spain,Mauritania,1154,922,232
1995,40,Austria,Mauritania,21,19,2
1995,56,Belgium,Mauritania,868,682,186
1995,250,France,Mauritania,11652,7995,3657
1995,528,Netherlands,Mauritania,240,234,6
1995,756,Switzerland,Mauritania,78,55,23
1995,124,Canada,Mauritania,85,41,44
2000,178,Congo,Mauritania,1564,1169,395
2000,384,Côte d'Ivoire,Mauritania,10749,8324,2425
2000,270,Gambia,Mauritania,3100,2646,454
2000,288,Ghana,Mauritania,10,7,3
2000,324,Guinea,Mauritania,478,328,150
2000,624,Guinea-Bissau,Mauritania,563,281,282
2000,466,Mali,Mauritania,12423,7103,5320
2000,686,Senegal,Mauritania,59956,32872,27084
2000,694,Sierra Leone,Mauritania,134,100,34
2000,768,Togo,Mauritania,85,35,50
2000,818,Egypt,Mauritania,114,82,32
2000,434,Libya,Mauritania,264,195,69
2000,504,Morocco,Mauritania,1053,541,512
2000,788,Tunisia,Mauritania,433,214,219
2000,732,Western Sahara,Mauritania,345,260,85
2000,368,Iraq,Mauritania,172,101,71
2000,400,Jordan,Mauritania,83,64,19
2000,152,Chile,Mauritania,1,1,0
2000,36,Australia,Mauritania,20,10,10
2000,100,Bulgaria,Mauritania,2,2,0
2000,203,Czechia,Mauritania,1,1,0
2000,348,Hungary,Mauritania,3,3,0
2000,208,Denmark,Mauritania,26,14,12
2000,372,Ireland,Mauritania,9,5,4
2000,578,Norway,Mauritania,12,9,3
2000,752,Sweden,Mauritania,20,18,2
2000,826,United Kingdom,Mauritania,29,18,11
2000,300,Greece,Mauritania,5,3,2
2000,380,Italy,Mauritania,385,261,124
2000,620,Portugal,Mauritania,30,24,6
2000,705,Slovenia,Mauritania,1,1,0
2000,724,Spain,Mauritania,2103,1704,399
2000,40,Austria,Mauritania,23,21,2
2000,56,Belgium,Mauritania,837,658,179
2000,250,France,Mauritania,12017,8187,3830
2000,528,Netherlands,Mauritania,325,315,10
2000,756,Switzerland,Mauritania,84,57,27
2000,124,Canada,Mauritania,149,72,77
2005,178,Congo,Mauritania,994,802,192
2005,384,Côte d'Ivoire,Mauritania,11252,8714,2538
2005,270,Gambia,Mauritania,3076,2622,454
2005,288,Ghana,Mauritania,14,10,4
2005,324,Guinea,Mauritania,870,536,334
2005,624,Guinea-Bissau,Mauritania,545,274,271
2005,466,Mali,Mauritania,5499,2823,2676
2005,686,Senegal,Mauritania,53740,28924,24816
2005,694,Sierra Leone,Mauritania,122,77,45
2005,768,Togo,Mauritania,95,39,56
2005,818,Egypt,Mauritania,136,100,36
2005,434,Libya,Mauritania,290,229,61
2005,504,Morocco,Mauritania,1080,548,532
2005,788,Tunisia,Mauritania,414,212,202
2005,732,Western Sahara,Mauritania,408,311,97
2005,368,Iraq,Mauritania,197,138,59
2005,400,Jordan,Mauritania,120,96,24
2005,68,Bolivia (Plurinational State of),Mauritania,1,0,1
2005,152,Chile,Mauritania,1,1,0
2005,36,Australia,Mauritania,20,10,10
2005,100,Bulgaria,Mauritania,3,3,0
2005,203,Czechia,Mauritania,3,3,0
2005,348,Hungary,Mauritania,4,4,0
2005,208,Denmark,Mauritania,28,13,15
2005,246,Finland,Mauritania,4,4,0
2005,372,Ireland,Mauritania,9,5,4
2005,578,Norway,Mauritania,10,10,0
2005,752,Sweden,Mauritania,26,24,2
2005,826,United Kingdom,Mauritania,113,68,45
2005,300,Greece,Mauritania,63,59,4
2005,380,Italy,Mauritania,531,395,136
2005,620,Portugal,Mauritania,35,29,6
2005,724,Spain,Mauritania,8638,6966,1672
2005,40,Austria,Mauritania,26,24,2
2005,56,Belgium,Mauritania,677,540,137
2005,250,France,Mauritania,12537,8241,4296
2005,528,Netherlands,Mauritania,401,365,36
2005,756,Switzerland,Mauritania,96,63,33
2005,124,Canada,Mauritania,332,198,134
2010,178,Congo,Mauritania,2369,1847,522
2010,384,Côte d'Ivoire,Mauritania,11755,9103,2652
2010,270,Gambia,Mauritania,3144,2679,465
2010,288,Ghana,Mauritania,11,7,4
2010,324,Guinea,Mauritania,1351,799,552
2010,624,Guinea-Bissau,Mauritania,527,267,260
2010,466,Mali,Mauritania,5823,3187,2636
2010,686,Senegal,Mauritania,50090,26729,23361
2010,694,Sierra Leone,Mauritania,109,69,40
2010,768,Togo,Mauritania,129,58,71
2010,818,Egypt,Mauritania,147,107,40
2010,434,Libya,Mauritania,317,251,66
2010,504,Morocco,Mauritania,1208,609,599
2010,788,Tunisia,Mauritania,409,211,198
2010,732,Western Sahara,Mauritania,471,361,110
2010,368,Iraq,Mauritania,199,143,56
2010,400,Jordan,Mauritania,155,126,29
2010,68,Bolivia (Plurinational State of),Mauritania,1,0,1
2010,152,Chile,Mauritania,2,2,0
2010,36,Australia,Mauritania,50,25,25
2010,100,Bulgaria,Mauritania,3,3,0
2010,203,Czechia,Mauritania,3,3,0
2010,348,Hungary,Mauritania,5,5,0
2010,208,Denmark,Mauritania,29,13,16
2010,233,Estonia,Mauritania,2,0,2
2010,246,Finland,Mauritania,10,10,0
2010,372,Ireland,Mauritania,8,5,3
2010,578,Norway,Mauritania,19,16,3
2010,752,Sweden,Mauritania,44,36,8
2010,826,United Kingdom,Mauritania,119,73,46
2010,300,Greece,Mauritania,125,120,5
2010,380,Italy,Mauritania,630,494,136
2010,620,Portugal,Mauritania,35,29,6
2010,724,Spain,Mauritania,11138,9090,2048
2010,40,Austria,Mauritania,29,27,2
2010,56,Belgium,Mauritania,1348,1088,260
2010,250,France,Mauritania,16685,10912,5773
2010,528,Netherlands,Mauritania,335,304,31
2010,756,Switzerland,Mauritania,112,71,41
2010,124,Canada,Mauritania,485,305,180
2015,178,Congo,Mauritania,3149,2426,723
2015,384,Côte d'Ivoire,Mauritania,12258,9493,2765
2015,270,Gambia,Mauritania,3257,2774,483
2015,288,Ghana,Mauritania,13,9,4
2015,324,Guinea,Mauritania,1154,776,378
2015,624,Guinea-Bissau,Mauritania,559,281,278
2015,466,Mali,Mauritania,7215,3950,3265
2015,686,Senegal,Mauritania,45357,24309,21048
2015,694,Sierra Leone,Mauritania,97,60,37
2015,768,Togo,Mauritania,145,65,80
2015,818,Egypt,Mauritania,108,83,25
2015,434,Libya,Mauritania,357,282,75
2015,504,Morocco,Mauritania,1574,790,784
2015,788,Tunisia,Mauritania,528,273,255
2015,732,Western Sahara,Mauritania,542,418,124
2015,368,Iraq,Mauritania,200,152,48
2015,400,Jordan,Mauritania,67,52,15
2015,68,Bolivia (Plurinational State of),Mauritania,1,0,1
2015,152,Chile,Mauritania,3,3,0
2015,36,Australia,Mauritania,60,34,26
2015,100,Bulgaria,Mauritania,2,2,0
2015,203,Czechia,Mauritania,7,7,0
2015,348,Hungary,Mauritania,5,5,0
2015,208,Denmark,Mauritania,28,12,16
2015,233,Estonia,Mauritania,2,0,2
2015,246,Finland,Mauritania,27,22,5
2015,372,Ireland,Mauritania,8,5,3
2015,578,Norway,Mauritania,60,55,5
2015,752,Sweden,Mauritania,68,56,12
2015,826,United Kingdom,Mauritania,152,92,60
2015,300,Greece,Mauritania,45,22,23
2015,380,Italy,Mauritania,697,542,155
2015,620,Portugal,Mauritania,40,32,8
2015,724,Spain,Mauritania,8532,6252,2280
2015,40,Austria,Mauritania,33,31,2
2015,56,Belgium,Mauritania,2172,1703,469
2015,250,France,Mauritania,18482,11911,6571
2015,528,Netherlands,Mauritania,320,290,30
2015,756,Switzerland,Mauritania,119,76,43
2015,124,Canada,Mauritania,899,576,323
2019,178,Congo,Mauritania,3245,2500,745
2019,384,Côte d'Ivoire,Mauritania,12661,9806,2855
2019,270,Gambia,Mauritania,3643,3103,540
2019,288,Ghana,Mauritania,14,10,4
2019,324,Guinea,Mauritania,1101,741,360
2019,624,Guinea-Bissau,Mauritania,613,308,305
2019,466,Mali,Mauritania,23331,12774,10557
2019,686,Senegal,Mauritania,46518,24937,21581
2019,694,Sierra Leone,Mauritania,92,57,35
2019,768,Togo,Mauritania,145,65,80
2019,818,Egypt,Mauritania,153,114,39
2019,434,Libya,Mauritania,378,299,79
2019,504,Morocco,Mauritania,1678,842,836
2019,788,Tunisia,Mauritania,536,277,259
2019,732,Western Sahara,Mauritania,563,435,128
2019,368,Iraq,Mauritania,204,155,49
2019,400,Jordan,Mauritania,72,56,16
2019,68,Bolivia (Plurinational State of),Mauritania,1,0,1
2019,152,Chile,Mauritania,4,4,0
2019,36,Australia,Mauritania,63,33,30
2019,100,Bulgaria,Mauritania,2,2,0
2019,203,Czechia,Mauritania,6,6,0
2019,348,Hungary,Mauritania,5,4,1
2019,208,Denmark,Mauritania,28,15,13
2019,233,Estonia,Mauritania,2,0,2
2019,246,Finland,Mauritania,33,26,7
2019,372,Ireland,Mauritania,8,5,3
2019,578,Norway,Mauritania,65,61,4
2019,752,Sweden,Mauritania,65,55,10
2019,826,United Kingdom,Mauritania,172,105,67
2019,300,Greece,Mauritania,58,29,29
2019,380,Italy,Mauritania,834,656,178
2019,620,Portugal,Mauritania,40,32,8
2019,724,Spain,Mauritania,8781,6189,2592
2019,40,Austria,Mauritania,38,36,2
2019,56,Belgium,Mauritania,2367,1791,576
2019,250,France,Mauritania,19563,12592,6971
2019,528,Netherlands,Mauritania,315,282,33
2019,756,Switzerland,Mauritania,149,93,56
2019,124,Canada,Mauritania,963,617,346
1990,638,Réunion,Mauritius,1008,541,467
1990,690,Seychelles,Mauritius,258,126,132
1990,834,United Republic of Tanzania,Mauritius,113,70,43
1990,72,Botswana,Mauritius,292,172,120
1990,516,Namibia,Mauritius,158,64,94
1990,710,South Africa,Mauritius,4711,3017,1694
1990,196,Cyprus,Mauritius,3,2,1
1990,356,India,Mauritius,2547,1297,1250
1990,152,Chile,Mauritius,1,1,0
1990,36,Australia,Mauritius,20215,9945,10270
1990,203,Czechia,Mauritius,1,1,0
1990,348,Hungary,Mauritius,21,9,12
1990,643,Russian Federation,Mauritius,273,134,139
1990,208,Denmark,Mauritius,83,41,42
1990,246,Finland,Mauritius,13,5,8
1990,352,Iceland,Mauritius,3,1,2
1990,372,Ireland,Mauritius,74,42,32
1990,578,Norway,Mauritius,145,71,74
1990,752,Sweden,Mauritius,104,37,67
1990,826,United Kingdom,Mauritius,22883,12015,10868
1990,300,Greece,Mauritius,45,25,20
1990,380,Italy,Mauritius,9594,3909,5685
1990,724,Spain,Mauritius,19,10,9
1990,40,Austria,Mauritius,63,30,33
1990,56,Belgium,Mauritius,2939,997,1942
1990,250,France,Mauritius,38101,15891,22210
1990,442,Luxembourg,Mauritius,51,15,36
1990,528,Netherlands,Mauritius,145,60,85
1990,756,Switzerland,Mauritius,1750,456,1294
1990,124,Canada,Mauritius,5095,2481,2614
1995,638,Réunion,Mauritius,2181,1077,1104
1995,690,Seychelles,Mauritius,383,225,158
1995,834,United Republic of Tanzania,Mauritius,151,94,57
1995,72,Botswana,Mauritius,471,284,187
1995,516,Namibia,Mauritius,151,62,89
1995,710,South Africa,Mauritius,3604,2169,1435
1995,196,Cyprus,Mauritius,4,2,2
1995,356,India,Mauritius,1455,719,736
1995,152,Chile,Mauritius,1,1,0
1995,36,Australia,Mauritius,19621,9569,10052
1995,203,Czechia,Mauritius,1,1,0
1995,348,Hungary,Mauritius,28,14,14
1995,643,Russian Federation,Mauritius,247,141,106
1995,208,Denmark,Mauritius,97,48,49
1995,246,Finland,Mauritius,18,8,10
1995,352,Iceland,Mauritius,5,2,3
1995,372,Ireland,Mauritius,206,115,91
1995,578,Norway,Mauritius,148,75,73
1995,752,Sweden,Mauritius,124,44,80
1995,826,United Kingdom,Mauritius,24326,12586,11740
1995,300,Greece,Mauritius,48,19,29
1995,380,Italy,Mauritius,10066,4157,5909
1995,724,Spain,Mauritius,29,15,14
1995,40,Austria,Mauritius,72,35,37
1995,56,Belgium,Mauritius,3397,997,2400
1995,250,France,Mauritius,39333,16019,23314
1995,442,Luxembourg,Mauritius,48,15,33
1995,528,Netherlands,Mauritius,213,85,128
1995,756,Switzerland,Mauritius,1862,569,1293
1995,124,Canada,Mauritius,5784,2801,2983
2000,638,Réunion,Mauritius,3455,1651,1804
2000,690,Seychelles,Mauritius,509,324,185
2000,834,United Republic of Tanzania,Mauritius,161,100,61
2000,72,Botswana,Mauritius,700,427,273
2000,516,Namibia,Mauritius,141,58,83
2000,710,South Africa,Mauritius,3573,1903,1670
2000,196,Cyprus,Mauritius,5,3,2
2000,356,India,Mauritius,362,141,221
2000,152,Chile,Mauritius,2,2,0
2000,36,Australia,Mauritius,18530,8974,9556
2000,203,Czechia,Mauritius,1,1,0
2000,348,Hungary,Mauritius,35,19,16
2000,643,Russian Federation,Mauritius,213,142,71
2000,208,Denmark,Mauritius,110,55,55
2000,246,Finland,Mauritius,22,11,11
2000,352,Iceland,Mauritius,7,3,4
2000,372,Ireland,Mauritius,451,257,194
2000,578,Norway,Mauritius,138,69,69
2000,752,Sweden,Mauritius,133,46,87
2000,826,United Kingdom,Mauritius,26180,13339,12841
2000,300,Greece,Mauritius,52,14,38
2000,380,Italy,Mauritius,10538,4405,6133
2000,724,Spain,Mauritius,359,200,159
2000,40,Austria,Mauritius,80,39,41
2000,56,Belgium,Mauritius,3755,974,2781
2000,250,France,Mauritius,40565,16147,24418
2000,442,Luxembourg,Mauritius,46,14,32
2000,528,Netherlands,Mauritius,289,112,177
2000,756,Switzerland,Mauritius,1982,689,1293
2000,124,Canada,Mauritius,6611,3189,3422
2005,638,Réunion,Mauritius,4294,2044,2250
2005,690,Seychelles,Mauritius,502,342,160
2005,834,United Republic of Tanzania,Mauritius,181,113,68
2005,72,Botswana,Mauritius,1056,639,417
2005,516,Namibia,Mauritius,111,45,66
2005,710,South Africa,Mauritius,4700,2405,2295
2005,196,Cyprus,Mauritius,7,4,3
2005,356,India,Mauritius,335,130,205
2005,152,Chile,Mauritius,3,3,0
2005,36,Australia,Mauritius,20310,9964,10346
2005,100,Bulgaria,Mauritius,1,0,1
2005,203,Czechia,Mauritius,15,9,6
2005,348,Hungary,Mauritius,43,24,19
2005,643,Russian Federation,Mauritius,139,95,44
2005,208,Denmark,Mauritius,128,60,68
2005,246,Finland,Mauritius,31,17,14
2005,352,Iceland,Mauritius,7,3,4
2005,372,Ireland,Mauritius,1969,1167,802
2005,578,Norway,Mauritius,148,69,79
2005,752,Sweden,Mauritius,142,50,92
2005,826,United Kingdom,Mauritius,31876,15936,15940
2005,300,Greece,Mauritius,46,11,35
2005,380,Italy,Mauritius,10018,4290,5728
2005,724,Spain,Mauritius,173,95,78
2005,40,Austria,Mauritius,89,42,47
2005,56,Belgium,Mauritius,3196,949,2247
2005,250,France,Mauritius,38979,15757,23222
2005,442,Luxembourg,Mauritius,39,13,26
2005,528,Netherlands,Mauritius,320,121,199
2005,756,Switzerland,Mauritius,2210,698,1512
2005,124,Canada,Mauritius,9627,4709,4918
2010,638,Réunion,Mauritius,4893,2318,2575
2010,690,Seychelles,Mauritius,495,359,136
2010,834,United Republic of Tanzania,Mauritius,187,117,70
2010,72,Botswana,Mauritius,200,100,100
2010,516,Namibia,Mauritius,106,43,63
2010,710,South Africa,Mauritius,7362,3754,3608
2010,196,Cyprus,Mauritius,11,7,4
2010,356,India,Mauritius,307,119,188
2010,152,Chile,Mauritius,4,4,0
2010,36,Australia,Mauritius,26980,13504,13476
2010,100,Bulgaria,Mauritius,1,0,1
2010,203,Czechia,Mauritius,27,15,12
2010,348,Hungary,Mauritius,51,29,22
2010,643,Russian Federation,Mauritius,63,45,18
2010,208,Denmark,Mauritius,143,65,78
2010,233,Estonia,Mauritius,2,1,1
2010,246,Finland,Mauritius,44,26,18
2010,352,Iceland,Mauritius,7,3,4
2010,372,Ireland,Mauritius,3163,1783,1380
2010,578,Norway,Mauritius,173,77,96
2010,752,Sweden,Mauritius,174,70,104
2010,826,United Kingdom,Mauritius,33580,17133,16447
2010,300,Greece,Mauritius,40,7,33
2010,380,Italy,Mauritius,9404,4106,5298
2010,705,Slovenia,Mauritius,4,2,2
2010,724,Spain,Mauritius,237,130,107
2010,40,Austria,Mauritius,98,46,52
2010,56,Belgium,Mauritius,3092,714,2378
2010,250,France,Mauritius,41634,16010,25624
2010,442,Luxembourg,Mauritius,34,13,21
2010,528,Netherlands,Mauritius,348,136,212
2010,756,Switzerland,Mauritius,2619,721,1898
2010,124,Canada,Mauritius,13160,6494,6666
2015,638,Réunion,Mauritius,5059,2384,2675
2015,690,Seychelles,Mauritius,554,410,144
2015,834,United Republic of Tanzania,Mauritius,192,104,88
2015,72,Botswana,Mauritius,218,109,109
2015,516,Namibia,Mauritius,103,42,61
2015,710,South Africa,Mauritius,13279,6440,6839
2015,324,Guinea,Mauritius,15,11,4
2015,196,Cyprus,Mauritius,10,7,3
2015,356,India,Mauritius,295,115,180
2015,152,Chile,Mauritius,6,6,0
2015,36,Australia,Mauritius,28660,14323,14337
2015,100,Bulgaria,Mauritius,4,2,2
2015,203,Czechia,Mauritius,32,20,12
2015,348,Hungary,Mauritius,59,31,28
2015,643,Russian Federation,Mauritius,64,46,18
2015,208,Denmark,Mauritius,151,67,84
2015,233,Estonia,Mauritius,4,1,3
2015,246,Finland,Mauritius,57,31,26
2015,352,Iceland,Mauritius,5,1,4
2015,372,Ireland,Mauritius,3231,1804,1427
2015,428,Latvia,Mauritius,2,1,1
2015,578,Norway,Mauritius,189,82,107
2015,752,Sweden,Mauritius,189,79,110
2015,826,United Kingdom,Mauritius,42943,21286,21657
2015,300,Greece,Mauritius,37,5,32
2015,380,Italy,Mauritius,8893,3848,5045
2015,705,Slovenia,Mauritius,8,6,2
2015,724,Spain,Mauritius,241,129,112
2015,40,Austria,Mauritius,114,54,60
2015,56,Belgium,Mauritius,3334,827,2507
2015,250,France,Mauritius,46122,16955,29167
2015,442,Luxembourg,Mauritius,51,20,31
2015,528,Netherlands,Mauritius,361,147,214
2015,756,Switzerland,Mauritius,2763,766,1997
2015,124,Canada,Mauritius,15802,7908,7894
2019,638,Réunion,Mauritius,5136,2421,2715
2019,690,Seychelles,Mauritius,559,414,145
2019,834,United Republic of Tanzania,Mauritius,172,93,79
2019,72,Botswana,Mauritius,233,117,116
2019,516,Namibia,Mauritius,109,45,64
2019,710,South Africa,Mauritius,14883,7226,7657
2019,324,Guinea,Mauritius,14,11,3
2019,196,Cyprus,Mauritius,9,7,2
2019,356,India,Mauritius,290,113,177
2019,152,Chile,Mauritius,8,8,0
2019,36,Australia,Mauritius,31380,15571,15809
2019,100,Bulgaria,Mauritius,4,2,2
2019,203,Czechia,Mauritius,43,27,16
2019,348,Hungary,Mauritius,56,29,27
2019,643,Russian Federation,Mauritius,63,46,17
2019,208,Denmark,Mauritius,157,74,83
2019,233,Estonia,Mauritius,1,1,0
2019,246,Finland,Mauritius,61,30,31
2019,352,Iceland,Mauritius,7,2,5
2019,372,Ireland,Mauritius,3547,1986,1561
2019,428,Latvia,Mauritius,2,2,0
2019,578,Norway,Mauritius,212,92,120
2019,752,Sweden,Mauritius,208,88,120
2019,826,United Kingdom,Mauritius,48766,24235,24531
2019,300,Greece,Mauritius,36,6,30
2019,380,Italy,Mauritius,9173,3978,5195
2019,705,Slovenia,Mauritius,8,6,2
2019,724,Spain,Mauritius,249,131,118
2019,40,Austria,Mauritius,134,65,69
2019,56,Belgium,Mauritius,3537,883,2654
2019,250,France,Mauritius,48820,17877,30943
2019,442,Luxembourg,Mauritius,345,158,187
2019,528,Netherlands,Mauritius,383,153,230
2019,756,Switzerland,Mauritius,2868,823,2045
2019,124,Canada,Mauritius,16933,8474,8459
1990,638,Réunion,Mayotte,1800,967,833
1990,876,Wallis and Futuna Islands,Mayotte,35,19,16
1995,638,Réunion,Mayotte,3893,1924,1969
1995,876,Wallis and Futuna Islands,Mayotte,44,24,20
2000,638,Réunion,Mayotte,6162,2948,3214
2000,152,Chile,Mayotte,1,1,0
2000,876,Wallis and Futuna Islands,Mayotte,52,28,24
2005,638,Réunion,Mayotte,6410,3107,3303
2005,152,Chile,Mayotte,1,1,0
2005,876,Wallis and Futuna Islands,Mayotte,58,30,28
2010,638,Réunion,Mayotte,6294,3085,3209
2010,152,Chile,Mayotte,2,2,0
2010,876,Wallis and Futuna Islands,Mayotte,31,17,14
2015,638,Réunion,Mayotte,6507,3173,3334
2015,152,Chile,Mayotte,3,3,0
2015,876,Wallis and Futuna Islands,Mayotte,8,5,3
2019,638,Réunion,Mayotte,6606,3222,3384
2019,152,Chile,Mayotte,4,4,0
2019,876,Wallis and Futuna Islands,Mayotte,7,4,3
1990,710,South Africa,Mexico,78,48,30
1990,132,Cabo Verde,Mexico,4,2,2
1990,818,Egypt,Mexico,71,25,46
1990,196,Cyprus,Mexico,16,6,10
1990,376,Israel,Mexico,1422,662,760
1990,792,Turkey,Mexico,37,19,18
1990,392,Japan,Mexico,786,400,386
1990,608,Philippines,Mexico,31,23,8
1990,28,Antigua and Barbuda,Mexico,3,1,2
1990,44,Bahamas,Mexico,21,9,12
1990,535,"Bonaire, Sint Eustatius and Saba",Mexico,10,2,8
1990,136,Cayman Islands,Mexico,12,6,6
1990,192,Cuba,Mexico,889,445,444
1990,214,Dominican Republic,Mexico,1737,773,964
1990,332,Haiti,Mexico,306,131,175
1990,630,Puerto Rico,Mexico,1907,903,1004
1990,662,Saint Lucia,Mexico,4,0,4
1990,84,Belize,Mexico,3025,1702,1323
1990,188,Costa Rica,Mexico,2081,962,1119
1990,222,El Salvador,Mexico,2457,1095,1362
1990,320,Guatemala,Mexico,5402,1558,3844
1990,340,Honduras,Mexico,795,409,386
1990,558,Nicaragua,Mexico,925,395,530
1990,591,Panama,Mexico,1393,554,839
1990,32,Argentina,Mexico,2332,1211,1121
1990,68,Bolivia (Plurinational State of),Mexico,8125,4025,4100
1990,76,Brazil,Mexico,792,480,312
1990,152,Chile,Mexico,746,365,381
1990,170,Colombia,Mexico,1908,945,963
1990,218,Ecuador,Mexico,656,296,360
1990,600,Paraguay,Mexico,3059,1512,1547
1990,604,Peru,Mexico,930,440,490
1990,858,Uruguay,Mexico,719,359,360
1990,862,Venezuela (Bolivarian Republic of),Mexico,2886,1284,1602
1990,36,Australia,Mexico,777,330,447
1990,100,Bulgaria,Mexico,2,1,1
1990,203,Czechia,Mexico,19,10,9
1990,348,Hungary,Mexico,20,11,9
1990,616,Poland,Mexico,165,86,79
1990,642,Romania,Mexico,4,1,3
1990,643,Russian Federation,Mexico,173,85,88
1990,703,Slovakia,Mexico,3,1,2
1990,208,Denmark,Mexico,239,97,142
1990,246,Finland,Mexico,67,41,26
1990,352,Iceland,Mexico,10,3,7
1990,372,Ireland,Mexico,59,19,40
1990,428,Latvia,Mexico,6,3,3
1990,578,Norway,Mexico,208,87,121
1990,752,Sweden,Mexico,847,395,452
1990,826,United Kingdom,Mexico,704,407,297
1990,300,Greece,Mexico,379,137,242
1990,380,Italy,Mexico,4331,532,3799
1990,620,Portugal,Mexico,62,23,39
1990,688,Serbia,Mexico,2,1,1
1990,705,Slovenia,Mexico,5,3,2
1990,724,Spain,Mexico,9649,3999,5650
1990,40,Austria,Mexico,832,348,484
1990,56,Belgium,Mexico,1647,617,1030
1990,250,France,Mexico,6305,2439,3866
1990,276,Germany,Mexico,3437,1253,2184
1990,442,Luxembourg,Mexico,27,7,20
1990,528,Netherlands,Mexico,658,287,371
1990,756,Switzerland,Mexico,2539,933,1606
1990,124,Canada,Mexico,18610,9060,9550
1990,840,United States of America,Mexico,4298014,2315850,1982164
1995,710,South Africa,Mexico,86,47,39
1995,132,Cabo Verde,Mexico,5,3,2
1995,818,Egypt,Mexico,57,19,38
1995,196,Cyprus,Mexico,23,8,15
1995,376,Israel,Mexico,1721,801,920
1995,792,Turkey,Mexico,89,44,45
1995,392,Japan,Mexico,1255,602,653
1995,608,Philippines,Mexico,41,31,10
1995,28,Antigua and Barbuda,Mexico,4,2,2
1995,44,Bahamas,Mexico,51,31,20
1995,535,"Bonaire, Sint Eustatius and Saba",Mexico,21,5,16
1995,136,Cayman Islands,Mexico,24,11,13
1995,192,Cuba,Mexico,674,323,351
1995,214,Dominican Republic,Mexico,1930,833,1097
1995,332,Haiti,Mexico,290,124,166
1995,630,Puerto Rico,Mexico,2302,1092,1210
1995,662,Saint Lucia,Mexico,5,0,5
1995,84,Belize,Mexico,2782,1528,1254
1995,188,Costa Rica,Mexico,1778,842,936
1995,222,El Salvador,Mexico,1948,871,1077
1995,320,Guatemala,Mexico,8236,3466,4770
1995,340,Honduras,Mexico,980,486,494
1995,558,Nicaragua,Mexico,734,310,424
1995,591,Panama,Mexico,1810,795,1015
1995,32,Argentina,Mexico,2686,1358,1328
1995,68,Bolivia (Plurinational State of),Mexico,8770,4341,4429
1995,76,Brazil,Mexico,1027,594,433
1995,152,Chile,Mexico,1223,614,609
1995,170,Colombia,Mexico,2072,1047,1025
1995,218,Ecuador,Mexico,797,364,433
1995,600,Paraguay,Mexico,2440,1219,1221
1995,604,Peru,Mexico,931,434,497
1995,858,Uruguay,Mexico,657,311,346
1995,862,Venezuela (Bolivarian Republic of),Mexico,3012,1378,1634
1995,36,Australia,Mexico,1049,462,587
1995,100,Bulgaria,Mexico,7,3,4
1995,203,Czechia,Mexico,29,16,13
1995,348,Hungary,Mexico,154,79,75
1995,616,Poland,Mexico,140,72,68
1995,642,Romania,Mexico,6,2,4
1995,643,Russian Federation,Mexico,170,90,80
1995,703,Slovakia,Mexico,24,16,8
1995,208,Denmark,Mexico,350,148,202
1995,246,Finland,Mexico,98,54,44
1995,352,Iceland,Mexico,24,7,17
1995,372,Ireland,Mexico,162,47,115
1995,428,Latvia,Mexico,9,5,4
1995,578,Norway,Mexico,262,104,158
1995,752,Sweden,Mexico,1006,465,541
1995,826,United Kingdom,Mexico,2769,1278,1491
1995,191,Croatia,Mexico,8,3,5
1995,300,Greece,Mexico,366,108,258
1995,380,Italy,Mexico,4177,702,3475
1995,620,Portugal,Mexico,134,49,85
1995,688,Serbia,Mexico,19,8,11
1995,705,Slovenia,Mexico,10,6,4
1995,724,Spain,Mexico,11659,4903,6756
1995,40,Austria,Mexico,939,402,537
1995,56,Belgium,Mexico,1637,613,1024
1995,250,France,Mexico,6509,2451,4058
1995,276,Germany,Mexico,4652,1514,3138
1995,442,Luxembourg,Mexico,25,7,18
1995,528,Netherlands,Mexico,968,410,558
1995,756,Switzerland,Mexico,3416,1404,2012
1995,124,Canada,Mexico,30113,14566,15547
1995,840,United States of America,Mexico,6827945,3692951,3134994
2000,710,South Africa,Mexico,120,58,62
2000,132,Cabo Verde,Mexico,6,4,2
2000,818,Egypt,Mexico,48,16,32
2000,196,Cyprus,Mexico,29,10,19
2000,376,Israel,Mexico,1923,905,1018
2000,792,Turkey,Mexico,143,69,74
2000,392,Japan,Mexico,1740,804,936
2000,608,Philippines,Mexico,105,63,42
2000,28,Antigua and Barbuda,Mexico,4,2,2
2000,44,Bahamas,Mexico,82,54,28
2000,535,"Bonaire, Sint Eustatius and Saba",Mexico,32,8,24
2000,136,Cayman Islands,Mexico,42,20,22
2000,192,Cuba,Mexico,459,202,257
2000,214,Dominican Republic,Mexico,2122,893,1229
2000,332,Haiti,Mexico,275,118,157
2000,630,Puerto Rico,Mexico,2703,1283,1420
2000,662,Saint Lucia,Mexico,8,1,7
2000,84,Belize,Mexico,2539,1354,1185
2000,188,Costa Rica,Mexico,2365,1106,1259
2000,222,El Salvador,Mexico,1438,647,791
2000,320,Guatemala,Mexico,11070,5374,5696
2000,340,Honduras,Mexico,1164,562,602
2000,558,Nicaragua,Mexico,725,315,410
2000,591,Panama,Mexico,2341,1078,1263
2000,32,Argentina,Mexico,3040,1505,1535
2000,68,Bolivia (Plurinational State of),Mexico,9323,4609,4714
2000,76,Brazil,Mexico,1261,707,554
2000,152,Chile,Mexico,1700,848,852
2000,170,Colombia,Mexico,2236,1150,1086
2000,218,Ecuador,Mexico,937,432,505
2000,600,Paraguay,Mexico,1813,913,900
2000,604,Peru,Mexico,1088,509,579
2000,858,Uruguay,Mexico,602,269,333
2000,862,Venezuela (Bolivarian Republic of),Mexico,3115,1461,1654
2000,36,Australia,Mexico,1270,583,687
2000,100,Bulgaria,Mexico,12,5,7
2000,203,Czechia,Mexico,39,22,17
2000,348,Hungary,Mexico,288,148,140
2000,616,Poland,Mexico,120,60,60
2000,642,Romania,Mexico,9,3,6
2000,643,Russian Federation,Mexico,162,91,71
2000,703,Slovakia,Mexico,53,35,18
2000,208,Denmark,Mexico,461,199,262
2000,246,Finland,Mexico,129,67,62
2000,352,Iceland,Mexico,38,11,27
2000,372,Ireland,Mexico,355,110,245
2000,428,Latvia,Mexico,12,7,5
2000,578,Norway,Mexico,380,150,230
2000,752,Sweden,Mexico,1079,495,584
2000,826,United Kingdom,Mexico,4882,2167,2715
2000,191,Croatia,Mexico,15,5,10
2000,300,Greece,Mexico,360,77,283
2000,380,Italy,Mexico,4023,873,3150
2000,620,Portugal,Mexico,212,76,136
2000,688,Serbia,Mexico,27,11,16
2000,705,Slovenia,Mexico,12,6,6
2000,724,Spain,Mexico,18686,8137,10549
2000,40,Austria,Mexico,1046,456,590
2000,56,Belgium,Mexico,1579,593,986
2000,250,France,Mexico,6712,2462,4250
2000,276,Germany,Mexico,5867,1775,4092
2000,442,Luxembourg,Mexico,24,6,18
2000,528,Netherlands,Mexico,1312,545,767
2000,756,Switzerland,Mexico,4306,1886,2420
2000,124,Canada,Mexico,42332,20421,21911
2000,840,United States of America,Mexico,9410529,5104175,4306354
2005,710,South Africa,Mexico,158,73,85
2005,132,Cabo Verde,Mexico,5,4,1
2005,818,Egypt,Mexico,57,21,36
2005,196,Cyprus,Mexico,42,14,28
2005,376,Israel,Mexico,2209,1056,1153
2005,792,Turkey,Mexico,147,70,77
2005,392,Japan,Mexico,1845,841,1004
2005,608,Philippines,Mexico,84,51,33
2005,28,Antigua and Barbuda,Mexico,5,3,2
2005,44,Bahamas,Mexico,103,66,37
2005,535,"Bonaire, Sint Eustatius and Saba",Mexico,34,9,25
2005,136,Cayman Islands,Mexico,38,18,20
2005,192,Cuba,Mexico,307,135,172
2005,214,Dominican Republic,Mexico,1777,820,957
2005,332,Haiti,Mexico,261,112,149
2005,630,Puerto Rico,Mexico,3118,1476,1642
2005,662,Saint Lucia,Mexico,14,2,12
2005,84,Belize,Mexico,2764,1467,1297
2005,188,Costa Rica,Mexico,1549,714,835
2005,222,El Salvador,Mexico,1541,700,841
2005,320,Guatemala,Mexico,13160,7133,6027
2005,340,Honduras,Mexico,1140,557,583
2005,558,Nicaragua,Mexico,735,326,409
2005,591,Panama,Mexico,3152,1613,1539
2005,32,Argentina,Mexico,2243,1129,1114
2005,68,Bolivia (Plurinational State of),Mexico,8760,4307,4453
2005,76,Brazil,Mexico,1973,1075,898
2005,152,Chile,Mexico,2552,1294,1258
2005,170,Colombia,Mexico,2255,1178,1077
2005,218,Ecuador,Mexico,1106,523,583
2005,600,Paraguay,Mexico,1727,870,857
2005,604,Peru,Mexico,1278,602,676
2005,858,Uruguay,Mexico,557,249,308
2005,862,Venezuela (Bolivarian Republic of),Mexico,3344,1530,1814
2005,36,Australia,Mexico,1820,862,958
2005,100,Bulgaria,Mexico,18,8,10
2005,203,Czechia,Mexico,147,87,60
2005,348,Hungary,Mexico,357,187,170
2005,616,Poland,Mexico,167,95,72
2005,642,Romania,Mexico,10,4,6
2005,643,Russian Federation,Mexico,182,94,88
2005,703,Slovakia,Mexico,60,40,20
2005,208,Denmark,Mexico,694,303,391
2005,246,Finland,Mexico,336,189,147
2005,352,Iceland,Mexico,54,20,34
2005,372,Ireland,Mexico,356,125,231
2005,428,Latvia,Mexico,28,22,6
2005,578,Norway,Mexico,520,194,326
2005,752,Sweden,Mexico,1526,733,793
2005,826,United Kingdom,Mexico,6836,3043,3793
2005,191,Croatia,Mexico,27,10,17
2005,300,Greece,Mexico,383,81,302
2005,380,Italy,Mexico,6424,1861,4563
2005,620,Portugal,Mexico,243,100,143
2005,688,Serbia,Mexico,27,11,16
2005,705,Slovenia,Mexico,17,7,10
2005,724,Spain,Mexico,35811,15602,20209
2005,40,Austria,Mexico,1169,494,675
2005,56,Belgium,Mexico,1476,579,897
2005,250,France,Mexico,9332,3799,5533
2005,276,Germany,Mexico,10738,4038,6700
2005,438,Liechtenstein,Mexico,10,5,5
2005,442,Luxembourg,Mexico,20,6,14
2005,528,Netherlands,Mexico,2086,799,1287
2005,756,Switzerland,Mexico,4915,2023,2892
2005,124,Canada,Mexico,61186,29641,31545
2005,840,United States of America,Mexico,10611064,5782166,4828898
2010,710,South Africa,Mexico,247,114,133
2010,132,Cabo Verde,Mexico,3,3,0
2010,818,Egypt,Mexico,62,22,40
2010,196,Cyprus,Mexico,68,23,45
2010,376,Israel,Mexico,2522,1218,1304
2010,792,Turkey,Mexico,151,70,81
2010,392,Japan,Mexico,1956,880,1076
2010,608,Philippines,Mexico,143,85,58
2010,28,Antigua and Barbuda,Mexico,5,3,2
2010,44,Bahamas,Mexico,124,79,45
2010,136,Cayman Islands,Mexico,38,18,20
2010,192,Cuba,Mexico,170,74,96
2010,531,Curaçao,Mexico,12,3,9
2010,214,Dominican Republic,Mexico,1419,740,679
2010,332,Haiti,Mexico,274,118,156
2010,630,Puerto Rico,Mexico,3142,1473,1669
2010,662,Saint Lucia,Mexico,19,2,17
2010,84,Belize,Mexico,2988,1586,1402
2010,188,Costa Rica,Mexico,3053,1411,1642
2010,222,El Salvador,Mexico,1644,753,891
2010,320,Guatemala,Mexico,15250,8892,6358
2010,340,Honduras,Mexico,1116,553,563
2010,558,Nicaragua,Mexico,785,351,434
2010,591,Panama,Mexico,4114,2248,1866
2010,32,Argentina,Mexico,1445,752,693
2010,68,Bolivia (Plurinational State of),Mexico,8179,3998,4181
2010,76,Brazil,Mexico,2656,1425,1231
2010,152,Chile,Mexico,3403,1739,1664
2010,170,Colombia,Mexico,2664,1426,1238
2010,218,Ecuador,Mexico,1553,713,840
2010,600,Paraguay,Mexico,1645,827,818
2010,604,Peru,Mexico,1928,984,944
2010,858,Uruguay,Mexico,516,228,288
2010,862,Venezuela (Bolivarian Republic of),Mexico,3627,1620,2007
2010,36,Australia,Mexico,3400,1695,1705
2010,100,Bulgaria,Mexico,24,11,13
2010,203,Czechia,Mexico,240,146,94
2010,348,Hungary,Mexico,425,225,200
2010,616,Poland,Mexico,220,132,88
2010,642,Romania,Mexico,13,4,9
2010,643,Russian Federation,Mexico,200,96,104
2010,703,Slovakia,Mexico,67,45,22
2010,208,Denmark,Mexico,909,399,510
2010,233,Estonia,Mexico,28,18,10
2010,246,Finland,Mexico,612,334,278
2010,352,Iceland,Mexico,69,30,39
2010,372,Ireland,Mexico,299,91,208
2010,428,Latvia,Mexico,45,38,7
2010,578,Norway,Mexico,843,348,495
2010,752,Sweden,Mexico,2015,938,1077
2010,826,United Kingdom,Mexico,7201,3288,3913
2010,191,Croatia,Mexico,39,16,23
2010,300,Greece,Mexico,421,88,333
2010,380,Italy,Mexico,9012,2912,6100
2010,620,Portugal,Mexico,234,107,127
2010,688,Serbia,Mexico,27,11,16
2010,705,Slovenia,Mexico,38,19,19
2010,724,Spain,Mexico,44801,19426,25375
2010,40,Austria,Mexico,1292,532,760
2010,56,Belgium,Mexico,1870,724,1146
2010,250,France,Mexico,11813,4165,7648
2010,276,Germany,Mexico,14779,5968,8811
2010,438,Liechtenstein,Mexico,21,10,11
2010,442,Luxembourg,Mexico,18,6,12
2010,528,Netherlands,Mexico,2882,1141,1741
2010,756,Switzerland,Mexico,5690,2138,3552
2010,124,Canada,Mexico,69695,33906,35789
2010,840,United States of America,Mexico,12168662,6554739,5613923
2015,710,South Africa,Mexico,444,193,251
2015,132,Cabo Verde,Mexico,3,3,0
2015,818,Egypt,Mexico,45,20,25
2015,196,Cyprus,Mexico,65,23,42
2015,376,Israel,Mexico,2601,1250,1351
2015,792,Turkey,Mexico,153,69,84
2015,392,Japan,Mexico,2141,956,1185
2015,608,Philippines,Mexico,145,87,58
2015,28,Antigua and Barbuda,Mexico,5,3,2
2015,44,Bahamas,Mexico,134,85,49
2015,136,Cayman Islands,Mexico,40,20,20
2015,192,Cuba,Mexico,136,59,77
2015,531,Curaçao,Mexico,13,4,9
2015,214,Dominican Republic,Mexico,1497,780,717
2015,332,Haiti,Mexico,287,124,163
2015,630,Puerto Rico,Mexico,2647,1235,1412
2015,662,Saint Lucia,Mexico,18,2,16
2015,84,Belize,Mexico,3523,1860,1663
2015,188,Costa Rica,Mexico,3100,1423,1677
2015,222,El Salvador,Mexico,1714,786,928
2015,320,Guatemala,Mexico,17540,10330,7210
2015,340,Honduras,Mexico,1567,779,788
2015,558,Nicaragua,Mexico,846,381,465
2015,591,Panama,Mexico,4832,2634,2198
2015,32,Argentina,Mexico,1450,754,696
2015,68,Bolivia (Plurinational State of),Mexico,9522,4654,4868
2015,76,Brazil,Mexico,3198,1716,1482
2015,152,Chile,Mexico,5155,2580,2575
2015,170,Colombia,Mexico,2982,1610,1372
2015,218,Ecuador,Mexico,2258,1028,1230
2015,600,Paraguay,Mexico,1605,806,799
2015,604,Peru,Mexico,3294,1905,1389
2015,858,Uruguay,Mexico,532,235,297
2015,862,Venezuela (Bolivarian Republic of),Mexico,3831,1681,2150
2015,36,Australia,Mexico,5390,2650,2740
2015,100,Bulgaria,Mexico,61,30,31
2015,203,Czechia,Mexico,432,271,161
2015,348,Hungary,Mexico,449,252,197
2015,616,Poland,Mexico,212,129,83
2015,642,Romania,Mexico,116,41,75
2015,643,Russian Federation,Mexico,204,97,107
2015,703,Slovakia,Mexico,93,62,31
2015,208,Denmark,Mexico,1204,558,646
2015,233,Estonia,Mexico,65,38,27
2015,246,Finland,Mexico,928,509,419
2015,352,Iceland,Mexico,92,44,48
2015,372,Ireland,Mexico,305,90,215
2015,428,Latvia,Mexico,13,11,2
2015,578,Norway,Mexico,1237,540,697
2015,752,Sweden,Mexico,2469,1112,1357
2015,826,United Kingdom,Mexico,9209,4057,5152
2015,191,Croatia,Mexico,39,16,23
2015,300,Greece,Mexico,395,70,325
2015,380,Italy,Mexico,8565,2632,5933
2015,620,Portugal,Mexico,264,112,152
2015,688,Serbia,Mexico,26,11,15
2015,705,Slovenia,Mexico,69,40,29
2015,724,Spain,Mexico,48613,20525,28088
2015,40,Austria,Mexico,1512,627,885
2015,56,Belgium,Mexico,2375,912,1463
2015,250,France,Mexico,13086,4381,8705
2015,276,Germany,Mexico,15399,6196,9203
2015,438,Liechtenstein,Mexico,24,9,15
2015,442,Luxembourg,Mexico,27,9,18
2015,528,Netherlands,Mexico,3801,1525,2276
2015,756,Switzerland,Mexico,7006,2629,4377
2015,124,Canada,Mexico,80090,37280,42810
2015,840,United States of America,Mexico,11643298,6230901,5412397
2019,710,South Africa,Mexico,497,217,280
2019,132,Cabo Verde,Mexico,3,3,0
2019,818,Egypt,Mexico,64,25,39
2019,196,Cyprus,Mexico,64,23,41
2019,376,Israel,Mexico,2529,1216,1313
2019,792,Turkey,Mexico,206,94,112
2019,392,Japan,Mexico,2416,1079,1337
2019,608,Philippines,Mexico,149,90,59
2019,28,Antigua and Barbuda,Mexico,5,3,2
2019,44,Bahamas,Mexico,142,90,52
2019,136,Cayman Islands,Mexico,44,22,22
2019,192,Cuba,Mexico,125,54,71
2019,531,Curaçao,Mexico,14,5,9
2019,214,Dominican Republic,Mexico,1547,807,740
2019,332,Haiti,Mexico,298,129,169
2019,630,Puerto Rico,Mexico,1977,919,1058
2019,662,Saint Lucia,Mexico,17,2,15
2019,84,Belize,Mexico,3866,2042,1824
2019,188,Costa Rica,Mexico,3145,1455,1690
2019,222,El Salvador,Mexico,1737,797,940
2019,320,Guatemala,Mexico,18003,10603,7400
2019,340,Honduras,Mexico,1592,792,800
2019,558,Nicaragua,Mexico,886,399,487
2019,591,Panama,Mexico,5141,2804,2337
2019,32,Argentina,Mexico,1475,766,709
2019,68,Bolivia (Plurinational State of),Mexico,10396,5082,5314
2019,76,Brazil,Mexico,3601,1932,1669
2019,152,Chile,Mexico,6887,3255,3632
2019,170,Colombia,Mexico,3050,1647,1403
2019,218,Ecuador,Mexico,2223,1012,1211
2019,600,Paraguay,Mexico,1646,827,819
2019,604,Peru,Mexico,3926,2339,1587
2019,858,Uruguay,Mexico,550,244,306
2019,862,Venezuela (Bolivarian Republic of),Mexico,3752,1637,2115
2019,36,Australia,Mexico,6760,3277,3483
2019,100,Bulgaria,Mexico,90,44,46
2019,203,Czechia,Mexico,627,389,238
2019,348,Hungary,Mexico,537,294,243
2019,616,Poland,Mexico,224,140,84
2019,642,Romania,Mexico,263,107,156
2019,643,Russian Federation,Mexico,203,97,106
2019,703,Slovakia,Mexico,133,87,46
2019,208,Denmark,Mexico,1572,705,867
2019,233,Estonia,Mexico,90,54,36
2019,246,Finland,Mexico,1159,630,529
2019,352,Iceland,Mexico,134,67,67
2019,372,Ireland,Mexico,334,99,235
2019,428,Latvia,Mexico,18,14,4
2019,578,Norway,Mexico,1444,630,814
2019,752,Sweden,Mexico,3153,1412,1741
2019,826,United Kingdom,Mexico,10457,4622,5835
2019,191,Croatia,Mexico,36,15,21
2019,300,Greece,Mexico,385,80,305
2019,380,Italy,Mexico,9441,2936,6505
2019,620,Portugal,Mexico,268,114,154
2019,688,Serbia,Mexico,26,11,15
2019,705,Slovenia,Mexico,72,37,35
2019,724,Spain,Mexico,53158,21872,31286
2019,40,Austria,Mexico,1784,758,1026
2019,56,Belgium,Mexico,2745,1063,1682
2019,250,France,Mexico,13851,4616,9235
2019,276,Germany,Mexico,16892,7599,9293
2019,438,Liechtenstein,Mexico,33,13,20
2019,442,Luxembourg,Mexico,399,162,237
2019,528,Netherlands,Mexico,4932,2023,2909
2019,756,Switzerland,Mexico,7789,2970,4819
2019,124,Canada,Mexico,85825,39950,45875
2019,840,United States of America,Mexico,11489684,6138480,5351204
1990,32,Argentina,Micronesia (Fed. States of),9,0,9
1990,152,Chile,Micronesia (Fed. States of),1,0,1
1990,36,Australia,Micronesia (Fed. States of),6,3,3
1990,316,Guam,Micronesia (Fed. States of),2962,1623,1339
1990,584,Marshall Islands,Micronesia (Fed. States of),92,60,32
1990,580,Northern Mariana Islands,Micronesia (Fed. States of),1720,814,906
1990,585,Palau,Micronesia (Fed. States of),166,86,80
1990,724,Spain,Micronesia (Fed. States of),15,7,8
1990,40,Austria,Micronesia (Fed. States of),1,0,1
1990,250,France,Micronesia (Fed. States of),1,1,0
1990,840,United States of America,Micronesia (Fed. States of),2741,1341,1400
1995,32,Argentina,Micronesia (Fed. States of),9,0,9
1995,152,Chile,Micronesia (Fed. States of),1,1,0
1995,36,Australia,Micronesia (Fed. States of),8,2,6
1995,316,Guam,Micronesia (Fed. States of),4962,2607,2355
1995,584,Marshall Islands,Micronesia (Fed. States of),112,70,42
1995,580,Northern Mariana Islands,Micronesia (Fed. States of),1760,867,893
1995,585,Palau,Micronesia (Fed. States of),282,125,157
1995,724,Spain,Micronesia (Fed. States of),23,11,12
1995,40,Austria,Micronesia (Fed. States of),1,0,1
1995,250,France,Micronesia (Fed. States of),1,1,0
1995,840,United States of America,Micronesia (Fed. States of),4980,2467,2513
2000,32,Argentina,Micronesia (Fed. States of),9,0,9
2000,152,Chile,Micronesia (Fed. States of),1,0,1
2000,36,Australia,Micronesia (Fed. States of),20,10,10
2000,316,Guam,Micronesia (Fed. States of),6961,3590,3371
2000,584,Marshall Islands,Micronesia (Fed. States of),139,83,56
2000,580,Northern Mariana Islands,Micronesia (Fed. States of),1908,918,990
2000,585,Palau,Micronesia (Fed. States of),326,146,180
2000,724,Spain,Micronesia (Fed. States of),282,149,133
2000,40,Austria,Micronesia (Fed. States of),1,0,1
2000,250,France,Micronesia (Fed. States of),1,1,0
2000,840,United States of America,Micronesia (Fed. States of),7267,3621,3646
2005,32,Argentina,Micronesia (Fed. States of),7,0,7
2005,152,Chile,Micronesia (Fed. States of),1,0,1
2005,36,Australia,Micronesia (Fed. States of),30,15,15
2005,316,Guam,Micronesia (Fed. States of),8753,4516,4237
2005,584,Marshall Islands,Micronesia (Fed. States of),178,102,76
2005,580,Northern Mariana Islands,Micronesia (Fed. States of),1841,819,1022
2005,585,Palau,Micronesia (Fed. States of),465,227,238
2005,724,Spain,Micronesia (Fed. States of),136,71,65
2005,40,Austria,Micronesia (Fed. States of),1,0,1
2005,250,France,Micronesia (Fed. States of),2,2,0
2005,840,United States of America,Micronesia (Fed. States of),6933,3475,3458
2010,32,Argentina,Micronesia (Fed. States of),4,0,4
2010,152,Chile,Micronesia (Fed. States of),2,1,1
2010,36,Australia,Micronesia (Fed. States of),20,10,10
2010,316,Guam,Micronesia (Fed. States of),10545,5443,5102
2010,584,Marshall Islands,Micronesia (Fed. States of),228,130,98
2010,580,Northern Mariana Islands,Micronesia (Fed. States of),1245,495,750
2010,585,Palau,Micronesia (Fed. States of),445,206,239
2010,752,Sweden,Micronesia (Fed. States of),1,0,1
2010,724,Spain,Micronesia (Fed. States of),109,60,49
2010,40,Austria,Micronesia (Fed. States of),1,0,1
2010,250,France,Micronesia (Fed. States of),3,3,0
2010,840,United States of America,Micronesia (Fed. States of),6803,3364,3439
2015,324,Guinea,Micronesia (Fed. States of),3,1,2
2015,32,Argentina,Micronesia (Fed. States of),4,0,4
2015,152,Chile,Micronesia (Fed. States of),3,2,1
2015,36,Australia,Micronesia (Fed. States of),40,23,17
2015,316,Guam,Micronesia (Fed. States of),10639,5488,5151
2015,584,Marshall Islands,Micronesia (Fed. States of),242,138,104
2015,580,Northern Mariana Islands,Micronesia (Fed. States of),1115,440,675
2015,585,Palau,Micronesia (Fed. States of),400,197,203
2015,752,Sweden,Micronesia (Fed. States of),1,0,1
2015,724,Spain,Micronesia (Fed. States of),119,53,66
2015,40,Austria,Micronesia (Fed. States of),1,0,1
2015,250,France,Micronesia (Fed. States of),3,3,0
2015,840,United States of America,Micronesia (Fed. States of),8064,3968,4096
2019,324,Guinea,Micronesia (Fed. States of),2,1,1
2019,32,Argentina,Micronesia (Fed. States of),4,0,4
2019,152,Chile,Micronesia (Fed. States of),4,3,1
2019,36,Australia,Micronesia (Fed. States of),31,17,14
2019,316,Guam,Micronesia (Fed. States of),11164,5759,5405
2019,584,Marshall Islands,Micronesia (Fed. States of),245,138,107
2019,580,Northern Mariana Islands,Micronesia (Fed. States of),1123,443,680
2019,585,Palau,Micronesia (Fed. States of),410,181,229
2019,752,Sweden,Micronesia (Fed. States of),1,0,1
2019,724,Spain,Micronesia (Fed. States of),123,53,70
2019,40,Austria,Micronesia (Fed. States of),1,0,1
2019,250,France,Micronesia (Fed. States of),3,3,0
2019,840,United States of America,Micronesia (Fed. States of),8708,4238,4470
1990,710,South Africa,Monaco,11,6,5
1990,818,Egypt,Monaco,62,29,33
1990,434,Libya,Monaco,176,83,93
1990,188,Costa Rica,Monaco,1,1,0
1990,32,Argentina,Monaco,23,1,22
1990,68,Bolivia (Plurinational State of),Monaco,2,0,2
1990,152,Chile,Monaco,4,1,3
1990,36,Australia,Monaco,37,23,14
1990,100,Bulgaria,Monaco,1,0,1
1990,616,Poland,Monaco,3,2,1
1990,643,Russian Federation,Monaco,192,94,98
1990,208,Denmark,Monaco,5,3,2
1990,246,Finland,Monaco,1,1,0
1990,372,Ireland,Monaco,1,1,0
1990,752,Sweden,Monaco,11,9,2
1990,826,United Kingdom,Monaco,60,44,16
1990,300,Greece,Monaco,11,6,5
1990,380,Italy,Monaco,154,53,101
1990,724,Spain,Monaco,82,43,39
1990,40,Austria,Monaco,14,6,8
1990,56,Belgium,Monaco,77,46,31
1990,250,France,Monaco,3282,1677,1605
1990,528,Netherlands,Monaco,23,11,12
1990,756,Switzerland,Monaco,116,53,63
1990,124,Canada,Monaco,130,63,67
1995,710,South Africa,Monaco,9,6,3
1995,818,Egypt,Monaco,59,28,31
1995,434,Libya,Monaco,187,101,86
1995,188,Costa Rica,Monaco,1,1,0
1995,32,Argentina,Monaco,22,1,21
1995,68,Bolivia (Plurinational State of),Monaco,1,0,1
1995,152,Chile,Monaco,6,3,3
1995,36,Australia,Monaco,19,12,7
1995,100,Bulgaria,Monaco,2,1,1
1995,203,Czechia,Monaco,1,1,0
1995,348,Hungary,Monaco,2,1,1
1995,616,Poland,Monaco,2,2,0
1995,643,Russian Federation,Monaco,218,98,120
1995,208,Denmark,Monaco,6,4,2
1995,246,Finland,Monaco,2,2,0
1995,352,Iceland,Monaco,1,0,1
1995,372,Ireland,Monaco,4,3,1
1995,752,Sweden,Monaco,13,11,2
1995,826,United Kingdom,Monaco,136,78,58
1995,300,Greece,Monaco,16,7,9
1995,380,Italy,Monaco,179,60,119
1995,724,Spain,Monaco,124,67,57
1995,40,Austria,Monaco,16,7,9
1995,56,Belgium,Monaco,77,46,31
1995,250,France,Monaco,3388,1703,1685
1995,528,Netherlands,Monaco,33,15,18
1995,756,Switzerland,Monaco,148,76,72
1995,124,Canada,Monaco,118,57,61
2000,710,South Africa,Monaco,11,9,2
2000,818,Egypt,Monaco,60,29,31
2000,434,Libya,Monaco,202,123,79
2000,188,Costa Rica,Monaco,1,1,0
2000,32,Argentina,Monaco,21,1,20
2000,152,Chile,Monaco,9,4,5
2000,36,Australia,Monaco,30,15,15
2000,100,Bulgaria,Monaco,2,1,1
2000,203,Czechia,Monaco,1,1,0
2000,348,Hungary,Monaco,4,2,2
2000,616,Poland,Monaco,2,1,1
2000,643,Russian Federation,Monaco,238,100,138
2000,208,Denmark,Monaco,7,5,2
2000,246,Finland,Monaco,2,2,0
2000,352,Iceland,Monaco,1,0,1
2000,372,Ireland,Monaco,8,5,3
2000,752,Sweden,Monaco,15,12,3
2000,826,United Kingdom,Monaco,215,113,102
2000,300,Greece,Monaco,22,8,14
2000,380,Italy,Monaco,203,67,136
2000,724,Spain,Monaco,154,81,73
2000,40,Austria,Monaco,18,9,9
2000,56,Belgium,Monaco,77,46,31
2000,250,France,Monaco,3494,1730,1764
2000,528,Netherlands,Monaco,46,19,27
2000,756,Switzerland,Monaco,181,98,83
2000,124,Canada,Monaco,109,52,57
2005,710,South Africa,Monaco,14,12,2
2005,818,Egypt,Monaco,71,36,35
2005,434,Libya,Monaco,223,152,71
2005,188,Costa Rica,Monaco,1,1,0
2005,32,Argentina,Monaco,16,1,15
2005,152,Chile,Monaco,13,6,7
2005,36,Australia,Monaco,50,25,25
2005,100,Bulgaria,Monaco,3,1,2
2005,203,Czechia,Monaco,2,2,0
2005,348,Hungary,Monaco,5,3,2
2005,616,Poland,Monaco,13,9,4
2005,643,Russian Federation,Monaco,142,58,84
2005,208,Denmark,Monaco,11,6,5
2005,246,Finland,Monaco,3,3,0
2005,352,Iceland,Monaco,1,0,1
2005,372,Ireland,Monaco,8,5,3
2005,752,Sweden,Monaco,22,17,5
2005,826,United Kingdom,Monaco,287,161,126
2005,300,Greece,Monaco,34,15,19
2005,380,Italy,Monaco,910,409,501
2005,724,Spain,Monaco,182,91,91
2005,40,Austria,Monaco,20,9,11
2005,56,Belgium,Monaco,108,46,62
2005,250,France,Monaco,16581,8309,8272
2005,528,Netherlands,Monaco,54,21,33
2005,756,Switzerland,Monaco,202,102,100
2005,124,Canada,Monaco,138,85,53
2010,710,South Africa,Monaco,21,18,3
2010,818,Egypt,Monaco,77,38,39
2010,434,Libya,Monaco,245,168,77
2010,188,Costa Rica,Monaco,1,1,0
2010,32,Argentina,Monaco,10,1,9
2010,76,Brazil,Monaco,125,46,79
2010,152,Chile,Monaco,18,9,9
2010,36,Australia,Monaco,70,35,35
2010,100,Bulgaria,Monaco,4,2,2
2010,203,Czechia,Monaco,2,2,0
2010,348,Hungary,Monaco,5,4,1
2010,616,Poland,Monaco,25,16,9
2010,643,Russian Federation,Monaco,45,15,30
2010,208,Denmark,Monaco,14,8,6
2010,233,Estonia,Monaco,1,0,1
2010,246,Finland,Monaco,3,3,0
2010,352,Iceland,Monaco,1,0,1
2010,372,Ireland,Monaco,7,5,2
2010,752,Sweden,Monaco,29,20,9
2010,826,United Kingdom,Monaco,302,172,130
2010,300,Greece,Monaco,47,24,23
2010,380,Italy,Monaco,1653,759,894
2010,724,Spain,Monaco,234,112,122
2010,40,Austria,Monaco,21,9,12
2010,56,Belgium,Monaco,124,53,71
2010,250,France,Monaco,23426,11335,12091
2010,528,Netherlands,Monaco,61,24,37
2010,756,Switzerland,Monaco,240,117,123
2010,124,Canada,Monaco,150,105,45
2015,710,South Africa,Monaco,36,32,4
2015,818,Egypt,Monaco,57,32,25
2015,434,Libya,Monaco,276,188,88
2015,188,Costa Rica,Monaco,1,1,0
2015,32,Argentina,Monaco,10,1,9
2015,76,Brazil,Monaco,151,56,95
2015,152,Chile,Monaco,27,14,13
2015,36,Australia,Monaco,80,45,35
2015,100,Bulgaria,Monaco,8,3,5
2015,203,Czechia,Monaco,6,5,1
2015,348,Hungary,Monaco,5,3,2
2015,616,Poland,Monaco,24,16,8
2015,643,Russian Federation,Monaco,45,15,30
2015,208,Denmark,Monaco,17,10,7
2015,246,Finland,Monaco,8,6,2
2015,352,Iceland,Monaco,1,0,1
2015,372,Ireland,Monaco,7,5,2
2015,752,Sweden,Monaco,45,25,20
2015,826,United Kingdom,Monaco,386,215,171
2015,300,Greece,Monaco,44,22,22
2015,380,Italy,Monaco,1299,601,698
2015,724,Spain,Monaco,235,111,124
2015,40,Austria,Monaco,24,10,14
2015,56,Belgium,Monaco,134,62,72
2015,250,France,Monaco,25951,12188,13763
2015,528,Netherlands,Monaco,78,36,42
2015,756,Switzerland,Monaco,288,130,158
2015,124,Canada,Monaco,109,95,14
2019,710,South Africa,Monaco,39,35,4
2019,818,Egypt,Monaco,81,42,39
2019,434,Libya,Monaco,292,199,93
2019,188,Costa Rica,Monaco,1,1,0
2019,32,Argentina,Monaco,10,1,9
2019,76,Brazil,Monaco,170,64,106
2019,152,Chile,Monaco,36,18,18
2019,36,Australia,Monaco,95,49,46
2019,100,Bulgaria,Monaco,9,4,5
2019,203,Czechia,Monaco,6,4,2
2019,348,Hungary,Monaco,4,1,3
2019,616,Poland,Monaco,25,17,8
2019,643,Russian Federation,Monaco,44,15,29
2019,208,Denmark,Monaco,21,11,10
2019,246,Finland,Monaco,12,8,4
2019,352,Iceland,Monaco,1,0,1
2019,372,Ireland,Monaco,7,5,2
2019,752,Sweden,Monaco,50,32,18
2019,826,United Kingdom,Monaco,438,245,193
2019,300,Greece,Monaco,42,22,20
2019,380,Italy,Monaco,1655,776,879
2019,724,Spain,Monaco,243,112,131
2019,40,Austria,Monaco,28,12,16
2019,56,Belgium,Monaco,144,67,77
2019,250,France,Monaco,27469,12868,14601
2019,528,Netherlands,Monaco,101,48,53
2019,756,Switzerland,Monaco,314,142,172
2019,124,Canada,Monaco,116,101,15
1990,818,Egypt,Mongolia,1,1,0
1990,792,Turkey,Mongolia,46,24,22
1990,410,Republic of Korea,Mongolia,112,57,55
1990,188,Costa Rica,Mongolia,7,5,2
1990,36,Australia,Mongolia,36,22,14
1990,112,Belarus,Mongolia,96,40,56
1990,100,Bulgaria,Mongolia,23,11,12
1990,203,Czechia,Mongolia,140,52,88
1990,348,Hungary,Mongolia,386,171,215
1990,616,Poland,Mongolia,234,110,124
1990,498,Republic of Moldova,Mongolia,348,148,200
1990,643,Russian Federation,Mongolia,21142,10375,10767
1990,703,Slovakia,Mongolia,11,6,5
1990,208,Denmark,Mongolia,2,1,1
1990,233,Estonia,Mongolia,28,10,18
1990,246,Finland,Mongolia,1,1,0
1990,352,Iceland,Mongolia,5,3,2
1990,372,Ireland,Mongolia,61,23,38
1990,428,Latvia,Mongolia,87,39,48
1990,440,Lithuania,Mongolia,79,36,43
1990,752,Sweden,Mongolia,30,10,20
1990,826,United Kingdom,Mongolia,40,23,17
1990,300,Greece,Mongolia,9,4,5
1990,380,Italy,Mongolia,5,1,4
1990,724,Spain,Mongolia,10,3,7
1990,40,Austria,Mongolia,993,353,640
1990,56,Belgium,Mongolia,47,15,32
1990,250,France,Mongolia,288,131,157
1990,528,Netherlands,Mongolia,27,12,15
1990,756,Switzerland,Mongolia,148,64,84
1990,124,Canada,Mongolia,24,11,13
1995,818,Egypt,Mongolia,6,5,1
1995,792,Turkey,Mongolia,111,55,56
1995,410,Republic of Korea,Mongolia,703,347,356
1995,188,Costa Rica,Mongolia,7,5,2
1995,68,Bolivia (Plurinational State of),Mongolia,1,0,1
1995,36,Australia,Mongolia,80,37,43
1995,112,Belarus,Mongolia,136,43,93
1995,100,Bulgaria,Mongolia,29,12,17
1995,203,Czechia,Mongolia,210,82,128
1995,348,Hungary,Mongolia,625,205,420
1995,616,Poland,Mongolia,200,93,107
1995,498,Republic of Moldova,Mongolia,235,96,139
1995,643,Russian Federation,Mongolia,22734,10881,11853
1995,703,Slovakia,Mongolia,22,9,13
1995,208,Denmark,Mongolia,10,4,6
1995,233,Estonia,Mongolia,43,15,28
1995,246,Finland,Mongolia,7,2,5
1995,352,Iceland,Mongolia,8,4,4
1995,372,Ireland,Mongolia,169,60,109
1995,428,Latvia,Mongolia,133,60,73
1995,440,Lithuania,Mongolia,88,41,47
1995,752,Sweden,Mongolia,36,11,25
1995,826,United Kingdom,Mongolia,162,75,87
1995,300,Greece,Mongolia,10,4,6
1995,380,Italy,Mongolia,31,5,26
1995,724,Spain,Mongolia,16,5,11
1995,40,Austria,Mongolia,1120,409,711
1995,56,Belgium,Mongolia,47,15,32
1995,250,France,Mongolia,297,132,165
1995,528,Netherlands,Mongolia,39,16,23
1995,756,Switzerland,Mongolia,303,107,196
1995,124,Canada,Mongolia,76,37,39
2000,818,Egypt,Mongolia,11,9,2
2000,268,Georgia,Mongolia,29,7,22
2000,792,Turkey,Mongolia,178,87,91
2000,410,Republic of Korea,Mongolia,1519,771,748
2000,188,Costa Rica,Mongolia,11,8,3
2000,68,Bolivia (Plurinational State of),Mongolia,1,0,1
2000,152,Chile,Mongolia,1,0,1
2000,36,Australia,Mongolia,120,64,56
2000,112,Belarus,Mongolia,175,45,130
2000,100,Bulgaria,Mongolia,35,13,22
2000,203,Czechia,Mongolia,279,111,168
2000,348,Hungary,Mongolia,863,238,625
2000,616,Poland,Mongolia,171,78,93
2000,498,Republic of Moldova,Mongolia,159,62,97
2000,643,Russian Federation,Mongolia,23503,10997,12506
2000,703,Slovakia,Mongolia,41,15,26
2000,208,Denmark,Mongolia,17,6,11
2000,233,Estonia,Mongolia,58,21,37
2000,246,Finland,Mongolia,13,4,9
2000,352,Iceland,Mongolia,10,5,5
2000,372,Ireland,Mongolia,369,139,230
2000,428,Latvia,Mongolia,180,82,98
2000,440,Lithuania,Mongolia,68,32,36
2000,578,Norway,Mongolia,8,3,5
2000,752,Sweden,Mongolia,39,12,27
2000,826,United Kingdom,Mongolia,288,128,160
2000,300,Greece,Mongolia,12,5,7
2000,380,Italy,Mongolia,57,10,47
2000,724,Spain,Mongolia,193,71,122
2000,40,Austria,Mongolia,1247,466,781
2000,56,Belgium,Mongolia,45,15,30
2000,250,France,Mongolia,306,133,173
2000,528,Netherlands,Mongolia,54,20,34
2000,756,Switzerland,Mongolia,460,150,310
2000,124,Canada,Mongolia,129,63,66
2005,818,Egypt,Mongolia,13,11,2
2005,268,Georgia,Mongolia,27,7,20
2005,792,Turkey,Mongolia,183,88,95
2005,410,Republic of Korea,Mongolia,9094,5422,3672
2005,188,Costa Rica,Mongolia,7,5,2
2005,68,Bolivia (Plurinational State of),Mongolia,1,0,1
2005,152,Chile,Mongolia,1,0,1
2005,36,Australia,Mongolia,240,104,136
2005,112,Belarus,Mongolia,168,43,125
2005,100,Bulgaria,Mongolia,47,17,30
2005,203,Czechia,Mongolia,2887,1097,1790
2005,348,Hungary,Mongolia,1066,308,758
2005,616,Poland,Mongolia,248,91,157
2005,498,Republic of Moldova,Mongolia,110,41,69
2005,643,Russian Federation,Mongolia,22355,10299,12056
2005,703,Slovakia,Mongolia,47,18,29
2005,208,Denmark,Mongolia,41,10,31
2005,233,Estonia,Mongolia,56,23,33
2005,246,Finland,Mongolia,30,11,19
2005,352,Iceland,Mongolia,18,8,10
2005,372,Ireland,Mongolia,371,154,217
2005,428,Latvia,Mongolia,155,68,87
2005,440,Lithuania,Mongolia,76,36,40
2005,578,Norway,Mongolia,42,13,29
2005,752,Sweden,Mongolia,123,35,88
2005,826,United Kingdom,Mongolia,917,340,577
2005,300,Greece,Mongolia,10,4,6
2005,380,Italy,Mongolia,166,44,122
2005,705,Slovenia,Mongolia,2,1,1
2005,724,Spain,Mongolia,93,33,60
2005,40,Austria,Mongolia,1395,501,894
2005,56,Belgium,Mongolia,164,57,107
2005,250,France,Mongolia,687,299,388
2005,528,Netherlands,Mongolia,412,156,256
2005,756,Switzerland,Mongolia,519,149,370
2005,124,Canada,Mongolia,607,277,330
2010,818,Egypt,Mongolia,14,12,2
2010,268,Georgia,Mongolia,27,7,20
2010,792,Turkey,Mongolia,188,88,100
2010,410,Republic of Korea,Mongolia,20266,11991,8275
2010,188,Costa Rica,Mongolia,15,11,4
2010,68,Bolivia (Plurinational State of),Mongolia,1,0,1
2010,152,Chile,Mongolia,2,1,1
2010,36,Australia,Mongolia,700,298,402
2010,112,Belarus,Mongolia,161,42,119
2010,100,Bulgaria,Mongolia,57,21,36
2010,203,Czechia,Mongolia,5209,2046,3163
2010,348,Hungary,Mongolia,1268,377,891
2010,616,Poland,Mongolia,334,106,228
2010,498,Republic of Moldova,Mongolia,83,32,51
2010,643,Russian Federation,Mongolia,20748,9397,11351
2010,703,Slovakia,Mongolia,52,20,32
2010,208,Denmark,Mongolia,63,13,50
2010,233,Estonia,Mongolia,53,24,29
2010,246,Finland,Mongolia,54,21,33
2010,352,Iceland,Mongolia,25,11,14
2010,372,Ireland,Mongolia,311,115,196
2010,428,Latvia,Mongolia,128,51,77
2010,440,Lithuania,Mongolia,75,33,42
2010,578,Norway,Mongolia,96,24,72
2010,752,Sweden,Mongolia,830,325,505
2010,826,United Kingdom,Mongolia,966,371,595
2010,300,Greece,Mongolia,8,4,4
2010,380,Italy,Mongolia,249,68,181
2010,705,Slovenia,Mongolia,5,2,3
2010,724,Spain,Mongolia,367,134,233
2010,40,Austria,Mongolia,1542,536,1006
2010,56,Belgium,Mongolia,437,159,278
2010,250,France,Mongolia,1339,566,773
2010,528,Netherlands,Mongolia,450,149,301
2010,756,Switzerland,Mongolia,608,153,455
2010,124,Canada,Mongolia,1035,471,564
2015,818,Egypt,Mongolia,10,9,1
2015,268,Georgia,Mongolia,28,8,20
2015,792,Turkey,Mongolia,190,87,103
2015,410,Republic of Korea,Mongolia,25180,14660,10520
2015,188,Costa Rica,Mongolia,15,11,4
2015,68,Bolivia (Plurinational State of),Mongolia,1,0,1
2015,152,Chile,Mongolia,3,2,1
2015,36,Australia,Mongolia,1780,792,988
2015,112,Belarus,Mongolia,168,43,125
2015,100,Bulgaria,Mongolia,90,34,56
2015,203,Czechia,Mongolia,4607,1817,2790
2015,348,Hungary,Mongolia,921,263,658
2015,616,Poland,Mongolia,322,107,215
2015,498,Republic of Moldova,Mongolia,69,27,42
2015,643,Russian Federation,Mongolia,21144,9518,11626
2015,703,Slovakia,Mongolia,64,28,36
2015,208,Denmark,Mongolia,63,13,50
2015,233,Estonia,Mongolia,50,20,30
2015,246,Finland,Mongolia,65,22,43
2015,352,Iceland,Mongolia,20,8,12
2015,372,Ireland,Mongolia,318,115,203
2015,428,Latvia,Mongolia,109,42,67
2015,440,Lithuania,Mongolia,62,24,38
2015,578,Norway,Mongolia,147,35,112
2015,752,Sweden,Mongolia,2609,1079,1530
2015,826,United Kingdom,Mongolia,1235,452,783
2015,300,Greece,Mongolia,7,4,3
2015,380,Italy,Mongolia,292,84,208
2015,705,Slovenia,Mongolia,4,2,2
2015,724,Spain,Mongolia,419,144,275
2015,40,Austria,Mongolia,1804,634,1170
2015,56,Belgium,Mongolia,778,279,499
2015,250,France,Mongolia,1483,603,880
2015,528,Netherlands,Mongolia,482,160,322
2015,756,Switzerland,Mongolia,916,234,682
2015,124,Canada,Mongolia,1411,636,775
2019,818,Egypt,Mongolia,14,13,1
2019,268,Georgia,Mongolia,28,8,20
2019,792,Turkey,Mongolia,256,119,137
2019,410,Republic of Korea,Mongolia,25633,14920,10713
2019,188,Costa Rica,Mongolia,15,11,4
2019,68,Bolivia (Plurinational State of),Mongolia,1,0,1
2019,152,Chile,Mongolia,4,3,1
2019,36,Australia,Mongolia,3787,1766,2021
2019,112,Belarus,Mongolia,165,42,123
2019,100,Bulgaria,Mongolia,95,34,61
2019,203,Czechia,Mongolia,5833,2472,3361
2019,348,Hungary,Mongolia,1058,309,749
2019,616,Poland,Mongolia,341,123,218
2019,498,Republic of Moldova,Mongolia,67,27,40
2019,643,Russian Federation,Mongolia,21139,9516,11623
2019,703,Slovakia,Mongolia,65,28,37
2019,208,Denmark,Mongolia,72,16,56
2019,233,Estonia,Mongolia,49,19,30
2019,246,Finland,Mongolia,83,27,56
2019,352,Iceland,Mongolia,20,8,12
2019,372,Ireland,Mongolia,349,127,222
2019,428,Latvia,Mongolia,99,38,61
2019,440,Lithuania,Mongolia,50,19,31
2019,578,Norway,Mongolia,164,45,119
2019,752,Sweden,Mongolia,4281,1853,2428
2019,826,United Kingdom,Mongolia,1402,516,886
2019,300,Greece,Mongolia,6,4,2
2019,380,Italy,Mongolia,298,87,211
2019,705,Slovenia,Mongolia,6,2,4
2019,724,Spain,Mongolia,434,143,291
2019,40,Austria,Mongolia,2129,772,1357
2019,56,Belgium,Mongolia,824,296,528
2019,250,France,Mongolia,1569,636,933
2019,528,Netherlands,Mongolia,575,184,391
2019,756,Switzerland,Mongolia,1071,288,783
2019,124,Canada,Mongolia,1512,682,830
1990,862,Venezuela (Bolivarian Republic of),Montenegro,241,117,124
1990,36,Australia,Montenegro,1297,650,647
1990,100,Bulgaria,Montenegro,7,4,3
1990,203,Czechia,Montenegro,29,20,9
1990,616,Poland,Montenegro,275,166,109
1990,643,Russian Federation,Montenegro,538,264,274
1990,703,Slovakia,Montenegro,10,5,5
1990,208,Denmark,Montenegro,1900,997,903
1990,826,United Kingdom,Montenegro,197,138,59
1990,70,Bosnia and Herzegovina,Montenegro,3727,1815,1912
1990,380,Italy,Montenegro,1458,507,951
1990,807,North Macedonia,Montenegro,9247,3855,5392
1990,688,Serbia,Montenegro,9511,4518,4993
1990,705,Slovenia,Montenegro,2646,1353,1293
1990,40,Austria,Montenegro,12031,5919,6112
1990,56,Belgium,Montenegro,10,6,4
1990,250,France,Montenegro,949,501,448
1990,276,Germany,Montenegro,30932,16661,14271
1990,438,Liechtenstein,Montenegro,78,78,0
1990,442,Luxembourg,Montenegro,2301,1245,1056
1995,862,Venezuela (Bolivarian Republic of),Montenegro,238,116,122
1995,36,Australia,Montenegro,3419,1758,1661
1995,100,Bulgaria,Montenegro,11,6,5
1995,203,Czechia,Montenegro,43,30,13
1995,348,Hungary,Montenegro,14,9,5
1995,616,Poland,Montenegro,235,141,94
1995,643,Russian Federation,Montenegro,551,276,275
1995,703,Slovakia,Montenegro,14,8,6
1995,208,Denmark,Montenegro,1933,1015,918
1995,826,United Kingdom,Montenegro,447,246,201
1995,70,Bosnia and Herzegovina,Montenegro,4701,2291,2410
1995,380,Italy,Montenegro,3757,1826,1931
1995,807,North Macedonia,Montenegro,8606,3559,5047
1995,620,Portugal,Montenegro,51,46,5
1995,688,Serbia,Montenegro,60383,27415,32968
1995,705,Slovenia,Montenegro,2630,1425,1205
1995,40,Austria,Montenegro,13573,6790,6783
1995,56,Belgium,Montenegro,10,6,4
1995,250,France,Montenegro,980,510,470
1995,276,Germany,Montenegro,37033,19823,17210
1995,438,Liechtenstein,Montenegro,94,94,0
1995,442,Luxembourg,Montenegro,4925,2588,2337
1995,756,Switzerland,Montenegro,992,539,453
2000,862,Venezuela (Bolivarian Republic of),Montenegro,233,113,120
2000,36,Australia,Montenegro,5330,2770,2560
2000,100,Bulgaria,Montenegro,15,9,6
2000,203,Czechia,Montenegro,57,40,17
2000,348,Hungary,Montenegro,27,17,10
2000,616,Poland,Montenegro,201,119,82
2000,643,Russian Federation,Montenegro,545,279,266
2000,703,Slovakia,Montenegro,24,15,9
2000,208,Denmark,Montenegro,1965,1032,933
2000,826,United Kingdom,Montenegro,705,358,347
2000,70,Bosnia and Herzegovina,Montenegro,5675,2767,2908
2000,380,Italy,Montenegro,6055,3145,2910
2000,807,North Macedonia,Montenegro,8065,3362,4703
2000,620,Portugal,Montenegro,105,93,12
2000,688,Serbia,Montenegro,88070,36182,51888
2000,40,Austria,Montenegro,15115,7662,7453
2000,56,Belgium,Montenegro,9,5,4
2000,250,France,Montenegro,1011,519,492
2000,276,Germany,Montenegro,43133,22984,20149
2000,438,Liechtenstein,Montenegro,110,110,0
2000,442,Luxembourg,Montenegro,7519,4012,3507
2000,756,Switzerland,Montenegro,1989,1081,908
2005,68,Bolivia (Plurinational State of),Montenegro,1,1,0
2005,862,Venezuela (Bolivarian Republic of),Montenegro,244,119,125
2005,36,Australia,Montenegro,4020,2064,1956
2005,100,Bulgaria,Montenegro,21,12,9
2005,203,Czechia,Montenegro,46,33,13
2005,348,Hungary,Montenegro,33,21,12
2005,616,Poland,Montenegro,128,80,48
2005,643,Russian Federation,Montenegro,406,245,161
2005,703,Slovakia,Montenegro,28,18,10
2005,208,Denmark,Montenegro,1023,536,487
2005,246,Finland,Montenegro,2,1,1
2005,826,United Kingdom,Montenegro,819,409,410
2005,70,Bosnia and Herzegovina,Montenegro,3921,1902,2019
2005,191,Croatia,Montenegro,3071,1438,1633
2005,380,Italy,Montenegro,4170,2111,2059
2005,807,North Macedonia,Montenegro,8292,3459,4833
2005,620,Portugal,Montenegro,94,54,40
2005,688,Serbia,Montenegro,74564,33040,41524
2005,40,Austria,Montenegro,16895,8365,8530
2005,250,France,Montenegro,1147,584,563
2005,276,Germany,Montenegro,19700,10689,9011
2005,438,Liechtenstein,Montenegro,55,55,0
2005,442,Luxembourg,Montenegro,6563,3682,2881
2005,756,Switzerland,Montenegro,2163,1124,1039
2005,124,Canada,Montenegro,750,367,383
2010,68,Bolivia (Plurinational State of),Montenegro,2,2,0
2010,76,Brazil,Montenegro,22,10,12
2010,862,Venezuela (Bolivarian Republic of),Montenegro,260,127,133
2010,36,Australia,Montenegro,1880,962,918
2010,100,Bulgaria,Montenegro,26,15,11
2010,203,Czechia,Montenegro,32,24,8
2010,348,Hungary,Montenegro,39,25,14
2010,616,Poland,Montenegro,61,44,17
2010,643,Russian Federation,Montenegro,259,206,53
2010,703,Slovakia,Montenegro,31,20,11
2010,208,Denmark,Montenegro,79,39,40
2010,246,Finland,Montenegro,2,0,2
2010,578,Norway,Montenegro,304,152,152
2010,752,Sweden,Montenegro,419,233,186
2010,826,United Kingdom,Montenegro,862,439,423
2010,70,Bosnia and Herzegovina,Montenegro,4423,2157,2266
2010,191,Croatia,Montenegro,6142,2877,3265
2010,380,Italy,Montenegro,2066,925,1141
2010,807,North Macedonia,Montenegro,8519,3555,4964
2010,620,Portugal,Montenegro,69,7,62
2010,688,Serbia,Montenegro,72867,32146,40721
2010,705,Slovenia,Montenegro,2763,1501,1262
2010,724,Spain,Montenegro,138,70,68
2010,40,Austria,Montenegro,18675,9068,9607
2010,56,Belgium,Montenegro,1,1,0
2010,250,France,Montenegro,1317,662,655
2010,276,Germany,Montenegro,17969,7215,10754
2010,438,Liechtenstein,Montenegro,1,1,0
2010,442,Luxembourg,Montenegro,5600,3351,2249
2010,756,Switzerland,Montenegro,2629,1295,1334
2010,124,Canada,Montenegro,1525,749,776
2015,68,Bolivia (Plurinational State of),Montenegro,2,2,0
2015,76,Brazil,Montenegro,26,12,14
2015,862,Venezuela (Bolivarian Republic of),Montenegro,272,131,141
2015,36,Australia,Montenegro,2030,1033,997
2015,100,Bulgaria,Montenegro,27,15,12
2015,203,Czechia,Montenegro,91,56,35
2015,348,Hungary,Montenegro,46,29,17
2015,616,Poland,Montenegro,58,42,16
2015,643,Russian Federation,Montenegro,263,209,54
2015,703,Slovakia,Montenegro,39,25,14
2015,208,Denmark,Montenegro,164,81,83
2015,246,Finland,Montenegro,4,2,2
2015,578,Norway,Montenegro,408,203,205
2015,752,Sweden,Montenegro,921,499,422
2015,826,United Kingdom,Montenegro,1102,546,556
2015,70,Bosnia and Herzegovina,Montenegro,4398,2145,2253
2015,191,Croatia,Montenegro,6181,2886,3295
2015,380,Italy,Montenegro,2342,1063,1279
2015,807,North Macedonia,Montenegro,9229,3837,5392
2015,620,Portugal,Montenegro,77,2,75
2015,688,Serbia,Montenegro,71224,31311,39913
2015,705,Slovenia,Montenegro,2843,1533,1310
2015,724,Spain,Montenegro,167,96,71
2015,40,Austria,Montenegro,21842,10667,11175
2015,56,Belgium,Montenegro,15,5,10
2015,250,France,Montenegro,1459,714,745
2015,276,Germany,Montenegro,16238,6874,9364
2015,438,Liechtenstein,Montenegro,4,3,1
2015,442,Luxembourg,Montenegro,8543,5165,3378
2015,756,Switzerland,Montenegro,2796,1322,1474
2015,124,Canada,Montenegro,1853,919,934
2019,68,Bolivia (Plurinational State of),Montenegro,2,2,0
2019,76,Brazil,Montenegro,29,14,15
2019,862,Venezuela (Bolivarian Republic of),Montenegro,266,128,138
2019,36,Australia,Montenegro,2158,1070,1088
2019,100,Bulgaria,Montenegro,40,23,17
2019,203,Czechia,Montenegro,122,74,48
2019,348,Hungary,Montenegro,74,44,30
2019,616,Poland,Montenegro,61,45,16
2019,643,Russian Federation,Montenegro,262,209,53
2019,703,Slovakia,Montenegro,42,27,15
2019,208,Denmark,Montenegro,310,148,162
2019,246,Finland,Montenegro,17,9,8
2019,578,Norway,Montenegro,482,233,249
2019,752,Sweden,Montenegro,1372,704,668
2019,826,United Kingdom,Montenegro,1251,622,629
2019,70,Bosnia and Herzegovina,Montenegro,4074,1984,2090
2019,191,Croatia,Montenegro,5707,2656,3051
2019,380,Italy,Montenegro,2510,1119,1391
2019,807,North Macedonia,Montenegro,9260,3850,5410
2019,620,Portugal,Montenegro,78,2,76
2019,688,Serbia,Montenegro,72359,31843,40516
2019,705,Slovenia,Montenegro,3362,1806,1556
2019,724,Spain,Montenegro,173,98,75
2019,40,Austria,Montenegro,25784,12820,12964
2019,56,Belgium,Montenegro,23,12,11
2019,250,France,Montenegro,1544,754,790
2019,276,Germany,Montenegro,14508,7927,6581
2019,438,Liechtenstein,Montenegro,5,3,2
2019,442,Luxembourg,Montenegro,2254,1163,1091
2019,756,Switzerland,Montenegro,2902,1379,1523
2019,124,Canada,Montenegro,1985,985,1000
1990,660,Anguilla,Montserrat,135,95,40
1990,28,Antigua and Barbuda,Montserrat,844,406,438
1990,92,British Virgin Islands,Montserrat,108,48,60
1990,212,Dominica,Montserrat,59,31,28
1990,308,Grenada,Montserrat,6,3,3
1990,659,Saint Kitts and Nevis,Montserrat,186,89,97
1990,662,Saint Lucia,Montserrat,14,7,7
1990,850,United States Virgin Islands,Montserrat,649,270,379
1990,188,Costa Rica,Montserrat,3,1,2
1990,152,Chile,Montserrat,10,3,7
1990,826,United Kingdom,Montserrat,1290,723,567
1990,300,Greece,Montserrat,2,2,0
1990,250,France,Montserrat,5,0,5
1990,124,Canada,Montserrat,384,187,197
1990,840,United States of America,Montserrat,3493,1501,1992
1995,660,Anguilla,Montserrat,174,122,52
1995,28,Antigua and Barbuda,Montserrat,890,439,451
1995,92,British Virgin Islands,Montserrat,127,55,72
1995,212,Dominica,Montserrat,78,41,37
1995,308,Grenada,Montserrat,7,4,3
1995,659,Saint Kitts and Nevis,Montserrat,246,120,126
1995,662,Saint Lucia,Montserrat,18,9,9
1995,850,United States Virgin Islands,Montserrat,728,302,426
1995,188,Costa Rica,Montserrat,2,0,2
1995,152,Chile,Montserrat,5,5,0
1995,372,Ireland,Montserrat,1,1,0
1995,826,United Kingdom,Montserrat,5069,2230,2839
1995,300,Greece,Montserrat,2,2,0
1995,250,France,Montserrat,6,0,6
1995,124,Canada,Montserrat,491,238,253
1995,840,United States of America,Montserrat,3747,1630,2117
2000,660,Anguilla,Montserrat,213,149,64
2000,28,Antigua and Barbuda,Montserrat,935,471,464
2000,92,British Virgin Islands,Montserrat,146,62,84
2000,212,Dominica,Montserrat,93,49,44
2000,308,Grenada,Montserrat,9,5,4
2000,659,Saint Kitts and Nevis,Montserrat,339,170,169
2000,662,Saint Lucia,Montserrat,25,12,13
2000,850,United States Virgin Islands,Montserrat,810,336,474
2000,188,Costa Rica,Montserrat,3,1,2
2000,152,Chile,Montserrat,1,1,0
2000,372,Ireland,Montserrat,2,1,1
2000,826,United Kingdom,Montserrat,8935,3768,5167
2000,300,Greece,Montserrat,2,2,0
2000,250,France,Montserrat,6,0,6
2000,124,Canada,Montserrat,610,295,315
2000,840,United States of America,Montserrat,4004,1762,2242
2005,660,Anguilla,Montserrat,245,172,73
2005,28,Antigua and Barbuda,Montserrat,1003,505,498
2005,92,British Virgin Islands,Montserrat,167,71,96
2005,212,Dominica,Montserrat,114,60,54
2005,308,Grenada,Montserrat,9,5,4
2005,659,Saint Kitts and Nevis,Montserrat,386,195,191
2005,662,Saint Lucia,Montserrat,29,14,15
2005,850,United States Virgin Islands,Montserrat,794,332,462
2005,188,Costa Rica,Montserrat,2,1,1
2005,152,Chile,Montserrat,1,1,0
2005,372,Ireland,Montserrat,2,1,1
2005,826,United Kingdom,Montserrat,7640,3297,4343
2005,300,Greece,Montserrat,41,19,22
2005,250,France,Montserrat,18,13,5
2005,124,Canada,Montserrat,591,292,299
2005,840,United States of America,Montserrat,4784,2120,2664
2010,660,Anguilla,Montserrat,266,187,79
2010,28,Antigua and Barbuda,Montserrat,1070,538,532
2010,92,British Virgin Islands,Montserrat,188,80,108
2010,212,Dominica,Montserrat,139,74,65
2010,308,Grenada,Montserrat,10,5,5
2010,659,Saint Kitts and Nevis,Montserrat,418,210,208
2010,662,Saint Lucia,Montserrat,32,15,17
2010,850,United States Virgin Islands,Montserrat,780,328,452
2010,188,Costa Rica,Montserrat,4,1,3
2010,152,Chile,Montserrat,2,2,0
2010,372,Ireland,Montserrat,1,0,1
2010,826,United Kingdom,Montserrat,8048,3567,4481
2010,300,Greece,Montserrat,83,39,44
2010,250,France,Montserrat,6,0,6
2010,124,Canada,Montserrat,590,298,292
2010,840,United States of America,Montserrat,5732,2497,3235
2015,660,Anguilla,Montserrat,285,201,84
2015,28,Antigua and Barbuda,Montserrat,1138,572,566
2015,92,British Virgin Islands,Montserrat,210,89,121
2015,212,Dominica,Montserrat,162,86,76
2015,308,Grenada,Montserrat,10,5,5
2015,659,Saint Kitts and Nevis,Montserrat,430,217,213
2015,662,Saint Lucia,Montserrat,30,15,15
2015,850,United States Virgin Islands,Montserrat,780,328,452
2015,188,Costa Rica,Montserrat,4,1,3
2015,152,Chile,Montserrat,3,3,0
2015,372,Ireland,Montserrat,1,0,1
2015,826,United Kingdom,Montserrat,10292,4392,5900
2015,300,Greece,Montserrat,77,34,43
2015,250,France,Montserrat,6,1,5
2015,124,Canada,Montserrat,606,278,328
2015,840,United States of America,Montserrat,6749,2921,3828
2019,660,Anguilla,Montserrat,295,208,87
2019,28,Antigua and Barbuda,Montserrat,1183,595,588
2019,92,British Virgin Islands,Montserrat,228,97,131
2019,212,Dominica,Montserrat,165,88,77
2019,308,Grenada,Montserrat,10,5,5
2019,659,Saint Kitts and Nevis,Montserrat,438,221,217
2019,662,Saint Lucia,Montserrat,28,14,14
2019,850,United States Virgin Islands,Montserrat,780,328,452
2019,188,Costa Rica,Montserrat,4,1,3
2019,152,Chile,Montserrat,4,4,0
2019,372,Ireland,Montserrat,1,0,1
2019,826,United Kingdom,Montserrat,11687,5004,6683
2019,300,Greece,Montserrat,75,35,40
2019,250,France,Montserrat,6,1,5
2019,124,Canada,Montserrat,649,298,351
2019,840,United States of America,Montserrat,7287,3110,4177
1990,266,Gabon,Morocco,221,109,112
1990,710,South Africa,Morocco,1058,591,467
1990,478,Mauritania,Morocco,306,142,164
1990,686,Senegal,Morocco,3405,1636,1769
1990,818,Egypt,Morocco,527,131,396
1990,434,Libya,Morocco,1505,381,1124
1990,788,Tunisia,Morocco,7275,3620,3655
1990,48,Bahrain,Morocco,257,184,73
1990,196,Cyprus,Morocco,16,9,7
1990,368,Iraq,Morocco,451,275,176
1990,376,Israel,Morocco,157029,76439,80590
1990,400,Jordan,Morocco,398,141,257
1990,414,Kuwait,Morocco,1594,966,628
1990,422,Lebanon,Morocco,182,65,117
1990,634,Qatar,Morocco,1300,948,352
1990,792,Turkey,Morocco,113,70,43
1990,784,United Arab Emirates,Morocco,1948,1387,561
1990,214,Dominican Republic,Morocco,21,12,9
1990,188,Costa Rica,Morocco,17,8,9
1990,484,Mexico,Morocco,186,82,104
1990,591,Panama,Morocco,24,15,9
1990,32,Argentina,Morocco,466,183,283
1990,68,Bolivia (Plurinational State of),Morocco,6,1,5
1990,152,Chile,Morocco,62,39,23
1990,170,Colombia,Morocco,73,49,24
1990,218,Ecuador,Morocco,16,10,6
1990,604,Peru,Morocco,23,16,7
1990,862,Venezuela (Bolivarian Republic of),Morocco,1551,827,724
1990,36,Australia,Morocco,984,599,385
1990,540,New Caledonia,Morocco,479,274,205
1990,100,Bulgaria,Morocco,19,15,4
1990,203,Czechia,Morocco,26,22,4
1990,348,Hungary,Morocco,38,33,5
1990,616,Poland,Morocco,221,162,59
1990,642,Romania,Morocco,4,2,2
1990,643,Russian Federation,Morocco,1755,861,894
1990,703,Slovakia,Morocco,3,2,1
1990,804,Ukraine,Morocco,2100,1469,631
1990,208,Denmark,Morocco,3004,1824,1180
1990,246,Finland,Morocco,412,390,22
1990,352,Iceland,Morocco,21,15,6
1990,372,Ireland,Morocco,52,36,16
1990,428,Latvia,Morocco,3,1,2
1990,578,Norway,Morocco,2393,1666,727
1990,752,Sweden,Morocco,3529,2114,1415
1990,826,United Kingdom,Morocco,8857,5132,3725
1990,20,Andorra,Morocco,296,159,137
1990,292,Gibraltar,Morocco,2021,1538,483
1990,300,Greece,Morocco,762,422,340
1990,380,Italy,Morocco,169285,131208,38077
1990,470,Malta,Morocco,83,18,65
1990,620,Portugal,Morocco,395,243,152
1990,688,Serbia,Morocco,3,1,2
1990,705,Slovenia,Morocco,3,2,1
1990,724,Spain,Morocco,133341,71364,61977
1990,40,Austria,Morocco,1061,581,480
1990,56,Belgium,Morocco,295459,154823,140636
1990,250,France,Morocco,713987,392571,321416
1990,276,Germany,Morocco,72631,44680,27951
1990,442,Luxembourg,Morocco,125,74,51
1990,528,Netherlands,Morocco,114850,65315,49535
1990,756,Switzerland,Morocco,8362,3948,4414
1990,124,Canada,Morocco,16116,7846,8270
1990,840,United States of America,Morocco,15541,6941,8600
1995,266,Gabon,Morocco,295,145,150
1995,710,South Africa,Morocco,660,393,267
1995,478,Mauritania,Morocco,326,168,158
1995,686,Senegal,Morocco,3560,1699,1861
1995,818,Egypt,Morocco,627,145,482
1995,434,Libya,Morocco,2534,886,1648
1995,788,Tunisia,Morocco,7220,3630,3590
1995,48,Bahrain,Morocco,282,199,83
1995,196,Cyprus,Morocco,23,12,11
1995,368,Iraq,Morocco,532,273,259
1995,376,Israel,Morocco,166657,79803,86854
1995,400,Jordan,Morocco,563,149,414
1995,414,Kuwait,Morocco,1277,814,463
1995,422,Lebanon,Morocco,256,56,200
1995,634,Qatar,Morocco,1412,1053,359
1995,792,Turkey,Morocco,274,166,108
1995,784,United Arab Emirates,Morocco,2496,1789,707
1995,214,Dominican Republic,Morocco,24,14,10
1995,188,Costa Rica,Morocco,8,4,4
1995,484,Mexico,Morocco,204,101,103
1995,591,Panama,Morocco,33,21,12
1995,32,Argentina,Morocco,455,182,273
1995,68,Bolivia (Plurinational State of),Morocco,6,1,5
1995,152,Chile,Morocco,73,40,33
1995,170,Colombia,Morocco,69,45,24
1995,218,Ecuador,Morocco,18,11,7
1995,604,Peru,Morocco,24,16,8
1995,862,Venezuela (Bolivarian Republic of),Morocco,1297,682,615
1995,36,Australia,Morocco,1212,761,451
1995,540,New Caledonia,Morocco,555,314,241
1995,100,Bulgaria,Morocco,30,20,10
1995,203,Czechia,Morocco,39,33,6
1995,348,Hungary,Morocco,83,62,21
1995,616,Poland,Morocco,189,139,50
1995,642,Romania,Morocco,6,3,3
1995,643,Russian Federation,Morocco,1514,901,613
1995,703,Slovakia,Morocco,15,13,2
1995,804,Ukraine,Morocco,2031,1438,593
1995,208,Denmark,Morocco,3943,2274,1669
1995,246,Finland,Morocco,642,560,82
1995,352,Iceland,Morocco,53,37,16
1995,372,Ireland,Morocco,145,99,46
1995,428,Latvia,Morocco,4,2,2
1995,578,Norway,Morocco,3044,2035,1009
1995,752,Sweden,Morocco,4188,2496,1692
1995,826,United Kingdom,Morocco,10312,5771,4541
1995,20,Andorra,Morocco,383,202,181
1995,292,Gibraltar,Morocco,1564,1135,429
1995,300,Greece,Morocco,772,413,359
1995,380,Italy,Morocco,227427,147722,79705
1995,470,Malta,Morocco,98,23,75
1995,620,Portugal,Morocco,853,526,327
1995,688,Serbia,Morocco,25,10,15
1995,705,Slovenia,Morocco,5,4,1
1995,724,Spain,Morocco,165214,94722,70492
1995,40,Austria,Morocco,1197,664,533
1995,56,Belgium,Morocco,267838,140907,126931
1995,250,France,Morocco,737068,399678,337390
1995,276,Germany,Morocco,75112,45175,29937
1995,442,Luxembourg,Morocco,169,82,87
1995,528,Netherlands,Morocco,130895,73368,57527
1995,756,Switzerland,Morocco,10113,4840,5273
1995,124,Canada,Morocco,20676,10009,10667
1995,840,United States of America,Morocco,25447,11525,13922
2000,266,Gabon,Morocco,369,182,187
2000,710,South Africa,Morocco,456,300,156
2000,478,Mauritania,Morocco,337,191,146
2000,686,Senegal,Morocco,3219,1477,1742
2000,818,Egypt,Morocco,776,170,606
2000,434,Libya,Morocco,3605,1444,2161
2000,788,Tunisia,Morocco,6607,3359,3248
2000,48,Bahrain,Morocco,308,213,95
2000,196,Cyprus,Morocco,29,15,14
2000,368,Iraq,Morocco,504,198,306
2000,376,Israel,Morocco,166953,79630,87323
2000,400,Jordan,Morocco,726,159,567
2000,414,Kuwait,Morocco,1457,984,473
2000,422,Lebanon,Morocco,330,47,283
2000,634,Qatar,Morocco,1315,1003,312
2000,792,Turkey,Morocco,437,262,175
2000,784,United Arab Emirates,Morocco,3188,2284,904
2000,214,Dominican Republic,Morocco,26,15,11
2000,188,Costa Rica,Morocco,3,1,2
2000,484,Mexico,Morocco,232,126,106
2000,591,Panama,Morocco,46,29,17
2000,32,Argentina,Morocco,444,181,263
2000,68,Bolivia (Plurinational State of),Morocco,5,1,4
2000,152,Chile,Morocco,85,46,39
2000,170,Colombia,Morocco,65,42,23
2000,218,Ecuador,Morocco,20,12,8
2000,604,Peru,Morocco,29,17,12
2000,862,Venezuela (Bolivarian Republic of),Morocco,1075,556,519
2000,36,Australia,Morocco,1380,875,505
2000,540,New Caledonia,Morocco,631,354,277
2000,100,Bulgaria,Morocco,41,25,16
2000,203,Czechia,Morocco,51,43,8
2000,348,Hungary,Morocco,128,92,36
2000,616,Poland,Morocco,162,118,44
2000,642,Romania,Morocco,8,4,4
2000,643,Russian Federation,Morocco,1220,910,310
2000,703,Slovakia,Morocco,33,28,5
2000,804,Ukraine,Morocco,1988,1425,563
2000,208,Denmark,Morocco,4881,2723,2158
2000,246,Finland,Morocco,871,730,141
2000,352,Iceland,Morocco,84,59,25
2000,372,Ireland,Morocco,318,221,97
2000,428,Latvia,Morocco,5,2,3
2000,578,Norway,Morocco,3719,2331,1388
2000,752,Sweden,Morocco,4492,2665,1827
2000,826,United Kingdom,Morocco,11941,6495,5446
2000,20,Andorra,Morocco,471,247,224
2000,292,Gibraltar,Morocco,1107,732,375
2000,300,Greece,Morocco,795,404,391
2000,380,Italy,Morocco,285569,164237,121332
2000,470,Malta,Morocco,124,30,94
2000,620,Portugal,Morocco,1346,830,516
2000,688,Serbia,Morocco,34,12,22
2000,705,Slovenia,Morocco,9,7,2
2000,724,Spain,Morocco,266706,161769,104937
2000,40,Austria,Morocco,1333,747,586
2000,56,Belgium,Morocco,232447,122580,109867
2000,250,France,Morocco,760148,406784,353364
2000,276,Germany,Morocco,77592,45669,31923
2000,442,Luxembourg,Morocco,216,91,125
2000,528,Netherlands,Morocco,151473,83806,67667
2000,756,Switzerland,Morocco,11902,5766,6136
2000,124,Canada,Morocco,25727,12411,13316
2000,840,United States of America,Morocco,35562,16230,19332
2005,266,Gabon,Morocco,402,200,202
2005,710,South Africa,Morocco,600,385,215
2005,478,Mauritania,Morocco,339,198,141
2005,686,Senegal,Morocco,3463,1644,1819
2005,818,Egypt,Morocco,924,247,677
2005,434,Libya,Morocco,3972,2016,1956
2005,788,Tunisia,Morocco,6315,3240,3075
2005,48,Bahrain,Morocco,439,298,141
2005,196,Cyprus,Morocco,42,22,20
2005,368,Iraq,Morocco,578,326,252
2005,376,Israel,Morocco,161576,76867,84709
2005,400,Jordan,Morocco,1048,328,720
2005,414,Kuwait,Morocco,1573,1038,535
2005,422,Lebanon,Morocco,258,45,213
2005,634,Qatar,Morocco,976,714,262
2005,792,Turkey,Morocco,457,270,187
2005,784,United Arab Emirates,Morocco,3594,2487,1107
2005,214,Dominican Republic,Morocco,29,19,10
2005,188,Costa Rica,Morocco,2,1,1
2005,484,Mexico,Morocco,219,128,91
2005,591,Panama,Morocco,55,36,19
2005,32,Argentina,Morocco,328,137,191
2005,68,Bolivia (Plurinational State of),Morocco,13,5,8
2005,152,Chile,Morocco,127,70,57
2005,170,Colombia,Morocco,60,39,21
2005,218,Ecuador,Morocco,24,15,9
2005,604,Peru,Morocco,34,22,12
2005,862,Venezuela (Bolivarian Republic of),Morocco,1035,545,490
2005,36,Australia,Morocco,1560,944,616
2005,540,New Caledonia,Morocco,672,378,294
2005,100,Bulgaria,Morocco,59,35,24
2005,203,Czechia,Morocco,154,132,22
2005,348,Hungary,Morocco,158,114,44
2005,616,Poland,Morocco,241,193,48
2005,642,Romania,Morocco,9,6,3
2005,643,Russian Federation,Morocco,1162,838,324
2005,703,Slovakia,Morocco,38,32,6
2005,804,Ukraine,Morocco,1816,1303,513
2005,208,Denmark,Morocco,5157,2790,2367
2005,246,Finland,Morocco,1301,1003,298
2005,352,Iceland,Morocco,120,79,41
2005,372,Ireland,Morocco,319,228,91
2005,428,Latvia,Morocco,8,6,2
2005,578,Norway,Morocco,4350,2577,1773
2005,752,Sweden,Morocco,5547,3133,2414
2005,826,United Kingdom,Morocco,15795,8320,7475
2005,20,Andorra,Morocco,549,290,259
2005,191,Croatia,Morocco,15,6,9
2005,292,Gibraltar,Morocco,1020,656,364
2005,300,Greece,Morocco,1458,965,493
2005,380,Italy,Morocco,355367,202077,153290
2005,470,Malta,Morocco,147,38,109
2005,620,Portugal,Morocco,1680,1093,587
2005,688,Serbia,Morocco,34,12,22
2005,705,Slovenia,Morocco,11,10,1
2005,724,Spain,Morocco,521940,338967,182973
2005,40,Austria,Morocco,1490,820,670
2005,56,Belgium,Morocco,174789,90180,84609
2005,250,France,Morocco,832641,431782,400859
2005,276,Germany,Morocco,85965,49783,36182
2005,442,Luxembourg,Morocco,186,85,101
2005,528,Netherlands,Morocco,168387,90352,78035
2005,756,Switzerland,Morocco,13265,6089,7176
2005,124,Canada,Morocco,40230,20690,19540
2005,840,United States of America,Morocco,47087,21632,25455
2010,266,Gabon,Morocco,467,238,229
2010,710,South Africa,Morocco,939,602,337
2010,466,Mali,Morocco,637,259,378
2010,478,Mauritania,Morocco,341,202,139
2010,686,Senegal,Morocco,3873,1916,1957
2010,818,Egypt,Morocco,997,239,758
2010,434,Libya,Morocco,4346,2231,2115
2010,788,Tunisia,Morocco,4480,2306,2174
2010,48,Bahrain,Morocco,669,451,218
2010,196,Cyprus,Morocco,68,36,32
2010,368,Iraq,Morocco,584,345,239
2010,376,Israel,Morocco,158158,74864,83294
2010,400,Jordan,Morocco,1348,474,874
2010,414,Kuwait,Morocco,2083,1357,726
2010,422,Lebanon,Morocco,186,44,142
2010,634,Qatar,Morocco,1431,1147,284
2010,792,Turkey,Morocco,469,274,195
2010,784,United Arab Emirates,Morocco,7508,5259,2249
2010,214,Dominican Republic,Morocco,32,24,8
2010,188,Costa Rica,Morocco,4,1,3
2010,484,Mexico,Morocco,233,145,88
2010,591,Panama,Morocco,67,45,22
2010,32,Argentina,Morocco,211,92,119
2010,68,Bolivia (Plurinational State of),Morocco,21,10,11
2010,76,Brazil,Morocco,503,310,193
2010,152,Chile,Morocco,170,94,76
2010,170,Colombia,Morocco,66,43,23
2010,218,Ecuador,Morocco,33,20,13
2010,604,Peru,Morocco,37,25,12
2010,862,Venezuela (Bolivarian Republic of),Morocco,1006,538,468
2010,36,Australia,Morocco,1800,1054,746
2010,540,New Caledonia,Morocco,714,403,311
2010,100,Bulgaria,Morocco,74,43,31
2010,203,Czechia,Morocco,243,210,33
2010,348,Hungary,Morocco,188,136,52
2010,616,Poland,Morocco,329,274,55
2010,642,Romania,Morocco,16,8,8
2010,643,Russian Federation,Morocco,1081,749,332
2010,703,Slovakia,Morocco,42,36,6
2010,804,Ukraine,Morocco,1732,1244,488
2010,208,Denmark,Morocco,5336,2808,2528
2010,233,Estonia,Morocco,15,12,3
2010,246,Finland,Morocco,2065,1491,574
2010,352,Iceland,Morocco,154,98,56
2010,372,Ireland,Morocco,268,186,82
2010,428,Latvia,Morocco,11,9,2
2010,578,Norway,Morocco,4881,2780,2101
2010,752,Sweden,Morocco,7391,3876,3515
2010,826,United Kingdom,Morocco,16639,8927,7712
2010,20,Andorra,Morocco,556,293,263
2010,191,Croatia,Morocco,29,11,18
2010,292,Gibraltar,Morocco,933,581,352
2010,300,Greece,Morocco,2206,1589,617
2010,380,Italy,Morocco,416832,237919,178913
2010,470,Malta,Morocco,182,48,134
2010,620,Portugal,Morocco,1736,1176,560
2010,688,Serbia,Morocco,34,12,22
2010,705,Slovenia,Morocco,18,14,4
2010,724,Spain,Morocco,763734,466079,297655
2010,40,Austria,Morocco,1647,893,754
2010,56,Belgium,Morocco,178899,93578,85321
2010,250,France,Morocco,870001,456489,413512
2010,276,Germany,Morocco,92677,53038,39639
2010,442,Luxembourg,Morocco,160,80,80
2010,528,Netherlands,Morocco,167858,88287,79571
2010,756,Switzerland,Morocco,15725,6718,9007
2010,124,Canada,Morocco,56280,29805,26475
2010,840,United States of America,Morocco,60357,27280,33077
2015,266,Gabon,Morocco,653,377,276
2015,710,South Africa,Morocco,1693,1055,638
2015,324,Guinea,Morocco,333,205,128
2015,466,Mali,Morocco,789,321,468
2015,478,Mauritania,Morocco,342,204,138
2015,686,Senegal,Morocco,4134,2044,2090
2015,818,Egypt,Morocco,739,250,489
2015,434,Libya,Morocco,4899,2482,2417
2015,788,Tunisia,Morocco,5785,2987,2798
2015,48,Bahrain,Morocco,648,434,214
2015,196,Cyprus,Morocco,65,35,30
2015,368,Iraq,Morocco,586,383,203
2015,376,Israel,Morocco,163113,76790,86323
2015,400,Jordan,Morocco,580,119,461
2015,414,Kuwait,Morocco,2795,1687,1108
2015,422,Lebanon,Morocco,157,76,81
2015,634,Qatar,Morocco,1437,1171,266
2015,792,Turkey,Morocco,481,277,204
2015,784,United Arab Emirates,Morocco,8204,5650,2554
2015,214,Dominican Republic,Morocco,33,25,8
2015,188,Costa Rica,Morocco,4,1,3
2015,484,Mexico,Morocco,247,153,94
2015,591,Panama,Morocco,79,54,25
2015,32,Argentina,Morocco,212,93,119
2015,68,Bolivia (Plurinational State of),Morocco,24,11,13
2015,76,Brazil,Morocco,606,374,232
2015,152,Chile,Morocco,257,140,117
2015,170,Colombia,Morocco,73,48,25
2015,218,Ecuador,Morocco,48,29,19
2015,604,Peru,Morocco,38,26,12
2015,862,Venezuela (Bolivarian Republic of),Morocco,1008,534,474
2015,36,Australia,Morocco,2170,1206,964
2015,540,New Caledonia,Morocco,548,282,266
2015,100,Bulgaria,Morocco,106,58,48
2015,203,Czechia,Morocco,303,253,50
2015,348,Hungary,Morocco,217,148,69
2015,616,Poland,Morocco,317,265,52
2015,642,Romania,Morocco,129,76,53
2015,643,Russian Federation,Morocco,1101,761,340
2015,703,Slovakia,Morocco,55,47,8
2015,804,Ukraine,Morocco,1737,1249,488
2015,208,Denmark,Morocco,5861,3063,2798
2015,233,Estonia,Morocco,25,21,4
2015,246,Finland,Morocco,2523,1714,809
2015,352,Iceland,Morocco,166,103,63
2015,372,Ireland,Morocco,274,189,85
2015,428,Latvia,Morocco,12,11,1
2015,578,Norway,Morocco,5583,3110,2473
2015,752,Sweden,Morocco,9480,4816,4664
2015,826,United Kingdom,Morocco,21278,11123,10155
2015,20,Andorra,Morocco,470,252,218
2015,191,Croatia,Morocco,29,11,18
2015,292,Gibraltar,Morocco,996,625,371
2015,300,Greece,Morocco,2070,1467,603
2015,380,Italy,Morocco,424080,235363,188717
2015,470,Malta,Morocco,309,97,212
2015,620,Portugal,Morocco,1968,1301,667
2015,688,Serbia,Morocco,33,12,21
2015,705,Slovenia,Morocco,22,16,6
2015,724,Spain,Morocco,699880,395003,304877
2015,40,Austria,Morocco,1926,1049,877
2015,56,Belgium,Morocco,208072,107420,100652
2015,250,France,Morocco,963774,493072,470702
2015,276,Germany,Morocco,96565,55165,41400
2015,442,Luxembourg,Morocco,244,124,120
2015,528,Netherlands,Morocco,172291,89756,82535
2015,756,Switzerland,Morocco,17400,7430,9970
2015,124,Canada,Morocco,69227,35883,33344
2015,840,United States of America,Morocco,73754,33128,40626
2019,266,Gabon,Morocco,709,410,299
2019,710,South Africa,Morocco,1896,1183,713
2019,324,Guinea,Morocco,317,195,122
2019,466,Mali,Morocco,878,357,521
2019,478,Mauritania,Morocco,355,212,143
2019,686,Senegal,Morocco,4271,2106,2165
2019,818,Egypt,Morocco,1053,274,779
2019,434,Libya,Morocco,5198,2634,2564
2019,788,Tunisia,Morocco,5879,3037,2842
2019,48,Bahrain,Morocco,682,457,225
2019,196,Cyprus,Morocco,64,35,29
2019,368,Iraq,Morocco,600,393,207
2019,376,Israel,Morocco,158622,74676,83946
2019,400,Jordan,Morocco,623,128,495
2019,414,Kuwait,Morocco,2959,1786,1173
2019,422,Lebanon,Morocco,148,72,76
2019,634,Qatar,Morocco,1465,1175,290
2019,792,Turkey,Morocco,650,377,273
2019,784,United Arab Emirates,Morocco,8811,6068,2743
2019,214,Dominican Republic,Morocco,34,26,8
2019,188,Costa Rica,Morocco,4,1,3
2019,484,Mexico,Morocco,254,158,96
2019,591,Panama,Morocco,82,57,25
2019,32,Argentina,Morocco,215,94,121
2019,68,Bolivia (Plurinational State of),Morocco,26,12,14
2019,76,Brazil,Morocco,682,421,261
2019,152,Chile,Morocco,343,178,165
2019,170,Colombia,Morocco,74,49,25
2019,218,Ecuador,Morocco,47,29,18
2019,604,Peru,Morocco,45,32,13
2019,862,Venezuela (Bolivarian Republic of),Morocco,987,521,466
2019,36,Australia,Morocco,2454,1351,1103
2019,540,New Caledonia,Morocco,577,296,281
2019,100,Bulgaria,Morocco,140,77,63
2019,203,Czechia,Morocco,354,287,67
2019,348,Hungary,Morocco,306,201,105
2019,616,Poland,Morocco,335,283,52
2019,642,Romania,Morocco,751,463,288
2019,643,Russian Federation,Morocco,1100,761,339
2019,703,Slovakia,Morocco,63,53,10
2019,804,Ukraine,Morocco,1754,1262,492
2019,208,Denmark,Morocco,6090,3054,3036
2019,233,Estonia,Morocco,29,26,3
2019,246,Finland,Morocco,3046,2040,1006
2019,352,Iceland,Morocco,219,142,77
2019,372,Ireland,Morocco,300,207,93
2019,428,Latvia,Morocco,14,14,0
2019,578,Norway,Morocco,6354,3478,2876
2019,752,Sweden,Morocco,11545,5776,5769
2019,826,United Kingdom,Morocco,24163,12661,11502
2019,20,Andorra,Morocco,501,271,230
2019,191,Croatia,Morocco,26,10,16
2019,292,Gibraltar,Morocco,1005,631,374
2019,300,Greece,Morocco,2021,1455,566
2019,380,Italy,Morocco,450557,248622,201935
2019,470,Malta,Morocco,498,159,339
2019,620,Portugal,Morocco,2001,1325,676
2019,688,Serbia,Morocco,33,12,21
2019,705,Slovenia,Morocco,27,18,9
2019,724,Spain,Morocco,711792,389960,321832
2019,40,Austria,Morocco,2273,1256,1017
2019,56,Belgium,Morocco,226216,116724,109492
2019,250,France,Morocco,1020162,520783,499379
2019,276,Germany,Morocco,105928,59645,46283
2019,442,Luxembourg,Morocco,2330,1170,1160
2019,528,Netherlands,Morocco,180879,93563,87316
2019,756,Switzerland,Morocco,18694,8094,10600
2019,124,Canada,Morocco,74184,38453,35731
2019,840,United States of America,Morocco,79646,35302,44344
1990,232,Eritrea,Mozambique,3537,1813,1724
1990,404,Kenya,Mozambique,1043,580,463
1990,454,Malawi,Mozambique,1075410,527139,548271
1990,800,Uganda,Mozambique,226,106,120
1990,834,United Republic of Tanzania,Mozambique,144353,71441,72912
1990,894,Zambia,Mozambique,41455,20691,20764
1990,716,Zimbabwe,Mozambique,482855,268617,214238
1990,24,Angola,Mozambique,97,53,44
1990,678,Sao Tome and Principe,Mozambique,243,216,27
1990,72,Botswana,Mozambique,184,99,85
1990,748,Eswatini,Mozambique,46196,25888,20308
1990,426,Lesotho,Mozambique,32,21,11
1990,516,Namibia,Mozambique,203,115,88
1990,710,South Africa,Mozambique,346433,246668,99765
1990,132,Cabo Verde,Mozambique,51,22,29
1990,818,Egypt,Mozambique,14,8,6
1990,196,Cyprus,Mozambique,3,1,2
1990,188,Costa Rica,Mozambique,3,1,2
1990,32,Argentina,Mozambique,25,0,25
1990,76,Brazil,Mozambique,987,752,235
1990,152,Chile,Mozambique,15,10,5
1990,862,Venezuela (Bolivarian Republic of),Mozambique,47,23,24
1990,36,Australia,Mozambique,386,212,174
1990,100,Bulgaria,Mozambique,6,4,2
1990,203,Czechia,Mozambique,1,1,0
1990,348,Hungary,Mozambique,12,11,1
1990,616,Poland,Mozambique,18,17,1
1990,643,Russian Federation,Mozambique,111,54,57
1990,208,Denmark,Mozambique,65,38,27
1990,246,Finland,Mozambique,6,4,2
1990,352,Iceland,Mozambique,4,1,3
1990,372,Ireland,Mozambique,8,4,4
1990,578,Norway,Mozambique,22,10,12
1990,752,Sweden,Mozambique,154,58,96
1990,826,United Kingdom,Mozambique,467,280,187
1990,300,Greece,Mozambique,39,21,18
1990,380,Italy,Mozambique,58,20,38
1990,620,Portugal,Mozambique,74609,35707,38902
1990,724,Spain,Mozambique,101,43,58
1990,40,Austria,Mozambique,37,16,21
1990,56,Belgium,Mozambique,189,45,144
1990,250,France,Mozambique,1048,483,565
1990,528,Netherlands,Mozambique,216,113,103
1990,756,Switzerland,Mozambique,709,314,395
1990,124,Canada,Mozambique,691,336,355
1995,232,Eritrea,Mozambique,2218,1081,1137
1995,404,Kenya,Mozambique,980,535,445
1995,454,Malawi,Mozambique,60845,31892,28953
1995,800,Uganda,Mozambique,214,97,117
1995,834,United Republic of Tanzania,Mozambique,57995,29901,28094
1995,894,Zambia,Mozambique,3127,1517,1610
1995,716,Zimbabwe,Mozambique,266322,151935,114387
1995,24,Angola,Mozambique,113,59,54
1995,678,Sao Tome and Principe,Mozambique,228,198,30
1995,72,Botswana,Mozambique,297,167,130
1995,748,Eswatini,Mozambique,18085,10440,7645
1995,426,Lesotho,Mozambique,28,19,9
1995,516,Namibia,Mozambique,194,111,83
1995,710,South Africa,Mozambique,320659,218533,102126
1995,132,Cabo Verde,Mozambique,64,29,35
1995,818,Egypt,Mozambique,13,8,5
1995,196,Cyprus,Mozambique,4,1,3
1995,188,Costa Rica,Mozambique,2,0,2
1995,32,Argentina,Mozambique,24,0,24
1995,76,Brazil,Mozambique,1162,783,379
1995,152,Chile,Mozambique,30,18,12
1995,862,Venezuela (Bolivarian Republic of),Mozambique,46,23,23
1995,36,Australia,Mozambique,528,284,244
1995,100,Bulgaria,Mozambique,10,6,4
1995,203,Czechia,Mozambique,1,1,0
1995,348,Hungary,Mozambique,14,10,4
1995,616,Poland,Mozambique,15,15,0
1995,643,Russian Federation,Mozambique,105,57,48
1995,208,Denmark,Mozambique,94,43,51
1995,246,Finland,Mozambique,12,4,8
1995,352,Iceland,Mozambique,6,2,4
1995,372,Ireland,Mozambique,21,10,11
1995,578,Norway,Mozambique,32,14,18
1995,752,Sweden,Mozambique,182,67,115
1995,826,United Kingdom,Mozambique,1840,899,941
1995,300,Greece,Mozambique,52,23,29
1995,380,Italy,Mozambique,186,50,136
1995,620,Portugal,Mozambique,73598,34900,38698
1995,724,Spain,Mozambique,153,67,86
1995,40,Austria,Mozambique,42,19,23
1995,56,Belgium,Mozambique,189,45,144
1995,250,France,Mozambique,1082,489,593
1995,528,Netherlands,Mozambique,317,161,156
1995,756,Switzerland,Mozambique,809,392,417
1995,124,Canada,Mozambique,777,376,401
2000,232,Eritrea,Mozambique,896,350,546
2000,404,Kenya,Mozambique,535,268,267
2000,454,Malawi,Mozambique,58576,30625,27951
2000,800,Uganda,Mozambique,27,14,13
2000,834,United Republic of Tanzania,Mozambique,46739,23874,22865
2000,894,Zambia,Mozambique,545,265,280
2000,716,Zimbabwe,Mozambique,197838,112819,85019
2000,24,Angola,Mozambique,128,65,63
2000,678,Sao Tome and Principe,Mozambique,213,179,34
2000,72,Botswana,Mozambique,441,253,188
2000,748,Eswatini,Mozambique,13127,8030,5097
2000,426,Lesotho,Mozambique,23,16,7
2000,516,Namibia,Mozambique,182,103,79
2000,710,South Africa,Mozambique,237813,172998,64815
2000,132,Cabo Verde,Mozambique,76,35,41
2000,818,Egypt,Mozambique,13,8,5
2000,196,Cyprus,Mozambique,5,1,4
2000,188,Costa Rica,Mozambique,3,1,2
2000,32,Argentina,Mozambique,23,0,23
2000,76,Brazil,Mozambique,1337,815,522
2000,152,Chile,Mozambique,46,27,19
2000,862,Venezuela (Bolivarian Republic of),Mozambique,46,23,23
2000,36,Australia,Mozambique,630,332,298
2000,100,Bulgaria,Mozambique,14,9,5
2000,203,Czechia,Mozambique,1,1,0
2000,348,Hungary,Mozambique,15,9,6
2000,616,Poland,Mozambique,13,12,1
2000,643,Russian Federation,Mozambique,96,58,38
2000,208,Denmark,Mozambique,122,48,74
2000,246,Finland,Mozambique,18,4,14
2000,352,Iceland,Mozambique,7,2,5
2000,372,Ireland,Mozambique,46,24,22
2000,578,Norway,Mozambique,60,17,43
2000,752,Sweden,Mozambique,196,71,125
2000,826,United Kingdom,Mozambique,3244,1530,1714
2000,300,Greece,Mozambique,65,24,41
2000,380,Italy,Mozambique,314,80,234
2000,620,Portugal,Mozambique,75573,35656,39917
2000,724,Spain,Mozambique,1854,906,948
2000,40,Austria,Mozambique,47,22,25
2000,56,Belgium,Mozambique,180,36,144
2000,250,France,Mozambique,1116,495,621
2000,528,Netherlands,Mozambique,431,216,215
2000,756,Switzerland,Mozambique,912,471,441
2000,124,Canada,Mozambique,881,425,456
2005,232,Eritrea,Mozambique,992,396,596
2005,404,Kenya,Mozambique,523,271,252
2005,454,Malawi,Mozambique,55817,29103,26714
2005,800,Uganda,Mozambique,26,14,12
2005,834,United Republic of Tanzania,Mozambique,36267,18413,17854
2005,894,Zambia,Mozambique,842,410,432
2005,716,Zimbabwe,Mozambique,145402,82953,62449
2005,24,Angola,Mozambique,166,82,84
2005,678,Sao Tome and Principe,Mozambique,167,141,26
2005,72,Botswana,Mozambique,665,378,287
2005,748,Eswatini,Mozambique,11345,6723,4622
2005,426,Lesotho,Mozambique,23,16,7
2005,516,Namibia,Mozambique,143,81,62
2005,710,South Africa,Mozambique,322964,229867,93097
2005,132,Cabo Verde,Mozambique,51,23,28
2005,818,Egypt,Mozambique,15,9,6
2005,196,Cyprus,Mozambique,7,1,6
2005,188,Costa Rica,Mozambique,2,1,1
2005,32,Argentina,Mozambique,17,0,17
2005,68,Bolivia (Plurinational State of),Mozambique,2,1,1
2005,76,Brazil,Mozambique,1385,722,663
2005,152,Chile,Mozambique,69,41,28
2005,862,Venezuela (Bolivarian Republic of),Mozambique,48,24,24
2005,36,Australia,Mozambique,770,405,365
2005,100,Bulgaria,Mozambique,20,12,8
2005,203,Czechia,Mozambique,3,2,1
2005,348,Hungary,Mozambique,18,11,7
2005,616,Poland,Mozambique,20,20,0
2005,643,Russian Federation,Mozambique,103,68,35
2005,208,Denmark,Mozambique,155,58,97
2005,246,Finland,Mozambique,39,16,23
2005,352,Iceland,Mozambique,11,5,6
2005,372,Ireland,Mozambique,46,25,21
2005,578,Norway,Mozambique,102,39,63
2005,752,Sweden,Mozambique,245,95,150
2005,826,United Kingdom,Mozambique,4282,1974,2308
2005,300,Greece,Mozambique,66,26,40
2005,380,Italy,Mozambique,586,192,394
2005,620,Portugal,Mozambique,74985,35425,39560
2005,724,Spain,Mozambique,892,429,463
2005,40,Austria,Mozambique,52,23,29
2005,56,Belgium,Mozambique,270,90,180
2005,250,France,Mozambique,1036,530,506
2005,528,Netherlands,Mozambique,541,271,270
2005,756,Switzerland,Mozambique,985,491,494
2005,124,Canada,Mozambique,982,484,498
2010,232,Eritrea,Mozambique,1088,442,646
2010,404,Kenya,Mozambique,589,291,298
2010,454,Malawi,Mozambique,54826,28545,26281
2010,800,Uganda,Mozambique,26,14,12
2010,834,United Republic of Tanzania,Mozambique,28177,14125,14052
2010,894,Zambia,Mozambique,1301,666,635
2010,716,Zimbabwe,Mozambique,117799,67134,50665
2010,24,Angola,Mozambique,203,98,105
2010,678,Sao Tome and Principe,Mozambique,131,111,20
2010,72,Botswana,Mozambique,520,300,220
2010,748,Eswatini,Mozambique,10841,6572,4269
2010,426,Lesotho,Mozambique,23,16,7
2010,516,Namibia,Mozambique,137,78,59
2010,710,South Africa,Mozambique,505932,359541,146391
2010,132,Cabo Verde,Mozambique,25,11,14
2010,818,Egypt,Mozambique,16,9,7
2010,196,Cyprus,Mozambique,11,2,9
2010,188,Costa Rica,Mozambique,4,1,3
2010,32,Argentina,Mozambique,11,1,10
2010,68,Bolivia (Plurinational State of),Mozambique,3,2,1
2010,76,Brazil,Mozambique,1413,617,796
2010,152,Chile,Mozambique,92,55,37
2010,862,Venezuela (Bolivarian Republic of),Mozambique,50,24,26
2010,36,Australia,Mozambique,860,445,415
2010,100,Bulgaria,Mozambique,25,15,10
2010,203,Czechia,Mozambique,5,4,1
2010,348,Hungary,Mozambique,20,13,7
2010,616,Poland,Mozambique,28,28,0
2010,643,Russian Federation,Mozambique,109,76,33
2010,208,Denmark,Mozambique,184,68,116
2010,233,Estonia,Mozambique,2,2,0
2010,246,Finland,Mozambique,67,30,37
2010,352,Iceland,Mozambique,14,7,7
2010,372,Ireland,Mozambique,38,19,19
2010,578,Norway,Mozambique,139,56,83
2010,752,Sweden,Mozambique,333,143,190
2010,826,United Kingdom,Mozambique,4510,2129,2381
2010,300,Greece,Mozambique,68,28,40
2010,380,Italy,Mozambique,834,294,540
2010,620,Portugal,Mozambique,61946,29400,32546
2010,705,Slovenia,Mozambique,2,1,1
2010,724,Spain,Mozambique,1239,613,626
2010,40,Austria,Mozambique,57,25,32
2010,56,Belgium,Mozambique,351,164,187
2010,250,France,Mozambique,1211,522,689
2010,528,Netherlands,Mozambique,634,319,315
2010,756,Switzerland,Mozambique,1206,558,648
2010,124,Canada,Mozambique,1125,565,560
2015,232,Eritrea,Mozambique,1107,457,650
2015,404,Kenya,Mozambique,601,298,303
2015,454,Malawi,Mozambique,54183,28186,25997
2015,800,Uganda,Mozambique,26,14,12
2015,834,United Republic of Tanzania,Mozambique,14651,7363,7288
2015,894,Zambia,Mozambique,1146,585,561
2015,716,Zimbabwe,Mozambique,118442,66675,51767
2015,24,Angola,Mozambique,240,114,126
2015,678,Sao Tome and Principe,Mozambique,116,95,21
2015,72,Botswana,Mozambique,567,327,240
2015,748,Eswatini,Mozambique,9857,5995,3862
2015,426,Lesotho,Mozambique,23,16,7
2015,516,Namibia,Mozambique,134,77,57
2015,710,South Africa,Mozambique,638833,444573,194260
2015,132,Cabo Verde,Mozambique,26,11,15
2015,324,Guinea,Mozambique,19,13,6
2015,818,Egypt,Mozambique,11,7,4
2015,196,Cyprus,Mozambique,10,2,8
2015,188,Costa Rica,Mozambique,4,1,3
2015,32,Argentina,Mozambique,11,1,10
2015,68,Bolivia (Plurinational State of),Mozambique,3,2,1
2015,76,Brazil,Mozambique,1702,743,959
2015,152,Chile,Mozambique,139,82,57
2015,862,Venezuela (Bolivarian Republic of),Mozambique,53,25,28
2015,36,Australia,Mozambique,1010,501,509
2015,100,Bulgaria,Mozambique,35,20,15
2015,203,Czechia,Mozambique,12,10,2
2015,348,Hungary,Mozambique,21,12,9
2015,616,Poland,Mozambique,26,26,0
2015,643,Russian Federation,Mozambique,111,77,34
2015,208,Denmark,Mozambique,217,77,140
2015,233,Estonia,Mozambique,2,1,1
2015,246,Finland,Mozambique,83,40,43
2015,352,Iceland,Mozambique,23,8,15
2015,372,Ireland,Mozambique,39,19,20
2015,428,Latvia,Mozambique,1,1,0
2015,578,Norway,Mozambique,193,85,108
2015,752,Sweden,Mozambique,330,141,189
2015,826,United Kingdom,Mozambique,5767,2632,3135
2015,300,Greece,Mozambique,63,24,39
2015,380,Italy,Mozambique,1433,676,757
2015,620,Portugal,Mozambique,70228,31434,38794
2015,705,Slovenia,Mozambique,4,2,2
2015,724,Spain,Mozambique,1197,594,603
2015,40,Austria,Mozambique,67,30,37
2015,56,Belgium,Mozambique,447,202,245
2015,250,France,Mozambique,1341,557,784
2015,528,Netherlands,Mozambique,655,331,324
2015,756,Switzerland,Mozambique,1366,653,713
2015,124,Canada,Mozambique,1242,591,651
2019,232,Eritrea,Mozambique,1118,462,656
2019,404,Kenya,Mozambique,557,277,280
2019,454,Malawi,Mozambique,58344,30191,28153
2019,800,Uganda,Mozambique,26,14,12
2019,834,United Republic of Tanzania,Mozambique,13138,6562,6576
2019,894,Zambia,Mozambique,1476,755,721
2019,716,Zimbabwe,Mozambique,121628,69040,52588
2019,24,Angola,Mozambique,254,128,126
2019,678,Sao Tome and Principe,Mozambique,105,86,19
2019,72,Botswana,Mozambique,607,350,257
2019,748,Eswatini,Mozambique,9844,5982,3862
2019,426,Lesotho,Mozambique,24,17,7
2019,516,Namibia,Mozambique,141,81,60
2019,710,South Africa,Mozambique,716057,498523,217534
2019,132,Cabo Verde,Mozambique,27,12,15
2019,324,Guinea,Mozambique,18,13,5
2019,818,Egypt,Mozambique,15,9,6
2019,196,Cyprus,Mozambique,9,2,7
2019,188,Costa Rica,Mozambique,4,1,3
2019,32,Argentina,Mozambique,11,1,10
2019,68,Bolivia (Plurinational State of),Mozambique,3,2,1
2019,76,Brazil,Mozambique,1916,836,1080
2019,152,Chile,Mozambique,185,105,80
2019,862,Venezuela (Bolivarian Republic of),Mozambique,51,24,27
2019,36,Australia,Mozambique,1089,532,557
2019,100,Bulgaria,Mozambique,40,23,17
2019,203,Czechia,Mozambique,18,15,3
2019,348,Hungary,Mozambique,21,12,9
2019,616,Poland,Mozambique,27,27,0
2019,643,Russian Federation,Mozambique,110,77,33
2019,208,Denmark,Mozambique,252,92,160
2019,233,Estonia,Mozambique,2,2,0
2019,246,Finland,Mozambique,98,50,48
2019,352,Iceland,Mozambique,24,11,13
2019,372,Ireland,Mozambique,42,21,21
2019,578,Norway,Mozambique,208,92,116
2019,752,Sweden,Mozambique,323,134,189
2019,826,United Kingdom,Mozambique,6549,2998,3551
2019,300,Greece,Mozambique,61,25,36
2019,380,Italy,Mozambique,907,325,582
2019,620,Portugal,Mozambique,71421,32053,39368
2019,705,Slovenia,Mozambique,5,3,2
2019,724,Spain,Mozambique,1240,601,639
2019,40,Austria,Mozambique,79,37,42
2019,56,Belgium,Mozambique,474,221,253
2019,250,France,Mozambique,1419,588,831
2019,528,Netherlands,Mozambique,688,339,349
2019,756,Switzerland,Mozambique,1436,687,749
2019,124,Canada,Mozambique,1330,633,697
1990,710,South Africa,Myanmar,211,45,166
1990,818,Egypt,Myanmar,9,7,2
1990,196,Cyprus,Myanmar,11,3,8
1990,400,Jordan,Myanmar,2,2,0
1990,682,Saudi Arabia,Myanmar,89529,59554,29975
1990,792,Turkey,Myanmar,18,16,2
1990,50,Bangladesh,Myanmar,225851,106150,119701
1990,64,Bhutan,Myanmar,16,10,6
1990,356,India,Myanmar,85706,44527,41179
1990,586,Pakistan,Myanmar,3598,1873,1725
1990,410,Republic of Korea,Myanmar,88,82,6
1990,116,Cambodia,Myanmar,24,16,8
1990,418,Lao People's Democratic Republic,Myanmar,404,213,191
1990,458,Malaysia,Myanmar,4568,3177,1391
1990,608,Philippines,Myanmar,55,32,23
1990,764,Thailand,Myanmar,229504,137948,91556
1990,704,Viet Nam,Myanmar,963,569,394
1990,188,Costa Rica,Myanmar,10,3,7
1990,591,Panama,Myanmar,23,23,0
1990,32,Argentina,Myanmar,19,19,0
1990,68,Bolivia (Plurinational State of),Myanmar,1,0,1
1990,152,Chile,Myanmar,2,1,1
1990,36,Australia,Myanmar,9884,4842,5042
1990,554,New Zealand,Myanmar,363,166,197
1990,203,Czechia,Myanmar,1,1,0
1990,348,Hungary,Myanmar,8,4,4
1990,643,Russian Federation,Myanmar,411,202,209
1990,208,Denmark,Myanmar,43,13,30
1990,246,Finland,Myanmar,7,3,4
1990,372,Ireland,Myanmar,12,6,6
1990,578,Norway,Myanmar,30,25,5
1990,752,Sweden,Myanmar,98,64,34
1990,826,United Kingdom,Myanmar,10359,4858,5501
1990,300,Greece,Myanmar,42,24,18
1990,380,Italy,Myanmar,28,10,18
1990,724,Spain,Myanmar,7,5,2
1990,40,Austria,Myanmar,39,17,22
1990,56,Belgium,Myanmar,49,29,20
1990,250,France,Myanmar,673,354,319
1990,276,Germany,Myanmar,276,221,55
1990,528,Netherlands,Myanmar,86,61,25
1990,756,Switzerland,Myanmar,110,55,55
1990,124,Canada,Myanmar,2337,1138,1199
1990,840,United States of America,Myanmar,19835,9741,10094
1995,710,South Africa,Myanmar,131,36,95
1995,818,Egypt,Myanmar,9,8,1
1995,196,Cyprus,Myanmar,16,4,12
1995,400,Jordan,Myanmar,16,16,0
1995,682,Saudi Arabia,Myanmar,101950,67994,33956
1995,792,Turkey,Myanmar,21,16,5
1995,50,Bangladesh,Myanmar,228109,107212,120897
1995,64,Bhutan,Myanmar,19,12,7
1995,356,India,Myanmar,73795,38244,35551
1995,586,Pakistan,Myanmar,3000,1559,1441
1995,410,Republic of Korea,Myanmar,552,512,40
1995,116,Cambodia,Myanmar,63,42,21
1995,418,Lao People's Democratic Republic,Myanmar,360,188,172
1995,458,Malaysia,Myanmar,10170,7080,3090
1995,608,Philippines,Myanmar,74,43,31
1995,764,Thailand,Myanmar,436777,243661,193116
1995,704,Viet Nam,Myanmar,2690,1552,1138
1995,188,Costa Rica,Myanmar,8,3,5
1995,591,Panama,Myanmar,32,32,0
1995,32,Argentina,Myanmar,19,19,0
1995,68,Bolivia (Plurinational State of),Myanmar,1,0,1
1995,152,Chile,Myanmar,1,1,0
1995,36,Australia,Myanmar,11346,5509,5837
1995,554,New Zealand,Myanmar,594,276,318
1995,203,Czechia,Myanmar,1,1,0
1995,348,Hungary,Myanmar,7,3,4
1995,643,Russian Federation,Myanmar,339,211,128
1995,208,Denmark,Myanmar,54,22,32
1995,246,Finland,Myanmar,29,16,13
1995,372,Ireland,Myanmar,35,18,17
1995,578,Norway,Myanmar,47,33,14
1995,752,Sweden,Myanmar,116,75,41
1995,826,United Kingdom,Myanmar,9891,4638,5253
1995,300,Greece,Myanmar,31,18,13
1995,380,Italy,Myanmar,97,43,54
1995,724,Spain,Myanmar,12,8,4
1995,40,Austria,Myanmar,44,19,25
1995,56,Belgium,Myanmar,49,29,20
1995,250,France,Myanmar,695,360,335
1995,276,Germany,Myanmar,431,306,125
1995,528,Netherlands,Myanmar,126,89,37
1995,756,Switzerland,Myanmar,133,69,64
1995,124,Canada,Myanmar,2995,1450,1545
1995,840,United States of America,Myanmar,26561,13182,13379
2000,710,South Africa,Myanmar,91,35,56
2000,818,Egypt,Myanmar,9,8,1
2000,196,Cyprus,Myanmar,20,4,16
2000,400,Jordan,Myanmar,29,29,0
2000,682,Saudi Arabia,Myanmar,104750,70010,34740
2000,792,Turkey,Myanmar,36,27,9
2000,50,Bangladesh,Myanmar,230390,108284,122106
2000,64,Bhutan,Myanmar,22,14,8
2000,356,India,Myanmar,61884,31962,29922
2000,586,Pakistan,Myanmar,2662,1382,1280
2000,410,Republic of Korea,Myanmar,1193,1107,86
2000,116,Cambodia,Myanmar,102,68,34
2000,418,Lao People's Democratic Republic,Myanmar,282,146,136
2000,458,Malaysia,Myanmar,19298,13427,5871
2000,608,Philippines,Myanmar,333,159,174
2000,764,Thailand,Myanmar,734129,394930,339199
2000,704,Viet Nam,Myanmar,6807,4087,2720
2000,188,Costa Rica,Myanmar,9,3,6
2000,591,Panama,Myanmar,44,44,0
2000,32,Argentina,Myanmar,19,19,0
2000,152,Chile,Myanmar,1,1,0
2000,36,Australia,Myanmar,12100,5986,6114
2000,554,New Zealand,Myanmar,682,332,350
2000,203,Czechia,Myanmar,1,1,0
2000,348,Hungary,Myanmar,6,3,3
2000,643,Russian Federation,Myanmar,256,213,43
2000,208,Denmark,Myanmar,64,30,34
2000,246,Finland,Myanmar,50,29,21
2000,372,Ireland,Myanmar,76,40,36
2000,578,Norway,Myanmar,56,38,18
2000,752,Sweden,Myanmar,125,80,45
2000,826,United Kingdom,Myanmar,9590,4483,5107
2000,300,Greece,Myanmar,21,13,8
2000,380,Italy,Myanmar,165,75,90
2000,724,Spain,Myanmar,145,92,53
2000,40,Austria,Myanmar,49,22,27
2000,56,Belgium,Myanmar,47,27,20
2000,250,France,Myanmar,716,366,350
2000,276,Germany,Myanmar,585,390,195
2000,528,Netherlands,Myanmar,171,118,53
2000,756,Switzerland,Myanmar,157,83,74
2000,124,Canada,Myanmar,3724,1796,1928
2000,840,United States of America,Myanmar,33415,16709,16706
2005,710,South Africa,Myanmar,119,42,77
2005,818,Egypt,Myanmar,11,10,1
2005,196,Cyprus,Myanmar,30,7,23
2005,400,Jordan,Myanmar,42,42,0
2005,682,Saudi Arabia,Myanmar,129398,88958,40440
2005,792,Turkey,Myanmar,36,27,9
2005,50,Bangladesh,Myanmar,232693,109366,123327
2005,64,Bhutan,Myanmar,27,17,10
2005,356,India,Myanmar,57177,29467,27710
2005,586,Pakistan,Myanmar,2551,1325,1226
2005,410,Republic of Korea,Myanmar,1978,1841,137
2005,116,Cambodia,Myanmar,80,54,26
2005,418,Lao People's Democratic Republic,Myanmar,245,122,123
2005,458,Malaysia,Myanmar,134525,96213,38312
2005,608,Philippines,Myanmar,269,131,138
2005,764,Thailand,Myanmar,1150168,615256,534912
2005,704,Viet Nam,Myanmar,7834,5012,2822
2005,188,Costa Rica,Myanmar,6,2,4
2005,591,Panama,Myanmar,62,62,0
2005,32,Argentina,Myanmar,14,14,0
2005,152,Chile,Myanmar,1,1,0
2005,36,Australia,Myanmar,13330,6505,6825
2005,554,New Zealand,Myanmar,806,392,414
2005,203,Czechia,Myanmar,30,18,12
2005,348,Hungary,Myanmar,7,3,4
2005,643,Russian Federation,Myanmar,440,411,29
2005,208,Denmark,Myanmar,660,389,271
2005,246,Finland,Myanmar,507,272,235
2005,372,Ireland,Myanmar,76,42,34
2005,578,Norway,Myanmar,514,297,217
2005,752,Sweden,Myanmar,442,240,202
2005,826,United Kingdom,Myanmar,10194,4758,5436
2005,300,Greece,Myanmar,21,14,7
2005,380,Italy,Myanmar,303,123,180
2005,724,Spain,Myanmar,70,44,26
2005,40,Austria,Myanmar,55,24,31
2005,56,Belgium,Myanmar,103,67,36
2005,250,France,Myanmar,369,153,216
2005,276,Germany,Myanmar,1271,824,447
2005,528,Netherlands,Myanmar,361,255,106
2005,756,Switzerland,Myanmar,184,91,93
2005,124,Canada,Myanmar,5703,2774,2929
2005,840,United States of America,Myanmar,49239,24758,24481
2010,710,South Africa,Myanmar,186,66,120
2010,818,Egypt,Myanmar,12,11,1
2010,196,Cyprus,Myanmar,49,12,37
2010,400,Jordan,Myanmar,55,55,0
2010,682,Saudi Arabia,Myanmar,167772,118084,49688
2010,792,Turkey,Myanmar,37,28,9
2010,50,Bangladesh,Myanmar,235019,110459,124560
2010,64,Bhutan,Myanmar,32,20,12
2010,356,India,Myanmar,52470,26972,25498
2010,586,Pakistan,Myanmar,2479,1287,1192
2010,410,Republic of Korea,Myanmar,3544,3292,252
2010,116,Cambodia,Myanmar,58,40,18
2010,418,Lao People's Democratic Republic,Myanmar,1540,826,714
2010,458,Malaysia,Myanmar,226432,164270,62162
2010,608,Philippines,Myanmar,415,192,223
2010,764,Thailand,Myanmar,1648602,890739,757863
2010,704,Viet Nam,Myanmar,9356,5904,3452
2010,188,Costa Rica,Myanmar,12,4,8
2010,591,Panama,Myanmar,84,83,1
2010,32,Argentina,Myanmar,9,9,0
2010,76,Brazil,Myanmar,12,6,6
2010,152,Chile,Myanmar,2,2,0
2010,36,Australia,Myanmar,23260,11363,11897
2010,554,New Zealand,Myanmar,1515,734,781
2010,203,Czechia,Myanmar,56,33,23
2010,348,Hungary,Myanmar,8,3,5
2010,643,Russian Federation,Myanmar,615,599,16
2010,208,Denmark,Myanmar,1233,735,498
2010,246,Finland,Myanmar,1084,541,543
2010,352,Iceland,Myanmar,1,1,0
2010,372,Ireland,Myanmar,63,32,31
2010,578,Norway,Myanmar,2433,1287,1146
2010,752,Sweden,Myanmar,1403,739,664
2010,826,United Kingdom,Myanmar,10738,5129,5609
2010,300,Greece,Myanmar,20,14,6
2010,380,Italy,Myanmar,385,143,242
2010,724,Spain,Myanmar,76,46,30
2010,40,Austria,Myanmar,60,26,34
2010,56,Belgium,Myanmar,149,102,47
2010,250,France,Myanmar,442,222,220
2010,276,Germany,Myanmar,1841,1189,652
2010,528,Netherlands,Myanmar,698,449,249
2010,756,Switzerland,Myanmar,208,98,110
2010,124,Canada,Myanmar,8080,3953,4127
2010,840,United States of America,Myanmar,66988,33226,33762
2015,710,South Africa,Myanmar,334,108,226
2015,324,Guinea,Myanmar,2,2,0
2015,818,Egypt,Myanmar,8,8,0
2015,196,Cyprus,Myanmar,47,12,35
2015,400,Jordan,Myanmar,23,23,0
2015,682,Saudi Arabia,Myanmar,214371,148499,65872
2015,792,Turkey,Myanmar,37,28,9
2015,50,Bangladesh,Myanmar,237369,111564,125805
2015,64,Bhutan,Myanmar,34,21,13
2015,356,India,Myanmar,50552,25957,24595
2015,586,Pakistan,Myanmar,2460,1279,1181
2015,410,Republic of Korea,Myanmar,4403,4083,320
2015,116,Cambodia,Myanmar,52,36,16
2015,418,Lao People's Democratic Republic,Myanmar,2835,1530,1305
2015,458,Malaysia,Myanmar,330851,234312,96539
2015,608,Philippines,Myanmar,421,195,226
2015,764,Thailand,Myanmar,1782773,960485,822288
2015,704,Viet Nam,Myanmar,11187,6801,4386
2015,188,Costa Rica,Myanmar,12,4,8
2015,591,Panama,Myanmar,98,97,1
2015,32,Argentina,Myanmar,9,9,0
2015,76,Brazil,Myanmar,14,7,7
2015,152,Chile,Myanmar,3,3,0
2015,36,Australia,Myanmar,32160,16000,16160
2015,554,New Zealand,Myanmar,2200,1064,1136
2015,203,Czechia,Myanmar,130,75,55
2015,348,Hungary,Myanmar,13,8,5
2015,643,Russian Federation,Myanmar,626,610,16
2015,208,Denmark,Myanmar,1869,1061,808
2015,246,Finland,Myanmar,1444,712,732
2015,352,Iceland,Myanmar,1,1,0
2015,372,Ireland,Myanmar,64,32,32
2015,578,Norway,Myanmar,3143,1596,1547
2015,752,Sweden,Myanmar,1511,784,727
2015,826,United Kingdom,Myanmar,13732,6347,7385
2015,300,Greece,Myanmar,24,12,12
2015,380,Italy,Myanmar,452,164,288
2015,724,Spain,Myanmar,87,49,38
2015,40,Austria,Myanmar,71,32,39
2015,56,Belgium,Myanmar,224,153,71
2015,250,France,Myanmar,490,240,250
2015,276,Germany,Myanmar,1918,1237,681
2015,528,Netherlands,Myanmar,1104,658,446
2015,756,Switzerland,Myanmar,290,130,160
2015,124,Canada,Myanmar,8164,3998,4166
2015,840,United States of America,Myanmar,134424,66326,68098
2019,710,South Africa,Myanmar,373,121,252
2019,324,Guinea,Myanmar,1,1,0
2019,818,Egypt,Myanmar,11,11,0
2019,196,Cyprus,Myanmar,46,12,34
2019,400,Jordan,Myanmar,24,24,0
2019,682,Saudi Arabia,Myanmar,261159,179141,82018
2019,792,Turkey,Myanmar,50,38,12
2019,50,Bangladesh,Myanmar,937521,747514,190007
2019,64,Bhutan,Myanmar,35,22,13
2019,356,India,Myanmar,49720,25530,24190
2019,586,Pakistan,Myanmar,2285,1188,1097
2019,410,Republic of Korea,Myanmar,4482,4157,325
2019,116,Cambodia,Myanmar,55,38,17
2019,418,Lao People's Democratic Republic,Myanmar,3005,1622,1383
2019,458,Malaysia,Myanmar,345947,245744,100203
2019,608,Philippines,Myanmar,434,201,233
2019,764,Thailand,Myanmar,1858735,1001269,857466
2019,704,Viet Nam,Myanmar,11695,7110,4585
2019,188,Costa Rica,Myanmar,12,4,8
2019,591,Panama,Myanmar,103,103,0
2019,32,Argentina,Myanmar,9,9,0
2019,76,Brazil,Myanmar,15,8,7
2019,152,Chile,Myanmar,4,4,0
2019,36,Australia,Myanmar,37537,19268,18269
2019,554,New Zealand,Myanmar,2261,1094,1167
2019,203,Czechia,Myanmar,134,81,53
2019,348,Hungary,Myanmar,15,9,6
2019,643,Russian Federation,Myanmar,625,610,15
2019,208,Denmark,Myanmar,1868,1004,864
2019,246,Finland,Myanmar,1591,782,809
2019,352,Iceland,Myanmar,2,1,1
2019,372,Ireland,Myanmar,70,35,35
2019,578,Norway,Myanmar,3458,1739,1719
2019,752,Sweden,Myanmar,1527,790,737
2019,826,United Kingdom,Myanmar,15594,7229,8365
2019,300,Greece,Myanmar,91,45,46
2019,380,Italy,Myanmar,488,179,309
2019,724,Spain,Myanmar,90,50,40
2019,40,Austria,Myanmar,83,38,45
2019,56,Belgium,Myanmar,203,132,71
2019,250,France,Myanmar,518,253,265
2019,276,Germany,Myanmar,2103,1397,706
2019,528,Netherlands,Myanmar,1249,723,526
2019,756,Switzerland,Myanmar,363,148,215
2019,124,Canada,Myanmar,8748,4284,4464
2019,840,United States of America,Myanmar,145165,70835,74330
1990,404,Kenya,Namibia,119,66,53
1990,834,United Republic of Tanzania,Namibia,370,224,146
1990,894,Zambia,Namibia,2360,1273,1087
1990,24,Angola,Namibia,345,182,163
1990,72,Botswana,Namibia,286,158,128
1990,426,Lesotho,Namibia,5,4,1
1990,710,South Africa,Namibia,10904,6691,4213
1990,818,Egypt,Namibia,379,124,255
1990,196,Cyprus,Namibia,1,1,0
1990,32,Argentina,Namibia,4,4,0
1990,152,Chile,Namibia,2,1,1
1990,36,Australia,Namibia,265,125,140
1990,100,Bulgaria,Namibia,1,1,0
1990,203,Czechia,Namibia,2,1,1
1990,643,Russian Federation,Namibia,106,52,54
1990,208,Denmark,Namibia,10,3,7
1990,246,Finland,Namibia,51,25,26
1990,352,Iceland,Namibia,10,5,5
1990,372,Ireland,Namibia,7,3,4
1990,578,Norway,Namibia,19,10,9
1990,752,Sweden,Namibia,37,20,17
1990,826,United Kingdom,Namibia,172,106,66
1990,300,Greece,Namibia,8,5,3
1990,380,Italy,Namibia,13,5,8
1990,724,Spain,Namibia,7,3,4
1990,40,Austria,Namibia,101,40,61
1990,56,Belgium,Namibia,29,13,16
1990,250,France,Namibia,104,50,54
1990,528,Netherlands,Namibia,68,30,38
1990,756,Switzerland,Namibia,127,55,72
1990,124,Canada,Namibia,167,81,86
1995,404,Kenya,Namibia,112,61,51
1995,834,United Republic of Tanzania,Namibia,494,299,195
1995,894,Zambia,Namibia,473,256,217
1995,24,Angola,Namibia,401,203,198
1995,72,Botswana,Namibia,462,245,217
1995,426,Lesotho,Namibia,4,3,1
1995,710,South Africa,Namibia,23874,12776,11098
1995,818,Egypt,Namibia,277,91,186
1995,196,Cyprus,Namibia,2,2,0
1995,32,Argentina,Namibia,4,4,0
1995,152,Chile,Namibia,4,2,2
1995,36,Australia,Namibia,394,198,196
1995,100,Bulgaria,Namibia,2,2,0
1995,203,Czechia,Namibia,3,2,1
1995,348,Hungary,Namibia,3,2,1
1995,643,Russian Federation,Namibia,95,54,41
1995,208,Denmark,Namibia,24,8,16
1995,246,Finland,Namibia,38,18,20
1995,352,Iceland,Namibia,15,8,7
1995,372,Ireland,Namibia,20,7,13
1995,578,Norway,Namibia,20,7,13
1995,752,Sweden,Namibia,44,24,20
1995,826,United Kingdom,Namibia,677,344,333
1995,300,Greece,Namibia,7,5,2
1995,380,Italy,Namibia,24,5,19
1995,724,Spain,Namibia,12,5,7
1995,40,Austria,Namibia,114,46,68
1995,56,Belgium,Namibia,29,13,16
1995,250,France,Namibia,108,51,57
1995,528,Netherlands,Namibia,99,42,57
1995,756,Switzerland,Namibia,157,81,76
1995,124,Canada,Namibia,232,112,120
2000,404,Kenya,Namibia,61,31,30
2000,834,United Republic of Tanzania,Namibia,526,319,207
2000,894,Zambia,Namibia,101,55,46
2000,24,Angola,Namibia,457,225,232
2000,72,Botswana,Namibia,687,359,328
2000,426,Lesotho,Namibia,4,3,1
2000,710,South Africa,Namibia,44274,22295,21979
2000,818,Egypt,Namibia,196,64,132
2000,196,Cyprus,Namibia,2,2,0
2000,32,Argentina,Namibia,4,4,0
2000,152,Chile,Namibia,6,2,4
2000,36,Australia,Namibia,450,228,222
2000,100,Bulgaria,Namibia,2,2,0
2000,203,Czechia,Namibia,4,3,1
2000,348,Hungary,Namibia,6,4,2
2000,643,Russian Federation,Namibia,82,55,27
2000,208,Denmark,Namibia,37,12,25
2000,246,Finland,Namibia,24,11,13
2000,352,Iceland,Namibia,19,11,8
2000,372,Ireland,Namibia,43,16,27
2000,578,Norway,Namibia,39,17,22
2000,752,Sweden,Namibia,48,26,22
2000,826,United Kingdom,Namibia,1195,587,608
2000,300,Greece,Namibia,7,6,1
2000,380,Italy,Namibia,35,5,30
2000,724,Spain,Namibia,151,65,86
2000,40,Austria,Namibia,127,53,74
2000,56,Belgium,Namibia,29,13,16
2000,250,France,Namibia,111,51,60
2000,528,Netherlands,Namibia,136,55,81
2000,756,Switzerland,Namibia,189,107,82
2000,124,Canada,Namibia,302,145,157
2005,404,Kenya,Namibia,60,31,29
2005,834,United Republic of Tanzania,Namibia,571,338,233
2005,894,Zambia,Namibia,251,137,114
2005,24,Angola,Namibia,591,283,308
2005,72,Botswana,Namibia,1036,535,501
2005,426,Lesotho,Namibia,4,3,1
2005,710,South Africa,Namibia,58250,28637,29613
2005,818,Egypt,Namibia,233,86,147
2005,196,Cyprus,Namibia,3,3,0
2005,32,Argentina,Namibia,3,3,0
2005,152,Chile,Namibia,9,4,5
2005,36,Australia,Namibia,740,381,359
2005,100,Bulgaria,Namibia,3,2,1
2005,203,Czechia,Namibia,14,8,6
2005,348,Hungary,Namibia,7,5,2
2005,643,Russian Federation,Namibia,101,64,37
2005,208,Denmark,Namibia,48,19,29
2005,246,Finland,Namibia,49,20,29
2005,352,Iceland,Namibia,28,13,15
2005,372,Ireland,Namibia,44,19,25
2005,578,Norway,Namibia,72,30,42
2005,752,Sweden,Namibia,67,34,33
2005,826,United Kingdom,Namibia,1707,798,909
2005,300,Greece,Namibia,8,6,2
2005,380,Italy,Namibia,64,27,37
2005,724,Spain,Namibia,73,31,42
2005,40,Austria,Namibia,142,57,85
2005,56,Belgium,Namibia,41,8,33
2005,250,France,Namibia,103,45,58
2005,528,Netherlands,Namibia,209,79,130
2005,756,Switzerland,Namibia,233,126,107
2005,124,Canada,Namibia,666,276,390
2010,404,Kenya,Namibia,67,33,34
2010,834,United Republic of Tanzania,Namibia,613,373,240
2010,894,Zambia,Namibia,630,281,349
2010,24,Angola,Namibia,725,342,383
2010,72,Botswana,Namibia,850,590,260
2010,426,Lesotho,Namibia,4,3,1
2010,710,South Africa,Namibia,91250,44685,46565
2010,818,Egypt,Namibia,251,86,165
2010,196,Cyprus,Namibia,4,4,0
2010,32,Argentina,Namibia,2,2,0
2010,76,Brazil,Namibia,48,39,9
2010,152,Chile,Namibia,12,5,7
2010,36,Australia,Namibia,1090,548,542
2010,100,Bulgaria,Namibia,3,2,1
2010,203,Czechia,Namibia,22,11,11
2010,348,Hungary,Namibia,7,5,2
2010,643,Russian Federation,Namibia,118,70,48
2010,208,Denmark,Namibia,57,25,32
2010,233,Estonia,Namibia,1,1,0
2010,246,Finland,Namibia,89,31,58
2010,352,Iceland,Namibia,36,15,21
2010,372,Ireland,Namibia,37,14,23
2010,578,Norway,Namibia,81,35,46
2010,752,Sweden,Namibia,90,47,43
2010,826,United Kingdom,Namibia,1798,861,937
2010,300,Greece,Namibia,8,5,3
2010,380,Italy,Namibia,93,47,46
2010,724,Spain,Namibia,112,52,60
2010,40,Austria,Namibia,157,61,96
2010,56,Belgium,Namibia,46,17,29
2010,250,France,Namibia,162,72,90
2010,528,Netherlands,Namibia,236,101,135
2010,756,Switzerland,Namibia,251,130,121
2010,124,Canada,Namibia,680,270,410
2015,404,Kenya,Namibia,68,33,35
2015,834,United Republic of Tanzania,Namibia,644,393,251
2015,894,Zambia,Namibia,554,246,308
2015,24,Angola,Namibia,859,401,458
2015,72,Botswana,Namibia,927,643,284
2015,426,Lesotho,Namibia,4,3,1
2015,710,South Africa,Namibia,164599,76326,88273
2015,324,Guinea,Namibia,3,2,1
2015,818,Egypt,Namibia,186,80,106
2015,196,Cyprus,Namibia,3,3,0
2015,32,Argentina,Namibia,2,2,0
2015,76,Brazil,Namibia,58,47,11
2015,152,Chile,Namibia,18,8,10
2015,36,Australia,Namibia,1430,713,717
2015,100,Bulgaria,Namibia,5,2,3
2015,203,Czechia,Namibia,24,14,10
2015,348,Hungary,Namibia,20,9,11
2015,643,Russian Federation,Namibia,121,72,49
2015,208,Denmark,Namibia,66,26,40
2015,233,Estonia,Namibia,1,1,0
2015,246,Finland,Namibia,115,43,72
2015,352,Iceland,Namibia,35,16,19
2015,372,Ireland,Namibia,38,14,24
2015,578,Norway,Namibia,82,31,51
2015,752,Sweden,Namibia,131,75,56
2015,826,United Kingdom,Namibia,2299,1066,1233
2015,300,Greece,Namibia,7,5,2
2015,380,Italy,Namibia,85,43,42
2015,705,Slovenia,Namibia,3,2,1
2015,724,Spain,Namibia,126,57,69
2015,40,Austria,Namibia,183,71,112
2015,56,Belgium,Namibia,67,31,36
2015,250,France,Namibia,178,75,103
2015,528,Netherlands,Namibia,268,112,156
2015,756,Switzerland,Namibia,279,125,154
2015,124,Canada,Namibia,1028,482,546
2019,404,Kenya,Namibia,63,31,32
2019,834,United Republic of Tanzania,Namibia,577,351,226
2019,894,Zambia,Namibia,713,318,395
2019,24,Angola,Namibia,909,451,458
2019,72,Botswana,Namibia,992,688,304
2019,426,Lesotho,Namibia,4,3,1
2019,710,South Africa,Namibia,184496,85648,98848
2019,324,Guinea,Namibia,2,2,0
2019,818,Egypt,Namibia,265,97,168
2019,196,Cyprus,Namibia,2,2,0
2019,32,Argentina,Namibia,2,2,0
2019,76,Brazil,Namibia,65,53,12
2019,152,Chile,Namibia,24,10,14
2019,36,Australia,Namibia,1639,809,830
2019,100,Bulgaria,Namibia,8,4,4
2019,203,Czechia,Namibia,27,13,14
2019,348,Hungary,Namibia,19,11,8
2019,643,Russian Federation,Namibia,120,72,48
2019,208,Denmark,Namibia,88,33,55
2019,233,Estonia,Namibia,2,2,0
2019,246,Finland,Namibia,124,46,78
2019,352,Iceland,Namibia,47,20,27
2019,372,Ireland,Namibia,41,15,26
2019,578,Norway,Namibia,97,37,60
2019,752,Sweden,Namibia,177,92,85
2019,826,United Kingdom,Namibia,2610,1214,1396
2019,300,Greece,Namibia,6,5,1
2019,380,Italy,Namibia,95,44,51
2019,705,Slovenia,Namibia,3,2,1
2019,724,Spain,Namibia,130,57,73
2019,40,Austria,Namibia,216,87,129
2019,56,Belgium,Namibia,77,35,42
2019,250,France,Namibia,188,79,109
2019,528,Netherlands,Namibia,287,121,166
2019,756,Switzerland,Namibia,303,147,156
2019,124,Canada,Namibia,1101,516,585
1990,710,South Africa,Nauru,23,9,14
1990,36,Australia,Nauru,463,216,247
1990,296,Kiribati,Nauru,921,399,522
1990,882,Samoa,Nauru,3,1,2
1990,798,Tuvalu,Nauru,7,1,6
1990,203,Czechia,Nauru,1,1,0
1990,40,Austria,Nauru,1,0,1
1995,710,South Africa,Nauru,14,6,8
1995,152,Chile,Nauru,3,2,1
1995,36,Australia,Nauru,491,230,261
1995,296,Kiribati,Nauru,988,456,532
1995,882,Samoa,Nauru,6,2,4
1995,798,Tuvalu,Nauru,6,1,5
1995,100,Bulgaria,Nauru,1,1,0
1995,203,Czechia,Nauru,1,0,1
1995,826,United Kingdom,Nauru,2,1,1
1995,380,Italy,Nauru,1,1,0
1995,40,Austria,Nauru,1,0,1
2000,710,South Africa,Nauru,10,4,6
2000,152,Chile,Nauru,7,4,3
2000,36,Australia,Nauru,500,241,259
2000,296,Kiribati,Nauru,1055,513,542
2000,882,Samoa,Nauru,10,3,7
2000,798,Tuvalu,Nauru,5,1,4
2000,100,Bulgaria,Nauru,1,1,0
2000,203,Czechia,Nauru,1,0,1
2000,752,Sweden,Nauru,2,1,1
2000,826,United Kingdom,Nauru,6,3,3
2000,380,Italy,Nauru,2,2,0
2000,40,Austria,Nauru,1,0,1
2005,710,South Africa,Nauru,12,5,7
2005,152,Chile,Nauru,10,6,4
2005,36,Australia,Nauru,570,294,276
2005,296,Kiribati,Nauru,1250,620,630
2005,882,Samoa,Nauru,9,3,6
2005,798,Tuvalu,Nauru,5,1,4
2005,100,Bulgaria,Nauru,2,2,0
2005,203,Czechia,Nauru,1,0,1
2005,752,Sweden,Nauru,2,1,1
2005,826,United Kingdom,Nauru,16,6,10
2005,380,Italy,Nauru,2,1,1
2005,40,Austria,Nauru,1,0,1
2010,710,South Africa,Nauru,18,8,10
2010,152,Chile,Nauru,14,9,5
2010,36,Australia,Nauru,630,345,285
2010,296,Kiribati,Nauru,1446,727,719
2010,882,Samoa,Nauru,8,2,6
2010,798,Tuvalu,Nauru,6,2,4
2010,100,Bulgaria,Nauru,2,2,0
2010,203,Czechia,Nauru,1,0,1
2010,752,Sweden,Nauru,2,1,1
2010,826,United Kingdom,Nauru,16,6,10
2010,380,Italy,Nauru,2,1,1
2010,40,Austria,Nauru,1,0,1
2015,710,South Africa,Nauru,31,14,17
2015,324,Guinea,Nauru,18,12,6
2015,152,Chile,Nauru,21,14,7
2015,36,Australia,Nauru,690,340,350
2015,296,Kiribati,Nauru,1471,740,731
2015,882,Samoa,Nauru,6,1,5
2015,798,Tuvalu,Nauru,6,2,4
2015,100,Bulgaria,Nauru,2,2,0
2015,203,Czechia,Nauru,1,0,1
2015,752,Sweden,Nauru,2,1,1
2015,826,United Kingdom,Nauru,20,7,13
2015,380,Italy,Nauru,6,1,5
2015,40,Austria,Nauru,1,0,1
2019,710,South Africa,Nauru,34,16,18
2019,324,Guinea,Nauru,17,12,5
2019,152,Chile,Nauru,28,19,9
2019,36,Australia,Nauru,772,376,396
2019,296,Kiribati,Nauru,1527,767,760
2019,882,Samoa,Nauru,5,1,4
2019,798,Tuvalu,Nauru,6,2,4
2019,100,Bulgaria,Nauru,2,2,0
2019,203,Czechia,Nauru,1,0,1
2019,752,Sweden,Nauru,1,0,1
2019,826,United Kingdom,Nauru,22,8,14
2019,380,Italy,Nauru,5,1,4
2019,40,Austria,Nauru,1,0,1
1990,690,Seychelles,Nepal,27,12,15
1990,710,South Africa,Nepal,125,64,61
1990,48,Bahrain,Nepal,228,163,65
1990,196,Cyprus,Nepal,14,12,2
1990,400,Jordan,Nepal,9,7,2
1990,414,Kuwait,Nepal,1416,858,558
1990,634,Qatar,Nepal,459,335,124
1990,682,Saudi Arabia,Nepal,177661,136023,41638
1990,784,United Arab Emirates,Nepal,1730,1232,498
1990,50,Bangladesh,Nepal,9670,5222,4448
1990,64,Bhutan,Nepal,334,220,114
1990,356,India,Nepal,518212,223552,294660
1990,144,Sri Lanka,Nepal,4,3,1
1990,344,"China, Hong Kong SAR",Nepal,6254,3275,2979
1990,410,Republic of Korea,Nepal,10,10,0
1990,96,Brunei Darussalam,Nepal,3665,2812,853
1990,116,Cambodia,Nepal,21,11,10
1990,458,Malaysia,Nepal,14931,7977,6954
1990,608,Philippines,Nepal,74,55,19
1990,764,Thailand,Nepal,5763,2760,3003
1990,704,Viet Nam,Nepal,106,50,56
1990,188,Costa Rica,Nepal,7,6,1
1990,152,Chile,Nepal,7,2,5
1990,36,Australia,Nepal,404,259,145
1990,554,New Zealand,Nepal,72,47,25
1990,580,Northern Mariana Islands,Nepal,156,130,26
1990,100,Bulgaria,Nepal,1,1,0
1990,203,Czechia,Nepal,4,3,1
1990,616,Poland,Nepal,13,13,0
1990,643,Russian Federation,Nepal,573,281,292
1990,208,Denmark,Nepal,37,23,14
1990,246,Finland,Nepal,16,4,12
1990,352,Iceland,Nepal,8,6,2
1990,372,Ireland,Nepal,26,18,8
1990,428,Latvia,Nepal,1,0,1
1990,578,Norway,Nepal,52,29,23
1990,752,Sweden,Nepal,121,66,55
1990,826,United Kingdom,Nepal,828,624,204
1990,300,Greece,Nepal,29,17,12
1990,380,Italy,Nepal,11,4,7
1990,620,Portugal,Nepal,9,8,1
1990,724,Spain,Nepal,45,19,26
1990,40,Austria,Nepal,323,207,116
1990,56,Belgium,Nepal,59,29,30
1990,250,France,Nepal,707,336,371
1990,276,Germany,Nepal,867,604,263
1990,442,Luxembourg,Nepal,30,21,9
1990,528,Netherlands,Nepal,206,108,98
1990,756,Switzerland,Nepal,353,191,162
1990,124,Canada,Nepal,120,58,62
1990,840,United States of America,Nepal,2262,1527,735
1995,690,Seychelles,Nepal,33,11,22
1995,710,South Africa,Nepal,77,43,34
1995,48,Bahrain,Nepal,250,176,74
1995,196,Cyprus,Nepal,20,17,3
1995,400,Jordan,Nepal,115,67,48
1995,414,Kuwait,Nepal,1134,723,411
1995,634,Qatar,Nepal,498,372,126
1995,682,Saudi Arabia,Nepal,182078,139627,42451
1995,784,United Arab Emirates,Nepal,2217,1589,628
1995,50,Bangladesh,Nepal,11361,6135,5226
1995,64,Bhutan,Nepal,392,258,134
1995,356,India,Nepal,591200,266232,324968
1995,144,Sri Lanka,Nepal,43,37,6
1995,344,"China, Hong Kong SAR",Nepal,6980,3633,3347
1995,410,Republic of Korea,Nepal,956,838,118
1995,96,Brunei Darussalam,Nepal,4337,3338,999
1995,116,Cambodia,Nepal,55,28,27
1995,458,Malaysia,Nepal,27097,14496,12601
1995,608,Philippines,Nepal,99,73,26
1995,764,Thailand,Nepal,9634,4443,5191
1995,704,Viet Nam,Nepal,299,150,149
1995,188,Costa Rica,Nepal,5,4,1
1995,68,Bolivia (Plurinational State of),Nepal,1,0,1
1995,152,Chile,Nepal,8,4,4
1995,36,Australia,Nepal,1238,843,395
1995,554,New Zealand,Nepal,229,132,97
1995,580,Northern Mariana Islands,Nepal,191,161,30
1995,100,Bulgaria,Nepal,2,2,0
1995,203,Czechia,Nepal,6,4,2
1995,348,Hungary,Nepal,19,12,7
1995,616,Poland,Nepal,10,10,0
1995,643,Russian Federation,Nepal,492,294,198
1995,208,Denmark,Nepal,78,44,34
1995,246,Finland,Nepal,49,29,20
1995,352,Iceland,Nepal,12,9,3
1995,372,Ireland,Nepal,73,49,24
1995,428,Latvia,Nepal,1,0,1
1995,578,Norway,Nepal,71,40,31
1995,752,Sweden,Nepal,143,77,66
1995,826,United Kingdom,Nepal,3257,2234,1023
1995,300,Greece,Nepal,21,13,8
1995,380,Italy,Nepal,103,54,49
1995,620,Portugal,Nepal,20,17,3
1995,724,Spain,Nepal,67,33,34
1995,40,Austria,Nepal,365,236,129
1995,56,Belgium,Nepal,50,25,25
1995,250,France,Nepal,730,340,390
1995,276,Germany,Nepal,1386,986,400
1995,442,Luxembourg,Nepal,28,20,8
1995,528,Netherlands,Nepal,303,155,148
1995,756,Switzerland,Nepal,502,298,204
1995,124,Canada,Nepal,620,299,321
1995,840,United States of America,Nepal,7081,4812,2269
2000,690,Seychelles,Nepal,39,9,30
2000,710,South Africa,Nepal,53,33,20
2000,48,Bahrain,Nepal,274,189,85
2000,196,Cyprus,Nepal,26,22,4
2000,268,Georgia,Nepal,18,18,0
2000,400,Jordan,Nepal,220,127,93
2000,414,Kuwait,Nepal,1294,874,420
2000,634,Qatar,Nepal,464,354,110
2000,682,Saudi Arabia,Nepal,187079,143648,43431
2000,784,United Arab Emirates,Nepal,2832,2029,803
2000,50,Bangladesh,Nepal,13051,7048,6003
2000,64,Bhutan,Nepal,451,297,154
2000,356,India,Nepal,664187,308912,355275
2000,144,Sri Lanka,Nepal,84,66,18
2000,344,"China, Hong Kong SAR",Nepal,7706,3991,3715
2000,410,Republic of Korea,Nepal,2208,1940,268
2000,96,Brunei Darussalam,Nepal,5008,3863,1145
2000,116,Cambodia,Nepal,89,46,43
2000,458,Malaysia,Nepal,48253,25762,22491
2000,608,Philippines,Nepal,616,340,276
2000,764,Thailand,Nepal,15494,6916,8578
2000,704,Viet Nam,Nepal,774,420,354
2000,188,Costa Rica,Nepal,6,5,1
2000,68,Bolivia (Plurinational State of),Nepal,1,0,1
2000,152,Chile,Nepal,9,4,5
2000,36,Australia,Nepal,2000,1376,624
2000,554,New Zealand,Nepal,335,163,172
2000,580,Northern Mariana Islands,Nepal,239,201,38
2000,100,Bulgaria,Nepal,3,3,0
2000,203,Czechia,Nepal,8,5,3
2000,348,Hungary,Nepal,38,25,13
2000,616,Poland,Nepal,9,9,0
2000,643,Russian Federation,Nepal,395,297,98
2000,208,Denmark,Nepal,118,65,53
2000,246,Finland,Nepal,82,54,28
2000,352,Iceland,Nepal,15,11,4
2000,372,Ireland,Nepal,159,108,51
2000,428,Latvia,Nepal,2,1,1
2000,578,Norway,Nepal,164,90,74
2000,752,Sweden,Nepal,154,82,72
2000,826,United Kingdom,Nepal,5741,3878,1863
2000,300,Greece,Nepal,14,10,4
2000,380,Italy,Nepal,195,105,90
2000,620,Portugal,Nepal,32,26,6
2000,705,Slovenia,Nepal,5,4,1
2000,724,Spain,Nepal,119,61,58
2000,40,Austria,Nepal,406,264,142
2000,56,Belgium,Nepal,38,20,18
2000,250,France,Nepal,753,345,408
2000,276,Germany,Nepal,1905,1369,536
2000,442,Luxembourg,Nepal,27,19,8
2000,528,Netherlands,Nepal,413,209,204
2000,756,Switzerland,Nepal,654,406,248
2000,124,Canada,Nepal,1134,547,587
2000,840,United States of America,Nepal,12012,8178,3834
2005,690,Seychelles,Nepal,98,74,24
2005,710,South Africa,Nepal,70,43,27
2005,48,Bahrain,Nepal,1066,722,344
2005,196,Cyprus,Nepal,38,32,6
2005,268,Georgia,Nepal,17,17,0
2005,400,Jordan,Nepal,318,200,118
2005,414,Kuwait,Nepal,1397,921,476
2005,634,Qatar,Nepal,23647,17821,5826
2005,682,Saudi Arabia,Nepal,231098,180541,50557
2005,784,United Arab Emirates,Nepal,8818,6074,2744
2005,50,Bangladesh,Nepal,24995,13498,11497
2005,64,Bhutan,Nepal,565,369,196
2005,356,India,Nepal,613671,284662,329009
2005,144,Sri Lanka,Nepal,167,111,56
2005,344,"China, Hong Kong SAR",Nepal,8413,4154,4259
2005,410,Republic of Korea,Nepal,4499,3838,661
2005,96,Brunei Darussalam,Nepal,5120,3956,1164
2005,116,Cambodia,Nepal,69,36,33
2005,458,Malaysia,Nepal,124125,69589,54536
2005,608,Philippines,Nepal,498,279,219
2005,764,Thailand,Nepal,12472,5483,6989
2005,704,Viet Nam,Nepal,1375,786,589
2005,188,Costa Rica,Nepal,4,3,1
2005,68,Bolivia (Plurinational State of),Nepal,3,1,2
2005,152,Chile,Nepal,13,6,7
2005,36,Australia,Nepal,3830,2420,1410
2005,554,New Zealand,Nepal,553,269,284
2005,580,Northern Mariana Islands,Nepal,221,184,37
2005,100,Bulgaria,Nepal,4,4,0
2005,203,Czechia,Nepal,59,47,12
2005,348,Hungary,Nepal,47,31,16
2005,616,Poland,Nepal,32,25,7
2005,643,Russian Federation,Nepal,285,225,60
2005,208,Denmark,Nepal,820,553,267
2005,246,Finland,Nepal,635,486,149
2005,352,Iceland,Nepal,56,33,23
2005,372,Ireland,Nepal,159,111,48
2005,428,Latvia,Nepal,8,7,1
2005,578,Norway,Nepal,328,185,143
2005,752,Sweden,Nepal,240,137,103
2005,826,United Kingdom,Nepal,26149,14837,11312
2005,300,Greece,Nepal,33,24,9
2005,380,Italy,Nepal,985,563,422
2005,620,Portugal,Nepal,272,195,77
2005,705,Slovenia,Nepal,9,7,2
2005,724,Spain,Nepal,680,444,236
2005,40,Austria,Nepal,454,291,163
2005,56,Belgium,Nepal,762,458,304
2005,250,France,Nepal,1007,485,522
2005,276,Germany,Nepal,2600,1611,989
2005,442,Luxembourg,Nepal,23,17,6
2005,528,Netherlands,Nepal,662,375,287
2005,756,Switzerland,Nepal,725,435,290
2005,124,Canada,Nepal,4820,2476,2344
2005,840,United States of America,Nepal,29611,14833,14778
2010,690,Seychelles,Nepal,157,138,19
2010,710,South Africa,Nepal,109,67,42
2010,48,Bahrain,Nepal,2095,1415,680
2010,196,Cyprus,Nepal,62,53,9
2010,268,Georgia,Nepal,17,17,0
2010,400,Jordan,Nepal,410,267,143
2010,414,Kuwait,Nepal,1850,1205,645
2010,634,Qatar,Nepal,66011,52886,13125
2010,682,Saudi Arabia,Nepal,299632,233077,66555
2010,784,United Arab Emirates,Nepal,23410,16396,7014
2010,50,Bangladesh,Nepal,33308,17987,15321
2010,64,Bhutan,Nepal,679,441,238
2010,356,India,Nepal,563154,260412,302742
2010,144,Sri Lanka,Nepal,337,226,111
2010,344,"China, Hong Kong SAR",Nepal,9141,4327,4814
2010,410,Republic of Korea,Nepal,8569,7211,1358
2010,96,Brunei Darussalam,Nepal,5232,4049,1183
2010,116,Cambodia,Nepal,50,27,23
2010,458,Malaysia,Nepal,276557,158199,118358
2010,608,Philippines,Nepal,67,37,30
2010,764,Thailand,Nepal,10345,4588,5757
2010,704,Viet Nam,Nepal,1944,1061,883
2010,188,Costa Rica,Nepal,8,7,1
2010,68,Bolivia (Plurinational State of),Nepal,5,2,3
2010,76,Brazil,Nepal,50,50,0
2010,152,Chile,Nepal,18,9,9
2010,36,Australia,Nepal,27200,17089,10111
2010,554,New Zealand,Nepal,1017,493,524
2010,580,Northern Mariana Islands,Nepal,140,114,26
2010,100,Bulgaria,Nepal,5,5,0
2010,203,Czechia,Nepal,105,85,20
2010,348,Hungary,Nepal,56,37,19
2010,616,Poland,Nepal,58,43,15
2010,643,Russian Federation,Nepal,171,150,21
2010,208,Denmark,Nepal,1495,1023,472
2010,233,Estonia,Nepal,20,19,1
2010,246,Finland,Nepal,1168,869,299
2010,352,Iceland,Nepal,95,55,40
2010,372,Ireland,Nepal,133,90,43
2010,428,Latvia,Nepal,14,13,1
2010,578,Norway,Nepal,724,427,297
2010,752,Sweden,Nepal,708,493,215
2010,826,United Kingdom,Nepal,27546,15874,11672
2010,300,Greece,Nepal,53,40,13
2010,380,Italy,Nepal,1647,950,697
2010,620,Portugal,Nepal,468,332,136
2010,705,Slovenia,Nepal,12,9,3
2010,724,Spain,Nepal,2594,1795,799
2010,40,Austria,Nepal,502,319,183
2010,56,Belgium,Nepal,1865,1076,789
2010,250,France,Nepal,1244,555,689
2010,276,Germany,Nepal,3174,1819,1355
2010,442,Luxembourg,Nepal,20,15,5
2010,528,Netherlands,Nepal,1346,822,524
2010,756,Switzerland,Nepal,865,500,365
2010,124,Canada,Nepal,8345,4328,4017
2010,840,United States of America,Nepal,48579,24002,24577
2015,690,Seychelles,Nepal,175,155,20
2015,710,South Africa,Nepal,195,117,78
2015,324,Guinea,Nepal,25,19,6
2015,48,Bahrain,Nepal,3789,2541,1248
2015,196,Cyprus,Nepal,59,51,8
2015,268,Georgia,Nepal,17,17,0
2015,400,Jordan,Nepal,176,101,75
2015,414,Kuwait,Nepal,22678,13683,8995
2015,634,Qatar,Nepal,151314,123207,28107
2015,682,Saudi Arabia,Nepal,403005,316320,86685
2015,784,United Arab Emirates,Nepal,25580,17614,7966
2015,50,Bangladesh,Nepal,39059,21092,17967
2015,64,Bhutan,Nepal,717,426,291
2015,356,India,Nepal,542573,250540,292033
2015,144,Sri Lanka,Nepal,342,227,115
2015,344,"China, Hong Kong SAR",Nepal,9334,4226,5108
2015,410,Republic of Korea,Nepal,10647,8921,1726
2015,96,Brunei Darussalam,Nepal,5344,4142,1202
2015,116,Cambodia,Nepal,45,25,20
2015,458,Malaysia,Nepal,552855,319950,232905
2015,608,Philippines,Nepal,68,37,31
2015,764,Thailand,Nepal,11186,4940,6246
2015,704,Viet Nam,Nepal,2315,1253,1062
2015,188,Costa Rica,Nepal,8,7,1
2015,68,Bolivia (Plurinational State of),Nepal,6,3,3
2015,76,Brazil,Nepal,60,60,0
2015,152,Chile,Nepal,27,14,13
2015,36,Australia,Nepal,50150,28134,22016
2015,554,New Zealand,Nepal,1465,709,756
2015,580,Northern Mariana Islands,Nepal,125,101,24
2015,100,Bulgaria,Nepal,8,8,0
2015,203,Czechia,Nepal,182,134,48
2015,348,Hungary,Nepal,55,33,22
2015,616,Poland,Nepal,55,41,14
2015,643,Russian Federation,Nepal,175,154,21
2015,208,Denmark,Nepal,2132,1273,859
2015,233,Estonia,Nepal,41,39,2
2015,246,Finland,Nepal,2970,2104,866
2015,352,Iceland,Nepal,98,56,42
2015,372,Ireland,Nepal,136,92,44
2015,428,Latvia,Nepal,16,14,2
2015,578,Norway,Nepal,1576,922,654
2015,752,Sweden,Nepal,853,514,339
2015,826,United Kingdom,Nepal,35227,19858,15369
2015,300,Greece,Nepal,49,37,12
2015,380,Italy,Nepal,1885,1084,801
2015,620,Portugal,Nepal,530,368,162
2015,705,Slovenia,Nepal,14,9,5
2015,724,Spain,Nepal,3136,1915,1221
2015,40,Austria,Nepal,588,374,214
2015,56,Belgium,Nepal,3529,1883,1646
2015,250,France,Nepal,1377,593,784
2015,276,Germany,Nepal,3307,1891,1416
2015,442,Luxembourg,Nepal,30,23,7
2015,528,Netherlands,Nepal,1639,905,734
2015,756,Switzerland,Nepal,970,529,441
2015,124,Canada,Nepal,14301,7272,7029
2015,840,United States of America,Nepal,105677,51938,53739
2019,690,Seychelles,Nepal,176,156,20
2019,710,South Africa,Nepal,217,130,87
2019,324,Guinea,Nepal,23,18,5
2019,48,Bahrain,Nepal,3988,2675,1313
2019,196,Cyprus,Nepal,58,51,7
2019,268,Georgia,Nepal,17,17,0
2019,400,Jordan,Nepal,189,109,80
2019,414,Kuwait,Nepal,24012,14488,9524
2019,634,Qatar,Nepal,254340,205722,48618
2019,682,Saudi Arabia,Nepal,490965,383033,107932
2019,784,United Arab Emirates,Nepal,27474,18917,8557
2019,50,Bangladesh,Nepal,39573,12068,27505
2019,64,Bhutan,Nepal,747,444,303
2019,356,India,Nepal,533646,246418,287228
2019,144,Sri Lanka,Nepal,344,229,115
2019,344,"China, Hong Kong SAR",Nepal,12093,5277,6816
2019,410,Republic of Korea,Nepal,10838,9081,1757
2019,96,Brunei Darussalam,Nepal,5755,4461,1294
2019,116,Cambodia,Nepal,47,26,21
2019,458,Malaysia,Nepal,578082,336336,241746
2019,608,Philippines,Nepal,70,39,31
2019,764,Thailand,Nepal,11662,5149,6513
2019,704,Viet Nam,Nepal,2420,1310,1110
2019,188,Costa Rica,Nepal,8,7,1
2019,68,Bolivia (Plurinational State of),Nepal,6,3,3
2019,76,Brazil,Nepal,67,67,0
2019,152,Chile,Nepal,36,18,18
2019,36,Australia,Nepal,78016,43164,34852
2019,554,New Zealand,Nepal,1505,728,777
2019,580,Northern Mariana Islands,Nepal,125,101,24
2019,100,Bulgaria,Nepal,17,15,2
2019,203,Czechia,Nepal,391,279,112
2019,348,Hungary,Nepal,80,47,33
2019,616,Poland,Nepal,58,44,14
2019,643,Russian Federation,Nepal,174,154,20
2019,208,Denmark,Nepal,4714,2570,2144
2019,233,Estonia,Nepal,62,59,3
2019,246,Finland,Nepal,4113,2784,1329
2019,352,Iceland,Nepal,122,71,51
2019,372,Ireland,Nepal,149,101,48
2019,428,Latvia,Nepal,16,13,3
2019,578,Norway,Nepal,1952,1099,853
2019,752,Sweden,Nepal,1063,606,457
2019,826,United Kingdom,Nepal,40003,22594,17409
2019,300,Greece,Nepal,63,31,32
2019,380,Italy,Nepal,2244,1312,932
2019,620,Portugal,Nepal,5884,3898,1986
2019,705,Slovenia,Nepal,20,14,6
2019,724,Spain,Nepal,3249,1954,1295
2019,40,Austria,Nepal,694,446,248
2019,56,Belgium,Nepal,3878,2012,1866
2019,250,France,Nepal,1457,626,831
2019,276,Germany,Nepal,5705,3233,2472
2019,442,Luxembourg,Nepal,302,177,125
2019,528,Netherlands,Nepal,1991,1075,916
2019,756,Switzerland,Nepal,1075,573,502
2019,124,Canada,Nepal,15325,7793,7532
2019,840,United States of America,Nepal,114120,55463,58657
1990,800,Uganda,Netherlands,208,112,96
1990,140,Central African Republic,Netherlands,19,10,9
1990,72,Botswana,Netherlands,188,113,75
1990,516,Namibia,Netherlands,763,370,393
1990,710,South Africa,Netherlands,17440,7247,10193
1990,132,Cabo Verde,Netherlands,62,33,29
1990,288,Ghana,Netherlands,131,73,58
1990,430,Liberia,Netherlands,298,159,139
1990,818,Egypt,Netherlands,1068,557,511
1990,434,Libya,Netherlands,3048,1596,1452
1990,48,Bahrain,Netherlands,174,66,108
1990,196,Cyprus,Netherlands,120,52,68
1990,376,Israel,Netherlands,4337,1890,2447
1990,400,Jordan,Netherlands,147,70,77
1990,414,Kuwait,Netherlands,1080,151,929
1990,512,Oman,Netherlands,611,342,269
1990,634,Qatar,Netherlands,407,297,110
1990,792,Turkey,Netherlands,9916,4899,5017
1990,784,United Arab Emirates,Netherlands,1320,491,829
1990,762,Tajikistan,Netherlands,78,35,43
1990,64,Bhutan,Netherlands,9,6,3
1990,344,"China, Hong Kong SAR",Netherlands,683,457,226
1990,392,Japan,Netherlands,749,382,367
1990,96,Brunei Darussalam,Netherlands,247,135,112
1990,116,Cambodia,Netherlands,14,9,5
1990,360,Indonesia,Netherlands,928,585,343
1990,608,Philippines,Netherlands,82,52,30
1990,764,Thailand,Netherlands,151,121,30
1990,28,Antigua and Barbuda,Netherlands,17,8,9
1990,533,Aruba,Netherlands,2096,1074,1022
1990,44,Bahamas,Netherlands,36,18,18
1990,535,"Bonaire, Sint Eustatius and Saba",Netherlands,6705,3417,3288
1990,136,Cayman Islands,Netherlands,11,10,1
1990,212,Dominica,Netherlands,4,2,2
1990,214,Dominican Republic,Netherlands,578,412,166
1990,312,Guadeloupe,Netherlands,318,153,165
1990,630,Puerto Rico,Netherlands,53,25,28
1990,662,Saint Lucia,Netherlands,9,6,3
1990,188,Costa Rica,Netherlands,381,232,149
1990,222,El Salvador,Netherlands,71,47,24
1990,320,Guatemala,Netherlands,83,46,37
1990,340,Honduras,Netherlands,69,49,20
1990,484,Mexico,Netherlands,638,326,312
1990,558,Nicaragua,Netherlands,117,61,56
1990,591,Panama,Netherlands,79,49,30
1990,32,Argentina,Netherlands,943,519,424
1990,68,Bolivia (Plurinational State of),Netherlands,2,2,0
1990,76,Brazil,Netherlands,3535,2155,1380
1990,152,Chile,Netherlands,462,268,194
1990,170,Colombia,Netherlands,425,234,191
1990,218,Ecuador,Netherlands,276,154,122
1990,604,Peru,Netherlands,421,232,189
1990,740,Suriname,Netherlands,1312,708,604
1990,862,Venezuela (Bolivarian Republic of),Netherlands,649,385,264
1990,36,Australia,Netherlands,104866,55141,49725
1990,554,New Zealand,Netherlands,23845,13378,10467
1990,184,Cook Islands,Netherlands,10,8,2
1990,100,Bulgaria,Netherlands,12,8,4
1990,203,Czechia,Netherlands,135,88,47
1990,348,Hungary,Netherlands,181,80,101
1990,616,Poland,Netherlands,1368,852,516
1990,642,Romania,Netherlands,59,29,30
1990,643,Russian Federation,Netherlands,371,182,189
1990,703,Slovakia,Netherlands,11,8,3
1990,208,Denmark,Netherlands,2389,1294,1095
1990,246,Finland,Netherlands,414,308,106
1990,352,Iceland,Netherlands,112,46,66
1990,372,Ireland,Netherlands,1642,849,793
1990,428,Latvia,Netherlands,16,7,9
1990,440,Lithuania,Netherlands,33,20,13
1990,578,Norway,Netherlands,3268,1566,1702
1990,752,Sweden,Netherlands,3561,2075,1486
1990,826,United Kingdom,Netherlands,28913,12098,16815
1990,20,Andorra,Netherlands,190,102,88
1990,191,Croatia,Netherlands,232,80,152
1990,300,Greece,Netherlands,5508,2130,3378
1990,380,Italy,Netherlands,17068,4933,12135
1990,470,Malta,Netherlands,72,38,34
1990,620,Portugal,Netherlands,1823,884,939
1990,688,Serbia,Netherlands,92,51,41
1990,705,Slovenia,Netherlands,261,123,138
1990,724,Spain,Netherlands,13912,6359,7553
1990,40,Austria,Netherlands,4668,2279,2389
1990,56,Belgium,Netherlands,55946,29323,26623
1990,250,France,Netherlands,34420,15813,18607
1990,276,Germany,Netherlands,116092,63164,52928
1990,438,Liechtenstein,Netherlands,40,21,19
1990,442,Luxembourg,Netherlands,3092,1537,1555
1990,756,Switzerland,Netherlands,14877,6619,8258
1990,124,Canada,Netherlands,124373,60548,63825
1990,840,United States of America,Netherlands,96198,44136,52062
1995,800,Uganda,Netherlands,197,103,94
1995,140,Central African Republic,Netherlands,36,19,17
1995,72,Botswana,Netherlands,181,108,73
1995,516,Namibia,Netherlands,729,356,373
1995,710,South Africa,Netherlands,11283,5321,5962
1995,132,Cabo Verde,Netherlands,72,39,33
1995,288,Ghana,Netherlands,131,79,52
1995,430,Liberia,Netherlands,291,152,139
1995,818,Egypt,Netherlands,863,432,431
1995,434,Libya,Netherlands,2158,1090,1068
1995,48,Bahrain,Netherlands,156,70,86
1995,196,Cyprus,Netherlands,170,70,100
1995,376,Israel,Netherlands,4717,2007,2710
1995,400,Jordan,Netherlands,195,94,101
1995,414,Kuwait,Netherlands,729,201,528
1995,512,Oman,Netherlands,780,464,316
1995,634,Qatar,Netherlands,442,330,112
1995,792,Turkey,Netherlands,15095,7476,7619
1995,784,United Arab Emirates,Netherlands,1346,643,703
1995,762,Tajikistan,Netherlands,63,23,40
1995,64,Bhutan,Netherlands,11,8,3
1995,344,"China, Hong Kong SAR",Netherlands,763,509,254
1995,392,Japan,Netherlands,834,401,433
1995,96,Brunei Darussalam,Netherlands,268,147,121
1995,116,Cambodia,Netherlands,37,24,13
1995,360,Indonesia,Netherlands,614,393,221
1995,608,Philippines,Netherlands,110,69,41
1995,764,Thailand,Netherlands,252,200,52
1995,28,Antigua and Barbuda,Netherlands,15,7,8
1995,533,Aruba,Netherlands,2885,1482,1403
1995,44,Bahamas,Netherlands,33,16,17
1995,535,"Bonaire, Sint Eustatius and Saba",Netherlands,6742,3406,3336
1995,136,Cayman Islands,Netherlands,22,19,3
1995,212,Dominica,Netherlands,5,2,3
1995,214,Dominican Republic,Netherlands,642,452,190
1995,312,Guadeloupe,Netherlands,425,200,225
1995,630,Puerto Rico,Netherlands,55,26,29
1995,662,Saint Lucia,Netherlands,11,8,3
1995,188,Costa Rica,Netherlands,332,203,129
1995,222,El Salvador,Netherlands,53,35,18
1995,320,Guatemala,Netherlands,86,47,39
1995,340,Honduras,Netherlands,69,48,21
1995,484,Mexico,Netherlands,870,469,401
1995,558,Nicaragua,Netherlands,93,48,45
1995,591,Panama,Netherlands,90,57,33
1995,32,Argentina,Netherlands,876,477,399
1995,68,Bolivia (Plurinational State of),Netherlands,14,7,7
1995,76,Brazil,Netherlands,3522,2193,1329
1995,152,Chile,Netherlands,551,326,225
1995,170,Colombia,Netherlands,383,220,163
1995,218,Ecuador,Netherlands,310,173,137
1995,604,Peru,Netherlands,423,230,193
1995,740,Suriname,Netherlands,1621,878,743
1995,862,Venezuela (Bolivarian Republic of),Netherlands,628,382,246
1995,36,Australia,Netherlands,100236,52126,48110
1995,554,New Zealand,Netherlands,22794,12589,10205
1995,184,Cook Islands,Netherlands,11,9,2
1995,100,Bulgaria,Netherlands,72,47,25
1995,203,Czechia,Netherlands,203,134,69
1995,348,Hungary,Netherlands,1012,573,439
1995,616,Poland,Netherlands,1170,723,447
1995,642,Romania,Netherlands,165,104,61
1995,643,Russian Federation,Netherlands,376,191,185
1995,703,Slovakia,Netherlands,163,111,52
1995,208,Denmark,Netherlands,3612,2033,1579
1995,246,Finland,Netherlands,515,388,127
1995,352,Iceland,Netherlands,133,56,77
1995,372,Ireland,Netherlands,1728,868,860
1995,428,Latvia,Netherlands,29,21,8
1995,440,Lithuania,Netherlands,37,23,14
1995,578,Norway,Netherlands,3552,1735,1817
1995,752,Sweden,Netherlands,4226,2450,1776
1995,826,United Kingdom,Netherlands,33722,14631,19091
1995,20,Andorra,Netherlands,209,111,98
1995,191,Croatia,Netherlands,250,91,159
1995,300,Greece,Netherlands,4247,1535,2712
1995,380,Italy,Netherlands,13450,4117,9333
1995,470,Malta,Netherlands,85,46,39
1995,620,Portugal,Netherlands,2476,1217,1259
1995,688,Serbia,Netherlands,586,316,270
1995,705,Slovenia,Netherlands,246,121,125
1995,724,Spain,Netherlands,17094,8058,9036
1995,40,Austria,Netherlands,5267,2616,2651
1995,56,Belgium,Netherlands,71295,38456,32839
1995,250,France,Netherlands,35533,16001,19532
1995,276,Germany,Netherlands,111594,59481,52113
1995,438,Liechtenstein,Netherlands,51,26,25
1995,442,Luxembourg,Netherlands,3111,1542,1569
1995,756,Switzerland,Netherlands,15529,7543,7986
1995,124,Canada,Netherlands,119431,57879,61552
1995,840,United States of America,Netherlands,96660,44777,51883
2000,800,Uganda,Netherlands,196,97,99
2000,140,Central African Republic,Netherlands,50,26,24
2000,72,Botswana,Netherlands,193,115,78
2000,516,Namibia,Netherlands,679,333,346
2000,710,South Africa,Netherlands,8450,4725,3725
2000,132,Cabo Verde,Netherlands,82,46,36
2000,288,Ghana,Netherlands,146,82,64
2000,430,Liberia,Netherlands,286,145,141
2000,818,Egypt,Netherlands,726,340,386
2000,434,Libya,Netherlands,1304,626,678
2000,48,Bahrain,Netherlands,140,74,66
2000,196,Cyprus,Netherlands,219,87,132
2000,268,Georgia,Netherlands,12,4,8
2000,376,Israel,Netherlands,4832,2039,2793
2000,400,Jordan,Netherlands,243,120,123
2000,414,Kuwait,Netherlands,662,334,328
2000,512,Oman,Netherlands,730,489,241
2000,634,Qatar,Netherlands,412,315,97
2000,792,Turkey,Netherlands,20329,10065,10264
2000,784,United Arab Emirates,Netherlands,1450,823,627
2000,762,Tajikistan,Netherlands,55,20,35
2000,64,Bhutan,Netherlands,13,9,4
2000,344,"China, Hong Kong SAR",Netherlands,842,560,282
2000,392,Japan,Netherlands,904,418,486
2000,96,Brunei Darussalam,Netherlands,289,160,129
2000,116,Cambodia,Netherlands,59,38,21
2000,360,Indonesia,Netherlands,300,201,99
2000,608,Philippines,Netherlands,229,136,93
2000,764,Thailand,Netherlands,406,320,86
2000,28,Antigua and Barbuda,Netherlands,13,6,7
2000,533,Aruba,Netherlands,3674,1890,1784
2000,44,Bahamas,Netherlands,30,15,15
2000,535,"Bonaire, Sint Eustatius and Saba",Netherlands,6780,3396,3384
2000,136,Cayman Islands,Netherlands,40,34,6
2000,212,Dominica,Netherlands,6,2,4
2000,214,Dominican Republic,Netherlands,706,492,214
2000,312,Guadeloupe,Netherlands,531,247,284
2000,630,Puerto Rico,Netherlands,59,28,31
2000,662,Saint Lucia,Netherlands,16,11,5
2000,188,Costa Rica,Netherlands,448,269,179
2000,222,El Salvador,Netherlands,35,23,12
2000,320,Guatemala,Netherlands,89,49,40
2000,340,Honduras,Netherlands,68,47,21
2000,484,Mexico,Netherlands,1140,634,506
2000,558,Nicaragua,Netherlands,160,75,85
2000,591,Panama,Netherlands,108,68,40
2000,32,Argentina,Netherlands,810,436,374
2000,68,Bolivia (Plurinational State of),Netherlands,26,13,13
2000,76,Brazil,Netherlands,3508,2231,1277
2000,152,Chile,Netherlands,641,377,264
2000,170,Colombia,Netherlands,341,207,134
2000,218,Ecuador,Netherlands,344,192,152
2000,604,Peru,Netherlands,495,266,229
2000,740,Suriname,Netherlands,2002,1084,918
2000,862,Venezuela (Bolivarian Republic of),Netherlands,603,375,228
2000,36,Australia,Netherlands,92790,48415,44375
2000,554,New Zealand,Netherlands,21639,10517,11122
2000,184,Cook Islands,Netherlands,11,9,2
2000,100,Bulgaria,Netherlands,132,86,46
2000,203,Czechia,Netherlands,271,180,91
2000,348,Hungary,Netherlands,1843,1066,777
2000,616,Poland,Netherlands,1001,613,388
2000,642,Romania,Netherlands,279,184,95
2000,643,Russian Federation,Netherlands,368,193,175
2000,703,Slovakia,Netherlands,360,244,116
2000,208,Denmark,Netherlands,4835,2773,2062
2000,246,Finland,Netherlands,615,467,148
2000,352,Iceland,Netherlands,153,65,88
2000,372,Ireland,Netherlands,2765,1433,1332
2000,428,Latvia,Netherlands,42,34,8
2000,440,Lithuania,Netherlands,28,18,10
2000,578,Norway,Netherlands,4108,2090,2018
2000,752,Sweden,Netherlands,4532,2614,1918
2000,826,United Kingdom,Netherlands,39100,17361,21739
2000,20,Andorra,Netherlands,229,121,108
2000,191,Croatia,Netherlands,241,95,146
2000,300,Greece,Netherlands,3056,917,2139
2000,380,Italy,Netherlands,9831,3300,6531
2000,470,Malta,Netherlands,214,115,99
2000,620,Portugal,Netherlands,3231,1605,1626
2000,688,Serbia,Netherlands,797,421,376
2000,705,Slovenia,Netherlands,327,166,161
2000,724,Spain,Netherlands,27629,13466,14163
2000,40,Austria,Netherlands,5865,2952,2913
2000,56,Belgium,Netherlands,84345,45383,38962
2000,250,France,Netherlands,36645,16189,20456
2000,276,Germany,Netherlands,107095,55798,51297
2000,438,Liechtenstein,Netherlands,62,31,31
2000,442,Luxembourg,Netherlands,3163,1566,1597
2000,756,Switzerland,Netherlands,16239,8518,7721
2000,124,Canada,Netherlands,117329,56600,60729
2000,840,United States of America,Netherlands,96971,45414,51557
2005,800,Uganda,Netherlands,189,92,97
2005,120,Cameroon,Netherlands,160,96,64
2005,140,Central African Republic,Netherlands,38,20,18
2005,72,Botswana,Netherlands,370,219,151
2005,516,Namibia,Netherlands,536,261,275
2005,710,South Africa,Netherlands,11117,6000,5117
2005,132,Cabo Verde,Netherlands,59,32,27
2005,288,Ghana,Netherlands,205,120,85
2005,430,Liberia,Netherlands,130,85,45
2005,818,Egypt,Netherlands,864,433,431
2005,434,Libya,Netherlands,1435,822,613
2005,48,Bahrain,Netherlands,169,97,72
2005,196,Cyprus,Netherlands,321,126,195
2005,268,Georgia,Netherlands,11,4,7
2005,376,Israel,Netherlands,4864,2035,2829
2005,400,Jordan,Netherlands,350,194,156
2005,414,Kuwait,Netherlands,640,344,296
2005,512,Oman,Netherlands,594,413,181
2005,634,Qatar,Netherlands,323,228,95
2005,792,Turkey,Netherlands,20949,10133,10816
2005,784,United Arab Emirates,Netherlands,1378,813,565
2005,762,Tajikistan,Netherlands,52,18,34
2005,64,Bhutan,Netherlands,16,11,5
2005,344,"China, Hong Kong SAR",Netherlands,919,596,323
2005,392,Japan,Netherlands,1037,473,564
2005,96,Brunei Darussalam,Netherlands,295,164,131
2005,116,Cambodia,Netherlands,46,30,16
2005,360,Indonesia,Netherlands,3187,2037,1150
2005,608,Philippines,Netherlands,185,111,74
2005,764,Thailand,Netherlands,500,370,130
2005,28,Antigua and Barbuda,Netherlands,14,6,8
2005,533,Aruba,Netherlands,4056,2092,1964
2005,44,Bahamas,Netherlands,40,22,18
2005,535,"Bonaire, Sint Eustatius and Saba",Netherlands,7224,3617,3607
2005,136,Cayman Islands,Netherlands,36,31,5
2005,212,Dominica,Netherlands,7,3,4
2005,214,Dominican Republic,Netherlands,636,429,207
2005,312,Guadeloupe,Netherlands,652,300,352
2005,630,Puerto Rico,Netherlands,46,23,23
2005,662,Saint Lucia,Netherlands,15,11,4
2005,534,Sint Maarten (Dutch part),Netherlands,350,170,180
2005,188,Costa Rica,Netherlands,293,174,119
2005,222,El Salvador,Netherlands,34,22,12
2005,320,Guatemala,Netherlands,106,55,51
2005,340,Honduras,Netherlands,67,46,21
2005,484,Mexico,Netherlands,1044,610,434
2005,558,Nicaragua,Netherlands,232,104,128
2005,591,Panama,Netherlands,253,169,84
2005,32,Argentina,Netherlands,598,326,272
2005,68,Bolivia (Plurinational State of),Netherlands,177,94,83
2005,76,Brazil,Netherlands,3426,2301,1125
2005,152,Chile,Netherlands,962,573,389
2005,170,Colombia,Netherlands,308,194,114
2005,218,Ecuador,Netherlands,406,230,176
2005,604,Peru,Netherlands,582,320,262
2005,740,Suriname,Netherlands,2450,1335,1115
2005,862,Venezuela (Bolivarian Republic of),Netherlands,628,382,246
2005,36,Australia,Netherlands,91620,47295,44325
2005,554,New Zealand,Netherlands,21138,10260,10878
2005,184,Cook Islands,Netherlands,14,11,3
2005,100,Bulgaria,Netherlands,214,142,72
2005,203,Czechia,Netherlands,1330,927,403
2005,348,Hungary,Netherlands,2276,1333,943
2005,616,Poland,Netherlands,1815,1100,715
2005,642,Romania,Netherlands,330,210,120
2005,643,Russian Federation,Netherlands,457,255,202
2005,703,Slovakia,Netherlands,404,276,128
2005,208,Denmark,Netherlands,5694,3270,2424
2005,246,Finland,Netherlands,973,728,245
2005,352,Iceland,Netherlands,228,108,120
2005,372,Ireland,Netherlands,4163,2160,2003
2005,428,Latvia,Netherlands,89,70,19
2005,440,Lithuania,Netherlands,85,55,30
2005,578,Norway,Netherlands,4742,2505,2237
2005,752,Sweden,Netherlands,5922,3398,2524
2005,826,United Kingdom,Netherlands,48075,22199,25876
2005,20,Andorra,Netherlands,260,137,123
2005,191,Croatia,Netherlands,523,236,287
2005,300,Greece,Netherlands,3442,1130,2312
2005,380,Italy,Netherlands,11432,4160,7272
2005,470,Malta,Netherlands,335,180,155
2005,620,Portugal,Netherlands,3666,1861,1805
2005,688,Serbia,Netherlands,787,411,376
2005,705,Slovenia,Netherlands,312,158,154
2005,724,Spain,Netherlands,34862,17708,17154
2005,40,Austria,Netherlands,6556,3222,3334
2005,56,Belgium,Netherlands,101202,53906,47296
2005,250,France,Netherlands,37519,17589,19930
2005,276,Germany,Netherlands,110348,57596,52752
2005,438,Liechtenstein,Netherlands,64,30,34
2005,442,Luxembourg,Netherlands,3027,1498,1529
2005,756,Switzerland,Netherlands,21259,10248,11011
2005,124,Canada,Netherlands,104551,51691,52860
2005,840,United States of America,Netherlands,94293,44437,49856
2010,800,Uganda,Netherlands,190,92,98
2010,120,Cameroon,Netherlands,127,78,49
2010,140,Central African Republic,Netherlands,38,20,18
2010,72,Botswana,Netherlands,548,324,224
2010,516,Namibia,Netherlands,516,252,264
2010,710,South Africa,Netherlands,17414,9369,8045
2010,132,Cabo Verde,Netherlands,36,19,17
2010,288,Ghana,Netherlands,152,85,67
2010,430,Liberia,Netherlands,60,28,32
2010,818,Egypt,Netherlands,932,449,483
2010,434,Libya,Netherlands,1570,907,663
2010,48,Bahrain,Netherlands,236,141,95
2010,196,Cyprus,Netherlands,525,210,315
2010,268,Georgia,Netherlands,11,4,7
2010,376,Israel,Netherlands,4955,2049,2906
2010,400,Jordan,Netherlands,449,259,190
2010,414,Kuwait,Netherlands,778,443,335
2010,512,Oman,Netherlands,556,412,144
2010,634,Qatar,Netherlands,497,376,121
2010,792,Turkey,Netherlands,21587,10190,11397
2010,784,United Arab Emirates,Netherlands,2651,1667,984
2010,762,Tajikistan,Netherlands,51,18,33
2010,64,Bhutan,Netherlands,19,13,6
2010,344,"China, Hong Kong SAR",Netherlands,999,635,364
2010,392,Japan,Netherlands,1099,495,604
2010,96,Brunei Darussalam,Netherlands,301,168,133
2010,116,Cambodia,Netherlands,33,22,11
2010,360,Indonesia,Netherlands,6279,3879,2400
2010,608,Philippines,Netherlands,476,279,197
2010,764,Thailand,Netherlands,630,448,182
2010,28,Antigua and Barbuda,Netherlands,15,7,8
2010,533,Aruba,Netherlands,4358,2252,2106
2010,44,Bahamas,Netherlands,50,29,21
2010,535,"Bonaire, Sint Eustatius and Saba",Netherlands,1859,782,1077
2010,136,Cayman Islands,Netherlands,36,30,6
2010,531,Curaçao,Netherlands,8745,4427,4318
2010,212,Dominica,Netherlands,9,5,4
2010,214,Dominican Republic,Netherlands,562,364,198
2010,312,Guadeloupe,Netherlands,772,352,420
2010,630,Puerto Rico,Netherlands,28,14,14
2010,662,Saint Lucia,Netherlands,13,9,4
2010,534,Sint Maarten (Dutch part),Netherlands,701,341,360
2010,188,Costa Rica,Netherlands,578,345,233
2010,222,El Salvador,Netherlands,32,21,11
2010,320,Guatemala,Netherlands,122,61,61
2010,340,Honduras,Netherlands,65,45,20
2010,484,Mexico,Netherlands,1070,657,413
2010,558,Nicaragua,Netherlands,248,113,135
2010,591,Panama,Netherlands,411,279,132
2010,32,Argentina,Netherlands,386,217,169
2010,68,Bolivia (Plurinational State of),Netherlands,328,176,152
2010,76,Brazil,Netherlands,3295,2336,959
2010,152,Chile,Netherlands,1283,768,515
2010,170,Colombia,Netherlands,329,217,112
2010,218,Ecuador,Netherlands,570,317,253
2010,604,Peru,Netherlands,650,356,294
2010,740,Suriname,Netherlands,2890,1576,1314
2010,862,Venezuela (Bolivarian Republic of),Netherlands,661,392,269
2010,36,Australia,Netherlands,88500,45245,43255
2010,554,New Zealand,Netherlands,21032,10193,10839
2010,184,Cook Islands,Netherlands,17,13,4
2010,100,Bulgaria,Netherlands,286,191,95
2010,203,Czechia,Netherlands,2258,1600,658
2010,348,Hungary,Netherlands,2709,1600,1109
2010,616,Poland,Netherlands,2686,1616,1070
2010,642,Romania,Netherlands,439,273,166
2010,643,Russian Federation,Netherlands,538,312,226
2010,703,Slovakia,Netherlands,453,312,141
2010,208,Denmark,Netherlands,6437,3702,2735
2010,233,Estonia,Netherlands,129,97,32
2010,246,Finland,Netherlands,1608,1162,446
2010,352,Iceland,Netherlands,302,151,151
2010,372,Ireland,Netherlands,4875,2277,2598
2010,428,Latvia,Netherlands,134,103,31
2010,440,Lithuania,Netherlands,131,82,49
2010,578,Norway,Netherlands,7271,3924,3347
2010,752,Sweden,Netherlands,8700,4988,3712
2010,826,United Kingdom,Netherlands,50645,23946,26699
2010,20,Andorra,Netherlands,257,135,122
2010,191,Croatia,Netherlands,804,377,427
2010,300,Greece,Netherlands,3982,1398,2584
2010,380,Italy,Netherlands,13617,5208,8409
2010,470,Malta,Netherlands,347,189,158
2010,499,Montenegro,Netherlands,138,28,110
2010,620,Portugal,Netherlands,3493,1812,1681
2010,688,Serbia,Netherlands,770,402,368
2010,705,Slovenia,Netherlands,385,207,178
2010,724,Spain,Netherlands,46634,24122,22512
2010,40,Austria,Netherlands,7247,3493,3754
2010,56,Belgium,Netherlands,124810,62021,62789
2010,250,France,Netherlands,41166,18894,22272
2010,276,Germany,Netherlands,112693,58743,53950
2010,438,Liechtenstein,Netherlands,68,29,39
2010,442,Luxembourg,Netherlands,2926,1447,1479
2010,756,Switzerland,Netherlands,21455,10122,11333
2010,124,Canada,Netherlands,98510,50262,48248
2010,840,United States of America,Netherlands,94442,43821,50621
2015,800,Uganda,Netherlands,191,92,99
2015,120,Cameroon,Netherlands,162,91,71
2015,140,Central African Republic,Netherlands,33,17,16
2015,72,Botswana,Netherlands,598,354,244
2015,516,Namibia,Netherlands,505,248,257
2015,710,South Africa,Netherlands,31411,16161,15250
2015,132,Cabo Verde,Netherlands,37,19,18
2015,288,Ghana,Netherlands,187,105,82
2015,324,Guinea,Netherlands,38,26,12
2015,430,Liberia,Netherlands,68,31,37
2015,818,Egypt,Netherlands,691,380,311
2015,434,Libya,Netherlands,1770,1013,757
2015,48,Bahrain,Netherlands,213,126,87
2015,196,Cyprus,Netherlands,504,204,300
2015,268,Georgia,Netherlands,11,4,7
2015,376,Israel,Netherlands,5110,2098,3012
2015,400,Jordan,Netherlands,193,94,99
2015,414,Kuwait,Netherlands,980,500,480
2015,512,Oman,Netherlands,1264,986,278
2015,634,Qatar,Netherlands,450,348,102
2015,792,Turkey,Netherlands,21913,10082,11831
2015,784,United Arab Emirates,Netherlands,2896,1779,1117
2015,762,Tajikistan,Netherlands,50,18,32
2015,64,Bhutan,Netherlands,20,14,6
2015,344,"China, Hong Kong SAR",Netherlands,1020,634,386
2015,392,Japan,Netherlands,1046,468,578
2015,96,Brunei Darussalam,Netherlands,307,172,135
2015,116,Cambodia,Netherlands,30,20,10
2015,360,Indonesia,Netherlands,6950,4351,2599
2015,608,Philippines,Netherlands,483,284,199
2015,764,Thailand,Netherlands,681,484,197
2015,28,Antigua and Barbuda,Netherlands,16,7,9
2015,533,Aruba,Netherlands,4585,2369,2216
2015,44,Bahamas,Netherlands,54,31,23
2015,535,"Bonaire, Sint Eustatius and Saba",Netherlands,2114,889,1225
2015,136,Cayman Islands,Netherlands,38,33,5
2015,531,Curaçao,Netherlands,9504,4819,4685
2015,212,Dominica,Netherlands,10,5,5
2015,214,Dominican Republic,Netherlands,593,384,209
2015,312,Guadeloupe,Netherlands,801,361,440
2015,630,Puerto Rico,Netherlands,27,13,14
2015,662,Saint Lucia,Netherlands,12,9,3
2015,534,Sint Maarten (Dutch part),Netherlands,730,354,376
2015,188,Costa Rica,Netherlands,586,348,238
2015,222,El Salvador,Netherlands,33,22,11
2015,320,Guatemala,Netherlands,140,71,69
2015,340,Honduras,Netherlands,91,64,27
2015,484,Mexico,Netherlands,1328,904,424
2015,558,Nicaragua,Netherlands,267,123,144
2015,591,Panama,Netherlands,482,327,155
2015,32,Argentina,Netherlands,387,217,170
2015,68,Bolivia (Plurinational State of),Netherlands,382,205,177
2015,76,Brazil,Netherlands,3968,2813,1155
2015,152,Chile,Netherlands,1943,1147,796
2015,170,Colombia,Netherlands,368,244,124
2015,218,Ecuador,Netherlands,829,459,370
2015,604,Peru,Netherlands,691,387,304
2015,740,Suriname,Netherlands,3138,1713,1425
2015,862,Venezuela (Bolivarian Republic of),Netherlands,690,407,283
2015,36,Australia,Netherlands,80620,41362,39258
2015,554,New Zealand,Netherlands,20589,9957,10632
2015,184,Cook Islands,Netherlands,15,12,3
2015,100,Bulgaria,Netherlands,1040,597,443
2015,203,Czechia,Netherlands,2593,1839,754
2015,348,Hungary,Netherlands,3289,1919,1370
2015,616,Poland,Netherlands,2589,1577,1012
2015,642,Romania,Netherlands,198,119,79
2015,643,Russian Federation,Netherlands,548,316,232
2015,703,Slovakia,Netherlands,585,414,171
2015,208,Denmark,Netherlands,7437,4265,3172
2015,233,Estonia,Netherlands,201,149,52
2015,246,Finland,Netherlands,1784,1303,481
2015,352,Iceland,Netherlands,288,152,136
2015,372,Ireland,Netherlands,4980,2293,2687
2015,428,Latvia,Netherlands,135,92,43
2015,440,Lithuania,Netherlands,166,107,59
2015,578,Norway,Netherlands,8686,4771,3915
2015,752,Sweden,Netherlands,10656,6090,4566
2015,826,United Kingdom,Netherlands,64767,29611,35156
2015,20,Andorra,Netherlands,244,134,110
2015,191,Croatia,Netherlands,809,378,431
2015,300,Greece,Netherlands,3737,1209,2528
2015,380,Italy,Netherlands,12795,4910,7885
2015,470,Malta,Netherlands,589,340,249
2015,499,Montenegro,Netherlands,155,32,123
2015,620,Portugal,Netherlands,3960,1956,2004
2015,688,Serbia,Netherlands,752,392,360
2015,705,Slovenia,Netherlands,325,186,139
2015,724,Spain,Netherlands,46711,24290,22421
2015,40,Austria,Netherlands,8476,4109,4367
2015,56,Belgium,Netherlands,128544,63812,64732
2015,250,France,Netherlands,40459,18948,21511
2015,276,Germany,Netherlands,117420,61075,56345
2015,438,Liechtenstein,Netherlands,75,33,42
2015,442,Luxembourg,Netherlands,4463,2242,2221
2015,756,Switzerland,Netherlands,23056,11063,11993
2015,124,Canada,Netherlands,87932,44883,43049
2015,840,United States of America,Netherlands,92801,42805,49996
2019,800,Uganda,Netherlands,191,92,99
2019,120,Cameroon,Netherlands,161,91,70
2019,140,Central African Republic,Netherlands,36,19,17
2019,72,Botswana,Netherlands,640,379,261
2019,516,Namibia,Netherlands,534,262,272
2019,710,South Africa,Netherlands,35207,18131,17076
2019,132,Cabo Verde,Netherlands,38,20,18
2019,288,Ghana,Netherlands,210,118,92
2019,324,Guinea,Netherlands,36,25,11
2019,430,Liberia,Netherlands,56,26,30
2019,818,Egypt,Netherlands,984,489,495
2019,434,Libya,Netherlands,1878,1075,803
2019,48,Bahrain,Netherlands,224,133,91
2019,196,Cyprus,Netherlands,503,207,296
2019,268,Georgia,Netherlands,11,4,7
2019,376,Israel,Netherlands,4969,2040,2929
2019,400,Jordan,Netherlands,207,101,106
2019,414,Kuwait,Netherlands,1037,529,508
2019,512,Oman,Netherlands,1556,1214,342
2019,634,Qatar,Netherlands,458,347,111
2019,792,Turkey,Netherlands,29630,13792,15838
2019,784,United Arab Emirates,Netherlands,3110,1911,1199
2019,762,Tajikistan,Netherlands,49,18,31
2019,64,Bhutan,Netherlands,20,14,6
2019,344,"China, Hong Kong SAR",Netherlands,1321,806,515
2019,392,Japan,Netherlands,1170,524,646
2019,96,Brunei Darussalam,Netherlands,330,185,145
2019,116,Cambodia,Netherlands,31,21,10
2019,360,Indonesia,Netherlands,7258,4544,2714
2019,608,Philippines,Netherlands,498,293,205
2019,764,Thailand,Netherlands,710,505,205
2019,28,Antigua and Barbuda,Netherlands,16,7,9
2019,533,Aruba,Netherlands,4638,2397,2241
2019,44,Bahamas,Netherlands,57,33,24
2019,535,"Bonaire, Sint Eustatius and Saba",Netherlands,2517,1059,1458
2019,136,Cayman Islands,Netherlands,41,36,5
2019,531,Curaçao,Netherlands,9830,4988,4842
2019,212,Dominica,Netherlands,10,5,5
2019,214,Dominican Republic,Netherlands,612,397,215
2019,312,Guadeloupe,Netherlands,813,367,446
2019,630,Puerto Rico,Netherlands,25,12,13
2019,662,Saint Lucia,Netherlands,11,9,2
2019,534,Sint Maarten (Dutch part),Netherlands,755,366,389
2019,188,Costa Rica,Netherlands,594,355,239
2019,222,El Salvador,Netherlands,33,22,11
2019,320,Guatemala,Netherlands,143,73,70
2019,340,Honduras,Netherlands,92,65,27
2019,484,Mexico,Netherlands,1369,932,437
2019,558,Nicaragua,Netherlands,279,129,150
2019,591,Panama,Netherlands,512,348,164
2019,32,Argentina,Netherlands,393,220,173
2019,68,Bolivia (Plurinational State of),Netherlands,417,224,193
2019,76,Brazil,Netherlands,4468,3168,1300
2019,152,Chile,Netherlands,2595,1473,1122
2019,170,Colombia,Netherlands,376,250,126
2019,218,Ecuador,Netherlands,816,452,364
2019,604,Peru,Netherlands,823,476,347
2019,740,Suriname,Netherlands,3358,1835,1523
2019,862,Venezuela (Bolivarian Republic of),Netherlands,675,397,278
2019,36,Australia,Netherlands,82100,41923,40177
2019,554,New Zealand,Netherlands,21163,10235,10928
2019,184,Cook Islands,Netherlands,15,12,3
2019,100,Bulgaria,Netherlands,1522,853,669
2019,203,Czechia,Netherlands,2735,1941,794
2019,348,Hungary,Netherlands,3750,2151,1599
2019,616,Poland,Netherlands,2741,1711,1030
2019,642,Romania,Netherlands,975,631,344
2019,643,Russian Federation,Netherlands,547,316,231
2019,703,Slovakia,Netherlands,684,487,197
2019,208,Denmark,Netherlands,8196,4640,3556
2019,233,Estonia,Netherlands,252,192,60
2019,246,Finland,Netherlands,2079,1509,570
2019,352,Iceland,Netherlands,358,192,166
2019,372,Ireland,Netherlands,5467,2527,2940
2019,428,Latvia,Netherlands,134,94,40
2019,440,Lithuania,Netherlands,205,144,61
2019,578,Norway,Netherlands,9547,5248,4299
2019,752,Sweden,Netherlands,12671,7136,5535
2019,826,United Kingdom,Netherlands,73549,33727,39822
2019,20,Andorra,Netherlands,260,144,116
2019,191,Croatia,Netherlands,746,347,399
2019,300,Greece,Netherlands,3649,1274,2375
2019,380,Italy,Netherlands,13267,5127,8140
2019,470,Malta,Netherlands,950,551,399
2019,499,Montenegro,Netherlands,155,33,122
2019,620,Portugal,Netherlands,4027,1994,2033
2019,688,Serbia,Netherlands,763,398,365
2019,705,Slovenia,Netherlands,334,192,142
2019,724,Spain,Netherlands,48248,24803,23445
2019,40,Austria,Netherlands,10005,4939,5066
2019,56,Belgium,Netherlands,137062,68493,68569
2019,250,France,Netherlands,42826,20005,22821
2019,276,Germany,Netherlands,137846,76544,61302
2019,438,Liechtenstein,Netherlands,83,36,47
2019,442,Luxembourg,Netherlands,4476,2396,2080
2019,756,Switzerland,Netherlands,23934,11640,12294
2019,124,Canada,Netherlands,94229,48098,46131
2019,840,United States of America,Netherlands,100216,45646,54570
1990,152,Chile,New Caledonia,3,1,2
1990,36,Australia,New Caledonia,1190,495,695
1990,90,Solomon Islands,New Caledonia,129,62,67
1990,548,Vanuatu,New Caledonia,163,66,97
1990,258,French Polynesia,New Caledonia,1745,830,915
1990,876,Wallis and Futuna Islands,New Caledonia,843,433,410
1990,372,Ireland,New Caledonia,1,0,1
1990,826,United Kingdom,New Caledonia,19,13,6
1990,124,Canada,New Caledonia,58,28,30
1995,68,Bolivia (Plurinational State of),New Caledonia,1,1,0
1995,152,Chile,New Caledonia,3,2,1
1995,36,Australia,New Caledonia,1252,522,730
1995,90,Solomon Islands,New Caledonia,128,61,67
1995,548,Vanuatu,New Caledonia,161,85,76
1995,258,French Polynesia,New Caledonia,1916,886,1030
1995,876,Wallis and Futuna Islands,New Caledonia,975,495,480
1995,372,Ireland,New Caledonia,4,2,2
1995,826,United Kingdom,New Caledonia,78,41,37
1995,124,Canada,New Caledonia,85,41,44
2000,68,Bolivia (Plurinational State of),New Caledonia,1,1,0
2000,152,Chile,New Caledonia,4,2,2
2000,36,Australia,New Caledonia,1210,509,701
2000,90,Solomon Islands,New Caledonia,122,58,64
2000,548,Vanuatu,New Caledonia,146,74,72
2000,258,French Polynesia,New Caledonia,2049,925,1124
2000,876,Wallis and Futuna Islands,New Caledonia,1152,578,574
2000,372,Ireland,New Caledonia,8,5,3
2000,826,United Kingdom,New Caledonia,139,69,70
2000,124,Canada,New Caledonia,114,55,59
2005,68,Bolivia (Plurinational State of),New Caledonia,1,1,0
2005,152,Chile,New Caledonia,6,4,2
2005,36,Australia,New Caledonia,1260,552,708
2005,90,Solomon Islands,New Caledonia,76,38,38
2005,548,Vanuatu,New Caledonia,197,99,98
2005,258,French Polynesia,New Caledonia,2232,1063,1169
2005,876,Wallis and Futuna Islands,New Caledonia,1207,609,598
2005,372,Ireland,New Caledonia,8,4,4
2005,826,United Kingdom,New Caledonia,119,60,59
2005,124,Canada,New Caledonia,119,60,59
2010,152,Chile,New Caledonia,8,5,3
2010,36,Australia,New Caledonia,1460,676,784
2010,90,Solomon Islands,New Caledonia,36,21,15
2010,548,Vanuatu,New Caledonia,242,121,121
2010,258,French Polynesia,New Caledonia,2235,1143,1092
2010,876,Wallis and Futuna Islands,New Caledonia,713,357,356
2010,372,Ireland,New Caledonia,7,3,4
2010,826,United Kingdom,New Caledonia,125,65,60
2010,124,Canada,New Caledonia,85,45,40
2015,152,Chile,New Caledonia,12,8,4
2015,36,Australia,New Caledonia,1560,693,867
2015,90,Solomon Islands,New Caledonia,33,19,14
2015,548,Vanuatu,New Caledonia,251,125,126
2015,258,French Polynesia,New Caledonia,2123,1085,1038
2015,876,Wallis and Futuna Islands,New Caledonia,187,93,94
2015,372,Ireland,New Caledonia,7,3,4
2015,826,United Kingdom,New Caledonia,159,80,79
2015,124,Canada,New Caledonia,218,109,109
2019,152,Chile,New Caledonia,16,11,5
2019,36,Australia,New Caledonia,1724,781,943
2019,90,Solomon Islands,New Caledonia,32,19,13
2019,548,Vanuatu,New Caledonia,255,127,128
2019,258,French Polynesia,New Caledonia,2204,1127,1077
2019,876,Wallis and Futuna Islands,New Caledonia,182,88,94
2019,372,Ireland,New Caledonia,7,3,4
2019,826,United Kingdom,New Caledonia,180,91,89
2019,124,Canada,New Caledonia,233,117,116
1990,748,Eswatini,New Zealand,4,4,0
1990,516,Namibia,New Zealand,74,43,31
1990,710,South Africa,New Zealand,1402,576,826
1990,818,Egypt,New Zealand,114,74,40
1990,196,Cyprus,New Zealand,23,9,14
1990,400,Jordan,New Zealand,28,16,12
1990,792,Turkey,New Zealand,70,31,39
1990,762,Tajikistan,New Zealand,166,74,92
1990,64,Bhutan,New Zealand,11,7,4
1990,462,Maldives,New Zealand,6,3,3
1990,144,Sri Lanka,New Zealand,1,1,0
1990,344,"China, Hong Kong SAR",New Zealand,1506,1010,496
1990,392,Japan,New Zealand,1275,650,625
1990,410,Republic of Korea,New Zealand,39,22,17
1990,96,Brunei Darussalam,New Zealand,119,68,51
1990,458,Malaysia,New Zealand,746,329,417
1990,608,Philippines,New Zealand,117,69,48
1990,702,Singapore,New Zealand,1131,625,506
1990,764,Thailand,New Zealand,2439,1011,1428
1990,626,Timor-Leste,New Zealand,139,75,64
1990,28,Antigua and Barbuda,New Zealand,3,1,2
1990,44,Bahamas,New Zealand,14,6,8
1990,535,"Bonaire, Sint Eustatius and Saba",New Zealand,3,1,2
1990,136,Cayman Islands,New Zealand,17,12,5
1990,662,Saint Lucia,New Zealand,1,1,0
1990,188,Costa Rica,New Zealand,14,4,10
1990,484,Mexico,New Zealand,35,23,12
1990,591,Panama,New Zealand,17,9,8
1990,32,Argentina,New Zealand,24,13,11
1990,68,Bolivia (Plurinational State of),New Zealand,34,11,23
1990,152,Chile,New Zealand,105,56,49
1990,170,Colombia,New Zealand,48,25,23
1990,218,Ecuador,New Zealand,38,16,22
1990,238,Falkland Islands (Malvinas),New Zealand,37,20,17
1990,604,Peru,New Zealand,58,27,31
1990,862,Venezuela (Bolivarian Republic of),New Zealand,16,8,8
1990,36,Australia,New Zealand,298309,153968,144341
1990,242,Fiji,New Zealand,1211,620,591
1990,540,New Caledonia,New Zealand,98,50,48
1990,598,Papua New Guinea,New Zealand,2540,1421,1119
1990,90,Solomon Islands,New Zealand,141,75,66
1990,548,Vanuatu,New Zealand,154,86,68
1990,296,Kiribati,New Zealand,42,28,14
1990,520,Nauru,New Zealand,32,21,11
1990,16,American Samoa,New Zealand,237,124,113
1990,184,Cook Islands,New Zealand,2155,1172,983
1990,258,French Polynesia,New Zealand,99,53,46
1990,570,Niue,New Zealand,233,113,120
1990,882,Samoa,New Zealand,1041,517,524
1990,772,Tokelau,New Zealand,103,48,55
1990,100,Bulgaria,New Zealand,5,3,2
1990,203,Czechia,New Zealand,9,6,3
1990,616,Poland,New Zealand,71,41,30
1990,643,Russian Federation,New Zealand,196,96,100
1990,703,Slovakia,New Zealand,1,1,0
1990,208,Denmark,New Zealand,309,155,154
1990,246,Finland,New Zealand,36,16,20
1990,352,Iceland,New Zealand,86,24,62
1990,372,Ireland,New Zealand,192,94,98
1990,833,Isle of Man,New Zealand,48,28,20
1990,428,Latvia,New Zealand,5,4,1
1990,578,Norway,New Zealand,266,114,152
1990,752,Sweden,New Zealand,499,330,169
1990,826,United Kingdom,New Zealand,40222,18887,21335
1990,191,Croatia,New Zealand,82,27,55
1990,300,Greece,New Zealand,567,296,271
1990,380,Italy,New Zealand,88,30,58
1990,470,Malta,New Zealand,9,3,6
1990,620,Portugal,New Zealand,13,6,7
1990,688,Serbia,New Zealand,2,1,1
1990,724,Spain,New Zealand,128,58,70
1990,40,Austria,New Zealand,244,132,112
1990,56,Belgium,New Zealand,219,121,98
1990,250,France,New Zealand,1221,606,615
1990,276,Germany,New Zealand,916,445,471
1990,442,Luxembourg,New Zealand,23,15,8
1990,528,Netherlands,New Zealand,2833,1469,1364
1990,756,Switzerland,New Zealand,1017,503,514
1990,124,Canada,New Zealand,7182,3496,3686
1990,840,United States of America,New Zealand,15415,5964,9451
1995,748,Eswatini,New Zealand,2,2,0
1995,516,Namibia,New Zealand,70,41,29
1995,710,South Africa,New Zealand,1181,566,615
1995,818,Egypt,New Zealand,88,57,31
1995,196,Cyprus,New Zealand,33,12,21
1995,400,Jordan,New Zealand,53,27,26
1995,792,Turkey,New Zealand,169,71,98
1995,762,Tajikistan,New Zealand,135,63,72
1995,64,Bhutan,New Zealand,13,8,5
1995,462,Maldives,New Zealand,8,4,4
1995,144,Sri Lanka,New Zealand,13,11,2
1995,344,"China, Hong Kong SAR",New Zealand,1681,1124,557
1995,392,Japan,New Zealand,2094,1005,1089
1995,410,Republic of Korea,New Zealand,558,308,250
1995,96,Brunei Darussalam,New Zealand,156,90,66
1995,458,Malaysia,New Zealand,853,378,475
1995,608,Philippines,New Zealand,157,92,65
1995,702,Singapore,New Zealand,1389,761,628
1995,764,Thailand,New Zealand,2194,974,1220
1995,626,Timor-Leste,New Zealand,151,81,70
1995,28,Antigua and Barbuda,New Zealand,7,3,4
1995,44,Bahamas,New Zealand,16,7,9
1995,535,"Bonaire, Sint Eustatius and Saba",New Zealand,7,4,3
1995,136,Cayman Islands,New Zealand,33,22,11
1995,188,Costa Rica,New Zealand,11,3,8
1995,484,Mexico,New Zealand,70,40,30
1995,591,Panama,New Zealand,24,13,11
1995,32,Argentina,New Zealand,23,12,11
1995,68,Bolivia (Plurinational State of),New Zealand,35,18,17
1995,152,Chile,New Zealand,122,65,57
1995,170,Colombia,New Zealand,47,24,23
1995,218,Ecuador,New Zealand,43,18,25
1995,238,Falkland Islands (Malvinas),New Zealand,49,29,20
1995,604,Peru,New Zealand,59,27,32
1995,862,Venezuela (Bolivarian Republic of),New Zealand,15,7,8
1995,36,Australia,New Zealand,310921,159309,151612
1995,242,Fiji,New Zealand,1045,538,507
1995,540,New Caledonia,New Zealand,113,57,56
1995,598,Papua New Guinea,New Zealand,2602,1496,1106
1995,90,Solomon Islands,New Zealand,140,74,66
1995,548,Vanuatu,New Zealand,165,87,78
1995,296,Kiribati,New Zealand,38,24,14
1995,520,Nauru,New Zealand,29,19,10
1995,16,American Samoa,New Zealand,233,121,112
1995,184,Cook Islands,New Zealand,2234,1214,1020
1995,258,French Polynesia,New Zealand,108,56,52
1995,570,Niue,New Zealand,192,99,93
1995,882,Samoa,New Zealand,1468,724,744
1995,772,Tokelau,New Zealand,103,49,54
1995,100,Bulgaria,New Zealand,9,5,4
1995,203,Czechia,New Zealand,13,9,4
1995,348,Hungary,New Zealand,61,33,28
1995,616,Poland,New Zealand,60,34,26
1995,643,Russian Federation,New Zealand,191,101,90
1995,703,Slovakia,New Zealand,10,7,3
1995,208,Denmark,New Zealand,427,245,182
1995,246,Finland,New Zealand,54,33,21
1995,352,Iceland,New Zealand,62,18,44
1995,372,Ireland,New Zealand,680,323,357
1995,833,Isle of Man,New Zealand,55,32,23
1995,428,Latvia,New Zealand,8,7,1
1995,578,Norway,New Zealand,305,130,175
1995,752,Sweden,New Zealand,593,391,202
1995,826,United Kingdom,New Zealand,47883,22696,25187
1995,191,Croatia,New Zealand,72,26,46
1995,300,Greece,New Zealand,530,242,288
1995,380,Italy,New Zealand,258,97,161
1995,470,Malta,New Zealand,11,4,7
1995,620,Portugal,New Zealand,29,13,16
1995,688,Serbia,New Zealand,18,11,7
1995,724,Spain,New Zealand,175,83,92
1995,40,Austria,New Zealand,275,151,124
1995,56,Belgium,New Zealand,217,119,98
1995,250,France,New Zealand,1261,615,646
1995,276,Germany,New Zealand,1178,559,619
1995,442,Luxembourg,New Zealand,21,14,7
1995,528,Netherlands,New Zealand,2968,1514,1454
1995,756,Switzerland,New Zealand,1139,605,534
1995,124,Canada,New Zealand,8186,3964,4222
1995,840,United States of America,New Zealand,19399,7623,11776
2000,748,Eswatini,New Zealand,5,4,1
2000,516,Namibia,New Zealand,67,39,28
2000,710,South Africa,New Zealand,1314,700,614
2000,818,Egypt,New Zealand,68,44,24
2000,196,Cyprus,New Zealand,42,15,27
2000,400,Jordan,New Zealand,77,37,40
2000,792,Turkey,New Zealand,270,112,158
2000,762,Tajikistan,New Zealand,117,56,61
2000,64,Bhutan,New Zealand,15,9,6
2000,462,Maldives,New Zealand,10,5,5
2000,144,Sri Lanka,New Zealand,27,19,8
2000,344,"China, Hong Kong SAR",New Zealand,1856,1238,618
2000,392,Japan,New Zealand,3264,1508,1756
2000,410,Republic of Korea,New Zealand,1256,708,548
2000,96,Brunei Darussalam,New Zealand,192,111,81
2000,458,Malaysia,New Zealand,1204,531,673
2000,608,Philippines,New Zealand,105,62,43
2000,702,Singapore,New Zealand,1783,959,824
2000,764,Thailand,New Zealand,2403,1109,1294
2000,626,Timor-Leste,New Zealand,165,88,77
2000,28,Antigua and Barbuda,New Zealand,10,5,5
2000,44,Bahamas,New Zealand,19,9,10
2000,535,"Bonaire, Sint Eustatius and Saba",New Zealand,11,6,5
2000,136,Cayman Islands,New Zealand,58,39,19
2000,662,Saint Lucia,New Zealand,1,1,0
2000,188,Costa Rica,New Zealand,13,3,10
2000,484,Mexico,New Zealand,110,60,50
2000,591,Panama,New Zealand,33,18,15
2000,32,Argentina,New Zealand,22,11,11
2000,68,Bolivia (Plurinational State of),New Zealand,35,25,10
2000,152,Chile,New Zealand,139,73,66
2000,170,Colombia,New Zealand,46,24,22
2000,218,Ecuador,New Zealand,47,20,27
2000,238,Falkland Islands (Malvinas),New Zealand,52,31,21
2000,604,Peru,New Zealand,69,31,38
2000,862,Venezuela (Bolivarian Republic of),New Zealand,15,7,8
2000,36,Australia,New Zealand,365060,186460,178600
2000,242,Fiji,New Zealand,870,448,422
2000,540,New Caledonia,New Zealand,129,64,65
2000,598,Papua New Guinea,New Zealand,1948,1171,777
2000,90,Solomon Islands,New Zealand,134,71,63
2000,548,Vanuatu,New Zealand,173,87,86
2000,296,Kiribati,New Zealand,35,21,14
2000,520,Nauru,New Zealand,27,18,9
2000,16,American Samoa,New Zealand,229,118,111
2000,184,Cook Islands,New Zealand,2319,1258,1061
2000,258,French Polynesia,New Zealand,116,59,57
2000,570,Niue,New Zealand,152,86,66
2000,882,Samoa,New Zealand,1885,920,965
2000,772,Tokelau,New Zealand,94,38,56
2000,100,Bulgaria,New Zealand,12,7,5
2000,203,Czechia,New Zealand,17,12,5
2000,348,Hungary,New Zealand,121,66,55
2000,616,Poland,New Zealand,52,29,23
2000,643,Russian Federation,New Zealand,180,103,77
2000,703,Slovakia,New Zealand,22,15,7
2000,208,Denmark,New Zealand,545,335,210
2000,246,Finland,New Zealand,72,51,21
2000,352,Iceland,New Zealand,37,12,25
2000,372,Ireland,New Zealand,1542,757,785
2000,833,Isle of Man,New Zealand,61,36,25
2000,428,Latvia,New Zealand,11,10,1
2000,578,Norway,New Zealand,316,141,175
2000,752,Sweden,New Zealand,636,417,219
2000,826,United Kingdom,New Zealand,56350,26822,29528
2000,191,Croatia,New Zealand,55,24,31
2000,300,Greece,New Zealand,501,186,315
2000,380,Italy,New Zealand,428,164,264
2000,470,Malta,New Zealand,13,5,8
2000,620,Portugal,New Zealand,47,20,27
2000,688,Serbia,New Zealand,25,14,11
2000,724,Spain,New Zealand,298,146,152
2000,40,Austria,New Zealand,306,170,136
2000,56,Belgium,New Zealand,210,116,94
2000,250,France,New Zealand,1300,623,677
2000,276,Germany,New Zealand,1439,672,767
2000,442,Luxembourg,New Zealand,20,13,7
2000,528,Netherlands,New Zealand,3210,1609,1601
2000,756,Switzerland,New Zealand,1267,712,555
2000,124,Canada,New Zealand,9384,4527,4857
2000,840,United States of America,New Zealand,23452,9327,14125
2005,748,Eswatini,New Zealand,13,9,4
2005,516,Namibia,New Zealand,52,30,22
2005,710,South Africa,New Zealand,1729,884,845
2005,818,Egypt,New Zealand,81,54,27
2005,196,Cyprus,New Zealand,62,23,39
2005,400,Jordan,New Zealand,112,61,51
2005,792,Turkey,New Zealand,278,112,166
2005,762,Tajikistan,New Zealand,112,53,59
2005,64,Bhutan,New Zealand,19,12,7
2005,462,Maldives,New Zealand,13,7,6
2005,144,Sri Lanka,New Zealand,54,26,28
2005,344,"China, Hong Kong SAR",New Zealand,2026,1317,709
2005,392,Japan,New Zealand,3065,1396,1669
2005,410,Republic of Korea,New Zealand,1268,916,352
2005,96,Brunei Darussalam,New Zealand,196,114,82
2005,458,Malaysia,New Zealand,1614,756,858
2005,608,Philippines,New Zealand,84,50,34
2005,702,Singapore,New Zealand,2514,1330,1184
2005,764,Thailand,New Zealand,1963,896,1067
2005,626,Timor-Leste,New Zealand,175,98,77
2005,28,Antigua and Barbuda,New Zealand,11,5,6
2005,44,Bahamas,New Zealand,21,8,13
2005,535,"Bonaire, Sint Eustatius and Saba",New Zealand,11,6,5
2005,136,Cayman Islands,New Zealand,53,35,18
2005,662,Saint Lucia,New Zealand,1,1,0
2005,188,Costa Rica,New Zealand,9,2,7
2005,484,Mexico,New Zealand,100,56,44
2005,591,Panama,New Zealand,37,24,13
2005,32,Argentina,New Zealand,17,9,8
2005,68,Bolivia (Plurinational State of),New Zealand,45,28,17
2005,152,Chile,New Zealand,208,111,97
2005,170,Colombia,New Zealand,43,23,20
2005,218,Ecuador,New Zealand,55,24,31
2005,238,Falkland Islands (Malvinas),New Zealand,73,42,31
2005,604,Peru,New Zealand,81,36,45
2005,862,Venezuela (Bolivarian Republic of),New Zealand,15,7,8
2005,36,Australia,New Zealand,423550,216840,206710
2005,242,Fiji,New Zealand,548,289,259
2005,540,New Caledonia,New Zealand,137,68,69
2005,598,Papua New Guinea,New Zealand,2068,1354,714
2005,90,Solomon Islands,New Zealand,103,56,47
2005,548,Vanuatu,New Zealand,251,126,125
2005,296,Kiribati,New Zealand,44,28,16
2005,520,Nauru,New Zealand,25,17,8
2005,16,American Samoa,New Zealand,478,244,234
2005,184,Cook Islands,New Zealand,2329,1204,1125
2005,258,French Polynesia,New Zealand,121,62,59
2005,570,Niue,New Zealand,160,89,71
2005,882,Samoa,New Zealand,1775,856,919
2005,772,Tokelau,New Zealand,94,35,59
2005,100,Bulgaria,New Zealand,17,10,7
2005,203,Czechia,New Zealand,68,49,19
2005,348,Hungary,New Zealand,149,82,67
2005,616,Poland,New Zealand,79,45,34
2005,643,Russian Federation,New Zealand,133,76,57
2005,703,Slovakia,New Zealand,25,17,8
2005,208,Denmark,New Zealand,648,394,254
2005,246,Finland,New Zealand,129,97,32
2005,352,Iceland,New Zealand,43,17,26
2005,372,Ireland,New Zealand,2051,1095,956
2005,833,Isle of Man,New Zealand,76,43,33
2005,428,Latvia,New Zealand,12,10,2
2005,578,Norway,New Zealand,365,184,181
2005,752,Sweden,New Zealand,819,569,250
2005,826,United Kingdom,New Zealand,55844,27158,28686
2005,191,Croatia,New Zealand,85,39,46
2005,300,Greece,New Zealand,502,182,320
2005,380,Italy,New Zealand,665,278,387
2005,470,Malta,New Zealand,17,6,11
2005,620,Portugal,New Zealand,46,19,27
2005,688,Serbia,New Zealand,25,14,11
2005,724,Spain,New Zealand,516,296,220
2005,40,Austria,New Zealand,343,187,156
2005,56,Belgium,New Zealand,302,160,142
2005,250,France,New Zealand,1566,803,763
2005,276,Germany,New Zealand,2087,1134,953
2005,442,Luxembourg,New Zealand,17,12,5
2005,528,Netherlands,New Zealand,3701,1809,1892
2005,756,Switzerland,New Zealand,1423,772,651
2005,124,Canada,New Zealand,10167,5248,4919
2005,840,United States of America,New Zealand,26243,10524,15719
2010,748,Eswatini,New Zealand,21,14,7
2010,516,Namibia,New Zealand,50,29,21
2010,710,South Africa,New Zealand,2708,1381,1327
2010,818,Egypt,New Zealand,87,57,30
2010,196,Cyprus,New Zealand,101,38,63
2010,400,Jordan,New Zealand,144,82,62
2010,792,Turkey,New Zealand,286,112,174
2010,762,Tajikistan,New Zealand,111,53,58
2010,64,Bhutan,New Zealand,23,15,8
2010,462,Maldives,New Zealand,15,11,4
2010,144,Sri Lanka,New Zealand,110,54,56
2010,344,"China, Hong Kong SAR",New Zealand,2201,1400,801
2010,392,Japan,New Zealand,3250,1462,1788
2010,410,Republic of Korea,New Zealand,1781,1462,319
2010,96,Brunei Darussalam,New Zealand,200,117,83
2010,458,Malaysia,New Zealand,1921,930,991
2010,608,Philippines,New Zealand,378,218,160
2010,702,Singapore,New Zealand,3386,1773,1613
2010,764,Thailand,New Zealand,1665,770,895
2010,626,Timor-Leste,New Zealand,179,104,75
2010,28,Antigua and Barbuda,New Zealand,11,5,6
2010,44,Bahamas,New Zealand,22,6,16
2010,535,"Bonaire, Sint Eustatius and Saba",New Zealand,3,0,3
2010,136,Cayman Islands,New Zealand,53,35,18
2010,662,Saint Lucia,New Zealand,2,2,0
2010,188,Costa Rica,New Zealand,17,4,13
2010,484,Mexico,New Zealand,103,58,45
2010,591,Panama,New Zealand,43,30,13
2010,32,Argentina,New Zealand,11,6,5
2010,68,Bolivia (Plurinational State of),New Zealand,55,31,24
2010,76,Brazil,New Zealand,271,218,53
2010,152,Chile,New Zealand,278,150,128
2010,170,Colombia,New Zealand,48,26,22
2010,218,Ecuador,New Zealand,77,33,44
2010,238,Falkland Islands (Malvinas),New Zealand,24,11,13
2010,604,Peru,New Zealand,90,34,56
2010,862,Venezuela (Bolivarian Republic of),New Zealand,17,8,9
2010,36,Australia,New Zealand,517780,266553,251227
2010,242,Fiji,New Zealand,588,314,274
2010,540,New Caledonia,New Zealand,146,73,73
2010,598,Papua New Guinea,New Zealand,1754,1219,535
2010,90,Solomon Islands,New Zealand,79,45,34
2010,548,Vanuatu,New Zealand,299,149,150
2010,296,Kiribati,New Zealand,54,35,19
2010,520,Nauru,New Zealand,2,2,0
2010,16,American Samoa,New Zealand,726,369,357
2010,184,Cook Islands,New Zealand,2340,1155,1185
2010,258,French Polynesia,New Zealand,117,62,55
2010,570,Niue,New Zealand,328,178,150
2010,882,Samoa,New Zealand,1551,738,813
2010,772,Tokelau,New Zealand,158,53,105
2010,100,Bulgaria,New Zealand,21,12,9
2010,203,Czechia,New Zealand,113,82,31
2010,348,Hungary,New Zealand,176,97,79
2010,616,Poland,New Zealand,110,62,48
2010,643,Russian Federation,New Zealand,85,48,37
2010,703,Slovakia,New Zealand,28,19,9
2010,208,Denmark,New Zealand,737,446,291
2010,233,Estonia,New Zealand,11,9,2
2010,246,Finland,New Zealand,226,170,56
2010,352,Iceland,New Zealand,48,22,26
2010,372,Ireland,New Zealand,2223,1133,1090
2010,833,Isle of Man,New Zealand,91,50,41
2010,428,Latvia,New Zealand,14,10,4
2010,578,Norway,New Zealand,527,297,230
2010,752,Sweden,New Zealand,1011,711,300
2010,826,United Kingdom,New Zealand,58829,29230,29599
2010,191,Croatia,New Zealand,115,55,60
2010,300,Greece,New Zealand,522,186,336
2010,380,Italy,New Zealand,973,426,547
2010,470,Malta,New Zealand,35,20,15
2010,620,Portugal,New Zealand,39,16,23
2010,688,Serbia,New Zealand,25,14,11
2010,724,Spain,New Zealand,821,477,344
2010,40,Austria,New Zealand,379,204,175
2010,56,Belgium,New Zealand,411,207,204
2010,250,France,New Zealand,1838,859,979
2010,276,Germany,New Zealand,2622,1517,1105
2010,442,Luxembourg,New Zealand,15,10,5
2010,528,Netherlands,New Zealand,3633,1780,1853
2010,756,Switzerland,New Zealand,1675,860,815
2010,124,Canada,New Zealand,10065,5482,4583
2010,840,United States of America,New Zealand,29914,11751,18163
2015,748,Eswatini,New Zealand,25,17,8
2015,516,Namibia,New Zealand,48,28,20
2015,710,South Africa,New Zealand,4884,2370,2514
2015,324,Guinea,New Zealand,2,2,0
2015,818,Egypt,New Zealand,64,45,19
2015,196,Cyprus,New Zealand,97,37,60
2015,400,Jordan,New Zealand,61,29,32
2015,792,Turkey,New Zealand,290,110,180
2015,762,Tajikistan,New Zealand,109,52,57
2015,64,Bhutan,New Zealand,24,15,9
2015,462,Maldives,New Zealand,17,15,2
2015,144,Sri Lanka,New Zealand,111,54,57
2015,344,"China, Hong Kong SAR",New Zealand,2247,1397,850
2015,392,Japan,New Zealand,3152,1407,1745
2015,410,Republic of Korea,New Zealand,2212,1807,405
2015,96,Brunei Darussalam,New Zealand,204,120,84
2015,458,Malaysia,New Zealand,2343,1158,1185
2015,608,Philippines,New Zealand,383,221,162
2015,702,Singapore,New Zealand,3938,2059,1879
2015,764,Thailand,New Zealand,1800,829,971
2015,626,Timor-Leste,New Zealand,72,46,26
2015,28,Antigua and Barbuda,New Zealand,12,6,6
2015,44,Bahamas,New Zealand,24,7,17
2015,535,"Bonaire, Sint Eustatius and Saba",New Zealand,3,0,3
2015,136,Cayman Islands,New Zealand,57,39,18
2015,662,Saint Lucia,New Zealand,1,1,0
2015,188,Costa Rica,New Zealand,17,4,13
2015,484,Mexico,New Zealand,109,61,48
2015,591,Panama,New Zealand,50,35,15
2015,32,Argentina,New Zealand,11,6,5
2015,68,Bolivia (Plurinational State of),New Zealand,64,36,28
2015,76,Brazil,New Zealand,326,262,64
2015,152,Chile,New Zealand,421,223,198
2015,170,Colombia,New Zealand,53,29,24
2015,218,Ecuador,New Zealand,112,48,64
2015,238,Falkland Islands (Malvinas),New Zealand,26,12,14
2015,604,Peru,New Zealand,95,44,51
2015,862,Venezuela (Bolivarian Republic of),New Zealand,18,8,10
2015,36,Australia,New Zealand,575430,296315,279115
2015,242,Fiji,New Zealand,606,327,279
2015,540,New Caledonia,New Zealand,111,49,62
2015,598,Papua New Guinea,New Zealand,1778,1243,535
2015,90,Solomon Islands,New Zealand,73,42,31
2015,548,Vanuatu,New Zealand,313,156,157
2015,296,Kiribati,New Zealand,54,36,18
2015,520,Nauru,New Zealand,3,3,0
2015,16,American Samoa,New Zealand,724,366,358
2015,184,Cook Islands,New Zealand,2158,1061,1097
2015,258,French Polynesia,New Zealand,111,59,52
2015,570,Niue,New Zealand,335,178,157
2015,882,Samoa,New Zealand,1290,612,678
2015,772,Tokelau,New Zealand,179,60,119
2015,100,Bulgaria,New Zealand,47,29,18
2015,203,Czechia,New Zealand,180,141,39
2015,348,Hungary,New Zealand,187,109,78
2015,616,Poland,New Zealand,106,61,45
2015,643,Russian Federation,New Zealand,86,48,38
2015,703,Slovakia,New Zealand,43,30,13
2015,208,Denmark,New Zealand,869,514,355
2015,233,Estonia,New Zealand,16,13,3
2015,246,Finland,New Zealand,254,189,65
2015,352,Iceland,New Zealand,50,25,25
2015,372,Ireland,New Zealand,2271,1144,1127
2015,833,Isle of Man,New Zealand,85,47,38
2015,428,Latvia,New Zealand,5,3,2
2015,578,Norway,New Zealand,637,378,259
2015,752,Sweden,New Zealand,1094,762,332
2015,826,United Kingdom,New Zealand,75233,36258,38975
2015,191,Croatia,New Zealand,116,55,61
2015,300,Greece,New Zealand,489,161,328
2015,380,Italy,New Zealand,862,374,488
2015,470,Malta,New Zealand,59,36,23
2015,620,Portugal,New Zealand,44,16,28
2015,688,Serbia,New Zealand,24,14,10
2015,724,Spain,New Zealand,1073,605,468
2015,40,Austria,New Zealand,443,240,203
2015,56,Belgium,New Zealand,386,194,192
2015,250,France,New Zealand,2036,922,1114
2015,276,Germany,New Zealand,2732,1578,1154
2015,442,Luxembourg,New Zealand,22,15,7
2015,528,Netherlands,New Zealand,3814,1885,1929
2015,756,Switzerland,New Zealand,1867,951,916
2015,124,Canada,New Zealand,9819,5275,4544
2015,840,United States of America,New Zealand,34157,13312,20845
2019,748,Eswatini,New Zealand,24,16,8
2019,516,Namibia,New Zealand,50,29,21
2019,710,South Africa,New Zealand,5473,2659,2814
2019,324,Guinea,New Zealand,1,1,0
2019,818,Egypt,New Zealand,91,61,30
2019,196,Cyprus,New Zealand,96,37,59
2019,400,Jordan,New Zealand,65,31,34
2019,792,Turkey,New Zealand,392,152,240
2019,762,Tajikistan,New Zealand,108,52,56
2019,64,Bhutan,New Zealand,25,16,9
2019,462,Maldives,New Zealand,18,16,2
2019,144,Sri Lanka,New Zealand,111,54,57
2019,344,"China, Hong Kong SAR",New Zealand,2911,1777,1134
2019,392,Japan,New Zealand,3396,1516,1880
2019,410,Republic of Korea,New Zealand,2251,1839,412
2019,96,Brunei Darussalam,New Zealand,219,129,90
2019,458,Malaysia,New Zealand,2449,1220,1229
2019,608,Philippines,New Zealand,395,228,167
2019,702,Singapore,New Zealand,3337,1743,1594
2019,764,Thailand,New Zealand,1876,864,1012
2019,626,Timor-Leste,New Zealand,71,46,25
2019,28,Antigua and Barbuda,New Zealand,12,6,6
2019,44,Bahamas,New Zealand,25,7,18
2019,535,"Bonaire, Sint Eustatius and Saba",New Zealand,3,0,3
2019,136,Cayman Islands,New Zealand,63,43,20
2019,188,Costa Rica,New Zealand,17,4,13
2019,484,Mexico,New Zealand,112,63,49
2019,591,Panama,New Zealand,52,38,14
2019,32,Argentina,New Zealand,11,6,5
2019,68,Bolivia (Plurinational State of),New Zealand,69,39,30
2019,76,Brazil,New Zealand,367,295,72
2019,152,Chile,New Zealand,562,283,279
2019,170,Colombia,New Zealand,54,30,24
2019,218,Ecuador,New Zealand,110,47,63
2019,238,Falkland Islands (Malvinas),New Zealand,31,15,16
2019,604,Peru,New Zealand,112,55,57
2019,862,Venezuela (Bolivarian Republic of),New Zealand,17,8,9
2019,36,Australia,New Zealand,600404,308029,292375
2019,242,Fiji,New Zealand,618,334,284
2019,540,New Caledonia,New Zealand,116,51,65
2019,598,Papua New Guinea,New Zealand,1793,1256,537
2019,90,Solomon Islands,New Zealand,71,41,30
2019,548,Vanuatu,New Zealand,318,159,159
2019,296,Kiribati,New Zealand,55,37,18
2019,520,Nauru,New Zealand,3,3,0
2019,16,American Samoa,New Zealand,724,366,358
2019,184,Cook Islands,New Zealand,2166,1065,1101
2019,258,French Polynesia,New Zealand,115,62,53
2019,570,Niue,New Zealand,335,178,157
2019,882,Samoa,New Zealand,1224,581,643
2019,772,Tokelau,New Zealand,185,63,122
2019,100,Bulgaria,New Zealand,54,35,19
2019,203,Czechia,New Zealand,212,163,49
2019,348,Hungary,New Zealand,205,116,89
2019,616,Poland,New Zealand,112,67,45
2019,643,Russian Federation,New Zealand,85,48,37
2019,703,Slovakia,New Zealand,53,35,18
2019,208,Denmark,New Zealand,971,569,402
2019,233,Estonia,New Zealand,21,18,3
2019,246,Finland,New Zealand,311,225,86
2019,352,Iceland,New Zealand,73,37,36
2019,372,Ireland,New Zealand,2493,1260,1233
2019,833,Isle of Man,New Zealand,86,48,38
2019,428,Latvia,New Zealand,7,5,2
2019,578,Norway,New Zealand,670,398,272
2019,752,Sweden,New Zealand,1295,870,425
2019,826,United Kingdom,New Zealand,85434,41286,44148
2019,191,Croatia,New Zealand,107,51,56
2019,300,Greece,New Zealand,477,169,308
2019,380,Italy,New Zealand,904,401,503
2019,470,Malta,New Zealand,95,59,36
2019,620,Portugal,New Zealand,44,16,28
2019,688,Serbia,New Zealand,24,14,10
2019,724,Spain,New Zealand,1111,615,496
2019,40,Austria,New Zealand,522,287,235
2019,56,Belgium,New Zealand,412,223,189
2019,250,France,New Zealand,2155,974,1181
2019,276,Germany,New Zealand,2996,1804,1192
2019,442,Luxembourg,New Zealand,100,54,46
2019,528,Netherlands,New Zealand,4269,2142,2127
2019,756,Switzerland,New Zealand,1907,988,919
2019,124,Canada,New Zealand,10522,5653,4869
2019,840,United States of America,New Zealand,36885,14133,22752
1990,710,South Africa,Nicaragua,106,26,80
1990,196,Cyprus,Nicaragua,3,2,1
1990,533,Aruba,Nicaragua,19,9,10
1990,44,Bahamas,Nicaragua,9,4,5
1990,136,Cayman Islands,Nicaragua,238,105,133
1990,192,Cuba,Nicaragua,595,227,368
1990,214,Dominican Republic,Nicaragua,415,208,207
1990,388,Jamaica,Nicaragua,121,51,70
1990,630,Puerto Rico,Nicaragua,460,218,242
1990,188,Costa Rica,Nicaragua,99153,50095,49058
1990,222,El Salvador,Nicaragua,3893,1772,2121
1990,320,Guatemala,Nicaragua,3726,1101,2625
1990,340,Honduras,Nicaragua,142802,74798,68004
1990,484,Mexico,Nicaragua,3096,1596,1500
1990,591,Panama,Nicaragua,4553,2116,2437
1990,32,Argentina,Nicaragua,145,77,68
1990,68,Bolivia (Plurinational State of),Nicaragua,66,29,37
1990,76,Brazil,Nicaragua,329,200,129
1990,152,Chile,Nicaragua,168,84,84
1990,170,Colombia,Nicaragua,470,222,248
1990,218,Ecuador,Nicaragua,131,67,64
1990,604,Peru,Nicaragua,99,39,60
1990,862,Venezuela (Bolivarian Republic of),Nicaragua,2526,1154,1372
1990,36,Australia,Nicaragua,725,349,376
1990,100,Bulgaria,Nicaragua,15,14,1
1990,203,Czechia,Nicaragua,4,3,1
1990,348,Hungary,Nicaragua,8,6,2
1990,643,Russian Federation,Nicaragua,71,35,36
1990,208,Denmark,Nicaragua,36,17,19
1990,246,Finland,Nicaragua,5,3,2
1990,352,Iceland,Nicaragua,1,0,1
1990,372,Ireland,Nicaragua,3,1,2
1990,428,Latvia,Nicaragua,1,0,1
1990,578,Norway,Nicaragua,35,12,23
1990,752,Sweden,Nicaragua,317,133,184
1990,826,United Kingdom,Nicaragua,31,16,15
1990,300,Greece,Nicaragua,41,23,18
1990,380,Italy,Nicaragua,78,27,51
1990,724,Spain,Nicaragua,1002,426,576
1990,40,Austria,Nicaragua,115,46,69
1990,56,Belgium,Nicaragua,138,43,95
1990,250,France,Nicaragua,489,179,310
1990,276,Germany,Nicaragua,653,336,317
1990,528,Netherlands,Nicaragua,133,59,74
1990,756,Switzerland,Nicaragua,244,93,151
1990,124,Canada,Nicaragua,6199,3018,3181
1990,840,United States of America,Nicaragua,168659,80771,87888
1995,710,South Africa,Nicaragua,66,20,46
1995,196,Cyprus,Nicaragua,4,2,2
1995,533,Aruba,Nicaragua,48,22,26
1995,44,Bahamas,Nicaragua,8,4,4
1995,136,Cayman Islands,Nicaragua,448,197,251
1995,192,Cuba,Nicaragua,451,160,291
1995,214,Dominican Republic,Nicaragua,461,224,237
1995,388,Jamaica,Nicaragua,128,55,73
1995,630,Puerto Rico,Nicaragua,483,229,254
1995,188,Costa Rica,Nicaragua,131695,67061,64634
1995,222,El Salvador,Nicaragua,4219,2043,2176
1995,320,Guatemala,Nicaragua,4565,1783,2782
1995,340,Honduras,Nicaragua,74273,38819,35454
1995,484,Mexico,Nicaragua,3324,1567,1757
1995,591,Panama,Nicaragua,4593,2061,2532
1995,32,Argentina,Nicaragua,167,85,82
1995,68,Bolivia (Plurinational State of),Nicaragua,76,34,42
1995,76,Brazil,Nicaragua,415,266,149
1995,152,Chile,Nicaragua,201,99,102
1995,170,Colombia,Nicaragua,475,222,253
1995,218,Ecuador,Nicaragua,147,75,72
1995,604,Peru,Nicaragua,100,39,61
1995,862,Venezuela (Bolivarian Republic of),Nicaragua,2193,994,1199
1995,36,Australia,Nicaragua,785,380,405
1995,100,Bulgaria,Nicaragua,17,15,2
1995,203,Czechia,Nicaragua,6,5,1
1995,348,Hungary,Nicaragua,12,7,5
1995,643,Russian Federation,Nicaragua,66,36,30
1995,208,Denmark,Nicaragua,79,36,43
1995,246,Finland,Nicaragua,23,9,14
1995,352,Iceland,Nicaragua,2,0,2
1995,372,Ireland,Nicaragua,9,4,5
1995,428,Latvia,Nicaragua,1,0,1
1995,578,Norway,Nicaragua,57,29,28
1995,752,Sweden,Nicaragua,376,156,220
1995,826,United Kingdom,Nicaragua,124,45,79
1995,300,Greece,Nicaragua,35,17,18
1995,380,Italy,Nicaragua,257,78,179
1995,724,Spain,Nicaragua,1240,531,709
1995,40,Austria,Nicaragua,130,53,77
1995,56,Belgium,Nicaragua,134,39,95
1995,250,France,Nicaragua,505,179,326
1995,276,Germany,Nicaragua,634,303,331
1995,528,Netherlands,Nicaragua,195,84,111
1995,756,Switzerland,Nicaragua,330,137,193
1995,124,Canada,Nicaragua,7730,3742,3988
1995,840,United States of America,Nicaragua,197100,94776,102324
2000,710,South Africa,Nicaragua,46,18,28
2000,196,Cyprus,Nicaragua,5,3,2
2000,533,Aruba,Nicaragua,77,36,41
2000,44,Bahamas,Nicaragua,7,4,3
2000,136,Cayman Islands,Nicaragua,770,338,432
2000,192,Cuba,Nicaragua,307,94,213
2000,214,Dominican Republic,Nicaragua,507,241,266
2000,388,Jamaica,Nicaragua,134,58,76
2000,630,Puerto Rico,Nicaragua,509,242,267
2000,188,Costa Rica,Nicaragua,230085,114900,115185
2000,222,El Salvador,Nicaragua,4545,2315,2230
2000,320,Guatemala,Nicaragua,5404,2465,2939
2000,340,Honduras,Nicaragua,5768,2841,2927
2000,484,Mexico,Nicaragua,3696,1615,2081
2000,591,Panama,Nicaragua,4923,2121,2802
2000,32,Argentina,Nicaragua,190,94,96
2000,68,Bolivia (Plurinational State of),Nicaragua,85,39,46
2000,76,Brazil,Nicaragua,501,332,169
2000,152,Chile,Nicaragua,234,114,120
2000,170,Colombia,Nicaragua,479,222,257
2000,218,Ecuador,Nicaragua,163,83,80
2000,604,Peru,Nicaragua,117,41,76
2000,862,Venezuela (Bolivarian Republic of),Nicaragua,1934,867,1067
2000,36,Australia,Nicaragua,800,378,422
2000,100,Bulgaria,Nicaragua,19,17,2
2000,203,Czechia,Nicaragua,8,7,1
2000,348,Hungary,Nicaragua,15,8,7
2000,643,Russian Federation,Nicaragua,60,37,23
2000,208,Denmark,Nicaragua,122,55,67
2000,246,Finland,Nicaragua,41,16,25
2000,352,Iceland,Nicaragua,3,0,3
2000,372,Ireland,Nicaragua,19,9,10
2000,428,Latvia,Nicaragua,1,0,1
2000,578,Norway,Nicaragua,98,49,49
2000,752,Sweden,Nicaragua,404,166,238
2000,826,United Kingdom,Nicaragua,221,75,146
2000,300,Greece,Nicaragua,30,12,18
2000,380,Italy,Nicaragua,436,129,307
2000,724,Spain,Nicaragua,2013,885,1128
2000,40,Austria,Nicaragua,144,60,84
2000,56,Belgium,Nicaragua,130,35,95
2000,250,France,Nicaragua,521,180,341
2000,276,Germany,Nicaragua,615,271,344
2000,528,Netherlands,Nicaragua,265,110,155
2000,756,Switzerland,Nicaragua,419,183,236
2000,124,Canada,Nicaragua,9444,4556,4888
2000,840,United States of America,Nicaragua,225929,109110,116819
2005,710,South Africa,Nicaragua,60,22,38
2005,196,Cyprus,Nicaragua,7,4,3
2005,533,Aruba,Nicaragua,90,42,48
2005,44,Bahamas,Nicaragua,8,4,4
2005,136,Cayman Islands,Nicaragua,543,233,310
2005,192,Cuba,Nicaragua,205,63,142
2005,214,Dominican Republic,Nicaragua,393,181,212
2005,388,Jamaica,Nicaragua,130,56,74
2005,630,Puerto Rico,Nicaragua,399,190,209
2005,188,Costa Rica,Nicaragua,148064,71223,76841
2005,222,El Salvador,Nicaragua,6024,3142,2882
2005,320,Guatemala,Nicaragua,6424,3203,3221
2005,340,Honduras,Nicaragua,5649,2817,2832
2005,484,Mexico,Nicaragua,3434,1546,1888
2005,591,Panama,Nicaragua,7775,3234,4541
2005,32,Argentina,Nicaragua,141,71,70
2005,68,Bolivia (Plurinational State of),Nicaragua,90,40,50
2005,76,Brazil,Nicaragua,436,264,172
2005,152,Chile,Nicaragua,351,174,177
2005,170,Colombia,Nicaragua,467,218,249
2005,218,Ecuador,Nicaragua,192,100,92
2005,604,Peru,Nicaragua,138,55,83
2005,862,Venezuela (Bolivarian Republic of),Nicaragua,1953,882,1071
2005,36,Australia,Nicaragua,770,363,407
2005,100,Bulgaria,Nicaragua,24,21,3
2005,203,Czechia,Nicaragua,10,8,2
2005,348,Hungary,Nicaragua,19,9,10
2005,643,Russian Federation,Nicaragua,60,41,19
2005,208,Denmark,Nicaragua,153,67,86
2005,246,Finland,Nicaragua,66,30,36
2005,352,Iceland,Nicaragua,4,0,4
2005,372,Ireland,Nicaragua,19,9,10
2005,578,Norway,Nicaragua,124,57,67
2005,752,Sweden,Nicaragua,495,214,281
2005,826,United Kingdom,Nicaragua,279,108,171
2005,300,Greece,Nicaragua,97,46,51
2005,380,Italy,Nicaragua,806,257,549
2005,724,Spain,Nicaragua,3156,1256,1900
2005,40,Austria,Nicaragua,161,65,96
2005,56,Belgium,Nicaragua,203,60,143
2005,250,France,Nicaragua,472,176,296
2005,276,Germany,Nicaragua,951,421,530
2005,528,Netherlands,Nicaragua,337,140,197
2005,756,Switzerland,Nicaragua,464,189,275
2005,124,Canada,Nicaragua,8894,4184,4710
2005,840,United States of America,Nicaragua,236243,114767,121476
2010,710,South Africa,Nicaragua,93,34,59
2010,196,Cyprus,Nicaragua,11,7,4
2010,533,Aruba,Nicaragua,102,47,55
2010,44,Bahamas,Nicaragua,9,5,4
2010,136,Cayman Islands,Nicaragua,364,148,216
2010,192,Cuba,Nicaragua,114,35,79
2010,214,Dominican Republic,Nicaragua,277,120,157
2010,388,Jamaica,Nicaragua,126,55,71
2010,630,Puerto Rico,Nicaragua,239,112,127
2010,188,Costa Rica,Nicaragua,287766,136118,151648
2010,222,El Salvador,Nicaragua,7502,3969,3533
2010,320,Guatemala,Nicaragua,7443,3941,3502
2010,340,Honduras,Nicaragua,5530,2793,2737
2010,484,Mexico,Nicaragua,3572,1661,1911
2010,591,Panama,Nicaragua,10998,4572,6426
2010,32,Argentina,Nicaragua,91,48,43
2010,68,Bolivia (Plurinational State of),Nicaragua,95,42,53
2010,76,Brazil,Nicaragua,364,192,172
2010,152,Chile,Nicaragua,468,234,234
2010,170,Colombia,Nicaragua,535,254,281
2010,218,Ecuador,Nicaragua,270,137,133
2010,604,Peru,Nicaragua,154,62,92
2010,862,Venezuela (Bolivarian Republic of),Nicaragua,1992,907,1085
2010,36,Australia,Nicaragua,820,384,436
2010,100,Bulgaria,Nicaragua,28,25,3
2010,203,Czechia,Nicaragua,11,9,2
2010,348,Hungary,Nicaragua,23,11,12
2010,643,Russian Federation,Nicaragua,59,43,16
2010,208,Denmark,Nicaragua,180,77,103
2010,233,Estonia,Nicaragua,1,1,0
2010,246,Finland,Nicaragua,107,44,63
2010,352,Iceland,Nicaragua,5,1,4
2010,372,Ireland,Nicaragua,16,7,9
2010,578,Norway,Nicaragua,156,65,91
2010,752,Sweden,Nicaragua,649,283,366
2010,826,United Kingdom,Nicaragua,293,117,176
2010,300,Greece,Nicaragua,170,83,87
2010,380,Italy,Nicaragua,1135,370,765
2010,705,Slovenia,Nicaragua,3,0,3
2010,724,Spain,Nicaragua,12892,3831,9061
2010,40,Austria,Nicaragua,178,70,108
2010,56,Belgium,Nicaragua,243,118,125
2010,250,France,Nicaragua,607,201,406
2010,276,Germany,Nicaragua,1229,547,682
2010,528,Netherlands,Nicaragua,402,163,239
2010,756,Switzerland,Nicaragua,554,207,347
2010,124,Canada,Nicaragua,8945,4107,4838
2010,840,United States of America,Nicaragua,254081,121636,132445
2015,710,South Africa,Nicaragua,166,56,110
2015,324,Guinea,Nicaragua,5,3,2
2015,196,Cyprus,Nicaragua,10,7,3
2015,533,Aruba,Nicaragua,107,49,58
2015,44,Bahamas,Nicaragua,10,6,4
2015,136,Cayman Islands,Nicaragua,396,162,234
2015,192,Cuba,Nicaragua,91,28,63
2015,214,Dominican Republic,Nicaragua,292,127,165
2015,388,Jamaica,Nicaragua,123,54,69
2015,630,Puerto Rico,Nicaragua,234,110,124
2015,188,Costa Rica,Nicaragua,292232,137289,154943
2015,222,El Salvador,Nicaragua,7823,4144,3679
2015,320,Guatemala,Nicaragua,8561,4590,3971
2015,340,Honduras,Nicaragua,7767,3931,3836
2015,484,Mexico,Nicaragua,3982,1834,2148
2015,591,Panama,Nicaragua,12915,5351,7564
2015,32,Argentina,Nicaragua,91,48,43
2015,68,Bolivia (Plurinational State of),Nicaragua,111,49,62
2015,76,Brazil,Nicaragua,438,231,207
2015,152,Chile,Nicaragua,708,347,361
2015,170,Colombia,Nicaragua,598,287,311
2015,218,Ecuador,Nicaragua,392,198,194
2015,604,Peru,Nicaragua,164,69,95
2015,862,Venezuela (Bolivarian Republic of),Nicaragua,2045,915,1130
2015,36,Australia,Nicaragua,860,410,450
2015,100,Bulgaria,Nicaragua,31,28,3
2015,203,Czechia,Nicaragua,13,9,4
2015,348,Hungary,Nicaragua,21,12,9
2015,643,Russian Federation,Nicaragua,60,44,16
2015,208,Denmark,Nicaragua,199,83,116
2015,233,Estonia,Nicaragua,2,1,1
2015,246,Finland,Nicaragua,126,53,73
2015,352,Iceland,Nicaragua,7,2,5
2015,372,Ireland,Nicaragua,16,7,9
2015,578,Norway,Nicaragua,193,86,107
2015,752,Sweden,Nicaragua,804,362,442
2015,826,United Kingdom,Nicaragua,374,143,231
2015,300,Greece,Nicaragua,159,74,85
2015,380,Italy,Nicaragua,1194,377,817
2015,705,Slovenia,Nicaragua,2,0,2
2015,724,Spain,Nicaragua,20361,4819,15542
2015,40,Austria,Nicaragua,208,82,126
2015,56,Belgium,Nicaragua,302,127,175
2015,250,France,Nicaragua,672,211,461
2015,276,Germany,Nicaragua,1281,569,712
2015,528,Netherlands,Nicaragua,478,201,277
2015,756,Switzerland,Nicaragua,641,236,405
2015,124,Canada,Nicaragua,9809,4694,5115
2015,840,United States of America,Nicaragua,280437,133503,146934
2019,710,South Africa,Nicaragua,185,63,122
2019,324,Guinea,Nicaragua,4,3,1
2019,196,Cyprus,Nicaragua,9,7,2
2019,533,Aruba,Nicaragua,108,50,58
2019,44,Bahamas,Nicaragua,10,6,4
2019,136,Cayman Islands,Nicaragua,437,178,259
2019,192,Cuba,Nicaragua,83,25,58
2019,214,Dominican Republic,Nicaragua,301,131,170
2019,388,Jamaica,Nicaragua,124,55,69
2019,630,Puerto Rico,Nicaragua,222,104,118
2019,188,Costa Rica,Nicaragua,296541,140332,156209
2019,222,El Salvador,Nicaragua,7929,4201,3728
2019,320,Guatemala,Nicaragua,8787,4712,4075
2019,340,Honduras,Nicaragua,7891,3994,3897
2019,484,Mexico,Nicaragua,4105,1891,2214
2019,591,Panama,Nicaragua,13752,5698,8054
2019,32,Argentina,Nicaragua,92,49,43
2019,68,Bolivia (Plurinational State of),Nicaragua,121,54,67
2019,76,Brazil,Nicaragua,493,260,233
2019,152,Chile,Nicaragua,945,436,509
2019,170,Colombia,Nicaragua,611,293,318
2019,218,Ecuador,Nicaragua,385,194,191
2019,604,Peru,Nicaragua,194,86,108
2019,862,Venezuela (Bolivarian Republic of),Nicaragua,2003,892,1111
2019,36,Australia,Nicaragua,931,450,481
2019,100,Bulgaria,Nicaragua,40,35,5
2019,203,Czechia,Nicaragua,17,11,6
2019,348,Hungary,Nicaragua,22,11,11
2019,643,Russian Federation,Nicaragua,59,44,15
2019,208,Denmark,Nicaragua,225,92,133
2019,233,Estonia,Nicaragua,2,1,1
2019,246,Finland,Nicaragua,150,60,90
2019,352,Iceland,Nicaragua,6,2,4
2019,372,Ireland,Nicaragua,17,8,9
2019,578,Norway,Nicaragua,226,103,123
2019,752,Sweden,Nicaragua,921,417,504
2019,826,United Kingdom,Nicaragua,424,163,261
2019,300,Greece,Nicaragua,155,76,79
2019,380,Italy,Nicaragua,1311,435,876
2019,705,Slovenia,Nicaragua,4,0,4
2019,724,Spain,Nicaragua,25969,6019,19950
2019,40,Austria,Nicaragua,245,99,146
2019,56,Belgium,Nicaragua,332,136,196
2019,250,France,Nicaragua,711,222,489
2019,276,Germany,Nicaragua,1405,676,729
2019,528,Netherlands,Nicaragua,566,249,317
2019,756,Switzerland,Nicaragua,718,265,453
2019,124,Canada,Nicaragua,10511,5030,5481
2019,840,United States of America,Nicaragua,302845,142464,160381
1990,148,Chad,Niger,2614,1411,1203
1990,710,South Africa,Niger,21,13,8
1990,204,Benin,Niger,26721,15843,10878
1990,854,Burkina Faso,Niger,8275,4170,4105
1990,384,Côte d'Ivoire,Niger,50297,37609,12688
1990,288,Ghana,Niger,4229,3027,1202
1990,324,Guinea,Niger,1393,706,687
1990,430,Liberia,Niger,1127,542,585
1990,466,Mali,Niger,3571,1980,1591
1990,478,Mauritania,Niger,135,51,84
1990,566,Nigeria,Niger,35442,19884,15558
1990,686,Senegal,Niger,1397,729,668
1990,694,Sierra Leone,Niger,161,133,28
1990,768,Togo,Niger,10540,6226,4314
1990,818,Egypt,Niger,97,92,5
1990,434,Libya,Niger,275,262,13
1990,196,Cyprus,Niger,2,1,1
1990,762,Tajikistan,Niger,37,17,20
1990,136,Cayman Islands,Niger,8,8,0
1990,32,Argentina,Niger,1,1,0
1990,68,Bolivia (Plurinational State of),Niger,1,1,0
1990,152,Chile,Niger,2,1,1
1990,36,Australia,Niger,15,15,0
1990,100,Bulgaria,Niger,8,5,3
1990,203,Czechia,Niger,1,1,0
1990,348,Hungary,Niger,15,13,2
1990,643,Russian Federation,Niger,27,13,14
1990,208,Denmark,Niger,3,1,2
1990,246,Finland,Niger,7,5,2
1990,372,Ireland,Niger,25,10,15
1990,752,Sweden,Niger,9,8,1
1990,826,United Kingdom,Niger,13,9,4
1990,300,Greece,Niger,33,18,15
1990,380,Italy,Niger,4,1,3
1990,470,Malta,Niger,10,7,3
1990,724,Spain,Niger,18,16,2
1990,40,Austria,Niger,17,11,6
1990,56,Belgium,Niger,1124,731,393
1990,250,France,Niger,1709,920,789
1990,276,Germany,Niger,223,192,31
1990,528,Netherlands,Niger,52,36,16
1990,756,Switzerland,Niger,72,44,28
1990,124,Canada,Niger,48,24,24
1995,148,Chad,Niger,2840,1531,1309
1995,710,South Africa,Niger,13,8,5
1995,204,Benin,Niger,36802,22012,14790
1995,854,Burkina Faso,Niger,10291,5195,5096
1995,384,Côte d'Ivoire,Niger,55202,41176,14026
1995,288,Ghana,Niger,4214,3131,1083
1995,324,Guinea,Niger,1606,901,705
1995,430,Liberia,Niger,1101,517,584
1995,466,Mali,Niger,4803,2596,2207
1995,478,Mauritania,Niger,144,63,81
1995,566,Nigeria,Niger,39858,22219,17639
1995,686,Senegal,Niger,1460,758,702
1995,694,Sierra Leone,Niger,157,129,28
1995,768,Togo,Niger,14286,8439,5847
1995,818,Egypt,Niger,88,79,9
1995,434,Libya,Niger,267,229,38
1995,196,Cyprus,Niger,3,1,2
1995,762,Tajikistan,Niger,30,14,16
1995,136,Cayman Islands,Niger,16,16,0
1995,32,Argentina,Niger,1,1,0
1995,68,Bolivia (Plurinational State of),Niger,1,1,0
1995,152,Chile,Niger,6,4,2
1995,36,Australia,Niger,7,7,0
1995,100,Bulgaria,Niger,6,4,2
1995,203,Czechia,Niger,2,1,1
1995,348,Hungary,Niger,12,9,3
1995,643,Russian Federation,Niger,24,14,10
1995,208,Denmark,Niger,6,3,3
1995,246,Finland,Niger,9,6,3
1995,372,Ireland,Niger,69,26,43
1995,578,Norway,Niger,5,5,0
1995,752,Sweden,Niger,11,10,1
1995,826,United Kingdom,Niger,54,30,24
1995,300,Greece,Niger,54,34,20
1995,380,Italy,Niger,86,48,38
1995,470,Malta,Niger,12,8,4
1995,724,Spain,Niger,28,24,4
1995,40,Austria,Niger,20,13,7
1995,56,Belgium,Niger,888,542,346
1995,250,France,Niger,1764,936,828
1995,276,Germany,Niger,519,458,61
1995,528,Netherlands,Niger,76,52,24
1995,756,Switzerland,Niger,108,71,37
1995,124,Canada,Niger,124,60,64
2000,148,Chad,Niger,3066,1651,1415
2000,710,South Africa,Niger,9,5,4
2000,204,Benin,Niger,46883,28181,18702
2000,854,Burkina Faso,Niger,10633,5478,5155
2000,384,Côte d'Ivoire,Niger,57521,42898,14623
2000,288,Ghana,Niger,4714,3391,1323
2000,324,Guinea,Niger,1124,631,493
2000,430,Liberia,Niger,1081,491,590
2000,466,Mali,Niger,5259,2810,2449
2000,478,Mauritania,Niger,148,73,75
2000,566,Nigeria,Niger,45868,25404,20464
2000,686,Senegal,Niger,1321,656,665
2000,694,Sierra Leone,Niger,153,125,28
2000,768,Togo,Niger,22364,11939,10425
2000,818,Egypt,Niger,86,72,14
2000,434,Libya,Niger,264,201,63
2000,196,Cyprus,Niger,4,2,2
2000,762,Tajikistan,Niger,26,13,13
2000,136,Cayman Islands,Niger,29,29,0
2000,32,Argentina,Niger,1,1,0
2000,152,Chile,Niger,10,5,5
2000,36,Australia,Niger,20,10,10
2000,100,Bulgaria,Niger,4,3,1
2000,203,Czechia,Niger,3,2,1
2000,348,Hungary,Niger,9,5,4
2000,643,Russian Federation,Niger,21,14,7
2000,208,Denmark,Niger,9,5,4
2000,246,Finland,Niger,10,6,4
2000,372,Ireland,Niger,150,60,90
2000,578,Norway,Niger,6,3,3
2000,752,Sweden,Niger,12,10,2
2000,826,United Kingdom,Niger,97,52,45
2000,300,Greece,Niger,75,50,25
2000,380,Italy,Niger,168,95,73
2000,470,Malta,Niger,15,11,4
2000,705,Slovenia,Niger,1,1,0
2000,724,Spain,Niger,349,296,53
2000,40,Austria,Niger,22,15,7
2000,56,Belgium,Niger,625,336,289
2000,250,France,Niger,1819,952,867
2000,276,Germany,Niger,814,723,91
2000,528,Netherlands,Niger,104,70,34
2000,756,Switzerland,Niger,146,98,48
2000,124,Canada,Niger,203,98,105
2005,120,Cameroon,Niger,10566,6925,3641
2005,148,Chad,Niger,2121,962,1159
2005,710,South Africa,Niger,11,7,4
2005,204,Benin,Niger,58072,33132,24940
2005,854,Burkina Faso,Niger,10807,5633,5174
2005,384,Côte d'Ivoire,Niger,60217,44909,15308
2005,288,Ghana,Niger,6629,4880,1749
2005,324,Guinea,Niger,786,632,154
2005,430,Liberia,Niger,491,300,191
2005,466,Mali,Niger,4693,2495,2198
2005,478,Mauritania,Niger,149,77,72
2005,566,Nigeria,Niger,91126,53061,38065
2005,686,Senegal,Niger,1421,731,690
2005,694,Sierra Leone,Niger,78,46,32
2005,768,Togo,Niger,46314,23683,22631
2005,818,Egypt,Niger,102,86,16
2005,434,Libya,Niger,290,234,56
2005,196,Cyprus,Niger,6,3,3
2005,762,Tajikistan,Niger,24,11,13
2005,136,Cayman Islands,Niger,27,27,0
2005,32,Argentina,Niger,1,1,0
2005,152,Chile,Niger,15,8,7
2005,36,Australia,Niger,10,5,5
2005,100,Bulgaria,Niger,3,2,1
2005,203,Czechia,Niger,5,4,1
2005,348,Hungary,Niger,12,7,5
2005,643,Russian Federation,Niger,25,21,4
2005,208,Denmark,Niger,12,6,6
2005,246,Finland,Niger,14,9,5
2005,372,Ireland,Niger,150,65,85
2005,578,Norway,Niger,22,19,3
2005,752,Sweden,Niger,17,13,4
2005,826,United Kingdom,Niger,139,76,63
2005,300,Greece,Niger,50,33,17
2005,380,Italy,Niger,614,459,155
2005,470,Malta,Niger,19,13,6
2005,724,Spain,Niger,168,142,26
2005,40,Austria,Niger,25,17,8
2005,56,Belgium,Niger,460,302,158
2005,250,France,Niger,4586,2263,2323
2005,276,Germany,Niger,788,653,135
2005,528,Netherlands,Niger,370,309,61
2005,756,Switzerland,Niger,156,101,55
2005,124,Canada,Niger,450,245,205
2010,120,Cameroon,Niger,8409,5642,2767
2010,148,Chad,Niger,2512,1125,1387
2010,710,South Africa,Niger,17,11,6
2010,204,Benin,Niger,68453,37786,30667
2010,854,Burkina Faso,Niger,12200,6332,5868
2010,384,Côte d'Ivoire,Niger,62913,46913,16000
2010,288,Ghana,Niger,4915,3529,1386
2010,324,Guinea,Niger,550,442,108
2010,430,Liberia,Niger,226,90,136
2010,466,Mali,Niger,9324,5467,3857
2010,478,Mauritania,Niger,150,79,71
2010,566,Nigeria,Niger,92949,54122,38827
2010,686,Senegal,Niger,1589,851,738
2010,694,Sierra Leone,Niger,64,39,25
2010,768,Togo,Niger,61226,33121,28105
2010,818,Egypt,Niger,110,92,18
2010,434,Libya,Niger,317,256,61
2010,196,Cyprus,Niger,9,5,4
2010,762,Tajikistan,Niger,23,11,12
2010,136,Cayman Islands,Niger,28,28,0
2010,32,Argentina,Niger,1,1,0
2010,76,Brazil,Niger,13,13,0
2010,152,Chile,Niger,20,11,9
2010,36,Australia,Niger,20,10,10
2010,100,Bulgaria,Niger,1,1,0
2010,203,Czechia,Niger,6,5,1
2010,348,Hungary,Niger,14,8,6
2010,643,Russian Federation,Niger,29,28,1
2010,208,Denmark,Niger,13,7,6
2010,246,Finland,Niger,26,19,7
2010,372,Ireland,Niger,126,49,77
2010,578,Norway,Niger,35,30,5
2010,752,Sweden,Niger,30,21,9
2010,826,United Kingdom,Niger,146,81,65
2010,300,Greece,Niger,26,17,9
2010,380,Italy,Niger,840,629,211
2010,470,Malta,Niger,45,23,22
2010,724,Spain,Niger,269,202,67
2010,40,Austria,Niger,27,18,9
2010,56,Belgium,Niger,1161,735,426
2010,250,France,Niger,5167,2649,2518
2010,276,Germany,Niger,764,593,171
2010,528,Netherlands,Niger,303,234,69
2010,756,Switzerland,Niger,193,122,71
2010,124,Canada,Niger,625,353,272
2015,120,Cameroon,Niger,10741,6730,4011
2015,148,Chad,Niger,3115,1435,1680
2015,710,South Africa,Niger,29,19,10
2015,204,Benin,Niger,72579,40165,32414
2015,854,Burkina Faso,Niger,12757,6621,6136
2015,384,Côte d'Ivoire,Niger,65609,48924,16685
2015,288,Ghana,Niger,6048,4342,1706
2015,324,Guinea,Niger,193,155,38
2015,430,Liberia,Niger,259,102,157
2015,466,Mali,Niger,11552,6774,4778
2015,478,Mauritania,Niger,150,80,70
2015,566,Nigeria,Niger,112733,61851,50882
2015,686,Senegal,Niger,1697,909,788
2015,694,Sierra Leone,Niger,53,33,20
2015,768,Togo,Niger,65729,36541,29188
2015,818,Egypt,Niger,81,70,11
2015,434,Libya,Niger,357,288,69
2015,196,Cyprus,Niger,8,5,3
2015,762,Tajikistan,Niger,22,11,11
2015,136,Cayman Islands,Niger,29,29,0
2015,32,Argentina,Niger,1,1,0
2015,76,Brazil,Niger,16,16,0
2015,152,Chile,Niger,30,17,13
2015,36,Australia,Niger,30,18,12
2015,100,Bulgaria,Niger,1,1,0
2015,203,Czechia,Niger,4,4,0
2015,348,Hungary,Niger,7,4,3
2015,643,Russian Federation,Niger,30,28,2
2015,208,Denmark,Niger,16,10,6
2015,246,Finland,Niger,26,19,7
2015,372,Ireland,Niger,129,49,80
2015,578,Norway,Niger,48,37,11
2015,752,Sweden,Niger,48,35,13
2015,826,United Kingdom,Niger,186,101,85
2015,300,Greece,Niger,24,16,8
2015,380,Italy,Niger,971,751,220
2015,470,Malta,Niger,51,50,1
2015,724,Spain,Niger,280,215,65
2015,40,Austria,Niger,31,21,10
2015,56,Belgium,Niger,1778,1087,691
2015,250,France,Niger,5723,2857,2866
2015,276,Germany,Niger,795,617,178
2015,528,Netherlands,Niger,270,209,61
2015,756,Switzerland,Niger,216,129,87
2015,124,Canada,Niger,1023,546,477
2019,120,Cameroon,Niger,10684,6697,3987
2019,148,Chad,Niger,3416,1572,1844
2019,710,South Africa,Niger,32,21,11
2019,204,Benin,Niger,77300,42835,34465
2019,854,Burkina Faso,Niger,13155,6829,6326
2019,384,Côte d'Ivoire,Niger,67766,50533,17233
2019,288,Ghana,Niger,6806,4891,1915
2019,324,Guinea,Niger,184,148,36
2019,430,Liberia,Niger,214,84,130
2019,466,Mali,Niger,12863,7543,5320
2019,478,Mauritania,Niger,155,83,72
2019,566,Nigeria,Niger,118119,64806,53313
2019,686,Senegal,Niger,1754,939,815
2019,694,Sierra Leone,Niger,49,31,18
2019,768,Togo,Niger,66155,36962,29193
2019,818,Egypt,Niger,115,98,17
2019,434,Libya,Niger,378,305,73
2019,196,Cyprus,Niger,7,5,2
2019,762,Tajikistan,Niger,21,11,10
2019,136,Cayman Islands,Niger,32,32,0
2019,32,Argentina,Niger,1,1,0
2019,76,Brazil,Niger,18,18,0
2019,152,Chile,Niger,40,22,18
2019,36,Australia,Niger,42,22,20
2019,100,Bulgaria,Niger,1,1,0
2019,203,Czechia,Niger,5,5,0
2019,348,Hungary,Niger,7,3,4
2019,643,Russian Federation,Niger,29,28,1
2019,208,Denmark,Niger,17,12,5
2019,246,Finland,Niger,28,20,8
2019,372,Ireland,Niger,141,54,87
2019,578,Norway,Niger,64,46,18
2019,752,Sweden,Niger,69,52,17
2019,826,United Kingdom,Niger,211,115,96
2019,300,Greece,Niger,23,16,7
2019,380,Italy,Niger,1179,954,225
2019,470,Malta,Niger,82,81,1
2019,724,Spain,Niger,290,222,68
2019,40,Austria,Niger,36,25,11
2019,56,Belgium,Niger,1989,1198,791
2019,250,France,Niger,6057,3017,3040
2019,276,Germany,Niger,1136,913,223
2019,528,Netherlands,Niger,279,214,65
2019,756,Switzerland,Niger,221,125,96
2019,124,Canada,Niger,1096,585,511
1990,508,Mozambique,Nigeria,1964,1036,928
1990,690,Seychelles,Nigeria,25,14,11
1990,800,Uganda,Nigeria,115,49,66
1990,894,Zambia,Nigeria,160,113,47
1990,120,Cameroon,Nigeria,105140,60603,44537
1990,148,Chad,Nigeria,14822,8001,6821
1990,226,Equatorial Guinea,Nigeria,91,48,43
1990,266,Gabon,Nigeria,7392,5357,2035
1990,72,Botswana,Nigeria,108,62,46
1990,516,Namibia,Nigeria,1453,885,568
1990,710,South Africa,Nigeria,16073,12492,3581
1990,204,Benin,Nigeria,15728,9404,6324
1990,854,Burkina Faso,Nigeria,2542,1177,1365
1990,132,Cabo Verde,Nigeria,84,41,43
1990,384,Côte d'Ivoire,Nigeria,31352,15798,15554
1990,288,Ghana,Nigeria,14876,7872,7004
1990,324,Guinea,Nigeria,910,670,240
1990,430,Liberia,Nigeria,2393,1483,910
1990,466,Mali,Nigeria,1590,863,727
1990,562,Niger,Nigeria,38319,15484,22835
1990,686,Senegal,Nigeria,701,515,186
1990,694,Sierra Leone,Nigeria,2116,1357,759
1990,768,Togo,Nigeria,9708,5433,4275
1990,818,Egypt,Nigeria,586,472,114
1990,434,Libya,Nigeria,1674,1351,323
1990,729,Sudan,Nigeria,23208,11928,11280
1990,788,Tunisia,Nigeria,116,58,58
1990,48,Bahrain,Nigeria,187,134,53
1990,196,Cyprus,Nigeria,76,44,32
1990,400,Jordan,Nigeria,23,14,9
1990,414,Kuwait,Nigeria,1160,703,457
1990,634,Qatar,Nigeria,311,128,183
1990,792,Turkey,Nigeria,70,61,9
1990,784,United Arab Emirates,Nigeria,1417,1009,408
1990,356,India,Nigeria,1286,734,552
1990,392,Japan,Nigeria,193,98,95
1990,608,Philippines,Nigeria,45,31,14
1990,28,Antigua and Barbuda,Nigeria,35,17,18
1990,44,Bahamas,Nigeria,30,20,10
1990,136,Cayman Islands,Nigeria,2,2,0
1990,212,Dominica,Nigeria,18,7,11
1990,214,Dominican Republic,Nigeria,42,33,9
1990,662,Saint Lucia,Nigeria,6,2,4
1990,780,Trinidad and Tobago,Nigeria,271,167,104
1990,84,Belize,Nigeria,30,25,5
1990,188,Costa Rica,Nigeria,3,2,1
1990,484,Mexico,Nigeria,69,57,12
1990,558,Nicaragua,Nigeria,11,5,6
1990,591,Panama,Nigeria,7,6,1
1990,32,Argentina,Nigeria,93,25,68
1990,68,Bolivia (Plurinational State of),Nigeria,7,3,4
1990,152,Chile,Nigeria,11,3,8
1990,170,Colombia,Nigeria,42,39,3
1990,218,Ecuador,Nigeria,17,16,1
1990,862,Venezuela (Bolivarian Republic of),Nigeria,89,69,20
1990,36,Australia,Nigeria,959,553,406
1990,100,Bulgaria,Nigeria,31,28,3
1990,203,Czechia,Nigeria,17,14,3
1990,348,Hungary,Nigeria,169,141,28
1990,616,Poland,Nigeria,281,240,41
1990,642,Romania,Nigeria,1,0,1
1990,643,Russian Federation,Nigeria,1165,572,593
1990,703,Slovakia,Nigeria,1,1,0
1990,208,Denmark,Nigeria,219,119,100
1990,246,Finland,Nigeria,94,79,15
1990,352,Iceland,Nigeria,3,2,1
1990,372,Ireland,Nigeria,837,411,426
1990,428,Latvia,Nigeria,4,3,1
1990,440,Lithuania,Nigeria,5,5,0
1990,578,Norway,Nigeria,306,221,85
1990,752,Sweden,Nigeria,550,396,154
1990,826,United Kingdom,Nigeria,45984,22988,22996
1990,300,Greece,Nigeria,1565,1213,352
1990,380,Italy,Nigeria,11859,6390,5469
1990,470,Malta,Nigeria,51,39,12
1990,620,Portugal,Nigeria,42,29,13
1990,705,Slovenia,Nigeria,2,1,1
1990,724,Spain,Nigeria,704,508,196
1990,40,Austria,Nigeria,4673,3239,1434
1990,56,Belgium,Nigeria,1443,887,556
1990,250,France,Nigeria,2710,1510,1200
1990,276,Germany,Nigeria,13230,10044,3186
1990,528,Netherlands,Nigeria,1410,918,492
1990,756,Switzerland,Nigeria,1315,911,404
1990,60,Bermuda,Nigeria,25,18,7
1990,124,Canada,Nigeria,3004,1463,1541
1990,840,United States of America,Nigeria,55350,36436,18914
1995,508,Mozambique,Nigeria,2702,1431,1271
1995,690,Seychelles,Nigeria,32,19,13
1995,800,Uganda,Nigeria,108,44,64
1995,894,Zambia,Nigeria,148,105,43
1995,120,Cameroon,Nigeria,97818,56266,41552
1995,148,Chad,Nigeria,16104,8683,7421
1995,226,Equatorial Guinea,Nigeria,121,63,58
1995,266,Gabon,Nigeria,9887,7164,2723
1995,72,Botswana,Nigeria,187,102,85
1995,516,Namibia,Nigeria,1389,850,539
1995,710,South Africa,Nigeria,10027,7974,2053
1995,204,Benin,Nigeria,21661,13062,8599
1995,854,Burkina Faso,Nigeria,3161,1466,1695
1995,132,Cabo Verde,Nigeria,114,57,57
1995,384,Côte d'Ivoire,Nigeria,36486,18250,18236
1995,288,Ghana,Nigeria,14826,8515,6311
1995,324,Guinea,Nigeria,1049,803,246
1995,430,Liberia,Nigeria,2337,1428,909
1995,466,Mali,Nigeria,1663,903,760
1995,562,Niger,Nigeria,28313,12483,15830
1995,686,Senegal,Nigeria,733,538,195
1995,694,Sierra Leone,Nigeria,2063,1302,761
1995,768,Togo,Nigeria,11900,6660,5240
1995,818,Egypt,Nigeria,567,432,135
1995,434,Libya,Nigeria,1870,1416,454
1995,729,Sudan,Nigeria,23677,12199,11478
1995,788,Tunisia,Nigeria,119,60,59
1995,48,Bahrain,Nigeria,205,145,60
1995,196,Cyprus,Nigeria,108,61,47
1995,400,Jordan,Nigeria,28,18,10
1995,414,Kuwait,Nigeria,929,593,336
1995,634,Qatar,Nigeria,282,142,140
1995,792,Turkey,Nigeria,170,148,22
1995,784,United Arab Emirates,Nigeria,1815,1300,515
1995,356,India,Nigeria,1038,570,468
1995,392,Japan,Nigeria,1269,608,661
1995,410,Republic of Korea,Nigeria,150,116,34
1995,608,Philippines,Nigeria,60,41,19
1995,28,Antigua and Barbuda,Nigeria,34,16,18
1995,44,Bahamas,Nigeria,61,42,19
1995,136,Cayman Islands,Nigeria,6,6,0
1995,212,Dominica,Nigeria,24,9,15
1995,214,Dominican Republic,Nigeria,47,37,10
1995,662,Saint Lucia,Nigeria,7,2,5
1995,780,Trinidad and Tobago,Nigeria,246,152,94
1995,84,Belize,Nigeria,31,25,6
1995,188,Costa Rica,Nigeria,2,1,1
1995,484,Mexico,Nigeria,55,44,11
1995,558,Nicaragua,Nigeria,9,4,5
1995,591,Panama,Nigeria,9,8,1
1995,32,Argentina,Nigeria,91,25,66
1995,68,Bolivia (Plurinational State of),Nigeria,10,6,4
1995,152,Chile,Nigeria,15,13,2
1995,170,Colombia,Nigeria,41,38,3
1995,218,Ecuador,Nigeria,19,18,1
1995,862,Venezuela (Bolivarian Republic of),Nigeria,87,68,19
1995,36,Australia,Nigeria,1431,860,571
1995,100,Bulgaria,Nigeria,38,33,5
1995,203,Czechia,Nigeria,25,21,4
1995,348,Hungary,Nigeria,484,339,145
1995,616,Poland,Nigeria,240,205,35
1995,642,Romania,Nigeria,1,1,0
1995,643,Russian Federation,Nigeria,1039,599,440
1995,703,Slovakia,Nigeria,30,29,1
1995,208,Denmark,Nigeria,389,232,157
1995,246,Finland,Nigeria,170,145,25
1995,352,Iceland,Nigeria,18,12,6
1995,372,Ireland,Nigeria,4542,2160,2382
1995,428,Latvia,Nigeria,6,5,1
1995,440,Lithuania,Nigeria,5,5,0
1995,578,Norway,Nigeria,370,257,113
1995,752,Sweden,Nigeria,653,468,185
1995,826,United Kingdom,Nigeria,65168,32488,32680
1995,300,Greece,Nigeria,1705,1274,431
1995,380,Italy,Nigeria,19320,8126,11194
1995,470,Malta,Nigeria,60,46,14
1995,620,Portugal,Nigeria,91,63,28
1995,705,Slovenia,Nigeria,4,3,1
1995,724,Spain,Nigeria,1884,1418,466
1995,40,Austria,Nigeria,5273,3681,1592
1995,56,Belgium,Nigeria,1434,881,553
1995,250,France,Nigeria,2798,1538,1260
1995,276,Germany,Nigeria,14054,10762,3292
1995,528,Netherlands,Nigeria,2580,1656,924
1995,756,Switzerland,Nigeria,1817,1297,520
1995,60,Bermuda,Nigeria,47,34,13
1995,124,Canada,Nigeria,6587,3184,3403
1995,840,United States of America,Nigeria,96418,63852,32566
2000,508,Mozambique,Nigeria,3143,1616,1527
2000,690,Seychelles,Nigeria,40,25,15
2000,800,Uganda,Nigeria,4,3,1
2000,894,Zambia,Nigeria,138,98,40
2000,120,Cameroon,Nigeria,90495,51929,38566
2000,148,Chad,Nigeria,17386,9365,8021
2000,226,Equatorial Guinea,Nigeria,150,78,72
2000,266,Gabon,Nigeria,12367,8984,3383
2000,72,Botswana,Nigeria,285,153,132
2000,516,Namibia,Nigeria,1290,790,500
2000,710,South Africa,Nigeria,6932,5720,1212
2000,204,Benin,Nigeria,27595,16721,10874
2000,854,Burkina Faso,Nigeria,3801,1778,2023
2000,132,Cabo Verde,Nigeria,144,74,70
2000,384,Côte d'Ivoire,Nigeria,38019,19006,19013
2000,288,Ghana,Nigeria,16584,8877,7707
2000,324,Guinea,Nigeria,734,562,172
2000,430,Liberia,Nigeria,2294,1377,917
2000,466,Mali,Nigeria,1524,831,693
2000,562,Niger,Nigeria,18540,9583,8957
2000,686,Senegal,Nigeria,663,478,185
2000,694,Sierra Leone,Nigeria,2012,1249,763
2000,768,Togo,Nigeria,16087,8564,7523
2000,818,Egypt,Nigeria,593,426,167
2000,434,Libya,Nigeria,2098,1516,582
2000,729,Sudan,Nigeria,24143,12462,11681
2000,788,Tunisia,Nigeria,133,68,65
2000,48,Bahrain,Nigeria,224,155,69
2000,196,Cyprus,Nigeria,139,77,62
2000,400,Jordan,Nigeria,32,21,11
2000,414,Kuwait,Nigeria,1060,716,344
2000,634,Qatar,Nigeria,211,135,76
2000,792,Turkey,Nigeria,272,235,37
2000,784,United Arab Emirates,Nigeria,2319,1661,658
2000,356,India,Nigeria,790,407,383
2000,392,Japan,Nigeria,1741,804,937
2000,410,Republic of Korea,Nigeria,348,270,78
2000,608,Philippines,Nigeria,321,176,145
2000,28,Antigua and Barbuda,Nigeria,33,15,18
2000,44,Bahamas,Nigeria,93,66,27
2000,136,Cayman Islands,Nigeria,11,11,0
2000,212,Dominica,Nigeria,29,11,18
2000,214,Dominican Republic,Nigeria,51,40,11
2000,662,Saint Lucia,Nigeria,10,3,7
2000,780,Trinidad and Tobago,Nigeria,267,165,102
2000,84,Belize,Nigeria,32,26,6
2000,188,Costa Rica,Nigeria,2,0,2
2000,484,Mexico,Nigeria,44,33,11
2000,558,Nicaragua,Nigeria,15,6,9
2000,591,Panama,Nigeria,13,11,2
2000,32,Argentina,Nigeria,89,26,63
2000,68,Bolivia (Plurinational State of),Nigeria,12,9,3
2000,152,Chile,Nigeria,20,16,4
2000,170,Colombia,Nigeria,40,37,3
2000,218,Ecuador,Nigeria,21,20,1
2000,862,Venezuela (Bolivarian Republic of),Nigeria,86,67,19
2000,36,Australia,Nigeria,1800,1104,696
2000,100,Bulgaria,Nigeria,45,39,6
2000,203,Czechia,Nigeria,33,28,5
2000,348,Hungary,Nigeria,799,537,262
2000,616,Poland,Nigeria,205,174,31
2000,642,Romania,Nigeria,1,1,0
2000,643,Russian Federation,Nigeria,876,604,272
2000,703,Slovakia,Nigeria,69,65,4
2000,208,Denmark,Nigeria,558,345,213
2000,246,Finland,Nigeria,245,210,35
2000,352,Iceland,Nigeria,33,23,10
2000,372,Ireland,Nigeria,10745,5287,5458
2000,428,Latvia,Nigeria,8,7,1
2000,440,Lithuania,Nigeria,3,3,0
2000,578,Norway,Nigeria,414,269,145
2000,752,Sweden,Nigeria,701,501,200
2000,826,United Kingdom,Nigeria,85449,42450,42999
2000,300,Greece,Nigeria,1872,1348,524
2000,380,Italy,Nigeria,26781,9863,16918
2000,470,Malta,Nigeria,76,59,17
2000,620,Portugal,Nigeria,145,99,46
2000,705,Slovenia,Nigeria,8,4,4
2000,724,Spain,Nigeria,3876,2952,924
2000,40,Austria,Nigeria,5872,4123,1749
2000,56,Belgium,Nigeria,1382,849,533
2000,250,France,Nigeria,2886,1567,1319
2000,276,Germany,Nigeria,14877,11479,3398
2000,528,Netherlands,Nigeria,3836,2445,1391
2000,756,Switzerland,Nigeria,2326,1689,637
2000,60,Bermuda,Nigeria,68,49,19
2000,124,Canada,Nigeria,10326,4981,5345
2000,840,United States of America,Nigeria,138366,91915,46451
2005,508,Mozambique,Nigeria,4251,1993,2258
2005,690,Seychelles,Nigeria,81,30,51
2005,800,Uganda,Nigeria,3,3,0
2005,894,Zambia,Nigeria,263,187,76
2005,120,Cameroon,Nigeria,101721,57127,44594
2005,148,Chad,Nigeria,2027,919,1108
2005,226,Equatorial Guinea,Nigeria,219,116,103
2005,266,Gabon,Nigeria,13486,9834,3652
2005,72,Botswana,Nigeria,422,224,198
2005,516,Namibia,Nigeria,1020,623,397
2005,710,South Africa,Nigeria,9146,7463,1683
2005,204,Benin,Nigeria,47531,25347,22184
2005,854,Burkina Faso,Nigeria,4380,2045,2335
2005,132,Cabo Verde,Nigeria,395,189,206
2005,384,Côte d'Ivoire,Nigeria,39801,19897,19904
2005,288,Ghana,Nigeria,23321,13134,10187
2005,324,Guinea,Nigeria,513,423,90
2005,430,Liberia,Nigeria,2713,2184,529
2005,466,Mali,Nigeria,6216,3299,2917
2005,562,Niger,Nigeria,18873,9745,9128
2005,686,Senegal,Nigeria,712,520,192
2005,694,Sierra Leone,Nigeria,1922,1433,489
2005,768,Togo,Nigeria,26919,14196,12723
2005,818,Egypt,Nigeria,706,519,187
2005,434,Libya,Nigeria,2311,1784,527
2005,729,Sudan,Nigeria,25762,13295,12467
2005,788,Tunisia,Nigeria,128,66,62
2005,48,Bahrain,Nigeria,631,427,204
2005,196,Cyprus,Nigeria,203,111,92
2005,400,Jordan,Nigeria,46,33,13
2005,414,Kuwait,Nigeria,1144,755,389
2005,634,Qatar,Nigeria,909,671,238
2005,792,Turkey,Nigeria,280,242,38
2005,784,United Arab Emirates,Nigeria,5207,3590,1617
2005,356,India,Nigeria,730,375,355
2005,392,Japan,Nigeria,2574,1172,1402
2005,410,Republic of Korea,Nigeria,643,499,144
2005,608,Philippines,Nigeria,259,144,115
2005,28,Antigua and Barbuda,Nigeria,36,16,20
2005,44,Bahamas,Nigeria,121,72,49
2005,136,Cayman Islands,Nigeria,10,10,0
2005,212,Dominica,Nigeria,35,14,21
2005,214,Dominican Republic,Nigeria,38,30,8
2005,662,Saint Lucia,Nigeria,43,12,31
2005,780,Trinidad and Tobago,Nigeria,286,177,109
2005,84,Belize,Nigeria,35,29,6
2005,188,Costa Rica,Nigeria,1,0,1
2005,484,Mexico,Nigeria,86,68,18
2005,558,Nicaragua,Nigeria,22,8,14
2005,591,Panama,Nigeria,21,17,4
2005,32,Argentina,Nigeria,66,20,46
2005,68,Bolivia (Plurinational State of),Nigeria,12,10,2
2005,152,Chile,Nigeria,30,25,5
2005,170,Colombia,Nigeria,38,35,3
2005,218,Ecuador,Nigeria,24,23,1
2005,862,Venezuela (Bolivarian Republic of),Nigeria,90,71,19
2005,36,Australia,Nigeria,2580,1551,1029
2005,100,Bulgaria,Nigeria,59,50,9
2005,203,Czechia,Nigeria,275,235,40
2005,348,Hungary,Nigeria,987,669,318
2005,616,Poland,Nigeria,295,277,18
2005,642,Romania,Nigeria,1,1,0
2005,643,Russian Federation,Nigeria,837,624,213
2005,703,Slovakia,Nigeria,78,73,5
2005,208,Denmark,Nigeria,838,508,330
2005,246,Finland,Nigeria,848,701,147
2005,352,Iceland,Nigeria,46,28,18
2005,372,Ireland,Nigeria,17533,8515,9018
2005,428,Latvia,Nigeria,10,10,0
2005,440,Lithuania,Nigeria,16,16,0
2005,578,Norway,Nigeria,584,370,214
2005,752,Sweden,Nigeria,1444,1082,362
2005,826,United Kingdom,Nigeria,133542,67665,65877
2005,191,Croatia,Nigeria,15,9,6
2005,300,Greece,Nigeria,2396,1619,777
2005,380,Italy,Nigeria,41515,18166,23349
2005,470,Malta,Nigeria,90,69,21
2005,620,Portugal,Nigeria,207,138,69
2005,705,Slovenia,Nigeria,15,10,5
2005,724,Spain,Nigeria,24338,15238,9100
2005,40,Austria,Nigeria,6563,4561,2002
2005,56,Belgium,Nigeria,2752,1393,1359
2005,250,France,Nigeria,3986,2009,1977
2005,276,Germany,Nigeria,18538,13038,5500
2005,528,Netherlands,Nigeria,4967,2971,1996
2005,756,Switzerland,Nigeria,2627,1853,774
2005,60,Bermuda,Nigeria,127,79,48
2005,124,Canada,Nigeria,19968,10329,9639
2005,840,United States of America,Nigeria,174148,87229,86919
2010,508,Mozambique,Nigeria,4923,2308,2615
2010,690,Seychelles,Nigeria,122,34,88
2010,728,South Sudan,Nigeria,3635,2091,1544
2010,800,Uganda,Nigeria,3,3,0
2010,894,Zambia,Nigeria,508,285,223
2010,120,Cameroon,Nigeria,82748,49494,33254
2010,148,Chad,Nigeria,2401,1075,1326
2010,226,Equatorial Guinea,Nigeria,287,154,133
2010,266,Gabon,Nigeria,15619,11471,4148
2010,72,Botswana,Nigeria,1060,550,510
2010,516,Namibia,Nigeria,982,601,381
2010,710,South Africa,Nigeria,14327,11682,2645
2010,204,Benin,Nigeria,67553,33929,33624
2010,854,Burkina Faso,Nigeria,4944,2296,2648
2010,132,Cabo Verde,Nigeria,645,303,342
2010,384,Côte d'Ivoire,Nigeria,41583,20780,20803
2010,288,Ghana,Nigeria,57056,32812,24244
2010,324,Guinea,Nigeria,359,296,63
2010,430,Liberia,Nigeria,4922,3829,1093
2010,466,Mali,Nigeria,2982,1535,1447
2010,562,Niger,Nigeria,19177,9889,9288
2010,686,Senegal,Nigeria,797,591,206
2010,694,Sierra Leone,Nigeria,2112,1427,685
2010,768,Togo,Nigeria,29347,16721,12626
2010,818,Egypt,Nigeria,762,552,210
2010,434,Libya,Nigeria,2528,1957,571
2010,729,Sudan,Nigeria,16214,8364,7850
2010,788,Tunisia,Nigeria,420,216,204
2010,48,Bahrain,Nigeria,1179,794,385
2010,196,Cyprus,Nigeria,332,184,148
2010,400,Jordan,Nigeria,59,43,16
2010,414,Kuwait,Nigeria,1515,987,528
2010,634,Qatar,Nigeria,2347,1881,466
2010,792,Turkey,Nigeria,292,251,41
2010,784,United Arab Emirates,Nigeria,13178,9228,3950
2010,356,India,Nigeria,670,344,326
2010,392,Japan,Nigeria,2729,1227,1502
2010,410,Republic of Korea,Nigeria,1194,916,278
2010,608,Philippines,Nigeria,189,102,87
2010,28,Antigua and Barbuda,Nigeria,38,17,21
2010,44,Bahamas,Nigeria,148,77,71
2010,136,Cayman Islands,Nigeria,10,10,0
2010,212,Dominica,Nigeria,43,17,26
2010,214,Dominican Republic,Nigeria,24,19,5
2010,662,Saint Lucia,Nigeria,73,20,53
2010,780,Trinidad and Tobago,Nigeria,485,309,176
2010,84,Belize,Nigeria,38,32,6
2010,188,Costa Rica,Nigeria,3,0,3
2010,484,Mexico,Nigeria,138,109,29
2010,558,Nicaragua,Nigeria,23,9,14
2010,591,Panama,Nigeria,32,25,7
2010,32,Argentina,Nigeria,43,14,29
2010,68,Bolivia (Plurinational State of),Nigeria,11,11,0
2010,76,Brazil,Nigeria,1109,823,286
2010,152,Chile,Nigeria,40,33,7
2010,170,Colombia,Nigeria,43,40,3
2010,218,Ecuador,Nigeria,34,33,1
2010,862,Venezuela (Bolivarian Republic of),Nigeria,100,78,22
2010,36,Australia,Nigeria,4640,2740,1900
2010,100,Bulgaria,Nigeria,71,60,11
2010,203,Czechia,Nigeria,490,420,70
2010,348,Hungary,Nigeria,1175,801,374
2010,616,Poland,Nigeria,395,388,7
2010,642,Romania,Nigeria,5,4,1
2010,643,Russian Federation,Nigeria,781,631,150
2010,703,Slovakia,Nigeria,87,82,5
2010,208,Denmark,Nigeria,1098,661,437
2010,233,Estonia,Nigeria,14,10,4
2010,246,Finland,Nigeria,1595,1301,294
2010,352,Iceland,Nigeria,59,34,25
2010,372,Ireland,Nigeria,21433,9196,12237
2010,428,Latvia,Nigeria,12,12,0
2010,440,Lithuania,Nigeria,28,28,0
2010,578,Norway,Nigeria,1012,610,402
2010,752,Sweden,Nigeria,2997,2106,891
2010,826,United Kingdom,Nigeria,162051,78067,83984
2010,191,Croatia,Nigeria,29,17,12
2010,300,Greece,Nigeria,3038,1968,1070
2010,380,Italy,Nigeria,53072,24219,28853
2010,470,Malta,Nigeria,275,140,135
2010,620,Portugal,Nigeria,235,154,81
2010,705,Slovenia,Nigeria,27,18,9
2010,724,Spain,Nigeria,36852,22825,14027
2010,40,Austria,Nigeria,7254,5000,2254
2010,56,Belgium,Nigeria,3949,1893,2056
2010,250,France,Nigeria,5415,2885,2530
2010,276,Germany,Nigeria,21539,14337,7202
2010,528,Netherlands,Nigeria,6310,3583,2727
2010,756,Switzerland,Nigeria,3073,2138,935
2010,60,Bermuda,Nigeria,185,108,77
2010,124,Canada,Nigeria,27625,14636,12989
2010,840,United States of America,Nigeria,216209,106813,109396
2015,508,Mozambique,Nigeria,5169,2424,2745
2015,690,Seychelles,Nigeria,136,43,93
2015,728,South Sudan,Nigeria,3537,2131,1406
2015,800,Uganda,Nigeria,3,3,0
2015,894,Zambia,Nigeria,447,250,197
2015,120,Cameroon,Nigeria,134610,60575,74035
2015,148,Chad,Nigeria,2977,1371,1606
2015,226,Equatorial Guinea,Nigeria,359,195,164
2015,266,Gabon,Nigeria,21840,16850,4990
2015,72,Botswana,Nigeria,1156,599,557
2015,516,Namibia,Nigeria,961,590,371
2015,710,South Africa,Nigeria,25842,20829,5013
2015,204,Benin,Nigeria,80960,40604,40356
2015,854,Burkina Faso,Nigeria,5170,2401,2769
2015,132,Cabo Verde,Nigeria,670,314,356
2015,384,Côte d'Ivoire,Nigeria,43365,21671,21694
2015,288,Ghana,Nigeria,70214,40371,29843
2015,324,Guinea,Nigeria,381,314,67
2015,430,Liberia,Nigeria,5649,4384,1265
2015,466,Mali,Nigeria,3694,1902,1792
2015,562,Niger,Nigeria,93179,45658,47521
2015,686,Senegal,Nigeria,829,619,210
2015,694,Sierra Leone,Nigeria,2022,1237,785
2015,768,Togo,Nigeria,31974,18046,13928
2015,818,Egypt,Nigeria,564,429,135
2015,434,Libya,Nigeria,2850,2198,652
2015,729,Sudan,Nigeria,14828,7655,7173
2015,788,Tunisia,Nigeria,542,280,262
2015,48,Bahrain,Nigeria,1952,1305,647
2015,196,Cyprus,Nigeria,318,177,141
2015,400,Jordan,Nigeria,25,17,8
2015,414,Kuwait,Nigeria,4441,2681,1760
2015,634,Qatar,Nigeria,4071,3316,755
2015,792,Turkey,Nigeria,880,586,294
2015,784,United Arab Emirates,Nigeria,14399,9913,4486
2015,356,India,Nigeria,645,331,314
2015,392,Japan,Nigeria,2638,1178,1460
2015,410,Republic of Korea,Nigeria,1483,1130,353
2015,608,Philippines,Nigeria,192,103,89
2015,28,Antigua and Barbuda,Nigeria,40,18,22
2015,44,Bahamas,Nigeria,160,83,77
2015,136,Cayman Islands,Nigeria,9,9,0
2015,212,Dominica,Nigeria,50,20,30
2015,214,Dominican Republic,Nigeria,25,20,5
2015,662,Saint Lucia,Nigeria,69,19,50
2015,780,Trinidad and Tobago,Nigeria,502,323,179
2015,84,Belize,Nigeria,44,37,7
2015,188,Costa Rica,Nigeria,3,0,3
2015,484,Mexico,Nigeria,146,115,31
2015,558,Nicaragua,Nigeria,24,9,15
2015,591,Panama,Nigeria,37,28,9
2015,32,Argentina,Nigeria,43,14,29
2015,68,Bolivia (Plurinational State of),Nigeria,13,13,0
2015,76,Brazil,Nigeria,1335,991,344
2015,152,Chile,Nigeria,60,50,10
2015,170,Colombia,Nigeria,48,45,3
2015,218,Ecuador,Nigeria,25,14,11
2015,862,Venezuela (Bolivarian Republic of),Nigeria,105,81,24
2015,36,Australia,Nigeria,8360,5073,3287
2015,100,Bulgaria,Nigeria,141,118,23
2015,203,Czechia,Nigeria,604,514,90
2015,348,Hungary,Nigeria,1547,982,565
2015,616,Poland,Nigeria,380,374,6
2015,642,Romania,Nigeria,170,59,111
2015,643,Russian Federation,Nigeria,796,643,153
2015,703,Slovakia,Nigeria,111,104,7
2015,208,Denmark,Nigeria,1465,896,569
2015,233,Estonia,Nigeria,118,99,19
2015,246,Finland,Nigeria,2704,1989,715
2015,352,Iceland,Nigeria,72,46,26
2015,372,Ireland,Nigeria,21894,9239,12655
2015,428,Latvia,Nigeria,13,12,1
2015,440,Lithuania,Nigeria,15,15,0
2015,578,Norway,Nigeria,1795,1049,746
2015,752,Sweden,Nigeria,4669,2996,1673
2015,826,United Kingdom,Nigeria,181136,90055,91081
2015,191,Croatia,Nigeria,29,17,12
2015,300,Greece,Nigeria,2851,1804,1047
2015,380,Italy,Nigeria,58477,27818,30659
2015,470,Malta,Nigeria,471,338,133
2015,620,Portugal,Nigeria,265,170,95
2015,705,Slovenia,Nigeria,49,37,12
2015,724,Spain,Nigeria,30198,17608,12590
2015,40,Austria,Nigeria,8485,5863,2622
2015,56,Belgium,Nigeria,5539,2713,2826
2015,250,France,Nigeria,5998,3118,2880
2015,276,Germany,Nigeria,22442,14921,7521
2015,528,Netherlands,Nigeria,7079,3856,3223
2015,756,Switzerland,Nigeria,3786,2548,1238
2015,60,Bermuda,Nigeria,188,110,78
2015,124,Canada,Nigeria,42169,21687,20482
2015,840,United States of America,Nigeria,286784,140934,145850
2019,508,Mozambique,Nigeria,5375,2521,2854
2019,690,Seychelles,Nigeria,137,44,93
2019,728,South Sudan,Nigeria,3626,2184,1442
2019,800,Uganda,Nigeria,3,3,0
2019,894,Zambia,Nigeria,576,323,253
2019,120,Cameroon,Nigeria,148076,66635,81441
2019,148,Chad,Nigeria,3265,1503,1762
2019,226,Equatorial Guinea,Nigeria,394,214,180
2019,266,Gabon,Nigeria,23730,18304,5426
2019,72,Botswana,Nigeria,1238,642,596
2019,516,Namibia,Nigeria,1017,625,392
2019,710,South Africa,Nigeria,28965,23352,5613
2019,204,Benin,Nigeria,86226,43317,42909
2019,854,Burkina Faso,Nigeria,5331,2477,2854
2019,132,Cabo Verde,Nigeria,703,330,373
2019,384,Côte d'Ivoire,Nigeria,44791,22384,22407
2019,288,Ghana,Nigeria,79023,45508,33515
2019,324,Guinea,Nigeria,363,300,63
2019,430,Liberia,Nigeria,4689,3639,1050
2019,466,Mali,Nigeria,4113,2118,1995
2019,562,Niger,Nigeria,130982,64182,66800
2019,686,Senegal,Nigeria,853,638,215
2019,694,Sierra Leone,Nigeria,2041,1179,862
2019,768,Togo,Nigeria,32176,18247,13929
2019,818,Egypt,Nigeria,803,588,215
2019,434,Libya,Nigeria,3023,2332,691
2019,729,Sudan,Nigeria,18285,9302,8983
2019,788,Tunisia,Nigeria,550,284,266
2019,48,Bahrain,Nigeria,2054,1373,681
2019,196,Cyprus,Nigeria,317,178,139
2019,400,Jordan,Nigeria,26,18,8
2019,414,Kuwait,Nigeria,4702,2839,1863
2019,634,Qatar,Nigeria,4152,3327,825
2019,792,Turkey,Nigeria,1189,796,393
2019,784,United Arab Emirates,Nigeria,15465,10646,4819
2019,356,India,Nigeria,634,327,307
2019,392,Japan,Nigeria,2933,1310,1623
2019,410,Republic of Korea,Nigeria,1509,1150,359
2019,608,Philippines,Nigeria,198,107,91
2019,28,Antigua and Barbuda,Nigeria,41,19,22
2019,44,Bahamas,Nigeria,169,88,81
2019,136,Cayman Islands,Nigeria,10,10,0
2019,212,Dominica,Nigeria,51,21,30
2019,214,Dominican Republic,Nigeria,25,20,5
2019,662,Saint Lucia,Nigeria,66,19,47
2019,780,Trinidad and Tobago,Nigeria,540,357,183
2019,84,Belize,Nigeria,48,41,7
2019,188,Costa Rica,Nigeria,3,0,3
2019,484,Mexico,Nigeria,150,119,31
2019,558,Nicaragua,Nigeria,25,10,15
2019,591,Panama,Nigeria,37,30,7
2019,32,Argentina,Nigeria,43,14,29
2019,68,Bolivia (Plurinational State of),Nigeria,14,14,0
2019,76,Brazil,Nigeria,1503,1116,387
2019,152,Chile,Nigeria,80,66,14
2019,170,Colombia,Nigeria,49,46,3
2019,218,Ecuador,Nigeria,36,19,17
2019,862,Venezuela (Bolivarian Republic of),Nigeria,102,79,23
2019,36,Australia,Nigeria,12135,7299,4836
2019,100,Bulgaria,Nigeria,191,148,43
2019,203,Czechia,Nigeria,695,571,124
2019,348,Hungary,Nigeria,1683,1096,587
2019,616,Poland,Nigeria,402,396,6
2019,642,Romania,Nigeria,411,215,196
2019,643,Russian Federation,Nigeria,795,643,152
2019,703,Slovakia,Nigeria,132,124,8
2019,208,Denmark,Nigeria,1693,993,700
2019,233,Estonia,Nigeria,305,244,61
2019,246,Finland,Nigeria,3517,2455,1062
2019,352,Iceland,Nigeria,110,69,41
2019,372,Ireland,Nigeria,24036,10185,13851
2019,428,Latvia,Nigeria,19,18,1
2019,440,Lithuania,Nigeria,2,0,2
2019,578,Norway,Nigeria,1997,1138,859
2019,752,Sweden,Nigeria,6248,3854,2394
2019,826,United Kingdom,Nigeria,205698,102528,103170
2019,191,Croatia,Nigeria,26,15,11
2019,300,Greece,Nigeria,2784,1801,983
2019,380,Italy,Nigeria,80235,45157,35078
2019,470,Malta,Nigeria,760,547,213
2019,620,Portugal,Nigeria,269,173,96
2019,705,Slovenia,Nigeria,62,49,13
2019,724,Spain,Nigeria,29204,16483,12721
2019,40,Austria,Nigeria,10016,6975,3041
2019,56,Belgium,Nigeria,6203,3038,3165
2019,250,France,Nigeria,6348,3293,3055
2019,276,Germany,Nigeria,44015,28696,15319
2019,528,Netherlands,Nigeria,7575,4176,3399
2019,756,Switzerland,Nigeria,3879,2508,1371
2019,60,Bermuda,Nigeria,190,112,78
2019,124,Canada,Nigeria,45188,23240,21948
2019,840,United States of America,Nigeria,309699,150500,159199
1990,710,South Africa,Niue,21,10,11
1990,152,Chile,Niue,2,0,2
1990,36,Australia,Niue,243,124,119
1990,554,New Zealand,Niue,5578,2688,2890
1990,184,Cook Islands,Niue,9,7,2
1990,882,Samoa,Niue,7,3,4
1995,710,South Africa,Niue,13,7,6
1995,68,Bolivia (Plurinational State of),Niue,41,21,20
1995,152,Chile,Niue,3,1,2
1995,36,Australia,Niue,367,167,200
1995,554,New Zealand,Niue,5133,2442,2691
1995,184,Cook Islands,Niue,10,8,2
1995,882,Samoa,Niue,7,3,4
2000,710,South Africa,Niue,9,7,2
2000,68,Bolivia (Plurinational State of),Niue,81,41,40
2000,152,Chile,Niue,5,1,4
2000,36,Australia,Niue,460,209,251
2000,554,New Zealand,Niue,5181,2519,2662
2000,184,Cook Islands,Niue,10,8,2
2000,882,Samoa,Niue,8,4,4
2005,710,South Africa,Niue,11,8,3
2005,68,Bolivia (Plurinational State of),Niue,41,20,21
2005,152,Chile,Niue,7,2,5
2005,36,Australia,Niue,580,295,285
2005,554,New Zealand,Niue,4639,2252,2387
2005,184,Cook Islands,Niue,13,10,3
2005,882,Samoa,Niue,7,3,4
2010,710,South Africa,Niue,17,13,4
2010,68,Bolivia (Plurinational State of),Niue,1,0,1
2010,152,Chile,Niue,10,3,7
2010,36,Australia,Niue,770,383,387
2010,554,New Zealand,Niue,4537,2199,2338
2010,184,Cook Islands,Niue,16,12,4
2010,882,Samoa,Niue,7,3,4
2015,710,South Africa,Niue,29,23,6
2015,68,Bolivia (Plurinational State of),Niue,1,0,1
2015,152,Chile,Niue,15,5,10
2015,36,Australia,Niue,940,479,461
2015,554,New Zealand,Niue,4364,2111,2253
2015,184,Cook Islands,Niue,14,11,3
2015,882,Samoa,Niue,6,3,3
2019,710,South Africa,Niue,32,26,6
2019,68,Bolivia (Plurinational State of),Niue,1,0,1
2019,152,Chile,Niue,20,6,14
2019,36,Australia,Niue,1036,533,503
2019,554,New Zealand,Niue,4485,2170,2315
2019,184,Cook Islands,Niue,14,11,3
2019,882,Samoa,Niue,5,3,2
1990,710,South Africa,North Macedonia,59,46,13
1990,818,Egypt,North Macedonia,147,89,58
1990,196,Cyprus,North Macedonia,5,2,3
1990,400,Jordan,North Macedonia,208,52,156
1990,792,Turkey,North Macedonia,37647,19251,18396
1990,496,Mongolia,North Macedonia,12,10,2
1990,214,Dominican Republic,North Macedonia,6,6,0
1990,188,Costa Rica,North Macedonia,26,17,9
1990,32,Argentina,North Macedonia,13164,6446,6718
1990,152,Chile,North Macedonia,226,107,119
1990,218,Ecuador,North Macedonia,29,19,10
1990,36,Australia,North Macedonia,40724,21072,19652
1990,100,Bulgaria,North Macedonia,1018,569,449
1990,203,Czechia,North Macedonia,131,105,26
1990,348,Hungary,North Macedonia,46027,20451,25576
1990,616,Poland,North Macedonia,291,191,100
1990,642,Romania,North Macedonia,3205,1366,1839
1990,643,Russian Federation,North Macedonia,359,176,183
1990,703,Slovakia,North Macedonia,54,41,13
1990,208,Denmark,North Macedonia,1151,586,565
1990,352,Iceland,North Macedonia,7,4,3
1990,372,Ireland,North Macedonia,126,73,53
1990,752,Sweden,North Macedonia,1856,981,875
1990,826,United Kingdom,North Macedonia,347,214,133
1990,8,Albania,North Macedonia,678,301,377
1990,70,Bosnia and Herzegovina,North Macedonia,2468,1184,1284
1990,191,Croatia,North Macedonia,12962,6891,6071
1990,300,Greece,North Macedonia,4152,2300,1852
1990,380,Italy,North Macedonia,72688,32775,39913
1990,470,Malta,North Macedonia,14,6,8
1990,620,Portugal,North Macedonia,3,2,1
1990,688,Serbia,North Macedonia,6395,2752,3643
1990,705,Slovenia,North Macedonia,6720,3435,3285
1990,724,Spain,North Macedonia,39,20,19
1990,40,Austria,North Macedonia,12075,6624,5451
1990,56,Belgium,North Macedonia,81,44,37
1990,250,France,North Macedonia,74534,38118,36416
1990,276,Germany,North Macedonia,35938,20280,15658
1990,438,Liechtenstein,North Macedonia,436,247,189
1990,442,Luxembourg,North Macedonia,1957,1118,839
1990,528,Netherlands,North Macedonia,5,3,2
1990,756,Switzerland,North Macedonia,36819,20583,16236
1990,124,Canada,North Macedonia,7038,3426,3612
1990,840,United States of America,North Macedonia,10469,5121,5348
1995,710,South Africa,North Macedonia,48,38,10
1995,818,Egypt,North Macedonia,113,67,46
1995,196,Cyprus,North Macedonia,7,2,5
1995,400,Jordan,North Macedonia,158,41,117
1995,792,Turkey,North Macedonia,84307,41060,43247
1995,496,Mongolia,North Macedonia,13,12,1
1995,214,Dominican Republic,North Macedonia,7,7,0
1995,188,Costa Rica,North Macedonia,18,11,7
1995,32,Argentina,North Macedonia,8143,3903,4240
1995,152,Chile,North Macedonia,312,144,168
1995,218,Ecuador,North Macedonia,15,9,6
1995,36,Australia,North Macedonia,46518,23997,22521
1995,100,Bulgaria,North Macedonia,1247,679,568
1995,203,Czechia,North Macedonia,197,158,39
1995,348,Hungary,North Macedonia,23063,10257,12806
1995,616,Poland,North Macedonia,248,162,86
1995,642,Romania,North Macedonia,1849,812,1037
1995,643,Russian Federation,North Macedonia,301,184,117
1995,703,Slovakia,North Macedonia,231,153,78
1995,208,Denmark,North Macedonia,1237,631,606
1995,352,Iceland,North Macedonia,9,5,4
1995,372,Ireland,North Macedonia,349,197,152
1995,578,Norway,North Macedonia,26,14,12
1995,752,Sweden,North Macedonia,2202,1156,1046
1995,826,United Kingdom,North Macedonia,787,335,452
1995,8,Albania,North Macedonia,732,327,405
1995,70,Bosnia and Herzegovina,North Macedonia,3126,1498,1628
1995,191,Croatia,North Macedonia,11990,6247,5743
1995,300,Greece,North Macedonia,2519,1404,1115
1995,380,Italy,North Macedonia,58600,29294,29306
1995,470,Malta,North Macedonia,17,7,10
1995,620,Portugal,North Macedonia,6,3,3
1995,688,Serbia,North Macedonia,40287,16683,23604
1995,705,Slovenia,North Macedonia,6599,3831,2768
1995,724,Spain,North Macedonia,81,45,36
1995,40,Austria,North Macedonia,13623,7574,6049
1995,56,Belgium,North Macedonia,120,65,55
1995,250,France,North Macedonia,76894,38714,38180
1995,276,Germany,North Macedonia,44914,23328,21586
1995,438,Liechtenstein,North Macedonia,529,291,238
1995,442,Luxembourg,North Macedonia,1124,637,487
1995,528,Netherlands,North Macedonia,6,3,3
1995,756,Switzerland,North Macedonia,37897,21267,16630
1995,124,Canada,North Macedonia,7067,3423,3644
1995,840,United States of America,North Macedonia,14768,7303,7465
2000,710,South Africa,North Macedonia,51,39,12
2000,818,Egypt,North Macedonia,88,51,37
2000,196,Cyprus,North Macedonia,9,3,6
2000,400,Jordan,North Macedonia,107,29,78
2000,792,Turkey,North Macedonia,134372,64668,69704
2000,496,Mongolia,North Macedonia,15,13,2
2000,214,Dominican Republic,North Macedonia,7,7,0
2000,188,Costa Rica,North Macedonia,20,11,9
2000,32,Argentina,North Macedonia,3123,1361,1762
2000,152,Chile,North Macedonia,399,183,216
2000,218,Ecuador,North Macedonia,1,0,1
2000,36,Australia,North Macedonia,49560,25607,23953
2000,100,Bulgaria,North Macedonia,1476,789,687
2000,203,Czechia,North Macedonia,263,212,51
2000,348,Hungary,North Macedonia,98,62,36
2000,616,Poland,North Macedonia,212,137,75
2000,642,Romania,North Macedonia,518,268,250
2000,643,Russian Federation,North Macedonia,234,186,48
2000,703,Slovakia,North Macedonia,473,308,165
2000,208,Denmark,North Macedonia,1322,675,647
2000,352,Iceland,North Macedonia,10,6,4
2000,372,Ireland,North Macedonia,763,440,323
2000,578,Norway,North Macedonia,537,289,248
2000,752,Sweden,North Macedonia,2362,1232,1130
2000,826,United Kingdom,North Macedonia,1241,460,781
2000,8,Albania,North Macedonia,787,354,433
2000,70,Bosnia and Herzegovina,North Macedonia,3783,1811,1972
2000,191,Croatia,North Macedonia,9737,5011,4726
2000,300,Greece,North Macedonia,928,512,416
2000,380,Italy,North Macedonia,44512,25814,18698
2000,470,Malta,North Macedonia,43,17,26
2000,620,Portugal,North Macedonia,11,5,6
2000,688,Serbia,North Macedonia,52051,20737,31314
2000,705,Slovenia,North Macedonia,8231,5813,2418
2000,724,Spain,North Macedonia,159,91,68
2000,40,Austria,North Macedonia,15170,8523,6647
2000,56,Belgium,North Macedonia,155,84,71
2000,250,France,North Macedonia,79353,39318,40035
2000,276,Germany,North Macedonia,53889,26376,27513
2000,438,Liechtenstein,North Macedonia,614,327,287
2000,442,Luxembourg,North Macedonia,304,164,140
2000,528,Netherlands,North Macedonia,10,4,6
2000,756,Switzerland,North Macedonia,39114,22077,17037
2000,124,Canada,North Macedonia,7265,3504,3761
2000,840,United States of America,North Macedonia,19154,9542,9612
2005,710,South Africa,North Macedonia,66,51,15
2005,818,Egypt,North Macedonia,105,64,41
2005,196,Cyprus,North Macedonia,13,4,9
2005,400,Jordan,North Macedonia,155,57,98
2005,792,Turkey,North Macedonia,138175,64857,73318
2005,496,Mongolia,North Macedonia,8,8,0
2005,214,Dominican Republic,North Macedonia,16,11,5
2005,188,Costa Rica,North Macedonia,13,7,6
2005,32,Argentina,North Macedonia,2304,1025,1279
2005,68,Bolivia (Plurinational State of),North Macedonia,5,4,1
2005,152,Chile,North Macedonia,598,280,318
2005,218,Ecuador,North Macedonia,1,0,1
2005,36,Australia,North Macedonia,51320,26335,24985
2005,100,Bulgaria,North Macedonia,1942,1052,890
2005,203,Czechia,North Macedonia,1155,919,236
2005,348,Hungary,North Macedonia,121,77,44
2005,616,Poland,North Macedonia,239,149,90
2005,642,Romania,North Macedonia,814,334,480
2005,643,Russian Federation,North Macedonia,245,199,46
2005,703,Slovakia,North Macedonia,531,349,182
2005,208,Denmark,North Macedonia,1976,1041,935
2005,352,Iceland,North Macedonia,21,12,9
2005,372,Ireland,North Macedonia,765,461,304
2005,578,Norway,North Macedonia,1848,1009,839
2005,752,Sweden,North Macedonia,3391,1742,1649
2005,826,United Kingdom,North Macedonia,1952,813,1139
2005,8,Albania,North Macedonia,664,326,338
2005,70,Bosnia and Herzegovina,North Macedonia,2671,1262,1409
2005,191,Croatia,North Macedonia,9865,4954,4911
2005,300,Greece,North Macedonia,1573,735,838
2005,380,Italy,North Macedonia,58767,33207,25560
2005,470,Malta,North Macedonia,70,28,42
2005,620,Portugal,North Macedonia,137,69,68
2005,688,Serbia,North Macedonia,48899,20248,28651
2005,705,Slovenia,North Macedonia,8770,5614,3156
2005,724,Spain,North Macedonia,376,225,151
2005,40,Austria,North Macedonia,16957,9350,7607
2005,56,Belgium,North Macedonia,315,164,151
2005,250,France,North Macedonia,3711,1852,1859
2005,276,Germany,North Macedonia,24598,12302,12296
2005,438,Liechtenstein,North Macedonia,344,183,161
2005,442,Luxembourg,North Macedonia,264,150,114
2005,528,Netherlands,North Macedonia,58,34,24
2005,756,Switzerland,North Macedonia,44147,23940,20207
2005,124,Canada,North Macedonia,8115,3988,4127
2005,840,United States of America,North Macedonia,21209,10625,10584
2010,710,South Africa,North Macedonia,103,80,23
2010,818,Egypt,North Macedonia,113,67,46
2010,196,Cyprus,North Macedonia,21,7,14
2010,400,Jordan,North Macedonia,199,80,119
2010,792,Turkey,North Macedonia,142389,65127,77262
2010,496,Mongolia,North Macedonia,3,3,0
2010,214,Dominican Republic,North Macedonia,25,15,10
2010,188,Costa Rica,North Macedonia,26,14,12
2010,32,Argentina,North Macedonia,1484,688,796
2010,68,Bolivia (Plurinational State of),North Macedonia,10,8,2
2010,76,Brazil,North Macedonia,38,24,14
2010,152,Chile,North Macedonia,798,377,421
2010,218,Ecuador,North Macedonia,1,0,1
2010,36,Australia,North Macedonia,51470,26066,25404
2010,100,Bulgaria,North Macedonia,2325,1269,1056
2010,203,Czechia,North Macedonia,1934,1546,388
2010,348,Hungary,North Macedonia,144,92,52
2010,616,Poland,North Macedonia,275,165,110
2010,642,Romania,North Macedonia,940,493,447
2010,643,Russian Federation,North Macedonia,251,206,45
2010,703,Slovakia,North Macedonia,595,394,201
2010,208,Denmark,North Macedonia,2583,1383,1200
2010,233,Estonia,North Macedonia,4,2,2
2010,352,Iceland,North Macedonia,41,23,18
2010,372,Ireland,North Macedonia,641,367,274
2010,578,Norway,North Macedonia,2137,1136,1001
2010,752,Sweden,North Macedonia,4752,2446,2306
2010,826,United Kingdom,North Macedonia,2056,881,1175
2010,8,Albania,North Macedonia,542,266,276
2010,70,Bosnia and Herzegovina,North Macedonia,3097,1458,1639
2010,191,Croatia,North Macedonia,9992,4896,5096
2010,300,Greece,North Macedonia,2306,997,1309
2010,380,Italy,North Macedonia,74223,41406,32817
2010,470,Malta,North Macedonia,24,17,7
2010,499,Montenegro,North Macedonia,2949,1210,1739
2010,620,Portugal,North Macedonia,241,122,119
2010,688,Serbia,North Macedonia,47797,18789,29008
2010,705,Slovenia,North Macedonia,14333,9272,5061
2010,724,Spain,North Macedonia,549,286,263
2010,40,Austria,North Macedonia,18743,10176,8567
2010,56,Belgium,North Macedonia,488,247,241
2010,250,France,North Macedonia,4214,2041,2173
2010,276,Germany,North Macedonia,46579,22041,24538
2010,438,Liechtenstein,North Macedonia,75,38,37
2010,442,Luxembourg,North Macedonia,227,137,90
2010,528,Netherlands,North Macedonia,82,43,39
2010,756,Switzerland,North Macedonia,51676,26670,25006
2010,124,Canada,North Macedonia,9610,4801,4809
2010,840,United States of America,North Macedonia,23970,11845,12125
2015,710,South Africa,North Macedonia,184,142,42
2015,818,Egypt,North Macedonia,83,54,29
2015,196,Cyprus,North Macedonia,20,7,13
2015,400,Jordan,North Macedonia,85,23,62
2015,792,Turkey,North Macedonia,144544,82339,62205
2015,496,Mongolia,North Macedonia,3,3,0
2015,214,Dominican Republic,North Macedonia,26,16,10
2015,188,Costa Rica,North Macedonia,26,14,12
2015,32,Argentina,North Macedonia,1489,690,799
2015,68,Bolivia (Plurinational State of),North Macedonia,12,10,2
2015,76,Brazil,North Macedonia,46,29,17
2015,152,Chile,North Macedonia,1208,557,651
2015,218,Ecuador,North Macedonia,1,0,1
2015,36,Australia,North Macedonia,49990,25344,24646
2015,100,Bulgaria,North Macedonia,2742,1542,1200
2015,203,Czechia,North Macedonia,1925,1454,471
2015,348,Hungary,North Macedonia,214,128,86
2015,616,Poland,North Macedonia,265,161,104
2015,642,Romania,North Macedonia,1536,857,679
2015,643,Russian Federation,North Macedonia,255,208,47
2015,703,Slovakia,North Macedonia,760,530,230
2015,208,Denmark,North Macedonia,3111,1683,1428
2015,233,Estonia,North Macedonia,9,7,2
2015,352,Iceland,North Macedonia,40,21,19
2015,372,Ireland,North Macedonia,655,372,283
2015,578,Norway,North Macedonia,2494,1325,1169
2015,752,Sweden,North Macedonia,6541,3403,3138
2015,826,United Kingdom,North Macedonia,2629,1082,1547
2015,8,Albania,North Macedonia,534,262,272
2015,70,Bosnia and Herzegovina,North Macedonia,3079,1450,1629
2015,191,Croatia,North Macedonia,10055,4912,5143
2015,300,Greece,North Macedonia,2164,884,1280
2015,380,Italy,North Macedonia,72699,39964,32735
2015,470,Malta,North Macedonia,41,30,11
2015,499,Montenegro,North Macedonia,3317,1372,1945
2015,620,Portugal,North Macedonia,272,131,141
2015,688,Serbia,North Macedonia,46737,18274,28463
2015,705,Slovenia,North Macedonia,15637,9370,6267
2015,724,Spain,North Macedonia,627,318,309
2015,40,Austria,North Macedonia,21921,11956,9965
2015,56,Belgium,North Macedonia,1290,666,624
2015,250,France,North Macedonia,4668,2195,2473
2015,276,Germany,North Macedonia,68560,32446,36114
2015,438,Liechtenstein,North Macedonia,88,39,49
2015,442,Luxembourg,North Macedonia,346,211,135
2015,528,Netherlands,North Macedonia,161,85,76
2015,756,Switzerland,North Macedonia,60503,31023,29480
2015,124,Canada,North Macedonia,10236,5046,5190
2015,840,United States of America,North Macedonia,28018,13774,14244
2019,710,South Africa,North Macedonia,205,159,46
2019,818,Egypt,North Macedonia,118,72,46
2019,196,Cyprus,North Macedonia,19,7,12
2019,400,Jordan,North Macedonia,91,25,66
2019,792,Turkey,North Macedonia,195449,112173,83276
2019,496,Mongolia,North Macedonia,3,3,0
2019,214,Dominican Republic,North Macedonia,26,16,10
2019,188,Costa Rica,North Macedonia,26,14,12
2019,32,Argentina,North Macedonia,1515,701,814
2019,68,Bolivia (Plurinational State of),North Macedonia,13,11,2
2019,76,Brazil,North Macedonia,51,32,19
2019,152,Chile,North Macedonia,1613,695,918
2019,218,Ecuador,North Macedonia,14,8,6
2019,36,Australia,North Macedonia,52201,26311,25890
2019,100,Bulgaria,North Macedonia,3595,2080,1515
2019,203,Czechia,North Macedonia,2196,1633,563
2019,348,Hungary,North Macedonia,226,136,90
2019,616,Poland,North Macedonia,280,175,105
2019,642,Romania,North Macedonia,206,102,104
2019,643,Russian Federation,North Macedonia,254,208,46
2019,703,Slovakia,North Macedonia,825,574,251
2019,208,Denmark,North Macedonia,3800,2079,1721
2019,233,Estonia,North Macedonia,12,9,3
2019,352,Iceland,North Macedonia,59,30,29
2019,372,Ireland,North Macedonia,719,410,309
2019,578,Norway,North Macedonia,2937,1570,1367
2019,752,Sweden,North Macedonia,9115,4743,4372
2019,826,United Kingdom,North Macedonia,2985,1233,1752
2019,8,Albania,North Macedonia,504,248,256
2019,70,Bosnia and Herzegovina,North Macedonia,2852,1341,1511
2019,191,Croatia,North Macedonia,9284,4522,4762
2019,300,Greece,North Macedonia,2113,911,1202
2019,380,Italy,North Macedonia,73343,40357,32986
2019,470,Malta,North Macedonia,66,49,17
2019,499,Montenegro,North Macedonia,3328,1386,1942
2019,620,Portugal,North Macedonia,276,133,143
2019,688,Serbia,North Macedonia,47482,18609,28873
2019,705,Slovenia,North Macedonia,16507,9725,6782
2019,724,Spain,North Macedonia,649,322,327
2019,40,Austria,North Macedonia,25877,14316,11561
2019,56,Belgium,North Macedonia,1541,788,753
2019,250,France,North Macedonia,4941,2318,2623
2019,276,Germany,North Macedonia,90542,48265,42277
2019,438,Liechtenstein,North Macedonia,97,45,52
2019,442,Luxembourg,North Macedonia,636,315,321
2019,528,Netherlands,North Macedonia,360,183,177
2019,756,Switzerland,North Macedonia,67668,35050,32618
2019,124,Canada,North Macedonia,10969,5408,5561
2019,840,United States of America,North Macedonia,30256,14708,15548
1990,710,South Africa,Northern Mariana Islands,28,20,8
1990,152,Chile,Northern Mariana Islands,8,5,3
1990,36,Australia,Northern Mariana Islands,6,3,3
1990,316,Guam,Northern Mariana Islands,2019,931,1088
1990,583,Micronesia (Fed. States of),Northern Mariana Islands,103,59,44
1990,585,Palau,Northern Mariana Islands,93,53,40
1990,643,Russian Federation,Northern Mariana Islands,254,125,129
1990,300,Greece,Northern Mariana Islands,14,8,6
1995,710,South Africa,Northern Mariana Islands,17,13,4
1995,152,Chile,Northern Mariana Islands,7,5,2
1995,36,Australia,Northern Mariana Islands,3,2,1
1995,316,Guam,Northern Mariana Islands,2098,982,1116
1995,583,Micronesia (Fed. States of),Northern Mariana Islands,93,60,33
1995,585,Palau,Northern Mariana Islands,159,81,78
1995,643,Russian Federation,Northern Mariana Islands,268,131,137
1995,300,Greece,Northern Mariana Islands,9,5,4
2000,710,South Africa,Northern Mariana Islands,12,10,2
2000,152,Chile,Northern Mariana Islands,7,4,3
2000,316,Guam,Northern Mariana Islands,2176,1032,1144
2000,583,Micronesia (Fed. States of),Northern Mariana Islands,86,49,37
2000,585,Palau,Northern Mariana Islands,214,108,106
2000,643,Russian Federation,Northern Mariana Islands,273,132,141
2000,300,Greece,Northern Mariana Islands,4,2,2
2005,710,South Africa,Northern Mariana Islands,14,12,2
2005,152,Chile,Northern Mariana Islands,10,6,4
2005,316,Guam,Northern Mariana Islands,2187,1083,1104
2005,583,Micronesia (Fed. States of),Northern Mariana Islands,80,45,35
2005,585,Palau,Northern Mariana Islands,280,128,152
2005,643,Russian Federation,Northern Mariana Islands,162,77,85
2005,300,Greece,Northern Mariana Islands,2,1,1
2010,710,South Africa,Northern Mariana Islands,21,18,3
2010,152,Chile,Northern Mariana Islands,14,9,5
2010,316,Guam,Northern Mariana Islands,2197,1134,1063
2010,583,Micronesia (Fed. States of),Northern Mariana Islands,77,43,34
2010,585,Palau,Northern Mariana Islands,268,115,153
2010,643,Russian Federation,Northern Mariana Islands,49,20,29
2015,710,South Africa,Northern Mariana Islands,36,32,4
2015,152,Chile,Northern Mariana Islands,21,14,7
2015,316,Guam,Northern Mariana Islands,2216,1143,1073
2015,583,Micronesia (Fed. States of),Northern Mariana Islands,75,42,33
2015,585,Palau,Northern Mariana Islands,241,111,130
2015,643,Russian Federation,Northern Mariana Islands,50,21,29
2019,710,South Africa,Northern Mariana Islands,39,35,4
2019,152,Chile,Northern Mariana Islands,28,19,9
2019,316,Guam,Northern Mariana Islands,2325,1200,1125
2019,583,Micronesia (Fed. States of),Northern Mariana Islands,76,43,33
2019,585,Palau,Northern Mariana Islands,247,101,146
2019,643,Russian Federation,Northern Mariana Islands,49,21,28
1990,800,Uganda,Norway,9,9,0
1990,72,Botswana,Norway,116,67,49
1990,516,Namibia,Norway,79,27,52
1990,710,South Africa,Norway,533,216,317
1990,818,Egypt,Norway,106,67,39
1990,434,Libya,Norway,302,190,112
1990,196,Cyprus,Norway,50,19,31
1990,400,Jordan,Norway,8,5,3
1990,792,Turkey,Norway,860,445,415
1990,50,Bangladesh,Norway,4240,2290,1950
1990,144,Sri Lanka,Norway,1,1,0
1990,392,Japan,Norway,360,183,177
1990,608,Philippines,Norway,100,69,31
1990,764,Thailand,Norway,812,423,389
1990,44,Bahamas,Norway,13,10,3
1990,535,"Bonaire, Sint Eustatius and Saba",Norway,2,1,1
1990,214,Dominican Republic,Norway,67,44,23
1990,188,Costa Rica,Norway,42,27,15
1990,484,Mexico,Norway,58,35,23
1990,591,Panama,Norway,7,3,4
1990,32,Argentina,Norway,129,98,31
1990,68,Bolivia (Plurinational State of),Norway,92,44,48
1990,76,Brazil,Norway,230,182,48
1990,152,Chile,Norway,184,91,93
1990,170,Colombia,Norway,61,30,31
1990,218,Ecuador,Norway,79,39,40
1990,604,Peru,Norway,64,36,28
1990,862,Venezuela (Bolivarian Republic of),Norway,80,43,37
1990,36,Australia,Norway,2622,1539,1083
1990,112,Belarus,Norway,49,30,19
1990,100,Bulgaria,Norway,4,3,1
1990,203,Czechia,Norway,24,13,11
1990,348,Hungary,Norway,118,53,65
1990,616,Poland,Norway,447,246,201
1990,642,Romania,Norway,120,55,65
1990,643,Russian Federation,Norway,1134,556,578
1990,703,Slovakia,Norway,3,1,2
1990,208,Denmark,Norway,12613,4748,7865
1990,234,Faroe Islands,Norway,151,83,68
1990,246,Finland,Norway,904,415,489
1990,352,Iceland,Norway,683,288,395
1990,372,Ireland,Norway,59,28,31
1990,428,Latvia,Norway,22,9,13
1990,440,Lithuania,Norway,43,30,13
1990,752,Sweden,Norway,33367,13969,19398
1990,826,United Kingdom,Norway,8506,3379,5127
1990,300,Greece,Norway,958,499,459
1990,380,Italy,Norway,159,55,104
1990,470,Malta,Norway,5,3,2
1990,620,Portugal,Norway,82,43,39
1990,688,Serbia,Norway,1,1,0
1990,724,Spain,Norway,3145,1386,1759
1990,40,Austria,Norway,533,208,325
1990,56,Belgium,Norway,763,420,343
1990,250,France,Norway,3257,1180,2077
1990,276,Germany,Norway,6286,2898,3388
1990,438,Liechtenstein,Norway,6,3,3
1990,442,Luxembourg,Norway,171,84,87
1990,528,Netherlands,Norway,1733,714,1019
1990,756,Switzerland,Norway,1612,689,923
1990,124,Canada,Norway,7926,3858,4068
1990,304,Greenland,Norway,106,88,18
1990,840,United States of America,Norway,42240,17626,24614
1995,800,Uganda,Norway,8,8,0
1995,72,Botswana,Norway,111,63,48
1995,516,Namibia,Norway,75,26,49
1995,710,South Africa,Norway,435,185,250
1995,818,Egypt,Norway,94,56,38
1995,434,Libya,Norway,271,158,113
1995,196,Cyprus,Norway,71,25,46
1995,400,Jordan,Norway,31,15,16
1995,792,Turkey,Norway,2081,1034,1047
1995,50,Bangladesh,Norway,7022,3792,3230
1995,144,Sri Lanka,Norway,14,12,2
1995,392,Japan,Norway,379,182,197
1995,608,Philippines,Norway,134,92,42
1995,764,Thailand,Norway,732,393,339
1995,44,Bahamas,Norway,11,8,3
1995,535,"Bonaire, Sint Eustatius and Saba",Norway,4,2,2
1995,214,Dominican Republic,Norway,75,49,26
1995,188,Costa Rica,Norway,40,25,15
1995,484,Mexico,Norway,124,70,54
1995,591,Panama,Norway,6,4,2
1995,32,Argentina,Norway,126,96,30
1995,68,Bolivia (Plurinational State of),Norway,46,22,24
1995,76,Brazil,Norway,187,146,41
1995,152,Chile,Norway,259,132,127
1995,170,Colombia,Norway,64,32,32
1995,218,Ecuador,Norway,89,44,45
1995,604,Peru,Norway,65,35,30
1995,862,Venezuela (Bolivarian Republic of),Norway,78,42,36
1995,36,Australia,Norway,3411,1907,1504
1995,112,Belarus,Norway,56,33,23
1995,100,Bulgaria,Norway,24,14,10
1995,203,Czechia,Norway,36,20,16
1995,348,Hungary,Norway,456,177,279
1995,616,Poland,Norway,381,207,174
1995,642,Romania,Norway,62,29,33
1995,643,Russian Federation,Norway,1193,584,609
1995,703,Slovakia,Norway,197,79,118
1995,208,Denmark,Norway,14633,5610,9023
1995,234,Faroe Islands,Norway,98,47,51
1995,246,Finland,Norway,853,422,431
1995,352,Iceland,Norway,760,328,432
1995,372,Ireland,Norway,162,74,88
1995,428,Latvia,Norway,37,22,15
1995,440,Lithuania,Norway,49,35,14
1995,752,Sweden,Norway,39596,16401,23195
1995,826,United Kingdom,Norway,10835,4364,6471
1995,191,Croatia,Norway,16,6,10
1995,300,Greece,Norway,701,312,389
1995,380,Italy,Norway,567,146,421
1995,470,Malta,Norway,7,4,3
1995,620,Portugal,Norway,177,92,85
1995,688,Serbia,Norway,17,10,7
1995,724,Spain,Norway,4036,1835,2201
1995,40,Austria,Norway,601,240,361
1995,56,Belgium,Norway,978,524,454
1995,250,France,Norway,3363,1183,2180
1995,276,Germany,Norway,6815,2994,3821
1995,438,Liechtenstein,Norway,9,4,5
1995,442,Luxembourg,Norway,161,82,79
1995,528,Netherlands,Norway,2008,804,1204
1995,756,Switzerland,Norway,1615,746,869
1995,124,Canada,Norway,7039,3412,3627
1995,304,Greenland,Norway,67,43,24
1995,840,United States of America,Norway,37720,15898,21822
2000,800,Uganda,Norway,8,8,0
2000,72,Botswana,Norway,118,67,51
2000,516,Namibia,Norway,71,24,47
2000,710,South Africa,Norway,468,200,268
2000,818,Egypt,Norway,89,48,41
2000,434,Libya,Norway,246,132,114
2000,196,Cyprus,Norway,91,31,60
2000,400,Jordan,Norway,53,25,28
2000,792,Turkey,Norway,3310,1624,1686
2000,50,Bangladesh,Norway,9804,5295,4509
2000,144,Sri Lanka,Norway,28,20,8
2000,392,Japan,Norway,380,176,204
2000,608,Philippines,Norway,1176,613,563
2000,764,Thailand,Norway,805,437,368
2000,44,Bahamas,Norway,10,7,3
2000,535,"Bonaire, Sint Eustatius and Saba",Norway,7,3,4
2000,214,Dominican Republic,Norway,82,53,29
2000,188,Costa Rica,Norway,58,36,22
2000,484,Mexico,Norway,197,108,89
2000,591,Panama,Norway,6,4,2
2000,32,Argentina,Norway,123,94,29
2000,76,Brazil,Norway,143,110,33
2000,152,Chile,Norway,335,169,166
2000,170,Colombia,Norway,67,34,33
2000,218,Ecuador,Norway,98,48,50
2000,604,Peru,Norway,77,41,36
2000,862,Venezuela (Bolivarian Republic of),Norway,77,41,36
2000,36,Australia,Norway,3990,2168,1822
2000,112,Belarus,Norway,63,36,27
2000,100,Bulgaria,Norway,43,25,18
2000,203,Czechia,Norway,48,27,21
2000,348,Hungary,Norway,793,300,493
2000,616,Poland,Norway,326,175,151
2000,642,Romania,Norway,2,1,1
2000,643,Russian Federation,Norway,1210,591,619
2000,703,Slovakia,Norway,447,179,268
2000,208,Denmark,Norway,16652,6471,10181
2000,234,Faroe Islands,Norway,129,62,67
2000,246,Finland,Norway,802,430,372
2000,352,Iceland,Norway,836,368,468
2000,372,Ireland,Norway,355,168,187
2000,428,Latvia,Norway,52,34,18
2000,440,Lithuania,Norway,38,28,10
2000,752,Sweden,Norway,42464,17427,25037
2000,826,United Kingdom,Norway,13348,5406,7942
2000,191,Croatia,Norway,30,11,19
2000,300,Greece,Norway,455,122,333
2000,380,Italy,Norway,975,238,737
2000,470,Malta,Norway,19,12,7
2000,620,Portugal,Norway,281,145,136
2000,688,Serbia,Norway,58,32,26
2000,705,Slovenia,Norway,9,2,7
2000,724,Spain,Norway,6665,3134,3531
2000,40,Austria,Norway,669,272,397
2000,56,Belgium,Norway,1165,613,552
2000,250,France,Norway,3468,1185,2283
2000,276,Germany,Norway,7344,3090,4254
2000,438,Liechtenstein,Norway,13,6,7
2000,442,Luxembourg,Norway,154,81,73
2000,528,Netherlands,Norway,2355,921,1434
2000,756,Switzerland,Norway,1625,808,817
2000,124,Canada,Norway,6319,3048,3271
2000,304,Greenland,Norway,90,55,35
2000,840,United States of America,Norway,33024,14119,18905
2005,800,Uganda,Norway,7,7,0
2005,72,Botswana,Norway,227,128,99
2005,516,Namibia,Norway,56,19,37
2005,710,South Africa,Norway,615,245,370
2005,818,Egypt,Norway,106,60,46
2005,434,Libya,Norway,271,169,102
2005,196,Cyprus,Norway,133,45,88
2005,400,Jordan,Norway,76,41,35
2005,792,Turkey,Norway,3410,1634,1776
2005,50,Bangladesh,Norway,11669,6302,5367
2005,144,Sri Lanka,Norway,57,29,28
2005,392,Japan,Norway,392,179,213
2005,608,Philippines,Norway,951,503,448
2005,764,Thailand,Norway,709,381,328
2005,44,Bahamas,Norway,11,6,5
2005,535,"Bonaire, Sint Eustatius and Saba",Norway,7,3,4
2005,214,Dominican Republic,Norway,67,41,26
2005,188,Costa Rica,Norway,38,23,15
2005,484,Mexico,Norway,176,105,71
2005,591,Panama,Norway,34,22,12
2005,32,Argentina,Norway,91,70,21
2005,68,Bolivia (Plurinational State of),Norway,42,20,22
2005,76,Brazil,Norway,359,265,94
2005,152,Chile,Norway,502,257,245
2005,170,Colombia,Norway,66,33,33
2005,218,Ecuador,Norway,115,57,58
2005,604,Peru,Norway,91,48,43
2005,862,Venezuela (Bolivarian Republic of),Norway,80,43,37
2005,36,Australia,Norway,4380,2188,2192
2005,112,Belarus,Norway,61,35,26
2005,100,Bulgaria,Norway,69,40,29
2005,203,Czechia,Norway,84,60,24
2005,348,Hungary,Norway,979,381,598
2005,616,Poland,Norway,940,458,482
2005,642,Romania,Norway,2,2,0
2005,643,Russian Federation,Norway,958,457,501
2005,703,Slovakia,Norway,502,206,296
2005,208,Denmark,Norway,18050,7009,11041
2005,234,Faroe Islands,Norway,153,79,74
2005,246,Finland,Norway,1197,638,559
2005,352,Iceland,Norway,921,416,505
2005,372,Ireland,Norway,356,180,176
2005,428,Latvia,Norway,123,83,40
2005,440,Lithuania,Norway,632,348,284
2005,752,Sweden,Norway,44773,19251,25522
2005,826,United Kingdom,Norway,14212,5780,8432
2005,191,Croatia,Norway,71,34,37
2005,300,Greece,Norway,492,151,341
2005,380,Italy,Norway,1478,488,990
2005,470,Malta,Norway,31,18,13
2005,620,Portugal,Norway,312,158,154
2005,688,Serbia,Norway,145,80,65
2005,705,Slovenia,Norway,18,8,10
2005,724,Spain,Norway,11673,5757,5916
2005,40,Austria,Norway,748,294,454
2005,56,Belgium,Norway,1288,636,652
2005,250,France,Norway,3173,1298,1875
2005,276,Germany,Norway,7252,3151,4101
2005,438,Liechtenstein,Norway,9,4,5
2005,442,Luxembourg,Norway,133,74,59
2005,528,Netherlands,Norway,2599,1072,1527
2005,756,Switzerland,Norway,1835,871,964
2005,124,Canada,Norway,5340,2584,2756
2005,304,Greenland,Norway,57,33,24
2005,840,United States of America,Norway,29894,12876,17018
2010,800,Uganda,Norway,7,7,0
2010,72,Botswana,Norway,337,189,148
2010,516,Namibia,Norway,53,18,35
2010,710,South Africa,Norway,962,382,580
2010,818,Egypt,Norway,114,62,52
2010,434,Libya,Norway,298,187,111
2010,196,Cyprus,Norway,217,75,142
2010,400,Jordan,Norway,98,55,43
2010,792,Turkey,Norway,3514,1643,1871
2010,50,Bangladesh,Norway,13509,7295,6214
2010,144,Sri Lanka,Norway,116,59,57
2010,392,Japan,Norway,416,187,229
2010,608,Philippines,Norway,642,328,314
2010,764,Thailand,Norway,664,359,305
2010,44,Bahamas,Norway,11,4,7
2010,535,"Bonaire, Sint Eustatius and Saba",Norway,2,2,0
2010,214,Dominican Republic,Norway,52,30,22
2010,188,Costa Rica,Norway,75,46,29
2010,484,Mexico,Norway,177,115,62
2010,591,Panama,Norway,65,41,24
2010,32,Argentina,Norway,58,45,13
2010,68,Bolivia (Plurinational State of),Norway,83,39,44
2010,76,Brazil,Norway,569,415,154
2010,152,Chile,Norway,670,346,324
2010,170,Colombia,Norway,77,39,38
2010,218,Ecuador,Norway,162,79,83
2010,604,Peru,Norway,101,53,48
2010,862,Venezuela (Bolivarian Republic of),Norway,86,47,39
2010,36,Australia,Norway,4350,2080,2270
2010,112,Belarus,Norway,58,33,25
2010,100,Bulgaria,Norway,92,54,38
2010,203,Czechia,Norway,112,88,24
2010,348,Hungary,Norway,1164,461,703
2010,616,Poland,Norway,1585,753,832
2010,642,Romania,Norway,4,2,2
2010,643,Russian Federation,Norway,687,313,374
2010,703,Slovakia,Norway,563,236,327
2010,208,Denmark,Norway,19104,7419,11685
2010,233,Estonia,Norway,150,102,48
2010,234,Faroe Islands,Norway,172,87,85
2010,246,Finland,Norway,1914,947,967
2010,352,Iceland,Norway,1003,462,541
2010,372,Ireland,Norway,299,140,159
2010,428,Latvia,Norway,192,129,63
2010,440,Lithuania,Norway,1142,608,534
2010,752,Sweden,Norway,43430,19043,24387
2010,826,United Kingdom,Norway,14971,6271,8700
2010,191,Croatia,Norway,112,57,55
2010,300,Greece,Norway,549,188,361
2010,380,Italy,Norway,1884,709,1175
2010,470,Malta,Norway,54,39,15
2010,620,Portugal,Norway,292,145,147
2010,688,Serbia,Norway,142,78,64
2010,705,Slovenia,Norway,25,12,13
2010,724,Spain,Norway,14587,7283,7304
2010,40,Austria,Norway,827,316,511
2010,56,Belgium,Norway,1296,595,701
2010,250,France,Norway,3822,1249,2573
2010,276,Germany,Norway,7150,3172,3978
2010,438,Liechtenstein,Norway,6,2,4
2010,442,Luxembourg,Norway,115,68,47
2010,528,Netherlands,Norway,2500,1046,1454
2010,756,Switzerland,Norway,2147,947,1200
2010,124,Canada,Norway,4390,2141,2249
2010,304,Greenland,Norway,71,43,28
2010,840,United States of America,Norway,27602,11672,15930
2015,800,Uganda,Norway,7,7,0
2015,72,Botswana,Norway,367,206,161
2015,516,Namibia,Norway,51,17,34
2015,710,South Africa,Norway,1735,637,1098
2015,324,Guinea,Norway,2,2,0
2015,818,Egypt,Norway,84,51,33
2015,434,Libya,Norway,335,209,126
2015,196,Cyprus,Norway,208,73,135
2015,400,Jordan,Norway,42,19,23
2015,792,Turkey,Norway,3567,1625,1942
2015,50,Bangladesh,Norway,14311,7728,6583
2015,144,Sri Lanka,Norway,117,59,58
2015,392,Japan,Norway,456,204,252
2015,608,Philippines,Norway,653,334,319
2015,764,Thailand,Norway,718,388,330
2015,44,Bahamas,Norway,12,4,8
2015,535,"Bonaire, Sint Eustatius and Saba",Norway,2,2,0
2015,214,Dominican Republic,Norway,54,31,23
2015,188,Costa Rica,Norway,76,47,29
2015,484,Mexico,Norway,187,121,66
2015,591,Panama,Norway,77,49,28
2015,32,Argentina,Norway,58,45,13
2015,68,Bolivia (Plurinational State of),Norway,97,46,51
2015,76,Brazil,Norway,685,500,185
2015,152,Chile,Norway,1015,514,501
2015,170,Colombia,Norway,86,44,42
2015,218,Ecuador,Norway,235,114,121
2015,604,Peru,Norway,107,58,49
2015,862,Venezuela (Bolivarian Republic of),Norway,90,48,42
2015,36,Australia,Norway,4360,1961,2399
2015,112,Belarus,Norway,61,34,27
2015,100,Bulgaria,Norway,262,138,124
2015,203,Czechia,Norway,168,124,44
2015,348,Hungary,Norway,1238,491,747
2015,616,Poland,Norway,1528,741,787
2015,642,Romania,Norway,263,144,119
2015,643,Russian Federation,Norway,701,318,383
2015,703,Slovakia,Norway,750,344,406
2015,208,Denmark,Norway,21153,8276,12877
2015,233,Estonia,Norway,203,140,63
2015,234,Faroe Islands,Norway,178,88,90
2015,246,Finland,Norway,2077,1038,1039
2015,352,Iceland,Norway,1036,486,550
2015,372,Ireland,Norway,305,141,164
2015,428,Latvia,Norway,325,184,141
2015,440,Lithuania,Norway,1418,745,673
2015,752,Sweden,Norway,42074,18687,23387
2015,826,United Kingdom,Norway,19145,7690,11455
2015,191,Croatia,Norway,113,57,56
2015,300,Greece,Norway,515,162,353
2015,380,Italy,Norway,1652,608,1044
2015,470,Malta,Norway,91,68,23
2015,620,Portugal,Norway,331,155,176
2015,688,Serbia,Norway,138,76,62
2015,705,Slovenia,Norway,16,6,10
2015,724,Spain,Norway,16018,7957,8061
2015,40,Austria,Norway,966,372,594
2015,56,Belgium,Norway,1164,543,621
2015,250,France,Norway,4233,1305,2928
2015,276,Germany,Norway,7450,3295,4155
2015,438,Liechtenstein,Norway,6,2,4
2015,442,Luxembourg,Norway,175,105,70
2015,528,Netherlands,Norway,2738,1182,1556
2015,756,Switzerland,Norway,2229,1032,1197
2015,124,Canada,Norway,3856,1893,1963
2015,304,Greenland,Norway,65,44,21
2015,840,United States of America,Norway,28874,12126,16748
2019,800,Uganda,Norway,7,7,0
2019,72,Botswana,Norway,393,221,172
2019,516,Namibia,Norway,53,18,35
2019,710,South Africa,Norway,1944,715,1229
2019,324,Guinea,Norway,1,1,0
2019,818,Egypt,Norway,119,67,52
2019,434,Libya,Norway,355,222,133
2019,196,Cyprus,Norway,207,74,133
2019,400,Jordan,Norway,45,21,24
2019,792,Turkey,Norway,4823,2224,2599
2019,50,Bangladesh,Norway,14499,4422,10077
2019,144,Sri Lanka,Norway,117,59,58
2019,392,Japan,Norway,509,228,281
2019,608,Philippines,Norway,673,344,329
2019,764,Thailand,Norway,748,404,344
2019,44,Bahamas,Norway,12,4,8
2019,535,"Bonaire, Sint Eustatius and Saba",Norway,2,2,0
2019,214,Dominican Republic,Norway,55,32,23
2019,188,Costa Rica,Norway,77,48,29
2019,484,Mexico,Norway,192,124,68
2019,591,Panama,Norway,80,52,28
2019,32,Argentina,Norway,59,46,13
2019,68,Bolivia (Plurinational State of),Norway,105,50,55
2019,76,Brazil,Norway,771,563,208
2019,152,Chile,Norway,1356,650,706
2019,170,Colombia,Norway,87,45,42
2019,218,Ecuador,Norway,231,112,119
2019,604,Peru,Norway,126,71,55
2019,862,Venezuela (Bolivarian Republic of),Norway,88,47,41
2019,36,Australia,Norway,4665,2137,2528
2019,112,Belarus,Norway,60,34,26
2019,100,Bulgaria,Norway,442,235,207
2019,203,Czechia,Norway,198,143,55
2019,348,Hungary,Norway,1409,544,865
2019,616,Poland,Norway,1618,817,801
2019,642,Romania,Norway,790,426,364
2019,643,Russian Federation,Norway,700,318,382
2019,703,Slovakia,Norway,924,422,502
2019,208,Denmark,Norway,21628,8452,13176
2019,233,Estonia,Norway,271,181,90
2019,234,Faroe Islands,Norway,200,100,100
2019,246,Finland,Norway,2303,1165,1138
2019,352,Iceland,Norway,1275,627,648
2019,372,Ireland,Norway,334,155,179
2019,428,Latvia,Norway,368,224,144
2019,440,Lithuania,Norway,2007,1058,949
2019,752,Sweden,Norway,41885,19024,22861
2019,826,United Kingdom,Norway,21741,8766,12975
2019,191,Croatia,Norway,104,53,51
2019,300,Greece,Norway,502,171,331
2019,380,Italy,Norway,1790,696,1094
2019,470,Malta,Norway,146,110,36
2019,620,Portugal,Norway,336,158,178
2019,688,Serbia,Norway,140,78,62
2019,705,Slovenia,Norway,16,6,10
2019,724,Spain,Norway,15786,7743,8043
2019,40,Austria,Norway,1140,451,689
2019,56,Belgium,Norway,1234,580,654
2019,250,France,Norway,4480,1374,3106
2019,276,Germany,Norway,8172,3884,4288
2019,438,Liechtenstein,Norway,8,3,5
2019,442,Luxembourg,Norway,289,158,131
2019,528,Netherlands,Norway,3021,1338,1683
2019,756,Switzerland,Norway,2286,1081,1205
2019,124,Canada,Norway,4132,2029,2103
2019,304,Greenland,Norway,63,43,20
2019,840,United States of America,Norway,31180,12900,18280
1990,710,South Africa,Oman,33,14,19
1990,818,Egypt,Oman,436,271,165
1990,434,Libya,Oman,1246,777,469
1990,196,Cyprus,Oman,16,10,6
1990,400,Jordan,Oman,540,293,247
1990,422,Lebanon,Oman,247,134,113
1990,275,State of Palestine,Oman,9110,4433,4677
1990,792,Turkey,Oman,6,3,3
1990,762,Tajikistan,Oman,57,26,31
1990,144,Sri Lanka,Oman,3,1,2
1990,608,Philippines,Oman,93,51,42
1990,188,Costa Rica,Oman,2,2,0
1990,68,Bolivia (Plurinational State of),Oman,1,0,1
1990,152,Chile,Oman,31,19,12
1990,36,Australia,Oman,45,29,16
1990,348,Hungary,Oman,14,4,10
1990,643,Russian Federation,Oman,61,30,31
1990,208,Denmark,Oman,1,0,1
1990,246,Finland,Oman,2,2,0
1990,372,Ireland,Oman,9,4,5
1990,578,Norway,Oman,10,3,7
1990,752,Sweden,Oman,5,2,3
1990,826,United Kingdom,Oman,281,198,83
1990,300,Greece,Oman,3,1,2
1990,380,Italy,Oman,38,13,25
1990,724,Spain,Oman,1,1,0
1990,40,Austria,Oman,17,9,8
1990,56,Belgium,Oman,2,0,2
1990,250,France,Oman,21,13,8
1990,528,Netherlands,Oman,175,89,86
1990,756,Switzerland,Oman,15,12,3
1990,124,Canada,Oman,14,6,8
1995,710,South Africa,Oman,20,10,10
1995,818,Egypt,Oman,401,254,147
1995,434,Libya,Oman,1236,847,389
1995,196,Cyprus,Oman,23,14,9
1995,400,Jordan,Oman,657,331,326
1995,422,Lebanon,Oman,299,142,157
1995,275,State of Palestine,Oman,8902,4309,4593
1995,792,Turkey,Oman,14,6,8
1995,762,Tajikistan,Oman,46,21,25
1995,144,Sri Lanka,Oman,41,32,9
1995,608,Philippines,Oman,125,68,57
1995,188,Costa Rica,Oman,2,2,0
1995,68,Bolivia (Plurinational State of),Oman,1,0,1
1995,152,Chile,Oman,18,8,10
1995,36,Australia,Oman,188,113,75
1995,100,Bulgaria,Oman,1,1,0
1995,348,Hungary,Oman,13,4,9
1995,643,Russian Federation,Oman,51,32,19
1995,208,Denmark,Oman,7,2,5
1995,246,Finland,Oman,2,1,1
1995,372,Ireland,Oman,26,13,13
1995,578,Norway,Oman,13,7,6
1995,752,Sweden,Oman,6,2,4
1995,826,United Kingdom,Oman,1108,689,419
1995,300,Greece,Oman,3,2,1
1995,380,Italy,Oman,39,14,25
1995,724,Spain,Oman,3,2,1
1995,40,Austria,Oman,20,11,9
1995,56,Belgium,Oman,2,0,2
1995,250,France,Oman,22,13,9
1995,528,Netherlands,Oman,257,128,129
1995,756,Switzerland,Oman,35,23,12
1995,124,Canada,Oman,281,135,146
2000,710,South Africa,Oman,14,8,6
2000,818,Egypt,Oman,397,256,141
2000,434,Libya,Oman,1247,940,307
2000,196,Cyprus,Oman,29,17,12
2000,400,Jordan,Oman,772,370,402
2000,422,Lebanon,Oman,351,150,201
2000,275,State of Palestine,Oman,8695,4185,4510
2000,792,Turkey,Oman,24,10,14
2000,762,Tajikistan,Oman,40,19,21
2000,144,Sri Lanka,Oman,81,54,27
2000,608,Philippines,Oman,428,217,211
2000,188,Costa Rica,Oman,2,2,0
2000,68,Bolivia (Plurinational State of),Oman,1,1,0
2000,152,Chile,Oman,5,2,3
2000,36,Australia,Oman,340,196,144
2000,100,Bulgaria,Oman,1,1,0
2000,348,Hungary,Oman,11,3,8
2000,643,Russian Federation,Oman,40,32,8
2000,208,Denmark,Oman,13,4,9
2000,246,Finland,Oman,2,1,1
2000,372,Ireland,Oman,57,29,28
2000,578,Norway,Oman,28,15,13
2000,752,Sweden,Oman,7,2,5
2000,826,United Kingdom,Oman,1954,1190,764
2000,300,Greece,Oman,3,2,1
2000,380,Italy,Oman,40,15,25
2000,705,Slovenia,Oman,1,0,1
2000,724,Spain,Oman,41,23,18
2000,40,Austria,Oman,22,12,10
2000,56,Belgium,Oman,2,0,2
2000,250,France,Oman,22,13,9
2000,528,Netherlands,Oman,347,169,178
2000,756,Switzerland,Oman,56,34,22
2000,124,Canada,Oman,555,268,287
2005,710,South Africa,Oman,17,10,7
2005,818,Egypt,Oman,473,316,157
2005,434,Libya,Oman,1373,1095,278
2005,196,Cyprus,Oman,42,24,18
2005,400,Jordan,Oman,1116,606,510
2005,422,Lebanon,Oman,275,124,151
2005,275,State of Palestine,Oman,9060,4337,4723
2005,792,Turkey,Oman,24,10,14
2005,762,Tajikistan,Oman,38,18,20
2005,144,Sri Lanka,Oman,161,75,86
2005,608,Philippines,Oman,346,178,168
2005,188,Costa Rica,Oman,1,1,0
2005,68,Bolivia (Plurinational State of),Oman,1,1,0
2005,152,Chile,Oman,7,3,4
2005,36,Australia,Oman,840,489,351
2005,100,Bulgaria,Oman,2,2,0
2005,348,Hungary,Oman,14,4,10
2005,643,Russian Federation,Oman,45,31,14
2005,208,Denmark,Oman,16,6,10
2005,246,Finland,Oman,4,1,3
2005,372,Ireland,Oman,57,30,27
2005,578,Norway,Oman,26,17,9
2005,752,Sweden,Oman,20,7,13
2005,826,United Kingdom,Oman,2406,1366,1040
2005,300,Greece,Oman,4,2,2
2005,380,Italy,Oman,46,19,27
2005,724,Spain,Oman,20,11,9
2005,40,Austria,Oman,25,13,12
2005,56,Belgium,Oman,10,6,4
2005,250,France,Oman,89,64,25
2005,528,Netherlands,Oman,414,205,209
2005,756,Switzerland,Oman,64,37,27
2005,124,Canada,Oman,1031,544,487
2010,710,South Africa,Oman,26,16,10
2010,818,Egypt,Oman,510,334,176
2010,434,Libya,Oman,1502,1200,302
2010,196,Cyprus,Oman,68,39,29
2010,400,Jordan,Oman,1435,816,619
2010,422,Lebanon,Oman,198,98,100
2010,275,State of Palestine,Oman,9426,4490,4936
2010,792,Turkey,Oman,24,10,14
2010,762,Tajikistan,Oman,37,18,19
2010,144,Sri Lanka,Oman,325,154,171
2010,608,Philippines,Oman,401,198,203
2010,188,Costa Rica,Oman,3,3,0
2010,76,Brazil,Oman,19,11,8
2010,152,Chile,Oman,10,5,5
2010,36,Australia,Oman,1250,743,507
2010,100,Bulgaria,Oman,2,2,0
2010,348,Hungary,Oman,17,5,12
2010,643,Russian Federation,Oman,51,31,20
2010,208,Denmark,Oman,17,7,10
2010,246,Finland,Oman,6,1,5
2010,372,Ireland,Oman,48,24,24
2010,578,Norway,Oman,35,23,12
2010,752,Sweden,Oman,37,16,21
2010,826,United Kingdom,Oman,2534,1461,1073
2010,300,Greece,Oman,5,2,3
2010,380,Italy,Oman,48,23,25
2010,705,Slovenia,Oman,2,1,1
2010,724,Spain,Oman,20,14,6
2010,40,Austria,Oman,27,14,13
2010,56,Belgium,Oman,21,14,7
2010,250,France,Oman,102,60,42
2010,528,Netherlands,Oman,427,216,211
2010,756,Switzerland,Oman,74,41,33
2010,124,Canada,Oman,1385,755,630
2015,710,South Africa,Oman,45,28,17
2015,818,Egypt,Oman,378,265,113
2015,434,Libya,Oman,1693,1348,345
2015,196,Cyprus,Oman,65,38,27
2015,400,Jordan,Oman,617,291,326
2015,422,Lebanon,Oman,167,80,87
2015,275,State of Palestine,Oman,9334,4435,4899
2015,792,Turkey,Oman,24,10,14
2015,762,Tajikistan,Oman,36,18,18
2015,144,Sri Lanka,Oman,330,154,176
2015,608,Philippines,Oman,408,203,205
2015,188,Costa Rica,Oman,3,3,0
2015,76,Brazil,Oman,23,13,10
2015,152,Chile,Oman,15,8,7
2015,36,Australia,Oman,1560,836,724
2015,100,Bulgaria,Oman,4,4,0
2015,348,Hungary,Oman,21,13,8
2015,643,Russian Federation,Oman,52,32,20
2015,208,Denmark,Oman,29,13,16
2015,246,Finland,Oman,12,5,7
2015,372,Ireland,Oman,49,24,25
2015,578,Norway,Oman,54,38,16
2015,752,Sweden,Oman,60,30,30
2015,826,United Kingdom,Oman,3240,1828,1412
2015,300,Greece,Oman,4,2,2
2015,380,Italy,Oman,53,23,30
2015,705,Slovenia,Oman,1,1,0
2015,724,Spain,Oman,51,33,18
2015,40,Austria,Oman,31,16,15
2015,56,Belgium,Oman,32,19,13
2015,250,France,Oman,112,63,49
2015,528,Netherlands,Oman,596,317,279
2015,756,Switzerland,Oman,98,52,46
2015,124,Canada,Oman,1530,770,760
2019,710,South Africa,Oman,49,31,18
2019,818,Egypt,Oman,538,358,180
2019,434,Libya,Oman,1796,1430,366
2019,196,Cyprus,Oman,64,38,26
2019,400,Jordan,Oman,663,313,350
2019,422,Lebanon,Oman,157,75,82
2019,275,State of Palestine,Oman,9269,4404,4865
2019,792,Turkey,Oman,32,14,18
2019,762,Tajikistan,Oman,35,18,17
2019,144,Sri Lanka,Oman,332,155,177
2019,608,Philippines,Oman,420,209,211
2019,188,Costa Rica,Oman,3,3,0
2019,76,Brazil,Oman,25,14,11
2019,152,Chile,Oman,20,11,9
2019,36,Australia,Oman,2221,1271,950
2019,100,Bulgaria,Oman,6,6,0
2019,348,Hungary,Oman,25,15,10
2019,643,Russian Federation,Oman,51,32,19
2019,208,Denmark,Oman,31,15,16
2019,246,Finland,Oman,14,5,9
2019,372,Ireland,Oman,53,26,27
2019,578,Norway,Oman,49,28,21
2019,752,Sweden,Oman,92,42,50
2019,826,United Kingdom,Oman,3679,2080,1599
2019,300,Greece,Oman,3,2,1
2019,380,Italy,Oman,92,45,47
2019,705,Slovenia,Oman,1,1,0
2019,724,Spain,Oman,52,33,19
2019,40,Austria,Oman,36,19,17
2019,56,Belgium,Oman,47,25,22
2019,250,France,Oman,118,67,51
2019,528,Netherlands,Oman,750,407,343
2019,756,Switzerland,Oman,99,51,48
2019,124,Canada,Oman,1639,825,814
1990,480,Mauritius,Pakistan,1,1,0
1990,508,Mozambique,Pakistan,516,341,175
1990,690,Seychelles,Pakistan,23,10,13
1990,800,Uganda,Pakistan,216,177,39
1990,834,United Republic of Tanzania,Pakistan,407,237,170
1990,72,Botswana,Pakistan,145,82,63
1990,426,Lesotho,Pakistan,308,172,136
1990,516,Namibia,Pakistan,246,219,27
1990,710,South Africa,Pakistan,1523,1098,425
1990,288,Ghana,Pakistan,47,25,22
1990,818,Egypt,Pakistan,387,272,115
1990,434,Libya,Pakistan,1104,777,327
1990,48,Bahrain,Pakistan,20949,15949,5000
1990,196,Cyprus,Pakistan,129,120,9
1990,368,Iraq,Pakistan,525,381,144
1990,400,Jordan,Pakistan,5168,2723,2445
1990,414,Kuwait,Pakistan,129928,88717,41211
1990,422,Lebanon,Pakistan,2361,1244,1117
1990,512,Oman,Pakistan,35675,31374,4301
1990,634,Qatar,Pakistan,334,244,90
1990,682,Saudi Arabia,Pakistan,556715,383365,173350
1990,792,Turkey,Pakistan,275,171,104
1990,784,United Arab Emirates,Pakistan,158710,121958,36752
1990,762,Tajikistan,Pakistan,178,79,99
1990,4,Afghanistan,Pakistan,8107,4576,3531
1990,64,Bhutan,Pakistan,10,10,0
1990,356,India,Pakistan,1921278,1024721,896557
1990,364,Iran (Islamic Republic of),Pakistan,10729,6142,4587
1990,462,Maldives,Pakistan,79,43,36
1990,524,Nepal,Pakistan,2371,886,1485
1990,144,Sri Lanka,Pakistan,173,86,87
1990,156,China,Pakistan,1817,1049,768
1990,344,"China, Hong Kong SAR",Pakistan,5062,3152,1910
1990,408,Dem. People's Republic of Korea,Pakistan,72,39,33
1990,392,Japan,Pakistan,2068,1054,1014
1990,496,Mongolia,Pakistan,12,12,0
1990,410,Republic of Korea,Pakistan,269,265,4
1990,96,Brunei Darussalam,Pakistan,378,249,129
1990,116,Cambodia,Pakistan,19,9,10
1990,360,Indonesia,Pakistan,5486,2706,2780
1990,458,Malaysia,Pakistan,3208,2767,441
1990,104,Myanmar,Pakistan,5171,4024,1147
1990,608,Philippines,Pakistan,262,235,27
1990,702,Singapore,Pakistan,12345,8176,4169
1990,764,Thailand,Pakistan,1086,602,484
1990,626,Timor-Leste,Pakistan,190,103,87
1990,704,Viet Nam,Pakistan,30,26,4
1990,28,Antigua and Barbuda,Pakistan,7,3,4
1990,44,Bahamas,Pakistan,15,8,7
1990,136,Cayman Islands,Pakistan,34,22,12
1990,214,Dominican Republic,Pakistan,166,140,26
1990,662,Saint Lucia,Pakistan,8,4,4
1990,188,Costa Rica,Pakistan,6,5,1
1990,320,Guatemala,Pakistan,17,5,12
1990,484,Mexico,Pakistan,23,11,12
1990,591,Panama,Pakistan,43,25,18
1990,32,Argentina,Pakistan,10,10,0
1990,68,Bolivia (Plurinational State of),Pakistan,55,37,18
1990,76,Brazil,Pakistan,127,99,28
1990,152,Chile,Pakistan,42,21,21
1990,170,Colombia,Pakistan,39,26,13
1990,218,Ecuador,Pakistan,18,16,2
1990,604,Peru,Pakistan,44,35,9
1990,862,Venezuela (Bolivarian Republic of),Pakistan,12,10,2
1990,36,Australia,Pakistan,5949,3570,2379
1990,554,New Zealand,Pakistan,28,19,9
1990,242,Fiji,Pakistan,1294,653,641
1990,112,Belarus,Pakistan,24,24,0
1990,100,Bulgaria,Pakistan,23,22,1
1990,203,Czechia,Pakistan,23,19,4
1990,348,Hungary,Pakistan,205,138,67
1990,616,Poland,Pakistan,85,70,15
1990,642,Romania,Pakistan,1,1,0
1990,643,Russian Federation,Pakistan,1683,826,857
1990,703,Slovakia,Pakistan,2,2,0
1990,208,Denmark,Pakistan,6946,3949,2997
1990,246,Finland,Pakistan,139,114,25
1990,352,Iceland,Pakistan,8,5,3
1990,372,Ireland,Pakistan,293,144,149
1990,428,Latvia,Pakistan,16,14,2
1990,440,Lithuania,Pakistan,35,29,6
1990,578,Norway,Pakistan,10470,6125,4345
1990,752,Sweden,Pakistan,2435,1373,1062
1990,826,United Kingdom,Pakistan,228321,117858,110463
1990,300,Greece,Pakistan,5947,4653,1294
1990,380,Italy,Pakistan,6808,5993,815
1990,470,Malta,Pakistan,54,17,37
1990,620,Portugal,Pakistan,250,223,27
1990,705,Slovenia,Pakistan,3,2,1
1990,724,Spain,Pakistan,2213,1722,491
1990,40,Austria,Pakistan,2651,1733,918
1990,56,Belgium,Pakistan,3767,2761,1006
1990,250,France,Pakistan,15579,9829,5750
1990,276,Germany,Pakistan,26620,21694,4926
1990,528,Netherlands,Pakistan,6717,4270,2447
1990,756,Switzerland,Pakistan,1918,1388,530
1990,60,Bermuda,Pakistan,13,8,5
1990,124,Canada,Pakistan,24161,11763,12398
1990,840,United States of America,Pakistan,91889,59445,32444
1995,480,Mauritius,Pakistan,3,2,1
1995,508,Mozambique,Pakistan,711,471,240
1995,690,Seychelles,Pakistan,17,7,10
1995,800,Uganda,Pakistan,204,166,38
1995,834,United Republic of Tanzania,Pakistan,517,302,215
1995,72,Botswana,Pakistan,175,99,76
1995,426,Lesotho,Pakistan,266,148,118
1995,516,Namibia,Pakistan,235,210,25
1995,710,South Africa,Pakistan,2469,1931,538
1995,288,Ghana,Pakistan,47,27,20
1995,818,Egypt,Pakistan,403,270,133
1995,434,Libya,Pakistan,1445,1004,441
1995,48,Bahrain,Pakistan,25280,18926,6354
1995,196,Cyprus,Pakistan,183,170,13
1995,368,Iraq,Pakistan,619,407,212
1995,400,Jordan,Pakistan,4558,2521,2037
1995,414,Kuwait,Pakistan,112925,79357,33568
1995,422,Lebanon,Pakistan,2077,1114,963
1995,512,Oman,Pakistan,59439,50942,8497
1995,634,Qatar,Pakistan,363,271,92
1995,682,Saudi Arabia,Pakistan,570555,393823,176732
1995,792,Turkey,Pakistan,666,403,263
1995,784,United Arab Emirates,Pakistan,225750,172353,53397
1995,762,Tajikistan,Pakistan,144,70,74
1995,4,Afghanistan,Pakistan,17225,9722,7503
1995,64,Bhutan,Pakistan,12,12,0
1995,356,India,Pakistan,1637255,863727,773528
1995,364,Iran (Islamic Republic of),Pakistan,11801,6756,5045
1995,462,Maldives,Pakistan,92,46,46
1995,524,Nepal,Pakistan,2734,1213,1521
1995,144,Sri Lanka,Pakistan,248,159,89
1995,156,China,Pakistan,2494,1427,1067
1995,344,"China, Hong Kong SAR",Pakistan,5650,3504,2146
1995,408,Dem. People's Republic of Korea,Pakistan,90,48,42
1995,392,Japan,Pakistan,4818,2313,2505
1995,496,Mongolia,Pakistan,13,13,0
1995,410,Republic of Korea,Pakistan,1674,1645,29
1995,96,Brunei Darussalam,Pakistan,574,380,194
1995,116,Cambodia,Pakistan,50,23,27
1995,360,Indonesia,Pakistan,3629,1838,1791
1995,458,Malaysia,Pakistan,4484,2981,1503
1995,104,Myanmar,Pakistan,4685,3543,1142
1995,608,Philippines,Pakistan,352,315,37
1995,702,Singapore,Pakistan,26021,17144,8877
1995,764,Thailand,Pakistan,1820,982,838
1995,626,Timor-Leste,Pakistan,207,111,96
1995,704,Viet Nam,Pakistan,70,46,24
1995,28,Antigua and Barbuda,Pakistan,4,2,2
1995,44,Bahamas,Pakistan,13,7,6
1995,136,Cayman Islands,Pakistan,66,43,23
1995,214,Dominican Republic,Pakistan,185,155,30
1995,662,Saint Lucia,Pakistan,10,5,5
1995,188,Costa Rica,Pakistan,5,5,0
1995,320,Guatemala,Pakistan,17,6,11
1995,484,Mexico,Pakistan,53,39,14
1995,591,Panama,Pakistan,45,27,18
1995,32,Argentina,Pakistan,10,10,0
1995,68,Bolivia (Plurinational State of),Pakistan,42,31,11
1995,76,Brazil,Pakistan,150,103,47
1995,152,Chile,Pakistan,100,81,19
1995,170,Colombia,Pakistan,38,25,13
1995,218,Ecuador,Pakistan,20,18,2
1995,604,Peru,Pakistan,45,35,10
1995,862,Venezuela (Bolivarian Republic of),Pakistan,11,9,2
1995,36,Australia,Pakistan,8707,5077,3630
1995,554,New Zealand,Pakistan,90,53,37
1995,242,Fiji,Pakistan,1382,708,674
1995,112,Belarus,Pakistan,37,37,0
1995,100,Bulgaria,Pakistan,25,23,2
1995,203,Czechia,Pakistan,34,28,6
1995,348,Hungary,Pakistan,182,122,60
1995,616,Poland,Pakistan,72,60,12
1995,642,Romania,Pakistan,1,1,0
1995,643,Russian Federation,Pakistan,1367,864,503
1995,703,Slovakia,Pakistan,25,25,0
1995,208,Denmark,Pakistan,8498,4692,3806
1995,246,Finland,Pakistan,237,174,63
1995,352,Iceland,Pakistan,10,6,4
1995,372,Ireland,Pakistan,1594,760,834
1995,428,Latvia,Pakistan,25,23,2
1995,440,Lithuania,Pakistan,40,34,6
1995,578,Norway,Pakistan,11567,6371,5196
1995,752,Sweden,Pakistan,2890,1620,1270
1995,826,United Kingdom,Pakistan,267177,137138,130039
1995,300,Greece,Pakistan,8295,7462,833
1995,380,Italy,Pakistan,15787,11358,4429
1995,470,Malta,Pakistan,64,21,43
1995,620,Portugal,Pakistan,540,482,58
1995,705,Slovenia,Pakistan,5,3,2
1995,724,Spain,Pakistan,3186,2514,672
1995,40,Austria,Pakistan,2991,1972,1019
1995,56,Belgium,Pakistan,4078,2759,1319
1995,250,France,Pakistan,16083,10047,6036
1995,276,Germany,Pakistan,31202,22551,8651
1995,528,Netherlands,Pakistan,8428,5295,3133
1995,756,Switzerland,Pakistan,2427,1679,748
1995,60,Bermuda,Pakistan,18,10,8
1995,124,Canada,Pakistan,52674,25461,27213
1995,840,United States of America,Pakistan,159793,104027,55766
2000,480,Mauritius,Pakistan,7,3,4
2000,508,Mozambique,Pakistan,828,539,289
2000,690,Seychelles,Pakistan,11,4,7
2000,800,Uganda,Pakistan,594,459,135
2000,834,United Republic of Tanzania,Pakistan,545,318,227
2000,72,Botswana,Pakistan,223,125,98
2000,426,Lesotho,Pakistan,215,120,95
2000,516,Namibia,Pakistan,219,195,24
2000,710,South Africa,Pakistan,4181,3339,842
2000,288,Ghana,Pakistan,52,28,24
2000,818,Egypt,Pakistan,452,290,162
2000,434,Libya,Pakistan,1810,1258,552
2000,48,Bahrain,Pakistan,29683,21876,7807
2000,196,Cyprus,Pakistan,236,219,17
2000,268,Georgia,Pakistan,86,79,7
2000,368,Iraq,Pakistan,587,337,250
2000,400,Jordan,Pakistan,3949,2328,1621
2000,414,Kuwait,Pakistan,139783,101202,38581
2000,422,Lebanon,Pakistan,1793,984,809
2000,512,Oman,Pakistan,66498,57118,9380
2000,634,Qatar,Pakistan,338,258,80
2000,682,Saudi Arabia,Pakistan,586225,405412,180813
2000,792,Turkey,Pakistan,1060,636,424
2000,784,United Arab Emirates,Pakistan,305782,232003,73779
2000,762,Tajikistan,Pakistan,125,63,62
2000,4,Afghanistan,Pakistan,26343,14868,11475
2000,64,Bhutan,Pakistan,14,14,0
2000,356,India,Pakistan,1353231,702733,650498
2000,364,Iran (Islamic Republic of),Pakistan,8144,4828,3316
2000,462,Maldives,Pakistan,100,55,45
2000,524,Nepal,Pakistan,2470,1341,1129
2000,144,Sri Lanka,Pakistan,324,204,120
2000,156,China,Pakistan,3172,1805,1367
2000,344,"China, Hong Kong SAR",Pakistan,6237,3855,2382
2000,408,Dem. People's Republic of Korea,Pakistan,107,56,51
2000,392,Japan,Pakistan,7499,3464,4035
2000,496,Mongolia,Pakistan,15,15,0
2000,410,Republic of Korea,Pakistan,3612,3549,63
2000,96,Brunei Darussalam,Pakistan,770,512,258
2000,116,Cambodia,Pakistan,81,38,43
2000,360,Indonesia,Pakistan,1773,970,803
2000,458,Malaysia,Pakistan,7140,4015,3125
2000,104,Myanmar,Pakistan,3980,2855,1125
2000,608,Philippines,Pakistan,1232,626,606
2000,702,Singapore,Pakistan,42217,27615,14602
2000,764,Thailand,Pakistan,2930,1543,1387
2000,626,Timor-Leste,Pakistan,226,120,106
2000,704,Viet Nam,Pakistan,166,96,70
2000,44,Bahamas,Pakistan,11,6,5
2000,136,Cayman Islands,Pakistan,114,73,41
2000,214,Dominican Republic,Pakistan,203,170,33
2000,662,Saint Lucia,Pakistan,14,7,7
2000,188,Costa Rica,Pakistan,7,7,0
2000,320,Guatemala,Pakistan,16,7,9
2000,484,Mexico,Pakistan,87,69,18
2000,591,Panama,Pakistan,51,31,20
2000,32,Argentina,Pakistan,10,10,0
2000,68,Bolivia (Plurinational State of),Pakistan,29,26,3
2000,76,Brazil,Pakistan,172,106,66
2000,152,Chile,Pakistan,158,127,31
2000,170,Colombia,Pakistan,37,25,12
2000,218,Ecuador,Pakistan,22,20,2
2000,604,Peru,Pakistan,53,41,12
2000,862,Venezuela (Bolivarian Republic of),Pakistan,11,9,2
2000,36,Australia,Pakistan,10950,6297,4653
2000,554,New Zealand,Pakistan,1283,624,659
2000,242,Fiji,Pakistan,1456,750,706
2000,112,Belarus,Pakistan,49,49,0
2000,100,Bulgaria,Pakistan,27,24,3
2000,203,Czechia,Pakistan,45,37,8
2000,348,Hungary,Pakistan,158,105,53
2000,616,Poland,Pakistan,62,51,11
2000,642,Romania,Pakistan,1,1,0
2000,643,Russian Federation,Pakistan,1002,871,131
2000,703,Slovakia,Pakistan,93,62,31
2000,208,Denmark,Pakistan,10049,5435,4614
2000,246,Finland,Pakistan,334,234,100
2000,352,Iceland,Pakistan,12,7,5
2000,372,Ireland,Pakistan,3770,1860,1910
2000,428,Latvia,Pakistan,34,31,3
2000,440,Lithuania,Pakistan,31,27,4
2000,578,Norway,Pakistan,13283,7094,6189
2000,752,Sweden,Pakistan,3100,1729,1371
2000,826,United Kingdom,Pakistan,310526,158388,152138
2000,300,Greece,Pakistan,10780,10380,400
2000,380,Italy,Pakistan,24765,16722,8043
2000,470,Malta,Pakistan,81,28,53
2000,620,Portugal,Pakistan,852,760,92
2000,705,Slovenia,Pakistan,13,7,6
2000,724,Spain,Pakistan,5531,4406,1125
2000,40,Austria,Pakistan,3331,2212,1119
2000,56,Belgium,Pakistan,4270,2681,1589
2000,250,France,Pakistan,16586,10264,6322
2000,276,Germany,Pakistan,35783,23408,12375
2000,528,Netherlands,Pakistan,10427,6491,3936
2000,756,Switzerland,Pakistan,2946,1978,968
2000,60,Bermuda,Pakistan,22,12,10
2000,124,Canada,Pakistan,82440,39770,42670
2000,840,United States of America,Pakistan,229151,149665,79486
2005,480,Mauritius,Pakistan,82,32,50
2005,508,Mozambique,Pakistan,1121,693,428
2005,690,Seychelles,Pakistan,16,10,6
2005,800,Uganda,Pakistan,572,441,131
2005,834,United Republic of Tanzania,Pakistan,617,365,252
2005,72,Botswana,Pakistan,374,208,166
2005,426,Lesotho,Pakistan,219,122,97
2005,516,Namibia,Pakistan,173,154,19
2005,710,South Africa,Pakistan,5528,4352,1176
2005,288,Ghana,Pakistan,73,41,32
2005,694,Sierra Leone,Pakistan,122,85,37
2005,818,Egypt,Pakistan,538,357,181
2005,434,Libya,Pakistan,1994,1495,499
2005,48,Bahrain,Pakistan,46931,35612,11319
2005,196,Cyprus,Pakistan,346,321,25
2005,268,Georgia,Pakistan,81,75,6
2005,368,Iraq,Pakistan,673,467,206
2005,400,Jordan,Pakistan,5704,3647,2057
2005,414,Kuwait,Pakistan,162363,120070,42293
2005,422,Lebanon,Pakistan,1403,795,608
2005,512,Oman,Pakistan,70569,61607,8962
2005,634,Qatar,Pakistan,51773,42682,9091
2005,682,Saudi Arabia,Pakistan,724160,511418,212742
2005,792,Turkey,Pakistan,1092,646,446
2005,784,United Arab Emirates,Pakistan,383831,295159,88672
2005,762,Tajikistan,Pakistan,108,55,53
2005,4,Afghanistan,Pakistan,37163,20975,16188
2005,64,Bhutan,Pakistan,17,17,0
2005,356,India,Pakistan,1250307,647902,602405
2005,364,Iran (Islamic Republic of),Pakistan,16288,9656,6632
2005,462,Maldives,Pakistan,104,61,43
2005,524,Nepal,Pakistan,2153,1077,1076
2005,144,Sri Lanka,Pakistan,482,259,223
2005,156,China,Pakistan,3499,2150,1349
2005,344,"China, Hong Kong SAR",Pakistan,6809,4078,2731
2005,408,Dem. People's Republic of Korea,Pakistan,131,67,64
2005,392,Japan,Pakistan,9714,4425,5289
2005,496,Mongolia,Pakistan,15,15,0
2005,410,Republic of Korea,Pakistan,4744,4536,208
2005,96,Brunei Darussalam,Pakistan,787,525,262
2005,116,Cambodia,Pakistan,63,30,33
2005,360,Indonesia,Pakistan,4457,2295,2162
2005,458,Malaysia,Pakistan,16632,9457,7175
2005,104,Myanmar,Pakistan,3371,2427,944
2005,608,Philippines,Pakistan,997,515,482
2005,702,Singapore,Pakistan,73468,41988,31480
2005,764,Thailand,Pakistan,2462,1304,1158
2005,626,Timor-Leste,Pakistan,240,133,107
2005,704,Viet Nam,Pakistan,338,197,141
2005,44,Bahamas,Pakistan,6,3,3
2005,136,Cayman Islands,Pakistan,103,66,37
2005,214,Dominican Republic,Pakistan,139,113,26
2005,662,Saint Lucia,Pakistan,8,4,4
2005,188,Costa Rica,Pakistan,5,5,0
2005,320,Guatemala,Pakistan,20,9,11
2005,484,Mexico,Pakistan,109,86,23
2005,591,Panama,Pakistan,59,35,24
2005,32,Argentina,Pakistan,8,8,0
2005,68,Bolivia (Plurinational State of),Pakistan,25,21,4
2005,76,Brazil,Pakistan,215,128,87
2005,152,Chile,Pakistan,237,192,45
2005,170,Colombia,Pakistan,35,24,11
2005,218,Ecuador,Pakistan,26,24,2
2005,604,Peru,Pakistan,62,47,15
2005,862,Venezuela (Bolivarian Republic of),Pakistan,11,9,2
2005,36,Australia,Pakistan,16810,9660,7150
2005,554,New Zealand,Pakistan,2114,1027,1087
2005,242,Fiji,Pakistan,1650,871,779
2005,112,Belarus,Pakistan,47,47,0
2005,100,Bulgaria,Pakistan,34,29,5
2005,203,Czechia,Pakistan,222,180,42
2005,348,Hungary,Pakistan,195,131,64
2005,616,Poland,Pakistan,139,124,15
2005,642,Romania,Pakistan,1,1,0
2005,643,Russian Federation,Pakistan,866,727,139
2005,703,Slovakia,Pakistan,125,102,23
2005,208,Denmark,Pakistan,10796,5809,4987
2005,246,Finland,Pakistan,866,613,253
2005,352,Iceland,Pakistan,20,13,7
2005,372,Ireland,Pakistan,6971,4309,2662
2005,428,Latvia,Pakistan,34,30,4
2005,440,Lithuania,Pakistan,50,46,4
2005,578,Norway,Pakistan,15225,7960,7265
2005,752,Sweden,Pakistan,4703,2892,1811
2005,826,United Kingdom,Pakistan,380338,195270,185068
2005,300,Greece,Pakistan,21381,20566,815
2005,380,Italy,Pakistan,54772,37285,17487
2005,470,Malta,Pakistan,97,35,62
2005,620,Portugal,Pakistan,1395,1036,359
2005,705,Slovenia,Pakistan,16,10,6
2005,724,Spain,Pakistan,30659,27602,3057
2005,40,Austria,Pakistan,3724,2443,1281
2005,56,Belgium,Pakistan,6772,4293,2479
2005,250,France,Pakistan,16544,10047,6497
2005,276,Germany,Pakistan,38473,24701,13772
2005,528,Netherlands,Pakistan,10817,6560,4257
2005,756,Switzerland,Pakistan,3334,2179,1155
2005,60,Bermuda,Pakistan,30,16,14
2005,124,Canada,Pakistan,116119,58437,57682
2005,840,United States of America,Pakistan,261537,131001,130536
2010,480,Mauritius,Pakistan,163,66,97
2010,508,Mozambique,Pakistan,1299,803,496
2010,690,Seychelles,Pakistan,22,17,5
2010,800,Uganda,Pakistan,630,471,159
2010,834,United Republic of Tanzania,Pakistan,635,377,258
2010,72,Botswana,Pakistan,400,210,190
2010,426,Lesotho,Pakistan,223,124,99
2010,516,Namibia,Pakistan,166,148,18
2010,710,South Africa,Pakistan,8659,6811,1848
2010,288,Ghana,Pakistan,55,29,26
2010,694,Sierra Leone,Pakistan,107,71,36
2010,818,Egypt,Pakistan,581,378,203
2010,434,Libya,Pakistan,2181,1641,540
2010,48,Bahrain,Pakistan,74535,57239,17296
2010,196,Cyprus,Pakistan,566,526,40
2010,268,Georgia,Pakistan,81,75,6
2010,368,Iraq,Pakistan,680,484,196
2010,400,Jordan,Pakistan,7335,4840,2495
2010,414,Kuwait,Pakistan,225431,169400,56031
2010,422,Lebanon,Pakistan,1013,607,406
2010,512,Oman,Pakistan,86029,76443,9586
2010,634,Qatar,Pakistan,145204,124634,20570
2010,682,Saudi Arabia,Pakistan,938913,680304,258609
2010,792,Turkey,Pakistan,1125,656,469
2010,784,United Arab Emirates,Pakistan,836310,657517,178793
2010,762,Tajikistan,Pakistan,107,55,52
2010,4,Afghanistan,Pakistan,47984,27082,20902
2010,64,Bhutan,Pakistan,20,20,0
2010,356,India,Pakistan,1147382,593071,554311
2010,364,Iran (Islamic Republic of),Pakistan,28689,17567,11122
2010,462,Maldives,Pakistan,203,152,51
2010,524,Nepal,Pakistan,1292,833,459
2010,144,Sri Lanka,Pakistan,809,449,360
2010,156,China,Pakistan,3827,2496,1331
2010,344,"China, Hong Kong SAR",Pakistan,7398,4312,3086
2010,408,Dem. People's Republic of Korea,Pakistan,154,77,77
2010,392,Japan,Pakistan,10299,4633,5666
2010,496,Mongolia,Pakistan,17,17,0
2010,410,Republic of Korea,Pakistan,7750,7301,449
2010,96,Brunei Darussalam,Pakistan,804,538,266
2010,116,Cambodia,Pakistan,45,22,23
2010,360,Indonesia,Pakistan,7428,3533,3895
2010,458,Malaysia,Pakistan,31814,18317,13497
2010,104,Myanmar,Pakistan,3102,2249,853
2010,608,Philippines,Pakistan,491,243,248
2010,702,Singapore,Pakistan,108812,58657,50155
2010,764,Thailand,Pakistan,2171,1181,990
2010,626,Timor-Leste,Pakistan,245,140,105
2010,704,Viet Nam,Pakistan,490,270,220
2010,136,Cayman Islands,Pakistan,102,65,37
2010,214,Dominican Republic,Pakistan,75,56,19
2010,662,Saint Lucia,Pakistan,3,2,1
2010,188,Costa Rica,Pakistan,9,9,0
2010,320,Guatemala,Pakistan,23,11,12
2010,484,Mexico,Pakistan,144,112,32
2010,591,Panama,Pakistan,71,42,29
2010,32,Argentina,Pakistan,5,5,0
2010,68,Bolivia (Plurinational State of),Pakistan,20,16,4
2010,76,Brazil,Pakistan,255,149,106
2010,152,Chile,Pakistan,316,256,60
2010,170,Colombia,Pakistan,39,27,12
2010,218,Ecuador,Pakistan,36,33,3
2010,604,Peru,Pakistan,69,53,16
2010,862,Venezuela (Bolivarian Republic of),Pakistan,13,11,2
2010,36,Australia,Pakistan,30600,18768,11832
2010,554,New Zealand,Pakistan,2558,1240,1318
2010,242,Fiji,Pakistan,1771,946,825
2010,112,Belarus,Pakistan,45,45,0
2010,100,Bulgaria,Pakistan,39,33,6
2010,203,Czechia,Pakistan,376,306,70
2010,348,Hungary,Pakistan,232,157,75
2010,616,Poland,Pakistan,221,201,20
2010,642,Romania,Pakistan,11,10,1
2010,643,Russian Federation,Pakistan,714,568,146
2010,703,Slovakia,Pakistan,69,66,3
2010,208,Denmark,Pakistan,11339,6077,5262
2010,233,Estonia,Pakistan,32,27,5
2010,246,Finland,Pakistan,1532,1052,480
2010,352,Iceland,Pakistan,26,17,9
2010,372,Ireland,Pakistan,9025,5711,3314
2010,428,Latvia,Pakistan,35,30,5
2010,440,Lithuania,Pakistan,63,59,4
2010,578,Norway,Pakistan,17220,8914,8306
2010,752,Sweden,Pakistan,10265,7356,2909
2010,826,United Kingdom,Pakistan,460473,243285,217188
2010,300,Greece,Pakistan,33275,31997,1278
2010,380,Italy,Pakistan,78200,53280,24920
2010,470,Malta,Pakistan,149,70,79
2010,620,Portugal,Pakistan,1708,1142,566
2010,705,Slovenia,Pakistan,18,12,6
2010,724,Spain,Pakistan,56836,48013,8823
2010,40,Austria,Pakistan,4116,2674,1442
2010,56,Belgium,Pakistan,8710,5482,3228
2010,250,France,Pakistan,22329,13630,8699
2010,276,Germany,Pakistan,40592,25686,14906
2010,528,Netherlands,Pakistan,11251,6713,4538
2010,756,Switzerland,Pakistan,3893,2471,1422
2010,60,Bermuda,Pakistan,37,20,17
2010,124,Canada,Pakistan,136865,75818,61047
2010,840,United States of America,Pakistan,302798,149589,153209
2015,480,Mauritius,Pakistan,187,81,106
2015,508,Mozambique,Pakistan,1363,843,520
2015,690,Seychelles,Pakistan,24,19,5
2015,800,Uganda,Pakistan,1004,655,349
2015,834,United Republic of Tanzania,Pakistan,668,399,269
2015,72,Botswana,Pakistan,436,229,207
2015,426,Lesotho,Pakistan,228,127,101
2015,516,Namibia,Pakistan,162,145,17
2015,710,South Africa,Pakistan,15619,12117,3502
2015,288,Ghana,Pakistan,67,35,32
2015,324,Guinea,Pakistan,19,15,4
2015,694,Sierra Leone,Pakistan,94,58,36
2015,818,Egypt,Pakistan,430,299,131
2015,434,Libya,Pakistan,2459,1842,617
2015,48,Bahrain,Pakistan,74710,57113,17597
2015,196,Cyprus,Pakistan,543,505,38
2015,268,Georgia,Pakistan,85,79,6
2015,368,Iraq,Pakistan,682,516,166
2015,400,Jordan,Pakistan,3157,1842,1315
2015,414,Kuwait,Pakistan,312434,224082,88352
2015,422,Lebanon,Pakistan,852,408,444
2015,512,Oman,Pakistan,195644,177125,18519
2015,634,Qatar,Pakistan,133212,115582,17630
2015,682,Saudi Arabia,Pakistan,1187817,844721,343096
2015,792,Turkey,Pakistan,1168,671,497
2015,784,United Arab Emirates,Pakistan,913855,710779,203076
2015,762,Tajikistan,Pakistan,105,54,51
2015,4,Afghanistan,Pakistan,348369,179052,169317
2015,64,Bhutan,Pakistan,22,22,0
2015,356,India,Pakistan,1101031,567861,533170
2015,364,Iran (Islamic Republic of),Pakistan,28402,17280,11122
2015,462,Maldives,Pakistan,303,244,59
2015,524,Nepal,Pakistan,1268,815,453
2015,144,Sri Lanka,Pakistan,823,451,372
2015,156,China,Pakistan,4404,2943,1461
2015,344,"China, Hong Kong SAR",Pakistan,7554,4280,3274
2015,408,Dem. People's Republic of Korea,Pakistan,170,86,84
2015,392,Japan,Pakistan,12708,5669,7039
2015,496,Mongolia,Pakistan,21,21,0
2015,410,Republic of Korea,Pakistan,9629,9059,570
2015,96,Brunei Darussalam,Pakistan,821,551,270
2015,116,Cambodia,Pakistan,41,21,20
2015,360,Indonesia,Pakistan,8223,4005,4218
2015,458,Malaysia,Pakistan,80224,46720,33504
2015,104,Myanmar,Pakistan,2975,2162,813
2015,608,Philippines,Pakistan,499,248,251
2015,702,Singapore,Pakistan,129253,68880,60373
2015,764,Thailand,Pakistan,2347,1273,1074
2015,626,Timor-Leste,Pakistan,306,199,107
2015,704,Viet Nam,Pakistan,591,323,268
2015,136,Cayman Islands,Pakistan,110,71,39
2015,214,Dominican Republic,Pakistan,79,59,20
2015,662,Saint Lucia,Pakistan,2,2,0
2015,188,Costa Rica,Pakistan,9,9,0
2015,320,Guatemala,Pakistan,26,12,14
2015,484,Mexico,Pakistan,152,118,34
2015,591,Panama,Pakistan,84,49,35
2015,32,Argentina,Pakistan,5,5,0
2015,68,Bolivia (Plurinational State of),Pakistan,23,18,5
2015,76,Brazil,Pakistan,307,179,128
2015,152,Chile,Pakistan,478,386,92
2015,170,Colombia,Pakistan,43,30,13
2015,218,Ecuador,Pakistan,29,16,13
2015,604,Peru,Pakistan,73,56,17
2015,862,Venezuela (Bolivarian Republic of),Pakistan,14,12,2
2015,36,Australia,Pakistan,62270,37991,24279
2015,554,New Zealand,Pakistan,2961,1432,1529
2015,242,Fiji,Pakistan,1824,984,840
2015,112,Belarus,Pakistan,47,47,0
2015,100,Bulgaria,Pakistan,156,101,55
2015,203,Czechia,Pakistan,533,412,121
2015,348,Hungary,Pakistan,359,267,92
2015,616,Poland,Pakistan,213,195,18
2015,642,Romania,Pakistan,289,238,51
2015,643,Russian Federation,Pakistan,728,579,149
2015,703,Slovakia,Pakistan,90,84,6
2015,208,Denmark,Pakistan,13576,7405,6171
2015,233,Estonia,Pakistan,72,63,9
2015,246,Finland,Pakistan,2752,1859,893
2015,352,Iceland,Pakistan,38,21,17
2015,372,Ireland,Pakistan,9219,5792,3427
2015,428,Latvia,Pakistan,24,21,3
2015,440,Lithuania,Pakistan,91,85,6
2015,578,Norway,Pakistan,19498,10128,9370
2015,752,Sweden,Pakistan,11469,6948,4521
2015,826,United Kingdom,Pakistan,532770,287337,245433
2015,300,Greece,Pakistan,31230,29980,1250
2015,380,Italy,Pakistan,89474,61312,28162
2015,470,Malta,Pakistan,253,128,125
2015,620,Portugal,Pakistan,1935,1261,674
2015,705,Slovenia,Pakistan,26,20,6
2015,724,Spain,Pakistan,54547,37953,16594
2015,40,Austria,Pakistan,4814,3137,1677
2015,56,Belgium,Pakistan,11995,7639,4356
2015,250,France,Pakistan,24736,14835,9901
2015,276,Germany,Pakistan,42295,26726,15569
2015,528,Netherlands,Pakistan,12127,7026,5101
2015,756,Switzerland,Pakistan,4909,3088,1821
2015,60,Bermuda,Pakistan,37,20,17
2015,124,Canada,Pakistan,201014,102542,98472
2015,840,United States of America,Pakistan,376432,184989,191443
2019,480,Mauritius,Pakistan,188,82,106
2019,508,Mozambique,Pakistan,1417,877,540
2019,690,Seychelles,Pakistan,24,19,5
2019,800,Uganda,Pakistan,1070,682,388
2019,834,United Republic of Tanzania,Pakistan,599,357,242
2019,72,Botswana,Pakistan,466,245,221
2019,426,Lesotho,Pakistan,240,134,106
2019,516,Namibia,Pakistan,171,154,17
2019,710,South Africa,Pakistan,17506,13585,3921
2019,288,Ghana,Pakistan,75,40,35
2019,324,Guinea,Pakistan,18,15,3
2019,694,Sierra Leone,Pakistan,89,54,35
2019,818,Egypt,Pakistan,612,404,208
2019,434,Libya,Pakistan,2609,1955,654
2019,48,Bahrain,Pakistan,78638,60116,18522
2019,196,Cyprus,Pakistan,542,505,37
2019,268,Georgia,Pakistan,87,81,6
2019,368,Iraq,Pakistan,698,528,170
2019,400,Jordan,Pakistan,3395,1981,1414
2019,414,Kuwait,Pakistan,330824,237272,93552
2019,422,Lebanon,Pakistan,804,385,419
2019,512,Oman,Pakistan,240965,218157,22808
2019,634,Qatar,Pakistan,235876,203923,31953
2019,682,Saudi Arabia,Pakistan,1447071,1019878,427193
2019,792,Turkey,Pakistan,1579,914,665
2019,784,United Arab Emirates,Pakistan,981536,763383,218153
2019,762,Tajikistan,Pakistan,104,54,50
2019,4,Afghanistan,Pakistan,106528,54102,52426
2019,64,Bhutan,Pakistan,22,22,0
2019,356,India,Pakistan,1082917,559112,523805
2019,364,Iran (Islamic Republic of),Pakistan,27941,17000,10941
2019,462,Maldives,Pakistan,326,263,63
2019,524,Nepal,Pakistan,1221,782,439
2019,144,Sri Lanka,Pakistan,829,455,374
2019,156,China,Pakistan,4641,3102,1539
2019,344,"China, Hong Kong SAR",Pakistan,9787,5418,4369
2019,408,Dem. People's Republic of Korea,Pakistan,173,88,85
2019,392,Japan,Pakistan,14421,6434,7987
2019,496,Mongolia,Pakistan,22,22,0
2019,410,Republic of Korea,Pakistan,9802,9222,580
2019,96,Brunei Darussalam,Pakistan,884,594,290
2019,116,Cambodia,Pakistan,43,22,21
2019,360,Indonesia,Pakistan,8588,4183,4405
2019,458,Malaysia,Pakistan,83884,49109,34775
2019,104,Myanmar,Pakistan,3084,2242,842
2019,608,Philippines,Pakistan,514,256,258
2019,702,Singapore,Pakistan,109537,58309,51228
2019,764,Thailand,Pakistan,2447,1328,1119
2019,626,Timor-Leste,Pakistan,302,197,105
2019,704,Viet Nam,Pakistan,617,337,280
2019,136,Cayman Islands,Pakistan,121,79,42
2019,214,Dominican Republic,Pakistan,81,61,20
2019,662,Saint Lucia,Pakistan,1,1,0
2019,188,Costa Rica,Pakistan,9,9,0
2019,320,Guatemala,Pakistan,26,12,14
2019,484,Mexico,Pakistan,156,121,35
2019,591,Panama,Pakistan,87,52,35
2019,32,Argentina,Pakistan,5,5,0
2019,68,Bolivia (Plurinational State of),Pakistan,25,20,5
2019,76,Brazil,Pakistan,345,201,144
2019,152,Chile,Pakistan,638,509,129
2019,170,Colombia,Pakistan,43,30,13
2019,218,Ecuador,Pakistan,36,19,17
2019,604,Peru,Pakistan,86,67,19
2019,862,Venezuela (Bolivarian Republic of),Pakistan,13,12,1
2019,36,Australia,Pakistan,81032,49733,31299
2019,554,New Zealand,Pakistan,3043,1472,1571
2019,242,Fiji,Pakistan,1862,1005,857
2019,112,Belarus,Pakistan,46,46,0
2019,100,Bulgaria,Pakistan,248,156,92
2019,203,Czechia,Pakistan,591,454,137
2019,348,Hungary,Pakistan,593,425,168
2019,616,Poland,Pakistan,225,207,18
2019,642,Romania,Pakistan,532,409,123
2019,643,Russian Federation,Pakistan,727,579,148
2019,703,Slovakia,Pakistan,106,97,9
2019,208,Denmark,Pakistan,14892,7895,6997
2019,233,Estonia,Pakistan,131,107,24
2019,246,Finland,Pakistan,3626,2417,1209
2019,352,Iceland,Pakistan,57,40,17
2019,372,Ireland,Pakistan,10121,6371,3750
2019,428,Latvia,Pakistan,52,43,9
2019,440,Lithuania,Pakistan,4,0,4
2019,578,Norway,Pakistan,21849,11314,10535
2019,752,Sweden,Pakistan,16976,10189,6787
2019,826,United Kingdom,Pakistan,605016,327006,278010
2019,300,Greece,Pakistan,8431,4114,4317
2019,380,Italy,Pakistan,112947,80841,32106
2019,470,Malta,Pakistan,408,208,200
2019,620,Portugal,Pakistan,1967,1284,683
2019,705,Slovenia,Pakistan,38,26,12
2019,724,Spain,Pakistan,55043,36068,18975
2019,40,Austria,Pakistan,5682,3737,1945
2019,56,Belgium,Pakistan,13217,8272,4945
2019,250,France,Pakistan,26183,15679,10504
2019,276,Germany,Pakistan,66033,45987,20046
2019,528,Netherlands,Pakistan,13559,7833,5726
2019,756,Switzerland,Pakistan,5387,3346,2041
2019,60,Bermuda,Pakistan,37,20,17
2019,124,Canada,Pakistan,215409,109885,105524
2019,840,United States of America,Pakistan,406509,197544,208965
1990,608,Philippines,Palau,3,3,0
1990,152,Chile,Palau,1,0,1
1990,316,Guam,Palau,1232,525,707
1990,583,Micronesia (Fed. States of),Palau,378,216,162
1990,580,Northern Mariana Islands,Palau,1332,619,713
1990,428,Latvia,Palau,1,0,1
1990,300,Greece,Palau,8,5,3
1990,380,Italy,Palau,2,1,1
1990,40,Austria,Palau,1,0,1
1995,608,Philippines,Palau,4,4,0
1995,152,Chile,Palau,1,1,0
1995,316,Guam,Palau,1284,545,739
1995,583,Micronesia (Fed. States of),Palau,342,216,126
1995,580,Northern Mariana Islands,Palau,1198,599,599
1995,428,Latvia,Palau,1,0,1
1995,300,Greece,Palau,10,5,5
1995,380,Italy,Palau,4,1,3
1995,40,Austria,Palau,1,0,1
2000,608,Philippines,Palau,1186,532,654
2000,152,Chile,Palau,2,1,1
2000,316,Guam,Palau,1335,565,770
2000,583,Micronesia (Fed. States of),Palau,318,173,145
2000,580,Northern Mariana Islands,Palau,1138,579,559
2000,428,Latvia,Palau,1,0,1
2000,752,Sweden,Palau,1,1,0
2000,300,Greece,Palau,12,5,7
2000,380,Italy,Palau,6,1,5
2000,40,Austria,Palau,1,0,1
2005,608,Philippines,Palau,959,438,521
2005,152,Chile,Palau,3,2,1
2005,316,Guam,Palau,1386,653,733
2005,583,Micronesia (Fed. States of),Palau,296,157,139
2005,580,Northern Mariana Islands,Palau,1032,492,540
2005,300,Greece,Palau,102,81,21
2005,380,Italy,Palau,7,2,5
2005,40,Austria,Palau,1,0,1
2010,608,Philippines,Palau,34,16,18
2010,76,Brazil,Palau,20,12,8
2010,152,Chile,Palau,4,3,1
2010,316,Guam,Palau,1437,742,695
2010,583,Micronesia (Fed. States of),Palau,285,150,135
2010,580,Northern Mariana Islands,Palau,630,270,360
2010,752,Sweden,Palau,2,0,2
2010,300,Greece,Palau,199,163,36
2010,380,Italy,Palau,9,4,5
2010,40,Austria,Palau,1,0,1
2015,324,Guinea,Palau,9,5,4
2015,608,Philippines,Palau,34,15,19
2015,76,Brazil,Palau,24,14,10
2015,152,Chile,Palau,6,5,1
2015,316,Guam,Palau,1449,748,701
2015,583,Micronesia (Fed. States of),Palau,280,148,132
2015,580,Northern Mariana Islands,Palau,564,241,323
2015,752,Sweden,Palau,3,2,1
2015,300,Greece,Palau,186,151,35
2015,380,Italy,Palau,5,2,3
2015,40,Austria,Palau,1,0,1
2019,324,Guinea,Palau,8,5,3
2019,608,Philippines,Palau,35,16,19
2019,76,Brazil,Palau,27,16,11
2019,152,Chile,Palau,8,7,1
2019,316,Guam,Palau,1520,785,735
2019,583,Micronesia (Fed. States of),Palau,286,152,134
2019,580,Northern Mariana Islands,Palau,568,243,325
2019,752,Sweden,Palau,11,7,4
2019,300,Greece,Palau,181,149,32
2019,380,Italy,Palau,5,2,3
2019,40,Austria,Palau,1,0,1
1990,710,South Africa,Panama,59,23,36
1990,196,Cyprus,Panama,5,4,1
1990,44,Bahamas,Panama,17,6,11
1990,136,Cayman Islands,Panama,42,23,19
1990,192,Cuba,Panama,184,63,121
1990,214,Dominican Republic,Panama,699,398,301
1990,388,Jamaica,Panama,73,31,42
1990,630,Puerto Rico,Panama,1873,887,986
1990,662,Saint Lucia,Panama,12,6,6
1990,188,Costa Rica,Panama,8692,4539,4153
1990,222,El Salvador,Panama,557,260,297
1990,320,Guatemala,Panama,242,67,175
1990,340,Honduras,Panama,190,111,79
1990,484,Mexico,Panama,25641,12956,12685
1990,558,Nicaragua,Panama,442,216,226
1990,32,Argentina,Panama,376,242,134
1990,68,Bolivia (Plurinational State of),Panama,92,52,40
1990,76,Brazil,Panama,974,567,407
1990,152,Chile,Panama,351,181,170
1990,170,Colombia,Panama,2073,962,1111
1990,218,Ecuador,Panama,321,164,157
1990,604,Peru,Panama,214,106,108
1990,862,Venezuela (Bolivarian Republic of),Panama,1470,687,783
1990,36,Australia,Panama,118,62,56
1990,100,Bulgaria,Panama,4,3,1
1990,203,Czechia,Panama,2,2,0
1990,348,Hungary,Panama,8,7,1
1990,616,Poland,Panama,34,20,14
1990,643,Russian Federation,Panama,81,40,41
1990,208,Denmark,Panama,25,14,11
1990,246,Finland,Panama,10,6,4
1990,352,Iceland,Panama,1,0,1
1990,372,Ireland,Panama,3,1,2
1990,578,Norway,Panama,12,5,7
1990,752,Sweden,Panama,157,81,76
1990,826,United Kingdom,Panama,68,38,30
1990,300,Greece,Panama,286,158,128
1990,380,Italy,Panama,143,50,93
1990,620,Portugal,Panama,35,16,19
1990,724,Spain,Panama,1236,532,704
1990,40,Austria,Panama,34,13,21
1990,56,Belgium,Panama,108,37,71
1990,250,France,Panama,358,153,205
1990,276,Germany,Panama,207,124,83
1990,528,Netherlands,Panama,101,57,44
1990,756,Switzerland,Panama,258,111,147
1990,124,Canada,Panama,1118,544,574
1990,840,United States of America,Panama,85737,41938,43799
1995,710,South Africa,Panama,36,16,20
1995,196,Cyprus,Panama,7,5,2
1995,44,Bahamas,Panama,15,6,9
1995,136,Cayman Islands,Panama,81,43,38
1995,192,Cuba,Panama,140,44,96
1995,214,Dominican Republic,Panama,777,434,343
1995,388,Jamaica,Panama,77,33,44
1995,630,Puerto Rico,Panama,1661,788,873
1995,662,Saint Lucia,Panama,16,9,7
1995,188,Costa Rica,Panama,7652,4085,3567
1995,222,El Salvador,Panama,456,211,245
1995,320,Guatemala,Panama,216,75,141
1995,340,Honduras,Panama,243,138,105
1995,484,Mexico,Panama,13722,6879,6843
1995,558,Nicaragua,Panama,351,170,181
1995,32,Argentina,Panama,357,214,143
1995,68,Bolivia (Plurinational State of),Panama,95,49,46
1995,76,Brazil,Panama,767,446,321
1995,152,Chile,Panama,427,216,211
1995,170,Colombia,Panama,1966,912,1054
1995,218,Ecuador,Panama,361,185,176
1995,604,Peru,Panama,215,105,110
1995,862,Venezuela (Bolivarian Republic of),Panama,1203,571,632
1995,36,Australia,Panama,138,79,59
1995,100,Bulgaria,Panama,4,3,1
1995,203,Czechia,Panama,4,3,1
1995,348,Hungary,Panama,13,9,4
1995,616,Poland,Panama,29,18,11
1995,643,Russian Federation,Panama,72,42,30
1995,208,Denmark,Panama,31,18,13
1995,246,Finland,Panama,11,8,3
1995,352,Iceland,Panama,2,1,1
1995,372,Ireland,Panama,9,3,6
1995,578,Norway,Panama,21,8,13
1995,752,Sweden,Panama,187,96,91
1995,826,United Kingdom,Panama,269,115,154
1995,300,Greece,Panama,210,106,104
1995,380,Italy,Panama,362,77,285
1995,620,Portugal,Panama,75,34,41
1995,724,Spain,Panama,1407,615,792
1995,40,Austria,Panama,39,15,24
1995,56,Belgium,Panama,105,34,71
1995,250,France,Panama,370,155,215
1995,276,Germany,Panama,237,115,122
1995,528,Netherlands,Panama,148,81,67
1995,756,Switzerland,Panama,302,136,166
1995,124,Canada,Panama,1785,863,922
1995,840,United States of America,Panama,96734,47766,48968
2000,710,South Africa,Panama,25,13,12
2000,196,Cyprus,Panama,9,7,2
2000,44,Bahamas,Panama,14,7,7
2000,136,Cayman Islands,Panama,140,74,66
2000,192,Cuba,Panama,95,25,70
2000,214,Dominican Republic,Panama,854,470,384
2000,388,Jamaica,Panama,80,35,45
2000,630,Puerto Rico,Panama,1454,690,764
2000,662,Saint Lucia,Panama,22,12,10
2000,188,Costa Rica,Panama,10438,5528,4910
2000,222,El Salvador,Panama,354,162,192
2000,320,Guatemala,Panama,190,84,106
2000,340,Honduras,Panama,296,165,131
2000,484,Mexico,Panama,2396,1138,1258
2000,558,Nicaragua,Panama,347,182,165
2000,32,Argentina,Panama,338,187,151
2000,68,Bolivia (Plurinational State of),Panama,97,46,51
2000,76,Brazil,Panama,559,325,234
2000,152,Chile,Panama,504,253,251
2000,170,Colombia,Panama,1858,862,996
2000,218,Ecuador,Panama,400,205,195
2000,604,Peru,Panama,252,123,129
2000,862,Venezuela (Bolivarian Republic of),Panama,976,469,507
2000,36,Australia,Panama,140,70,70
2000,100,Bulgaria,Panama,4,4,0
2000,203,Czechia,Panama,5,4,1
2000,348,Hungary,Panama,18,12,6
2000,616,Poland,Panama,25,15,10
2000,643,Russian Federation,Panama,61,42,19
2000,208,Denmark,Panama,37,22,15
2000,246,Finland,Panama,12,10,2
2000,352,Iceland,Panama,2,1,1
2000,372,Ireland,Panama,19,7,12
2000,578,Norway,Panama,27,9,18
2000,752,Sweden,Panama,201,102,99
2000,826,United Kingdom,Panama,476,195,281
2000,300,Greece,Panama,137,53,84
2000,380,Italy,Panama,580,104,476
2000,620,Portugal,Panama,119,53,66
2000,724,Spain,Panama,2185,984,1201
2000,40,Austria,Panama,43,17,26
2000,56,Belgium,Panama,102,34,68
2000,250,France,Panama,381,156,225
2000,276,Germany,Panama,267,107,160
2000,528,Netherlands,Panama,201,107,94
2000,756,Switzerland,Panama,348,162,186
2000,124,Canada,Panama,2495,1203,1292
2000,840,United States of America,Panama,107847,53721,54126
2005,710,South Africa,Panama,32,17,15
2005,196,Cyprus,Panama,13,10,3
2005,44,Bahamas,Panama,31,11,20
2005,136,Cayman Islands,Panama,127,68,59
2005,192,Cuba,Panama,63,17,46
2005,214,Dominican Republic,Panama,788,423,365
2005,388,Jamaica,Panama,78,34,44
2005,630,Puerto Rico,Panama,1104,524,580
2005,662,Saint Lucia,Panama,15,9,6
2005,188,Costa Rica,Panama,6201,3210,2991
2005,222,El Salvador,Panama,394,180,214
2005,320,Guatemala,Panama,226,110,116
2005,340,Honduras,Panama,290,163,127
2005,484,Mexico,Panama,1966,943,1023
2005,558,Nicaragua,Panama,352,196,156
2005,32,Argentina,Panama,249,139,110
2005,68,Bolivia (Plurinational State of),Panama,96,48,48
2005,76,Brazil,Panama,541,333,208
2005,152,Chile,Panama,756,386,370
2005,170,Colombia,Panama,1743,815,928
2005,218,Ecuador,Panama,472,247,225
2005,604,Peru,Panama,296,145,151
2005,862,Venezuela (Bolivarian Republic of),Panama,925,439,486
2005,36,Australia,Panama,170,97,73
2005,100,Bulgaria,Panama,5,5,0
2005,203,Czechia,Panama,15,11,4
2005,348,Hungary,Panama,22,15,7
2005,616,Poland,Panama,29,15,14
2005,643,Russian Federation,Panama,42,31,11
2005,208,Denmark,Panama,53,28,25
2005,246,Finland,Panama,17,12,5
2005,352,Iceland,Panama,4,2,2
2005,372,Ireland,Panama,19,8,11
2005,578,Norway,Panama,36,13,23
2005,752,Sweden,Panama,221,104,117
2005,826,United Kingdom,Panama,557,231,326
2005,300,Greece,Panama,149,65,84
2005,380,Italy,Panama,801,191,610
2005,620,Portugal,Panama,81,36,45
2005,724,Spain,Panama,3120,1382,1738
2005,40,Austria,Panama,48,18,30
2005,56,Belgium,Panama,136,46,90
2005,250,France,Panama,385,150,235
2005,276,Germany,Panama,446,188,258
2005,528,Netherlands,Panama,243,121,122
2005,756,Switzerland,Panama,364,162,202
2005,124,Canada,Panama,2458,1216,1242
2005,840,United States of America,Panama,106087,53139,52948
2010,710,South Africa,Panama,50,27,23
2010,196,Cyprus,Panama,21,17,4
2010,44,Bahamas,Panama,48,16,32
2010,136,Cayman Islands,Panama,126,68,58
2010,192,Cuba,Panama,35,10,25
2010,214,Dominican Republic,Panama,717,373,344
2010,388,Jamaica,Panama,76,34,42
2010,630,Puerto Rico,Panama,617,289,328
2010,662,Saint Lucia,Panama,8,5,3
2010,188,Costa Rica,Panama,11250,5773,5477
2010,222,El Salvador,Panama,433,198,235
2010,320,Guatemala,Panama,261,135,126
2010,340,Honduras,Panama,284,162,122
2010,484,Mexico,Panama,1766,860,906
2010,558,Nicaragua,Panama,376,211,165
2010,32,Argentina,Panama,160,92,68
2010,68,Bolivia (Plurinational State of),Panama,94,50,44
2010,76,Brazil,Panama,516,336,180
2010,152,Chile,Panama,1008,519,489
2010,170,Colombia,Panama,1929,923,1006
2010,218,Ecuador,Panama,663,339,324
2010,604,Peru,Panama,330,161,169
2010,862,Venezuela (Bolivarian Republic of),Panama,886,416,470
2010,36,Australia,Panama,220,130,90
2010,100,Bulgaria,Panama,6,6,0
2010,203,Czechia,Panama,24,17,7
2010,348,Hungary,Panama,26,18,8
2010,616,Poland,Panama,34,15,19
2010,643,Russian Federation,Panama,24,20,4
2010,208,Denmark,Panama,67,34,33
2010,246,Finland,Panama,26,17,9
2010,352,Iceland,Panama,6,4,2
2010,372,Ireland,Panama,16,6,10
2010,578,Norway,Panama,52,17,35
2010,752,Sweden,Panama,263,118,145
2010,826,United Kingdom,Panama,586,250,336
2010,300,Greece,Panama,166,79,87
2010,380,Italy,Panama,1055,288,767
2010,620,Portugal,Panama,30,13,17
2010,724,Spain,Panama,4381,1909,2472
2010,40,Austria,Panama,53,20,33
2010,56,Belgium,Panama,140,47,93
2010,250,France,Panama,479,189,290
2010,276,Germany,Panama,594,257,337
2010,528,Netherlands,Panama,262,125,137
2010,756,Switzerland,Panama,460,187,273
2010,124,Canada,Panama,2445,1243,1202
2010,840,United States of America,Panama,107540,53129,54411
2015,710,South Africa,Panama,89,47,42
2015,196,Cyprus,Panama,20,17,3
2015,44,Bahamas,Panama,52,17,35
2015,136,Cayman Islands,Panama,136,74,62
2015,192,Cuba,Panama,28,8,20
2015,214,Dominican Republic,Panama,756,393,363
2015,388,Jamaica,Panama,74,33,41
2015,630,Puerto Rico,Panama,921,430,491
2015,662,Saint Lucia,Panama,7,5,2
2015,188,Costa Rica,Panama,11424,5828,5596
2015,222,El Salvador,Panama,451,206,245
2015,320,Guatemala,Panama,300,157,143
2015,340,Honduras,Panama,398,228,170
2015,484,Mexico,Panama,1636,952,684
2015,558,Nicaragua,Panama,405,228,177
2015,32,Argentina,Panama,161,93,68
2015,68,Bolivia (Plurinational State of),Panama,109,58,51
2015,76,Brazil,Panama,621,404,217
2015,152,Chile,Panama,1527,771,756
2015,170,Colombia,Panama,2159,1044,1115
2015,218,Ecuador,Panama,964,490,474
2015,604,Peru,Panama,350,176,174
2015,862,Venezuela (Bolivarian Republic of),Panama,880,407,473
2015,36,Australia,Panama,250,134,116
2015,100,Bulgaria,Panama,7,6,1
2015,203,Czechia,Panama,44,31,13
2015,348,Hungary,Panama,29,14,15
2015,616,Poland,Panama,32,15,17
2015,643,Russian Federation,Panama,25,20,5
2015,208,Denmark,Panama,86,38,48
2015,246,Finland,Panama,28,17,11
2015,352,Iceland,Panama,6,3,3
2015,372,Ireland,Panama,16,6,10
2015,578,Norway,Panama,60,23,37
2015,752,Sweden,Panama,293,128,165
2015,826,United Kingdom,Panama,749,307,442
2015,300,Greece,Panama,155,70,85
2015,380,Italy,Panama,1124,314,810
2015,620,Portugal,Panama,35,15,20
2015,724,Spain,Panama,4246,1784,2462
2015,40,Austria,Panama,62,24,38
2015,56,Belgium,Panama,171,59,112
2015,250,France,Panama,530,201,329
2015,276,Germany,Panama,618,266,352
2015,528,Netherlands,Panama,318,154,164
2015,756,Switzerland,Panama,486,207,279
2015,124,Canada,Panama,2598,1226,1372
2015,840,United States of America,Panama,116055,57035,59020
2019,710,South Africa,Panama,99,53,46
2019,196,Cyprus,Panama,19,17,2
2019,44,Bahamas,Panama,55,18,37
2019,136,Cayman Islands,Panama,151,82,69
2019,192,Cuba,Panama,25,7,18
2019,214,Dominican Republic,Panama,781,406,375
2019,388,Jamaica,Panama,74,33,41
2019,630,Puerto Rico,Panama,636,296,340
2019,662,Saint Lucia,Panama,6,5,1
2019,188,Costa Rica,Panama,11592,5951,5641
2019,222,El Salvador,Panama,457,209,248
2019,320,Guatemala,Panama,307,161,146
2019,340,Honduras,Panama,404,232,172
2019,484,Mexico,Panama,1686,981,705
2019,558,Nicaragua,Panama,424,239,185
2019,32,Argentina,Panama,163,94,69
2019,68,Bolivia (Plurinational State of),Panama,119,64,55
2019,76,Brazil,Panama,699,455,244
2019,152,Chile,Panama,2040,974,1066
2019,170,Colombia,Panama,2208,1068,1140
2019,218,Ecuador,Panama,949,483,466
2019,604,Peru,Panama,412,214,198
2019,862,Venezuela (Bolivarian Republic of),Panama,861,396,465
2019,36,Australia,Panama,285,136,149
2019,100,Bulgaria,Panama,9,7,2
2019,203,Czechia,Panama,58,38,20
2019,348,Hungary,Panama,26,13,13
2019,616,Poland,Panama,33,16,17
2019,643,Russian Federation,Panama,24,20,4
2019,208,Denmark,Panama,104,44,60
2019,246,Finland,Panama,40,23,17
2019,352,Iceland,Panama,5,3,2
2019,372,Ireland,Panama,17,7,10
2019,578,Norway,Panama,83,30,53
2019,752,Sweden,Panama,337,160,177
2019,826,United Kingdom,Panama,850,350,500
2019,300,Greece,Panama,151,72,79
2019,380,Italy,Panama,1094,299,795
2019,620,Portugal,Panama,35,15,20
2019,724,Spain,Panama,4399,1787,2612
2019,40,Austria,Panama,73,29,44
2019,56,Belgium,Panama,187,68,119
2019,250,France,Panama,561,212,349
2019,276,Germany,Panama,677,302,375
2019,528,Netherlands,Panama,362,177,185
2019,756,Switzerland,Panama,568,240,328
2019,124,Canada,Panama,2784,1314,1470
2019,840,United States of America,Panama,125329,60907,64422
1990,710,South Africa,Papua New Guinea,59,21,38
1990,608,Philippines,Papua New Guinea,9,9,0
1990,152,Chile,Papua New Guinea,4,3,1
1990,554,New Zealand,Papua New Guinea,1160,540,620
1990,90,Solomon Islands,Papua New Guinea,1110,576,534
1990,548,Vanuatu,Papua New Guinea,50,16,34
1990,184,Cook Islands,Papua New Guinea,10,5,5
1990,882,Samoa,Papua New Guinea,24,9,15
1990,100,Bulgaria,Papua New Guinea,1,1,0
1990,208,Denmark,Papua New Guinea,4,2,2
1990,246,Finland,Papua New Guinea,1,0,1
1990,372,Ireland,Papua New Guinea,3,2,1
1990,752,Sweden,Papua New Guinea,18,11,7
1990,826,United Kingdom,Papua New Guinea,147,89,58
1990,300,Greece,Papua New Guinea,3,1,2
1990,380,Italy,Papua New Guinea,3,1,2
1990,724,Spain,Papua New Guinea,1,1,0
1990,40,Austria,Papua New Guinea,33,17,16
1990,56,Belgium,Papua New Guinea,99,66,33
1990,250,France,Papua New Guinea,108,56,52
1990,756,Switzerland,Papua New Guinea,158,95,63
1990,124,Canada,Papua New Guinea,106,52,54
1995,710,South Africa,Papua New Guinea,36,15,21
1995,608,Philippines,Papua New Guinea,12,12,0
1995,68,Bolivia (Plurinational State of),Papua New Guinea,1,0,1
1995,152,Chile,Papua New Guinea,4,3,1
1995,554,New Zealand,Papua New Guinea,1560,733,827
1995,90,Solomon Islands,Papua New Guinea,1098,571,527
1995,548,Vanuatu,Papua New Guinea,50,27,23
1995,184,Cook Islands,Papua New Guinea,11,6,5
1995,882,Samoa,Papua New Guinea,41,16,25
1995,100,Bulgaria,Papua New Guinea,2,2,0
1995,203,Czechia,Papua New Guinea,1,0,1
1995,348,Hungary,Papua New Guinea,1,0,1
1995,208,Denmark,Papua New Guinea,6,4,2
1995,246,Finland,Papua New Guinea,2,1,1
1995,352,Iceland,Papua New Guinea,1,0,1
1995,372,Ireland,Papua New Guinea,7,3,4
1995,752,Sweden,Papua New Guinea,21,12,9
1995,826,United Kingdom,Papua New Guinea,580,287,293
1995,300,Greece,Papua New Guinea,2,1,1
1995,380,Italy,Papua New Guinea,9,3,6
1995,724,Spain,Papua New Guinea,3,2,1
1995,40,Austria,Papua New Guinea,37,19,18
1995,56,Belgium,Papua New Guinea,99,66,33
1995,250,France,Papua New Guinea,112,57,55
1995,756,Switzerland,Papua New Guinea,168,102,66
1995,124,Canada,Papua New Guinea,199,96,103
2000,710,South Africa,Papua New Guinea,25,13,12
2000,608,Philippines,Papua New Guinea,373,171,202
2000,68,Bolivia (Plurinational State of),Papua New Guinea,1,0,1
2000,152,Chile,Papua New Guinea,4,2,2
2000,554,New Zealand,Papua New Guinea,1117,543,574
2000,90,Solomon Islands,Papua New Guinea,1047,546,501
2000,548,Vanuatu,Papua New Guinea,50,26,24
2000,184,Cook Islands,Papua New Guinea,11,6,5
2000,882,Samoa,Papua New Guinea,58,22,36
2000,100,Bulgaria,Papua New Guinea,2,2,0
2000,203,Czechia,Papua New Guinea,1,0,1
2000,348,Hungary,Papua New Guinea,1,0,1
2000,208,Denmark,Papua New Guinea,7,5,2
2000,246,Finland,Papua New Guinea,3,2,1
2000,352,Iceland,Papua New Guinea,1,0,1
2000,372,Ireland,Papua New Guinea,15,6,9
2000,752,Sweden,Papua New Guinea,23,13,10
2000,826,United Kingdom,Papua New Guinea,1023,489,534
2000,300,Greece,Papua New Guinea,1,0,1
2000,380,Italy,Papua New Guinea,14,4,10
2000,724,Spain,Papua New Guinea,47,33,14
2000,40,Austria,Papua New Guinea,41,22,19
2000,56,Belgium,Papua New Guinea,99,66,33
2000,250,France,Papua New Guinea,115,58,57
2000,756,Switzerland,Papua New Guinea,180,109,71
2000,124,Canada,Papua New Guinea,297,143,154
2005,710,South Africa,Papua New Guinea,32,15,17
2005,608,Philippines,Papua New Guinea,301,141,160
2005,68,Bolivia (Plurinational State of),Papua New Guinea,1,0,1
2005,152,Chile,Papua New Guinea,6,4,2
2005,554,New Zealand,Papua New Guinea,1199,582,617
2005,90,Solomon Islands,Papua New Guinea,800,429,371
2005,548,Vanuatu,Papua New Guinea,56,28,28
2005,184,Cook Islands,Papua New Guinea,14,6,8
2005,882,Samoa,Papua New Guinea,54,20,34
2005,100,Bulgaria,Papua New Guinea,3,3,0
2005,203,Czechia,Papua New Guinea,2,1,1
2005,348,Hungary,Papua New Guinea,1,0,1
2005,208,Denmark,Papua New Guinea,8,5,3
2005,246,Finland,Papua New Guinea,6,3,3
2005,352,Iceland,Papua New Guinea,1,0,1
2005,372,Ireland,Papua New Guinea,15,6,9
2005,752,Sweden,Papua New Guinea,25,15,10
2005,826,United Kingdom,Papua New Guinea,1005,480,525
2005,300,Greece,Papua New Guinea,3,2,1
2005,380,Italy,Papua New Guinea,23,7,16
2005,724,Spain,Papua New Guinea,23,16,7
2005,40,Austria,Papua New Guinea,46,24,22
2005,56,Belgium,Papua New Guinea,99,66,33
2005,250,France,Papua New Guinea,50,17,33
2005,528,Netherlands,Papua New Guinea,131,59,72
2005,756,Switzerland,Papua New Guinea,199,117,82
2005,124,Canada,Papua New Guinea,399,183,216
2010,710,South Africa,Papua New Guinea,50,24,26
2010,608,Philippines,Papua New Guinea,59,27,32
2010,68,Bolivia (Plurinational State of),Papua New Guinea,1,1,0
2010,152,Chile,Papua New Guinea,8,5,3
2010,554,New Zealand,Papua New Guinea,1309,635,674
2010,90,Solomon Islands,Papua New Guinea,603,338,265
2010,548,Vanuatu,Papua New Guinea,63,32,31
2010,184,Cook Islands,Papua New Guinea,17,6,11
2010,882,Samoa,Papua New Guinea,48,18,30
2010,100,Bulgaria,Papua New Guinea,3,3,0
2010,203,Czechia,Papua New Guinea,3,2,1
2010,348,Hungary,Papua New Guinea,1,0,1
2010,208,Denmark,Papua New Guinea,7,4,3
2010,233,Estonia,Papua New Guinea,1,1,0
2010,246,Finland,Papua New Guinea,9,4,5
2010,352,Iceland,Papua New Guinea,4,2,2
2010,372,Ireland,Papua New Guinea,13,5,8
2010,752,Sweden,Papua New Guinea,25,14,11
2010,826,United Kingdom,Papua New Guinea,1058,517,541
2010,300,Greece,Papua New Guinea,4,4,0
2010,380,Italy,Papua New Guinea,33,12,21
2010,724,Spain,Papua New Guinea,28,16,12
2010,40,Austria,Papua New Guinea,51,26,25
2010,56,Belgium,Papua New Guinea,33,12,21
2010,250,France,Papua New Guinea,25,13,12
2010,528,Netherlands,Papua New Guinea,134,61,73
2010,756,Switzerland,Papua New Guinea,238,133,105
2010,124,Canada,Papua New Guinea,410,183,227
2015,710,South Africa,Papua New Guinea,89,41,48
2015,324,Guinea,Papua New Guinea,16,12,4
2015,608,Philippines,Papua New Guinea,60,27,33
2015,68,Bolivia (Plurinational State of),Papua New Guinea,1,1,0
2015,152,Chile,Papua New Guinea,12,8,4
2015,554,New Zealand,Papua New Guinea,1399,677,722
2015,90,Solomon Islands,Papua New Guinea,564,317,247
2015,548,Vanuatu,Papua New Guinea,64,32,32
2015,184,Cook Islands,Papua New Guinea,15,5,10
2015,882,Samoa,Papua New Guinea,40,15,25
2015,100,Bulgaria,Papua New Guinea,2,2,0
2015,203,Czechia,Papua New Guinea,4,3,1
2015,348,Hungary,Papua New Guinea,4,0,4
2015,208,Denmark,Papua New Guinea,9,6,3
2015,233,Estonia,Papua New Guinea,2,2,0
2015,246,Finland,Papua New Guinea,12,7,5
2015,352,Iceland,Papua New Guinea,1,0,1
2015,372,Ireland,Papua New Guinea,13,5,8
2015,752,Sweden,Papua New Guinea,31,18,13
2015,826,United Kingdom,Papua New Guinea,1353,641,712
2015,300,Greece,Papua New Guinea,3,3,0
2015,380,Italy,Papua New Guinea,617,211,406
2015,724,Spain,Papua New Guinea,30,16,14
2015,40,Austria,Papua New Guinea,60,31,29
2015,56,Belgium,Papua New Guinea,35,11,24
2015,250,France,Papua New Guinea,27,14,13
2015,528,Netherlands,Papua New Guinea,132,62,70
2015,756,Switzerland,Papua New Guinea,250,136,114
2015,124,Canada,Papua New Guinea,233,99,134
2019,710,South Africa,Papua New Guinea,99,46,53
2019,324,Guinea,Papua New Guinea,15,12,3
2019,608,Philippines,Papua New Guinea,61,27,34
2019,68,Bolivia (Plurinational State of),Papua New Guinea,1,1,0
2019,152,Chile,Papua New Guinea,16,11,5
2019,554,New Zealand,Papua New Guinea,1438,696,742
2019,90,Solomon Islands,Papua New Guinea,552,311,241
2019,548,Vanuatu,Papua New Guinea,65,33,32
2019,184,Cook Islands,Papua New Guinea,15,5,10
2019,882,Samoa,Papua New Guinea,37,14,23
2019,100,Bulgaria,Papua New Guinea,3,2,1
2019,203,Czechia,Papua New Guinea,6,5,1
2019,348,Hungary,Papua New Guinea,3,0,3
2019,208,Denmark,Papua New Guinea,8,4,4
2019,233,Estonia,Papua New Guinea,2,2,0
2019,246,Finland,Papua New Guinea,14,7,7
2019,352,Iceland,Papua New Guinea,1,0,1
2019,372,Ireland,Papua New Guinea,14,6,8
2019,752,Sweden,Papua New Guinea,28,15,13
2019,826,United Kingdom,Papua New Guinea,1536,730,806
2019,300,Greece,Papua New Guinea,2,2,0
2019,380,Italy,Papua New Guinea,43,21,22
2019,724,Spain,Papua New Guinea,31,17,14
2019,40,Austria,Papua New Guinea,70,37,33
2019,56,Belgium,Papua New Guinea,32,10,22
2019,250,France,Papua New Guinea,28,15,13
2019,528,Netherlands,Papua New Guinea,140,66,74
2019,756,Switzerland,Papua New Guinea,244,135,109
2019,124,Canada,Papua New Guinea,249,106,143
1990,710,South Africa,Paraguay,116,44,72
1990,196,Cyprus,Paraguay,2,0,2
1990,214,Dominican Republic,Paraguay,61,41,20
1990,188,Costa Rica,Paraguay,58,20,38
1990,222,El Salvador,Paraguay,36,18,18
1990,320,Guatemala,Paraguay,72,35,37
1990,340,Honduras,Paraguay,27,16,11
1990,484,Mexico,Paraguay,290,198,92
1990,591,Panama,Paraguay,38,14,24
1990,32,Argentina,Paraguay,257243,112781,144462
1990,68,Bolivia (Plurinational State of),Paraguay,1173,593,580
1990,76,Brazil,Paraguay,21394,10075,11319
1990,152,Chile,Paraguay,641,290,351
1990,170,Colombia,Paraguay,237,155,82
1990,218,Ecuador,Paraguay,81,43,38
1990,604,Peru,Paraguay,339,154,185
1990,858,Uruguay,Paraguay,1241,1031,210
1990,862,Venezuela (Bolivarian Republic of),Paraguay,359,175,184
1990,36,Australia,Paraguay,277,148,129
1990,203,Czechia,Paraguay,8,5,3
1990,348,Hungary,Paraguay,5,4,1
1990,643,Russian Federation,Paraguay,104,51,53
1990,208,Denmark,Paraguay,28,13,15
1990,246,Finland,Paraguay,7,4,3
1990,352,Iceland,Paraguay,1,0,1
1990,372,Ireland,Paraguay,5,2,3
1990,428,Latvia,Paraguay,1,0,1
1990,578,Norway,Paraguay,50,19,31
1990,752,Sweden,Paraguay,102,49,53
1990,826,United Kingdom,Paraguay,70,42,28
1990,300,Greece,Paraguay,72,40,32
1990,380,Italy,Paraguay,53,18,35
1990,620,Portugal,Paraguay,6,3,3
1990,724,Spain,Paraguay,907,355,552
1990,40,Austria,Paraguay,125,53,72
1990,56,Belgium,Paraguay,166,53,113
1990,250,France,Paraguay,755,347,408
1990,276,Germany,Paraguay,636,309,327
1990,528,Netherlands,Paraguay,78,33,45
1990,756,Switzerland,Paraguay,356,164,192
1990,124,Canada,Paraguay,4702,2289,2413
1990,840,United States of America,Paraguay,6057,1945,4112
1995,710,South Africa,Paraguay,72,31,41
1995,196,Cyprus,Paraguay,3,0,3
1995,214,Dominican Republic,Paraguay,68,45,23
1995,188,Costa Rica,Paraguay,48,16,32
1995,222,El Salvador,Paraguay,26,13,13
1995,320,Guatemala,Paraguay,55,27,28
1995,340,Honduras,Paraguay,27,16,11
1995,484,Mexico,Paraguay,302,170,132
1995,591,Panama,Paraguay,35,13,22
1995,32,Argentina,Paraguay,286164,124821,161343
1995,68,Bolivia (Plurinational State of),Paraguay,2216,1142,1074
1995,76,Brazil,Paraguay,25143,11813,13330
1995,152,Chile,Paraguay,919,441,478
1995,170,Colombia,Paraguay,219,132,87
1995,218,Ecuador,Paraguay,91,48,43
1995,604,Peru,Paraguay,340,152,188
1995,858,Uruguay,Paraguay,1199,793,406
1995,862,Venezuela (Bolivarian Republic of),Paraguay,294,142,152
1995,36,Australia,Paraguay,343,168,175
1995,100,Bulgaria,Paraguay,1,1,0
1995,203,Czechia,Paraguay,12,7,5
1995,348,Hungary,Paraguay,10,5,5
1995,643,Russian Federation,Paraguay,117,54,63
1995,208,Denmark,Paraguay,41,19,22
1995,246,Finland,Paraguay,7,4,3
1995,352,Iceland,Paraguay,2,1,1
1995,372,Ireland,Paraguay,14,4,10
1995,428,Latvia,Paraguay,1,0,1
1995,578,Norway,Paraguay,55,20,35
1995,752,Sweden,Paraguay,121,58,63
1995,826,United Kingdom,Paraguay,275,131,144
1995,300,Greece,Paraguay,63,23,40
1995,380,Italy,Paraguay,315,57,258
1995,620,Portugal,Paraguay,14,6,8
1995,724,Spain,Paraguay,1090,436,654
1995,40,Austria,Paraguay,142,62,80
1995,56,Belgium,Paraguay,166,53,113
1995,250,France,Paraguay,780,351,429
1995,276,Germany,Paraguay,731,284,447
1995,528,Netherlands,Paraguay,114,46,68
1995,756,Switzerland,Paraguay,511,235,276
1995,124,Canada,Paraguay,4780,2316,2464
1995,840,United States of America,Paraguay,9138,3002,6136
2000,710,South Africa,Paraguay,50,26,24
2000,196,Cyprus,Paraguay,4,0,4
2000,214,Dominican Republic,Paraguay,75,49,26
2000,188,Costa Rica,Paraguay,63,19,44
2000,222,El Salvador,Paraguay,15,8,7
2000,320,Guatemala,Paraguay,38,20,18
2000,340,Honduras,Paraguay,26,15,11
2000,484,Mexico,Paraguay,329,151,178
2000,591,Panama,Paraguay,35,13,22
2000,32,Argentina,Paraguay,315086,136863,178223
2000,68,Bolivia (Plurinational State of),Paraguay,3236,1678,1558
2000,76,Brazil,Paraguay,28891,13551,15340
2000,152,Chile,Paraguay,1198,571,627
2000,170,Colombia,Paraguay,201,110,91
2000,218,Ecuador,Paraguay,101,54,47
2000,604,Peru,Paraguay,398,179,219
2000,858,Uruguay,Paraguay,1160,375,785
2000,862,Venezuela (Bolivarian Republic of),Paraguay,239,113,126
2000,36,Australia,Paraguay,360,164,196
2000,100,Bulgaria,Paraguay,1,1,0
2000,203,Czechia,Paraguay,15,8,7
2000,348,Hungary,Paraguay,14,6,8
2000,643,Russian Federation,Paraguay,126,55,71
2000,208,Denmark,Paraguay,54,25,29
2000,246,Finland,Paraguay,6,3,3
2000,352,Iceland,Paraguay,2,1,1
2000,372,Ireland,Paraguay,31,10,21
2000,428,Latvia,Paraguay,2,1,1
2000,578,Norway,Paraguay,74,33,41
2000,752,Sweden,Paraguay,130,61,69
2000,826,United Kingdom,Paraguay,486,222,264
2000,300,Greece,Paraguay,56,6,50
2000,380,Italy,Paraguay,577,97,480
2000,620,Portugal,Paraguay,23,9,14
2000,724,Spain,Paraguay,1744,724,1020
2000,40,Austria,Paraguay,158,70,88
2000,56,Belgium,Paraguay,161,54,107
2000,250,France,Paraguay,804,355,449
2000,276,Germany,Paraguay,826,260,566
2000,528,Netherlands,Paraguay,156,61,95
2000,756,Switzerland,Paraguay,669,308,361
2000,124,Canada,Paraguay,4972,2399,2573
2000,840,United States of America,Paraguay,12284,4092,8192
2005,710,South Africa,Paraguay,65,32,33
2005,196,Cyprus,Paraguay,6,0,6
2005,214,Dominican Republic,Paraguay,50,31,19
2005,188,Costa Rica,Paraguay,41,12,29
2005,222,El Salvador,Paraguay,13,7,6
2005,320,Guatemala,Paraguay,45,23,22
2005,340,Honduras,Paraguay,26,15,11
2005,484,Mexico,Paraguay,394,173,221
2005,591,Panama,Paraguay,67,26,41
2005,32,Argentina,Paraguay,451769,199442,252327
2005,68,Bolivia (Plurinational State of),Paraguay,3462,1788,1674
2005,76,Brazil,Paraguay,34146,15867,18279
2005,152,Chile,Paraguay,1798,873,925
2005,170,Colombia,Paraguay,185,95,90
2005,218,Ecuador,Paraguay,119,65,54
2005,604,Peru,Paraguay,468,213,255
2005,858,Uruguay,Paraguay,1074,348,726
2005,862,Venezuela (Bolivarian Republic of),Paraguay,226,109,117
2005,36,Australia,Paraguay,410,193,217
2005,100,Bulgaria,Paraguay,2,2,0
2005,203,Czechia,Paraguay,24,16,8
2005,348,Hungary,Paraguay,17,7,10
2005,643,Russian Federation,Paraguay,81,36,45
2005,208,Denmark,Paraguay,60,27,33
2005,246,Finland,Paraguay,10,5,5
2005,352,Iceland,Paraguay,3,2,1
2005,372,Ireland,Paraguay,31,11,20
2005,428,Latvia,Paraguay,1,1,0
2005,578,Norway,Paraguay,99,40,59
2005,752,Sweden,Paraguay,147,64,83
2005,826,United Kingdom,Paraguay,582,260,322
2005,300,Greece,Paraguay,69,11,58
2005,380,Italy,Paraguay,1607,455,1152
2005,620,Portugal,Paraguay,38,15,23
2005,724,Spain,Paraguay,16642,6186,10456
2005,40,Austria,Paraguay,177,76,101
2005,56,Belgium,Paraguay,250,78,172
2005,250,France,Paraguay,699,284,415
2005,276,Germany,Paraguay,2622,1099,1523
2005,528,Netherlands,Paraguay,169,61,108
2005,756,Switzerland,Paraguay,761,327,434
2005,124,Canada,Paraguay,6040,2960,3080
2005,840,United States of America,Paraguay,21344,7188,14156
2010,710,South Africa,Paraguay,101,50,51
2010,196,Cyprus,Paraguay,9,0,9
2010,214,Dominican Republic,Paraguay,24,13,11
2010,188,Costa Rica,Paraguay,82,25,57
2010,222,El Salvador,Paraguay,11,7,4
2010,320,Guatemala,Paraguay,51,26,25
2010,340,Honduras,Paraguay,25,15,10
2010,484,Mexico,Paraguay,506,215,291
2010,591,Panama,Paraguay,103,40,63
2010,32,Argentina,Paraguay,588452,262021,326431
2010,68,Bolivia (Plurinational State of),Paraguay,3681,1895,1786
2010,76,Brazil,Paraguay,38911,17933,20978
2010,152,Chile,Paraguay,2398,1174,1224
2010,170,Colombia,Paraguay,202,99,103
2010,218,Ecuador,Paraguay,167,89,78
2010,604,Peru,Paraguay,523,236,287
2010,858,Uruguay,Paraguay,995,316,679
2010,862,Venezuela (Bolivarian Republic of),Paraguay,217,107,110
2010,36,Australia,Paraguay,450,206,244
2010,100,Bulgaria,Paraguay,2,2,0
2010,203,Czechia,Paraguay,31,23,8
2010,348,Hungary,Paraguay,20,8,12
2010,643,Russian Federation,Paraguay,36,16,20
2010,208,Denmark,Paraguay,64,28,36
2010,246,Finland,Paraguay,15,7,8
2010,352,Iceland,Paraguay,3,3,0
2010,372,Ireland,Paraguay,26,8,18
2010,428,Latvia,Paraguay,1,1,0
2010,578,Norway,Paraguay,137,55,82
2010,752,Sweden,Paraguay,180,72,108
2010,826,United Kingdom,Paraguay,613,281,332
2010,300,Greece,Paraguay,84,16,68
2010,380,Italy,Paraguay,2646,831,1815
2010,620,Portugal,Paraguay,48,19,29
2010,724,Spain,Paraguay,80087,26611,53476
2010,40,Austria,Paraguay,195,82,113
2010,56,Belgium,Paraguay,358,137,221
2010,250,France,Paraguay,970,418,552
2010,276,Germany,Paraguay,4116,1820,2296
2010,528,Netherlands,Paraguay,177,59,118
2010,756,Switzerland,Paraguay,885,355,530
2010,124,Canada,Paraguay,7110,3528,3582
2010,840,United States of America,Paraguay,31296,10254,21042
2015,710,South Africa,Paraguay,181,86,95
2015,196,Cyprus,Paraguay,8,0,8
2015,214,Dominican Republic,Paraguay,25,14,11
2015,188,Costa Rica,Paraguay,83,25,58
2015,222,El Salvador,Paraguay,11,7,4
2015,320,Guatemala,Paraguay,59,31,28
2015,340,Honduras,Paraguay,35,22,13
2015,484,Mexico,Paraguay,536,225,311
2015,591,Panama,Paraguay,122,48,74
2015,32,Argentina,Paraguay,679044,302136,376908
2015,68,Bolivia (Plurinational State of),Paraguay,4285,2206,2079
2015,76,Brazil,Paraguay,46857,21395,25462
2015,152,Chile,Paraguay,3632,1738,1894
2015,170,Colombia,Paraguay,226,112,114
2015,218,Ecuador,Paraguay,242,128,114
2015,604,Peru,Paraguay,555,258,297
2015,858,Uruguay,Paraguay,1027,326,701
2015,862,Venezuela (Bolivarian Republic of),Paraguay,214,104,110
2015,36,Australia,Paraguay,500,234,266
2015,100,Bulgaria,Paraguay,2,2,0
2015,203,Czechia,Paraguay,27,20,7
2015,348,Hungary,Paraguay,16,7,9
2015,642,Romania,Paraguay,13,4,9
2015,643,Russian Federation,Paraguay,36,16,20
2015,208,Denmark,Paraguay,74,30,44
2015,246,Finland,Paraguay,29,18,11
2015,352,Iceland,Paraguay,4,3,1
2015,372,Ireland,Paraguay,27,8,19
2015,428,Latvia,Paraguay,3,2,1
2015,578,Norway,Paraguay,150,58,92
2015,752,Sweden,Paraguay,202,74,128
2015,826,United Kingdom,Paraguay,783,346,437
2015,300,Greece,Paraguay,78,12,66
2015,380,Italy,Paraguay,2651,793,1858
2015,620,Portugal,Paraguay,53,18,35
2015,724,Spain,Paraguay,58926,16474,42452
2015,40,Austria,Paraguay,229,97,132
2015,56,Belgium,Paraguay,447,156,291
2015,250,France,Paraguay,1073,445,628
2015,276,Germany,Paraguay,4289,1891,2398
2015,528,Netherlands,Paraguay,201,69,132
2015,756,Switzerland,Paraguay,1111,402,709
2015,124,Canada,Paraguay,7255,3522,3733
2015,840,United States of America,Paraguay,31770,10301,21469
2019,710,South Africa,Paraguay,202,96,106
2019,196,Cyprus,Paraguay,7,0,7
2019,214,Dominican Republic,Paraguay,25,14,11
2019,188,Costa Rica,Paraguay,84,26,58
2019,222,El Salvador,Paraguay,11,7,4
2019,320,Guatemala,Paraguay,60,32,28
2019,340,Honduras,Paraguay,35,22,13
2019,484,Mexico,Paraguay,552,232,320
2019,591,Panama,Paraguay,128,51,77
2019,32,Argentina,Paraguay,690948,306802,384146
2019,68,Bolivia (Plurinational State of),Paraguay,4678,2409,2269
2019,76,Brazil,Paraguay,52770,24095,28675
2019,152,Chile,Paraguay,4852,2181,2671
2019,170,Colombia,Paraguay,231,115,116
2019,218,Ecuador,Paraguay,238,126,112
2019,604,Peru,Paraguay,661,322,339
2019,858,Uruguay,Paraguay,1061,339,722
2019,862,Venezuela (Bolivarian Republic of),Paraguay,209,101,108
2019,36,Australia,Paraguay,603,282,321
2019,100,Bulgaria,Paraguay,3,2,1
2019,203,Czechia,Paraguay,26,18,8
2019,348,Hungary,Paraguay,14,6,8
2019,642,Romania,Paraguay,59,19,40
2019,643,Russian Federation,Paraguay,35,16,19
2019,208,Denmark,Paraguay,95,38,57
2019,246,Finland,Paraguay,34,19,15
2019,352,Iceland,Paraguay,3,2,1
2019,372,Ireland,Paraguay,29,9,20
2019,428,Latvia,Paraguay,1,1,0
2019,578,Norway,Paraguay,175,65,110
2019,752,Sweden,Paraguay,223,85,138
2019,826,United Kingdom,Paraguay,889,394,495
2019,300,Greece,Paraguay,76,14,62
2019,380,Italy,Paraguay,2862,877,1985
2019,620,Portugal,Paraguay,53,18,35
2019,724,Spain,Paraguay,64547,18116,46431
2019,40,Austria,Paraguay,270,117,153
2019,56,Belgium,Paraguay,516,183,333
2019,250,France,Paraguay,1135,469,666
2019,276,Germany,Paraguay,4704,1864,2840
2019,528,Netherlands,Paraguay,223,78,145
2019,756,Switzerland,Paraguay,1230,424,806
2019,124,Canada,Paraguay,7774,3774,4000
2019,840,United States of America,Paraguay,34307,10873,23434
1990,710,South Africa,Peru,199,88,111
1990,132,Cabo Verde,Peru,4,2,2
1990,196,Cyprus,Peru,8,3,5
1990,376,Israel,Peru,649,264,385
1990,792,Turkey,Peru,13,6,7
1990,156,China,Peru,2202,1217,985
1990,408,Dem. People's Republic of Korea,Peru,87,44,43
1990,392,Japan,Peru,10282,5238,5044
1990,608,Philippines,Peru,6,5,1
1990,533,Aruba,Peru,141,83,58
1990,44,Bahamas,Peru,43,27,16
1990,136,Cayman Islands,Peru,4,2,2
1990,192,Cuba,Peru,191,82,109
1990,214,Dominican Republic,Peru,1991,1202,789
1990,332,Haiti,Peru,351,208,143
1990,630,Puerto Rico,Peru,703,333,370
1990,188,Costa Rica,Peru,2225,1186,1039
1990,222,El Salvador,Peru,246,135,111
1990,320,Guatemala,Peru,210,77,133
1990,340,Honduras,Peru,291,171,120
1990,484,Mexico,Peru,2981,1630,1351
1990,558,Nicaragua,Peru,221,125,96
1990,591,Panama,Peru,1781,1052,729
1990,32,Argentina,Peru,16366,9721,6645
1990,68,Bolivia (Plurinational State of),Peru,7138,3932,3206
1990,76,Brazil,Peru,5716,3394,2322
1990,152,Chile,Peru,7052,3583,3469
1990,170,Colombia,Peru,2896,1604,1292
1990,218,Ecuador,Peru,2567,1307,1260
1990,254,French Guiana,Peru,309,165,144
1990,858,Uruguay,Peru,555,279,276
1990,862,Venezuela (Bolivarian Republic of),Peru,29635,16669,12966
1990,36,Australia,Peru,3795,1640,2155
1990,100,Bulgaria,Peru,7,6,1
1990,203,Czechia,Peru,17,14,3
1990,348,Hungary,Peru,72,48,24
1990,616,Poland,Peru,143,109,34
1990,643,Russian Federation,Peru,784,385,399
1990,703,Slovakia,Peru,5,3,2
1990,208,Denmark,Peru,245,103,142
1990,246,Finland,Peru,88,32,56
1990,352,Iceland,Peru,20,8,12
1990,372,Ireland,Peru,24,8,16
1990,428,Latvia,Peru,3,2,1
1990,578,Norway,Peru,277,140,137
1990,752,Sweden,Peru,3560,1720,1840
1990,826,United Kingdom,Peru,567,296,271
1990,191,Croatia,Peru,53,14,39
1990,300,Greece,Peru,209,116,93
1990,380,Italy,Peru,12843,3314,9529
1990,470,Malta,Peru,8,3,5
1990,620,Portugal,Peru,59,22,37
1990,688,Serbia,Peru,5,2,3
1990,705,Slovenia,Peru,4,2,2
1990,724,Spain,Peru,18828,7617,11211
1990,40,Austria,Peru,930,309,621
1990,56,Belgium,Peru,1877,688,1189
1990,250,France,Peru,7906,3350,4556
1990,276,Germany,Peru,4288,1922,2366
1990,442,Luxembourg,Peru,96,36,60
1990,528,Netherlands,Peru,1040,396,644
1990,756,Switzerland,Peru,4829,1760,3069
1990,124,Canada,Peru,11010,5359,5651
1990,840,United States of America,Peru,144199,67084,77115
1995,710,South Africa,Peru,124,61,63
1995,132,Cabo Verde,Peru,4,2,2
1995,196,Cyprus,Peru,12,4,8
1995,376,Israel,Peru,1021,434,587
1995,792,Turkey,Peru,31,13,18
1995,156,China,Peru,5956,3201,2755
1995,408,Dem. People's Republic of Korea,Peru,207,101,106
1995,392,Japan,Peru,36768,17648,19120
1995,608,Philippines,Peru,8,7,1
1995,533,Aruba,Peru,540,295,245
1995,44,Bahamas,Peru,41,22,19
1995,136,Cayman Islands,Peru,8,2,6
1995,192,Cuba,Peru,145,59,86
1995,214,Dominican Republic,Peru,2212,1314,898
1995,332,Haiti,Peru,333,198,135
1995,630,Puerto Rico,Peru,916,435,481
1995,188,Costa Rica,Peru,2045,1092,953
1995,222,El Salvador,Peru,209,116,93
1995,320,Guatemala,Peru,249,111,138
1995,340,Honduras,Peru,288,165,123
1995,484,Mexico,Peru,4140,2093,2047
1995,558,Nicaragua,Peru,176,99,77
1995,591,Panama,Peru,2170,1266,904
1995,32,Argentina,Peru,50888,22702,28186
1995,68,Bolivia (Plurinational State of),Peru,8306,4590,3716
1995,76,Brazil,Peru,8278,5042,3236
1995,152,Chile,Peru,21265,8382,12883
1995,170,Colombia,Peru,3342,1889,1453
1995,218,Ecuador,Peru,4125,2334,1791
1995,254,French Guiana,Peru,344,176,168
1995,858,Uruguay,Peru,240,145,95
1995,862,Venezuela (Bolivarian Republic of),Peru,32973,18421,14552
1995,36,Australia,Peru,4928,2142,2786
1995,100,Bulgaria,Peru,10,7,3
1995,203,Czechia,Peru,25,20,5
1995,348,Hungary,Peru,111,62,49
1995,616,Poland,Peru,122,93,29
1995,643,Russian Federation,Peru,702,403,299
1995,703,Slovakia,Peru,17,11,6
1995,208,Denmark,Peru,396,163,233
1995,246,Finland,Peru,125,55,70
1995,352,Iceland,Peru,30,12,18
1995,372,Ireland,Peru,67,21,46
1995,428,Latvia,Peru,5,4,1
1995,578,Norway,Peru,417,203,214
1995,752,Sweden,Peru,4225,2024,2201
1995,826,United Kingdom,Peru,2231,872,1359
1995,191,Croatia,Peru,50,15,35
1995,300,Greece,Peru,187,78,109
1995,380,Italy,Peru,29771,9348,20423
1995,470,Malta,Peru,10,4,6
1995,620,Portugal,Peru,127,47,80
1995,688,Serbia,Peru,38,15,23
1995,705,Slovenia,Peru,7,4,3
1995,724,Spain,Peru,25606,10460,15146
1995,40,Austria,Peru,1049,360,689
1995,56,Belgium,Peru,1865,682,1183
1995,250,France,Peru,8162,3379,4783
1995,276,Germany,Peru,6123,2314,3809
1995,442,Luxembourg,Peru,91,34,57
1995,528,Netherlands,Peru,1437,528,909
1995,756,Switzerland,Peru,5665,2198,3467
1995,124,Canada,Peru,14301,6921,7380
1995,840,United States of America,Peru,214019,98574,115445
2000,710,South Africa,Peru,86,50,36
2000,132,Cabo Verde,Peru,4,3,1
2000,196,Cyprus,Peru,15,5,10
2000,268,Georgia,Peru,22,2,20
2000,376,Israel,Peru,1336,586,750
2000,792,Turkey,Peru,50,20,30
2000,156,China,Peru,9711,5185,4526
2000,408,Dem. People's Republic of Korea,Peru,327,159,168
2000,392,Japan,Peru,46174,21331,24843
2000,608,Philippines,Peru,512,249,263
2000,533,Aruba,Peru,939,507,432
2000,44,Bahamas,Peru,39,18,21
2000,136,Cayman Islands,Peru,15,4,11
2000,192,Cuba,Peru,98,35,63
2000,214,Dominican Republic,Peru,2432,1426,1006
2000,332,Haiti,Peru,316,188,128
2000,630,Puerto Rico,Peru,1132,537,595
2000,188,Costa Rica,Peru,2887,1505,1382
2000,222,El Salvador,Peru,172,98,74
2000,320,Guatemala,Peru,288,146,142
2000,340,Honduras,Peru,285,160,125
2000,484,Mexico,Peru,5479,2659,2820
2000,558,Nicaragua,Peru,185,106,79
2000,591,Panama,Peru,2697,1555,1142
2000,32,Argentina,Peru,85411,35684,49727
2000,68,Bolivia (Plurinational State of),Peru,9386,5197,4189
2000,76,Brazil,Peru,10840,6690,4150
2000,152,Chile,Peru,35460,13862,21598
2000,170,Colombia,Peru,3788,2175,1613
2000,218,Ecuador,Peru,5682,3360,2322
2000,254,French Guiana,Peru,379,187,192
2000,858,Uruguay,Peru,104,71,33
2000,862,Venezuela (Bolivarian Republic of),Peru,36348,20145,16203
2000,36,Australia,Peru,5770,2520,3250
2000,100,Bulgaria,Peru,12,8,4
2000,203,Czechia,Peru,33,26,7
2000,348,Hungary,Peru,149,75,74
2000,616,Poland,Peru,105,79,26
2000,643,Russian Federation,Peru,595,406,189
2000,703,Slovakia,Peru,35,23,12
2000,208,Denmark,Peru,547,223,324
2000,234,Faroe Islands,Peru,1,0,1
2000,246,Finland,Peru,161,77,84
2000,352,Iceland,Peru,39,15,24
2000,372,Ireland,Peru,147,50,97
2000,428,Latvia,Peru,7,5,2
2000,578,Norway,Peru,548,255,293
2000,752,Sweden,Peru,4531,2155,2376
2000,826,United Kingdom,Peru,3933,1458,2475
2000,191,Croatia,Peru,41,14,27
2000,300,Greece,Peru,168,40,128
2000,380,Italy,Peru,46699,15383,31316
2000,470,Malta,Peru,12,5,7
2000,620,Portugal,Peru,202,75,127
2000,688,Serbia,Peru,52,19,33
2000,705,Slovenia,Peru,12,8,4
2000,724,Spain,Peru,42184,17596,24588
2000,40,Austria,Peru,1168,411,757
2000,56,Belgium,Peru,1798,658,1140
2000,250,France,Peru,8418,3409,5009
2000,276,Germany,Peru,7957,2705,5252
2000,442,Luxembourg,Peru,87,32,55
2000,528,Netherlands,Peru,1884,675,1209
2000,756,Switzerland,Peru,6523,2654,3869
2000,124,Canada,Peru,17932,8650,9282
2000,840,United States of America,Peru,285249,130887,154362
2005,710,South Africa,Peru,112,61,51
2005,132,Cabo Verde,Peru,4,3,1
2005,196,Cyprus,Peru,22,7,15
2005,268,Georgia,Peru,20,2,18
2005,376,Israel,Peru,1840,830,1010
2005,792,Turkey,Peru,51,20,31
2005,156,China,Peru,10713,6245,4468
2005,408,Dem. People's Republic of Korea,Peru,401,198,203
2005,392,Japan,Peru,51532,23472,28060
2005,608,Philippines,Peru,414,205,209
2005,533,Aruba,Peru,1019,534,485
2005,44,Bahamas,Peru,165,74,91
2005,136,Cayman Islands,Peru,14,4,10
2005,192,Cuba,Peru,65,23,42
2005,214,Dominican Republic,Peru,1899,1129,770
2005,332,Haiti,Peru,300,179,121
2005,630,Puerto Rico,Peru,925,439,486
2005,188,Costa Rica,Peru,1891,974,917
2005,222,El Salvador,Peru,198,115,83
2005,320,Guatemala,Peru,343,186,157
2005,340,Honduras,Peru,280,159,121
2005,484,Mexico,Peru,5371,2712,2659
2005,558,Nicaragua,Peru,199,115,84
2005,591,Panama,Peru,3101,1752,1349
2005,32,Argentina,Peru,127337,56274,71063
2005,68,Bolivia (Plurinational State of),Peru,9549,5404,4145
2005,76,Brazil,Peru,12958,7925,5033
2005,152,Chile,Peru,80085,32215,47870
2005,170,Colombia,Peru,3909,2274,1635
2005,218,Ecuador,Peru,6708,4025,2683
2005,254,French Guiana,Peru,399,195,204
2005,858,Uruguay,Peru,96,66,30
2005,862,Venezuela (Bolivarian Republic of),Peru,39846,22265,17581
2005,36,Australia,Peru,6680,2917,3763
2005,100,Bulgaria,Peru,16,10,6
2005,203,Czechia,Peru,105,67,38
2005,348,Hungary,Peru,184,94,90
2005,616,Poland,Peru,108,85,23
2005,643,Russian Federation,Peru,437,304,133
2005,703,Slovakia,Peru,40,26,14
2005,208,Denmark,Peru,769,281,488
2005,234,Faroe Islands,Peru,2,0,2
2005,246,Finland,Peru,293,138,155
2005,352,Iceland,Peru,56,20,36
2005,372,Ireland,Peru,148,57,91
2005,428,Latvia,Peru,7,6,1
2005,578,Norway,Peru,792,333,459
2005,752,Sweden,Peru,5514,2576,2938
2005,826,United Kingdom,Peru,5220,1934,3286
2005,191,Croatia,Peru,63,23,40
2005,300,Greece,Peru,233,63,170
2005,380,Italy,Peru,81359,30057,51302
2005,470,Malta,Peru,15,6,9
2005,620,Portugal,Peru,247,98,149
2005,688,Serbia,Peru,52,19,33
2005,705,Slovenia,Peru,21,13,8
2005,724,Spain,Peru,101295,45374,55921
2005,40,Austria,Peru,1306,440,866
2005,56,Belgium,Peru,2647,892,1755
2005,250,France,Peru,9822,4113,5709
2005,276,Germany,Peru,11825,4130,7695
2005,442,Luxembourg,Peru,75,31,44
2005,528,Netherlands,Peru,2732,933,1799
2005,756,Switzerland,Peru,7334,2771,4563
2005,124,Canada,Peru,21778,9954,11824
2005,840,United States of America,Peru,350703,161970,188733
2010,710,South Africa,Peru,175,95,80
2010,132,Cabo Verde,Peru,3,3,0
2010,196,Cyprus,Peru,36,12,24
2010,268,Georgia,Peru,20,2,18
2010,376,Israel,Peru,2366,1082,1284
2010,792,Turkey,Peru,52,20,32
2010,156,China,Peru,11716,7306,4410
2010,408,Dem. People's Republic of Korea,Peru,474,237,237
2010,392,Japan,Peru,54636,24573,30063
2010,608,Philippines,Peru,110,53,57
2010,533,Aruba,Peru,1078,549,529
2010,44,Bahamas,Peru,290,129,161
2010,136,Cayman Islands,Peru,15,5,10
2010,192,Cuba,Peru,36,13,23
2010,531,Curaçao,Peru,97,42,55
2010,214,Dominican Republic,Peru,1353,824,529
2010,332,Haiti,Peru,315,188,127
2010,630,Puerto Rico,Peru,603,283,320
2010,188,Costa Rica,Peru,3726,1923,1803
2010,222,El Salvador,Peru,224,132,92
2010,320,Guatemala,Peru,397,226,171
2010,340,Honduras,Peru,274,157,117
2010,484,Mexico,Peru,5886,3084,2802
2010,558,Nicaragua,Peru,212,123,89
2010,591,Panama,Peru,3654,2054,1600
2010,32,Argentina,Peru,169262,76864,92398
2010,68,Bolivia (Plurinational State of),Peru,9691,5600,4091
2010,76,Brazil,Peru,14890,9041,5849
2010,152,Chile,Peru,124672,50564,74108
2010,170,Colombia,Peru,4708,2792,1916
2010,218,Ecuador,Peru,9422,5558,3864
2010,254,French Guiana,Peru,419,204,215
2010,858,Uruguay,Peru,88,60,28
2010,862,Venezuela (Bolivarian Republic of),Peru,44126,24873,19253
2010,36,Australia,Peru,9610,4319,5291
2010,100,Bulgaria,Peru,20,13,7
2010,203,Czechia,Peru,166,101,65
2010,348,Hungary,Peru,219,114,105
2010,616,Poland,Peru,116,94,22
2010,643,Russian Federation,Peru,271,195,76
2010,703,Slovakia,Peru,45,30,15
2010,208,Denmark,Peru,973,334,639
2010,233,Estonia,Peru,15,8,7
2010,234,Faroe Islands,Peru,5,2,3
2010,246,Finland,Peru,497,206,291
2010,352,Iceland,Peru,73,27,46
2010,372,Ireland,Peru,124,42,82
2010,428,Latvia,Peru,8,7,1
2010,578,Norway,Peru,1170,437,733
2010,752,Sweden,Peru,6738,3091,3647
2010,826,United Kingdom,Peru,5499,2109,3390
2010,191,Croatia,Peru,85,32,53
2010,300,Greece,Peru,309,90,219
2010,380,Italy,Peru,115021,43666,71355
2010,470,Malta,Peru,22,7,15
2010,620,Portugal,Peru,252,106,146
2010,688,Serbia,Peru,51,18,33
2010,705,Slovenia,Peru,36,21,15
2010,724,Spain,Peru,197827,93550,104277
2010,40,Austria,Peru,1443,468,975
2010,56,Belgium,Peru,3073,1108,1965
2010,250,France,Peru,10970,4297,6673
2010,276,Germany,Peru,15022,5350,9672
2010,442,Luxembourg,Peru,65,30,35
2010,528,Netherlands,Peru,3453,1101,2352
2010,756,Switzerland,Peru,8619,2940,5679
2010,124,Canada,Peru,26715,11792,14923
2010,840,United States of America,Peru,428629,171403,257226
2015,710,South Africa,Peru,314,164,150
2015,132,Cabo Verde,Peru,3,3,0
2015,196,Cyprus,Peru,34,12,22
2015,268,Georgia,Peru,20,2,18
2015,376,Israel,Peru,2440,1109,1331
2015,792,Turkey,Peru,52,19,33
2015,156,China,Peru,13483,8640,4843
2015,408,Dem. People's Republic of Korea,Peru,522,263,259
2015,392,Japan,Peru,47721,21285,26436
2015,608,Philippines,Peru,111,54,57
2015,533,Aruba,Peru,1134,577,557
2015,44,Bahamas,Peru,314,138,176
2015,136,Cayman Islands,Peru,15,6,9
2015,192,Cuba,Peru,28,10,18
2015,531,Curaçao,Peru,105,46,59
2015,214,Dominican Republic,Peru,1428,870,558
2015,332,Haiti,Peru,330,197,133
2015,630,Puerto Rico,Peru,686,321,365
2015,188,Costa Rica,Peru,3783,1941,1842
2015,222,El Salvador,Peru,234,138,96
2015,320,Guatemala,Peru,457,263,194
2015,340,Honduras,Peru,384,221,163
2015,484,Mexico,Peru,4800,3166,1634
2015,558,Nicaragua,Peru,228,133,95
2015,591,Panama,Peru,4290,2407,1883
2015,32,Argentina,Peru,195320,88634,106686
2015,68,Bolivia (Plurinational State of),Peru,11282,6519,4763
2015,76,Brazil,Peru,17931,10888,7043
2015,152,Chile,Peru,150885,59251,91634
2015,170,Colombia,Peru,5271,3147,2124
2015,218,Ecuador,Peru,13705,8045,5660
2015,254,French Guiana,Peru,506,243,263
2015,858,Uruguay,Peru,90,62,28
2015,862,Venezuela (Bolivarian Republic of),Peru,47007,26206,20801
2015,36,Australia,Peru,11270,4974,6296
2015,100,Bulgaria,Peru,29,18,11
2015,203,Czechia,Peru,234,149,85
2015,348,Hungary,Peru,201,102,99
2015,616,Poland,Peru,111,91,20
2015,643,Russian Federation,Peru,277,199,78
2015,703,Slovakia,Peru,59,40,19
2015,208,Denmark,Peru,1151,395,756
2015,233,Estonia,Peru,20,12,8
2015,234,Faroe Islands,Peru,15,5,10
2015,246,Finland,Peru,607,255,352
2015,352,Iceland,Peru,75,26,49
2015,372,Ireland,Peru,127,42,85
2015,428,Latvia,Peru,7,5,2
2015,578,Norway,Peru,1492,583,909
2015,752,Sweden,Peru,7509,3454,4055
2015,826,United Kingdom,Peru,7032,2569,4463
2015,191,Croatia,Peru,86,33,53
2015,300,Greece,Peru,290,76,214
2015,380,Italy,Peru,113226,42926,70300
2015,470,Malta,Peru,38,15,23
2015,620,Portugal,Peru,285,110,175
2015,688,Serbia,Peru,49,17,32
2015,705,Slovenia,Peru,52,26,26
2015,724,Spain,Peru,184802,82081,102721
2015,40,Austria,Peru,1688,553,1135
2015,56,Belgium,Peru,3593,1267,2326
2015,250,France,Peru,12152,4557,7595
2015,276,Germany,Peru,15652,5551,10101
2015,442,Luxembourg,Peru,99,47,52
2015,528,Netherlands,Peru,3907,1221,2686
2015,756,Switzerland,Peru,9667,3267,6400
2015,124,Canada,Peru,29433,12863,16570
2015,840,United States of America,Peru,486643,193103,293540
2019,710,South Africa,Peru,351,184,167
2019,132,Cabo Verde,Peru,3,3,0
2019,196,Cyprus,Peru,33,12,21
2019,268,Georgia,Peru,20,2,18
2019,376,Israel,Peru,2372,1078,1294
2019,792,Turkey,Peru,70,26,44
2019,156,China,Peru,14211,9107,5104
2019,408,Dem. People's Republic of Korea,Peru,532,269,263
2019,392,Japan,Peru,50065,22331,27734
2019,608,Philippines,Peru,114,56,58
2019,533,Aruba,Peru,1147,584,563
2019,44,Bahamas,Peru,333,147,186
2019,136,Cayman Islands,Peru,16,6,10
2019,192,Cuba,Peru,25,9,16
2019,531,Curaçao,Peru,114,50,64
2019,214,Dominican Republic,Peru,1475,899,576
2019,332,Haiti,Peru,343,205,138
2019,630,Puerto Rico,Peru,2261,1054,1207
2019,188,Costa Rica,Peru,3838,1981,1857
2019,222,El Salvador,Peru,237,140,97
2019,320,Guatemala,Peru,469,270,199
2019,340,Honduras,Peru,390,225,165
2019,484,Mexico,Peru,4948,3264,1684
2019,558,Nicaragua,Peru,238,139,99
2019,591,Panama,Peru,4568,2564,2004
2019,32,Argentina,Peru,198744,90009,108735
2019,68,Bolivia (Plurinational State of),Peru,12317,7117,5200
2019,76,Brazil,Peru,20194,12263,7931
2019,152,Chile,Peru,205609,76358,129251
2019,170,Colombia,Peru,5391,3219,2172
2019,218,Ecuador,Peru,13492,7918,5574
2019,254,French Guiana,Peru,559,269,290
2019,858,Uruguay,Peru,93,65,28
2019,862,Venezuela (Bolivarian Republic of),Peru,46044,25578,20466
2019,36,Australia,Peru,12473,5450,7023
2019,100,Bulgaria,Peru,30,17,13
2019,203,Czechia,Peru,274,175,99
2019,348,Hungary,Peru,220,114,106
2019,616,Poland,Peru,117,97,20
2019,643,Russian Federation,Peru,276,199,77
2019,703,Slovakia,Peru,69,50,19
2019,208,Denmark,Peru,1240,428,812
2019,233,Estonia,Peru,25,16,9
2019,234,Faroe Islands,Peru,19,7,12
2019,246,Finland,Peru,725,307,418
2019,352,Iceland,Peru,93,34,59
2019,372,Ireland,Peru,139,46,93
2019,428,Latvia,Peru,10,7,3
2019,578,Norway,Peru,1701,661,1040
2019,752,Sweden,Peru,7996,3694,4302
2019,826,United Kingdom,Peru,7985,2930,5055
2019,191,Croatia,Peru,79,30,49
2019,300,Greece,Peru,283,82,201
2019,380,Italy,Peru,117189,45018,72171
2019,470,Malta,Peru,61,25,36
2019,620,Portugal,Peru,289,112,177
2019,688,Serbia,Peru,49,17,32
2019,705,Slovenia,Peru,58,25,33
2019,724,Spain,Peru,193786,83995,109791
2019,40,Austria,Peru,1992,676,1316
2019,56,Belgium,Peru,3894,1397,2497
2019,250,France,Peru,12862,4805,8057
2019,276,Germany,Peru,17169,6258,10911
2019,442,Luxembourg,Peru,554,228,326
2019,528,Netherlands,Peru,4479,1462,3017
2019,756,Switzerland,Peru,10393,3552,6841
2019,124,Canada,Peru,31540,13784,17756
2019,840,United States of America,Peru,525527,205120,320407
1990,690,Seychelles,Philippines,61,28,33
1990,516,Namibia,Philippines,364,132,232
1990,710,South Africa,Philippines,1485,1049,436
1990,288,Ghana,Philippines,20,10,10
1990,818,Egypt,Philippines,677,302,375
1990,434,Libya,Philippines,1929,865,1064
1990,48,Bahrain,Philippines,7934,4499,3435
1990,196,Cyprus,Philippines,1793,196,1597
1990,400,Jordan,Philippines,2245,275,1970
1990,414,Kuwait,Philippines,49207,21606,27601
1990,422,Lebanon,Philippines,1026,126,900
1990,512,Oman,Philippines,5930,2356,3574
1990,634,Qatar,Philippines,37462,29310,8152
1990,682,Saudi Arabia,Philippines,239551,123253,116298
1990,792,Turkey,Philippines,141,54,87
1990,784,United Arab Emirates,Philippines,60107,35485,24622
1990,64,Bhutan,Philippines,9,7,2
1990,462,Maldives,Philippines,303,167,136
1990,156,China,Philippines,28155,9490,18665
1990,344,"China, Hong Kong SAR",Philippines,79010,9320,69690
1990,446,"China, Macao SAR",Philippines,1891,600,1291
1990,408,Dem. People's Republic of Korea,Philippines,1116,304,812
1990,392,Japan,Philippines,49106,25018,24088
1990,496,Mongolia,Philippines,31,19,12
1990,410,Republic of Korea,Philippines,482,310,172
1990,96,Brunei Darussalam,Philippines,7837,3188,4649
1990,116,Cambodia,Philippines,71,37,34
1990,360,Indonesia,Philippines,3472,1787,1685
1990,458,Malaysia,Philippines,104730,55859,48871
1990,702,Singapore,Philippines,1175,268,907
1990,764,Thailand,Philippines,1266,495,771
1990,626,Timor-Leste,Philippines,591,317,274
1990,704,Viet Nam,Philippines,12,7,5
1990,533,Aruba,Philippines,217,165,52
1990,44,Bahamas,Philippines,64,32,32
1990,136,Cayman Islands,Philippines,33,23,10
1990,214,Dominican Republic,Philippines,115,72,43
1990,630,Puerto Rico,Philippines,274,130,144
1990,662,Saint Lucia,Philippines,14,9,5
1990,780,Trinidad and Tobago,Philippines,187,86,101
1990,188,Costa Rica,Philippines,72,28,44
1990,222,El Salvador,Philippines,31,18,13
1990,320,Guatemala,Philippines,15,7,8
1990,484,Mexico,Philippines,186,117,69
1990,591,Panama,Philippines,223,209,14
1990,32,Argentina,Philippines,128,40,88
1990,68,Bolivia (Plurinational State of),Philippines,14,3,11
1990,152,Chile,Philippines,92,48,44
1990,170,Colombia,Philippines,56,22,34
1990,218,Ecuador,Philippines,42,29,13
1990,604,Peru,Philippines,200,137,63
1990,862,Venezuela (Bolivarian Republic of),Philippines,143,60,83
1990,36,Australia,Philippines,90580,32427,58153
1990,554,New Zealand,Philippines,4379,1154,3225
1990,598,Papua New Guinea,Philippines,2005,1177,828
1990,90,Solomon Islands,Philippines,147,115,32
1990,316,Guam,Philippines,24527,12732,11795
1990,584,Marshall Islands,Philippines,120,38,82
1990,583,Micronesia (Fed. States of),Philippines,170,97,73
1990,520,Nauru,Philippines,100,66,34
1990,580,Northern Mariana Islands,Philippines,12836,8180,4656
1990,585,Palau,Philippines,1569,1024,545
1990,16,American Samoa,Philippines,379,217,162
1990,100,Bulgaria,Philippines,10,4,6
1990,203,Czechia,Philippines,8,2,6
1990,616,Poland,Philippines,67,27,40
1990,642,Romania,Philippines,18,0,18
1990,643,Russian Federation,Philippines,190,93,97
1990,208,Denmark,Philippines,1972,540,1432
1990,234,Faroe Islands,Philippines,14,4,10
1990,246,Finland,Philippines,299,56,243
1990,352,Iceland,Philippines,135,30,105
1990,372,Ireland,Philippines,774,380,394
1990,428,Latvia,Philippines,1,0,1
1990,578,Norway,Philippines,3552,1129,2423
1990,752,Sweden,Philippines,4290,1021,3269
1990,826,United Kingdom,Philippines,21328,5337,15991
1990,20,Andorra,Philippines,146,78,68
1990,300,Greece,Philippines,11217,1486,9731
1990,380,Italy,Philippines,65197,12997,52200
1990,470,Malta,Philippines,94,21,73
1990,620,Portugal,Philippines,74,13,61
1990,688,Serbia,Philippines,5,1,4
1990,705,Slovenia,Philippines,3,2,1
1990,724,Spain,Philippines,8682,2884,5798
1990,40,Austria,Philippines,7633,2584,5049
1990,56,Belgium,Philippines,7502,62,7440
1990,250,France,Philippines,7979,2360,5619
1990,276,Germany,Philippines,22895,5250,17645
1990,442,Luxembourg,Philippines,183,36,147
1990,528,Netherlands,Philippines,3077,795,2282
1990,756,Switzerland,Philippines,7161,1637,5524
1990,60,Bermuda,Philippines,92,48,44
1990,124,Canada,Philippines,118304,57593,60711
1990,304,Greenland,Philippines,1,1,0
1990,840,United States of America,Philippines,912674,352063,560611
1995,690,Seychelles,Philippines,229,72,157
1995,516,Namibia,Philippines,348,128,220
1995,710,South Africa,Philippines,922,582,340
1995,288,Ghana,Philippines,20,11,9
1995,818,Egypt,Philippines,711,279,432
1995,434,Libya,Philippines,2566,1139,1427
1995,48,Bahrain,Philippines,10206,6281,3925
1995,196,Cyprus,Philippines,2535,186,2349
1995,400,Jordan,Philippines,3455,307,3148
1995,414,Kuwait,Philippines,45266,24346,20920
1995,422,Lebanon,Philippines,1572,195,1377
1995,512,Oman,Philippines,7180,2733,4447
1995,634,Qatar,Philippines,44332,35034,9298
1995,682,Saudi Arabia,Philippines,245507,126940,118567
1995,792,Turkey,Philippines,341,123,218
1995,784,United Arab Emirates,Philippines,91840,59497,32343
1995,64,Bhutan,Philippines,10,8,2
1995,462,Maldives,Philippines,237,119,118
1995,156,China,Philippines,40390,15571,24819
1995,344,"China, Hong Kong SAR",Philippines,88179,9883,78296
1995,446,"China, Macao SAR",Philippines,2074,634,1440
1995,408,Dem. People's Republic of Korea,Philippines,1444,462,982
1995,392,Japan,Philippines,75318,36152,39166
1995,496,Mongolia,Philippines,33,22,11
1995,410,Republic of Korea,Philippines,7943,4249,3694
1995,96,Brunei Darussalam,Philippines,10226,4226,6000
1995,116,Cambodia,Philippines,186,96,90
1995,360,Indonesia,Philippines,2297,1212,1085
1995,458,Malaysia,Philippines,123116,65881,57235
1995,702,Singapore,Philippines,2480,548,1932
1995,764,Thailand,Philippines,1146,469,677
1995,626,Timor-Leste,Philippines,629,320,309
1995,704,Viet Nam,Philippines,29,17,12
1995,533,Aruba,Philippines,486,299,187
1995,44,Bahamas,Philippines,103,41,62
1995,136,Cayman Islands,Philippines,64,43,21
1995,214,Dominican Republic,Philippines,128,79,49
1995,630,Puerto Rico,Philippines,289,138,151
1995,662,Saint Lucia,Philippines,14,7,7
1995,780,Trinidad and Tobago,Philippines,169,78,91
1995,188,Costa Rica,Philippines,71,27,44
1995,222,El Salvador,Philippines,24,14,10
1995,320,Guatemala,Philippines,28,11,17
1995,484,Mexico,Philippines,315,164,151
1995,591,Panama,Philippines,323,304,19
1995,32,Argentina,Philippines,125,40,85
1995,68,Bolivia (Plurinational State of),Philippines,26,8,18
1995,152,Chile,Philippines,144,110,34
1995,170,Colombia,Philippines,64,28,36
1995,218,Ecuador,Philippines,47,32,15
1995,604,Peru,Philippines,201,136,65
1995,862,Venezuela (Bolivarian Republic of),Philippines,141,60,81
1995,36,Australia,Philippines,103492,36612,66880
1995,554,New Zealand,Philippines,6812,2022,4790
1995,598,Papua New Guinea,Philippines,2054,1259,795
1995,90,Solomon Islands,Philippines,146,114,32
1995,316,Guam,Philippines,28576,14511,14065
1995,584,Marshall Islands,Philippines,209,102,107
1995,583,Micronesia (Fed. States of),Philippines,154,98,56
1995,520,Nauru,Philippines,92,61,31
1995,580,Northern Mariana Islands,Philippines,12905,7799,5106
1995,585,Palau,Philippines,2654,1605,1049
1995,16,American Samoa,Philippines,520,295,225
1995,100,Bulgaria,Philippines,15,3,12
1995,203,Czechia,Philippines,13,4,9
1995,348,Hungary,Philippines,85,15,70
1995,616,Poland,Philippines,57,23,34
1995,642,Romania,Philippines,15,2,13
1995,643,Russian Federation,Philippines,175,98,77
1995,703,Slovakia,Philippines,8,3,5
1995,208,Denmark,Philippines,2951,759,2192
1995,234,Faroe Islands,Philippines,15,6,9
1995,246,Finland,Philippines,484,113,371
1995,352,Iceland,Philippines,405,99,306
1995,372,Ireland,Philippines,2741,1303,1438
1995,428,Latvia,Philippines,1,0,1
1995,578,Norway,Philippines,4686,1384,3302
1995,752,Sweden,Philippines,5091,1182,3909
1995,826,United Kingdom,Philippines,29809,7313,22496
1995,20,Andorra,Philippines,222,117,105
1995,300,Greece,Philippines,8569,1373,7196
1995,380,Italy,Philippines,75405,21351,54054
1995,470,Malta,Philippines,110,26,84
1995,620,Portugal,Philippines,160,28,132
1995,688,Serbia,Philippines,33,5,28
1995,705,Slovenia,Philippines,5,3,2
1995,724,Spain,Philippines,10514,3624,6890
1995,40,Austria,Philippines,8611,3008,5603
1995,56,Belgium,Philippines,8282,2146,6136
1995,250,France,Philippines,8237,2339,5898
1995,276,Germany,Philippines,23278,4689,18589
1995,442,Luxembourg,Philippines,173,33,140
1995,528,Netherlands,Philippines,4794,1156,3638
1995,756,Switzerland,Philippines,8124,2184,5940
1995,60,Bermuda,Philippines,142,60,82
1995,124,Canada,Philippines,175504,84913,90591
1995,304,Greenland,Philippines,5,0,5
1995,840,United States of America,Philippines,1156143,448777,707366
2000,690,Seychelles,Philippines,398,116,282
2000,516,Namibia,Philippines,325,121,204
2000,710,South Africa,Philippines,630,268,362
2000,288,Ghana,Philippines,22,11,11
2000,818,Egypt,Philippines,801,278,523
2000,434,Libya,Philippines,3246,1466,1780
2000,48,Bahrain,Philippines,12508,8031,4477
2000,196,Cyprus,Philippines,3277,176,3101
2000,400,Jordan,Philippines,4664,357,4307
2000,414,Kuwait,Philippines,58906,36779,22127
2000,422,Lebanon,Philippines,2117,263,1854
2000,512,Oman,Philippines,6412,2825,3587
2000,634,Qatar,Philippines,44593,35585,9008
2000,682,Saudi Arabia,Philippines,252250,126808,125442
2000,792,Turkey,Philippines,544,192,352
2000,784,United Arab Emirates,Philippines,128860,86564,42296
2000,64,Bhutan,Philippines,12,10,2
2000,462,Maldives,Philippines,156,86,70
2000,156,China,Philippines,52626,21652,30974
2000,344,"China, Hong Kong SAR",Philippines,97347,10445,86902
2000,446,"China, Macao SAR",Philippines,5239,1840,3399
2000,408,Dem. People's Republic of Korea,Philippines,1771,619,1152
2000,392,Japan,Philippines,144882,66932,77950
2000,496,Mongolia,Philippines,37,25,12
2000,410,Republic of Korea,Philippines,17932,9772,8160
2000,96,Brunei Darussalam,Philippines,12614,5263,7351
2000,116,Cambodia,Philippines,301,156,145
2000,360,Indonesia,Philippines,1122,636,486
2000,458,Malaysia,Philippines,176961,94441,82520
2000,702,Singapore,Philippines,4027,848,3179
2000,764,Thailand,Philippines,1264,524,740
2000,626,Timor-Leste,Philippines,673,324,349
2000,704,Viet Nam,Philippines,70,42,28
2000,533,Aruba,Philippines,754,433,321
2000,44,Bahamas,Philippines,143,52,91
2000,136,Cayman Islands,Philippines,111,75,36
2000,214,Dominican Republic,Philippines,140,85,55
2000,630,Puerto Rico,Philippines,306,146,160
2000,662,Saint Lucia,Philippines,27,14,13
2000,780,Trinidad and Tobago,Philippines,184,85,99
2000,188,Costa Rica,Philippines,106,39,67
2000,222,El Salvador,Philippines,17,10,7
2000,320,Guatemala,Philippines,41,16,25
2000,484,Mexico,Philippines,458,218,240
2000,591,Panama,Philippines,444,418,26
2000,32,Argentina,Philippines,122,40,82
2000,68,Bolivia (Plurinational State of),Philippines,37,13,24
2000,152,Chile,Philippines,197,149,48
2000,170,Colombia,Philippines,72,34,38
2000,218,Ecuador,Philippines,52,36,16
2000,604,Peru,Philippines,235,159,76
2000,862,Venezuela (Bolivarian Republic of),Philippines,138,58,80
2000,36,Australia,Philippines,112180,39051,73129
2000,554,New Zealand,Philippines,9860,4793,5067
2000,598,Papua New Guinea,Philippines,1537,1024,513
2000,90,Solomon Islands,Philippines,140,109,31
2000,316,Guam,Philippines,32625,16290,16335
2000,584,Marshall Islands,Philippines,311,173,138
2000,583,Micronesia (Fed. States of),Philippines,143,80,63
2000,520,Nauru,Philippines,85,57,28
2000,580,Northern Mariana Islands,Philippines,13757,7580,6177
2000,585,Palau,Philippines,2892,1788,1104
2000,16,American Samoa,Philippines,661,374,287
2000,100,Bulgaria,Philippines,20,3,17
2000,203,Czechia,Philippines,17,5,12
2000,348,Hungary,Philippines,170,31,139
2000,616,Poland,Philippines,49,19,30
2000,642,Romania,Philippines,14,4,10
2000,643,Russian Federation,Philippines,154,99,55
2000,703,Slovakia,Philippines,19,6,13
2000,208,Denmark,Philippines,3929,978,2951
2000,234,Faroe Islands,Philippines,20,7,13
2000,246,Finland,Philippines,669,171,498
2000,352,Iceland,Philippines,675,168,507
2000,372,Ireland,Philippines,6214,3057,3157
2000,428,Latvia,Philippines,2,1,1
2000,578,Norway,Philippines,5698,1604,4094
2000,752,Sweden,Philippines,5460,1240,4220
2000,826,United Kingdom,Philippines,38793,9354,29439
2000,20,Andorra,Philippines,297,156,141
2000,300,Greece,Philippines,6061,1151,4910
2000,380,Italy,Philippines,85612,29705,55907
2000,470,Malta,Philippines,139,34,105
2000,620,Portugal,Philippines,253,44,209
2000,688,Serbia,Philippines,46,7,39
2000,705,Slovenia,Philippines,6,3,3
2000,724,Spain,Philippines,16870,6109,10761
2000,40,Austria,Philippines,9589,3432,6157
2000,56,Belgium,Philippines,8127,2160,5967
2000,250,France,Philippines,8495,2318,6177
2000,276,Germany,Philippines,23660,4128,19532
2000,438,Liechtenstein,Philippines,1,0,1
2000,442,Luxembourg,Philippines,166,31,135
2000,528,Netherlands,Philippines,6671,1546,5125
2000,756,Switzerland,Philippines,9117,2756,6361
2000,60,Bermuda,Philippines,192,72,120
2000,124,Canada,Philippines,236877,114272,122605
2000,304,Greenland,Philippines,6,0,6
2000,840,United States of America,Philippines,1403834,548206,855628
2005,690,Seychelles,Philippines,514,289,225
2005,516,Namibia,Philippines,256,94,162
2005,710,South Africa,Philippines,828,331,497
2005,288,Ghana,Philippines,31,16,15
2005,818,Egypt,Philippines,954,370,584
2005,434,Libya,Philippines,3576,1965,1611
2005,48,Bahrain,Philippines,24672,17725,6947
2005,196,Cyprus,Philippines,4796,228,4568
2005,400,Jordan,Philippines,6736,1269,5467
2005,414,Kuwait,Philippines,76327,52479,23848
2005,422,Lebanon,Philippines,1657,190,1467
2005,512,Oman,Philippines,10324,4218,6106
2005,634,Qatar,Philippines,54268,42802,11466
2005,682,Saudi Arabia,Philippines,311603,170395,141208
2005,792,Turkey,Philippines,561,191,370
2005,784,United Arab Emirates,Philippines,202658,148170,54488
2005,64,Bhutan,Philippines,15,12,3
2005,462,Maldives,Philippines,525,323,202
2005,156,China,Philippines,58059,27482,30577
2005,344,"China, Hong Kong SAR",Philippines,106282,6641,99641
2005,446,"China, Macao SAR",Philippines,6077,2225,3852
2005,408,Dem. People's Republic of Korea,Philippines,2214,819,1395
2005,392,Japan,Philippines,198241,90299,107942
2005,496,Mongolia,Philippines,82,63,19
2005,410,Republic of Korea,Philippines,22847,13344,9503
2005,96,Brunei Darussalam,Philippines,12895,5425,7470
2005,116,Cambodia,Philippines,235,125,110
2005,360,Indonesia,Philippines,2305,1363,942
2005,458,Malaysia,Philippines,91270,49362,41908
2005,702,Singapore,Philippines,8195,1406,6789
2005,764,Thailand,Philippines,1195,518,677
2005,626,Timor-Leste,Philippines,731,378,353
2005,704,Viet Nam,Philippines,80,50,30
2005,533,Aruba,Philippines,863,455,408
2005,44,Bahamas,Philippines,587,278,309
2005,136,Cayman Islands,Philippines,879,477,402
2005,214,Dominican Republic,Philippines,94,55,39
2005,630,Puerto Rico,Philippines,239,114,125
2005,662,Saint Lucia,Philippines,27,14,13
2005,780,Trinidad and Tobago,Philippines,197,91,106
2005,188,Costa Rica,Philippines,69,24,45
2005,222,El Salvador,Philippines,18,10,8
2005,320,Guatemala,Philippines,50,15,35
2005,484,Mexico,Philippines,452,223,229
2005,591,Panama,Philippines,882,835,47
2005,32,Argentina,Philippines,90,30,60
2005,68,Bolivia (Plurinational State of),Philippines,39,15,24
2005,152,Chile,Philippines,295,225,70
2005,170,Colombia,Philippines,75,37,38
2005,218,Ecuador,Philippines,61,43,18
2005,604,Peru,Philippines,276,187,89
2005,862,Venezuela (Bolivarian Republic of),Philippines,144,61,83
2005,36,Australia,Philippines,134580,48256,86324
2005,554,New Zealand,Philippines,14617,7095,7522
2005,598,Papua New Guinea,Philippines,1697,1196,501
2005,90,Solomon Islands,Philippines,130,88,42
2005,316,Guam,Philippines,30827,15637,15190
2005,584,Marshall Islands,Philippines,398,220,178
2005,583,Micronesia (Fed. States of),Philippines,133,73,60
2005,520,Nauru,Philippines,79,53,26
2005,580,Northern Mariana Islands,Philippines,15233,7822,7411
2005,585,Palau,Philippines,3179,1835,1344
2005,16,American Samoa,Philippines,889,500,389
2005,100,Bulgaria,Philippines,28,3,25
2005,203,Czechia,Philippines,177,72,105
2005,348,Hungary,Philippines,210,41,169
2005,616,Poland,Philippines,123,27,96
2005,642,Romania,Philippines,11,3,8
2005,643,Russian Federation,Philippines,150,80,70
2005,703,Slovakia,Philippines,22,7,15
2005,208,Denmark,Philippines,6663,1284,5379
2005,234,Faroe Islands,Philippines,33,10,23
2005,246,Finland,Philippines,1324,359,965
2005,352,Iceland,Philippines,1056,320,736
2005,372,Ireland,Philippines,11553,5176,6377
2005,428,Latvia,Philippines,3,1,2
2005,578,Norway,Philippines,8015,2064,5951
2005,752,Sweden,Philippines,7214,1634,5580
2005,826,United Kingdom,Philippines,78326,25387,52939
2005,20,Andorra,Philippines,392,207,185
2005,191,Croatia,Philippines,38,8,30
2005,300,Greece,Philippines,7359,1715,5644
2005,380,Italy,Philippines,114522,43623,70899
2005,470,Malta,Philippines,165,44,121
2005,620,Portugal,Philippines,366,71,295
2005,688,Serbia,Philippines,46,7,39
2005,705,Slovenia,Philippines,17,5,12
2005,724,Spain,Philippines,23923,9042,14881
2005,40,Austria,Philippines,10718,3672,7046
2005,56,Belgium,Philippines,8424,2245,6179
2005,250,France,Philippines,10645,3171,7474
2005,276,Germany,Philippines,35620,8748,26872
2005,438,Liechtenstein,Philippines,18,2,16
2005,442,Luxembourg,Philippines,144,34,110
2005,528,Netherlands,Philippines,8661,2023,6638
2005,756,Switzerland,Philippines,10168,2716,7452
2005,60,Bermuda,Philippines,299,147,152
2005,124,Canada,Philippines,351848,151734,200114
2005,304,Greenland,Philippines,9,2,7
2005,840,United States of America,Philippines,1596459,628805,967654
2010,690,Seychelles,Philippines,630,461,169
2010,516,Namibia,Philippines,246,91,155
2010,710,South Africa,Philippines,1296,515,781
2010,288,Ghana,Philippines,23,12,11
2010,818,Egypt,Philippines,1030,376,654
2010,434,Libya,Philippines,3912,2170,1742
2010,48,Bahrain,Philippines,42281,31351,10930
2010,196,Cyprus,Philippines,7853,466,7387
2010,400,Jordan,Philippines,8661,2027,6634
2010,414,Kuwait,Philippines,112782,81558,31224
2010,422,Lebanon,Philippines,1197,118,1079
2010,512,Oman,Philippines,15904,6570,9334
2010,634,Qatar,Philippines,107963,90926,17037
2010,682,Saudi Arabia,Philippines,404010,230033,173977
2010,792,Turkey,Philippines,578,189,389
2010,784,United Arab Emirates,Philippines,474083,361185,112898
2010,64,Bhutan,Philippines,18,14,4
2010,462,Maldives,Philippines,717,313,404
2010,156,China,Philippines,63493,33313,30180
2010,344,"China, Hong Kong SAR",Philippines,115475,2857,112618
2010,446,"China, Macao SAR",Philippines,14193,4599,9594
2010,408,Dem. People's Republic of Korea,Philippines,2656,1018,1638
2010,392,Japan,Philippines,210181,94533,115648
2010,496,Mongolia,Philippines,138,110,28
2010,410,Republic of Korea,Philippines,36786,21604,15182
2010,96,Brunei Darussalam,Philippines,13176,5587,7589
2010,116,Cambodia,Philippines,169,94,75
2010,360,Indonesia,Philippines,3636,2075,1561
2010,458,Malaysia,Philippines,38871,22228,16643
2010,702,Singapore,Philippines,12820,2032,10788
2010,764,Thailand,Philippines,1213,564,649
2010,626,Timor-Leste,Philippines,762,427,335
2010,704,Viet Nam,Philippines,94,58,36
2010,533,Aruba,Philippines,954,468,486
2010,44,Bahamas,Philippines,1031,504,527
2010,136,Cayman Islands,Philippines,1730,923,807
2010,214,Dominican Republic,Philippines,48,25,23
2010,630,Puerto Rico,Philippines,143,67,76
2010,662,Saint Lucia,Philippines,25,13,12
2010,780,Trinidad and Tobago,Philippines,334,164,170
2010,188,Costa Rica,Philippines,137,49,88
2010,222,El Salvador,Philippines,18,10,8
2010,320,Guatemala,Philippines,58,13,45
2010,484,Mexico,Philippines,499,254,245
2010,591,Panama,Philippines,1363,1293,70
2010,32,Argentina,Philippines,58,21,37
2010,68,Bolivia (Plurinational State of),Philippines,40,17,23
2010,76,Brazil,Philippines,354,169,185
2010,152,Chile,Philippines,394,301,93
2010,170,Colombia,Philippines,90,47,43
2010,218,Ecuador,Philippines,86,60,26
2010,604,Peru,Philippines,308,206,102
2010,862,Venezuela (Bolivarian Republic of),Philippines,153,64,89
2010,36,Australia,Philippines,183770,68192,115578
2010,554,New Zealand,Philippines,26902,13027,13875
2010,598,Papua New Guinea,Philippines,1439,1030,409
2010,90,Solomon Islands,Philippines,129,73,56
2010,316,Guam,Philippines,29028,14983,14045
2010,584,Marshall Islands,Philippines,509,293,216
2010,583,Micronesia (Fed. States of),Philippines,128,70,58
2010,520,Nauru,Philippines,36,25,11
2010,580,Northern Mariana Islands,Philippines,12330,5900,6430
2010,585,Palau,Philippines,3247,1989,1258
2010,16,American Samoa,Philippines,1117,626,491
2010,100,Bulgaria,Philippines,34,3,31
2010,203,Czechia,Philippines,320,136,184
2010,348,Hungary,Philippines,250,51,199
2010,616,Poland,Philippines,202,36,166
2010,642,Romania,Philippines,47,10,37
2010,643,Russian Federation,Philippines,144,60,84
2010,703,Slovakia,Philippines,24,8,16
2010,208,Denmark,Philippines,9230,1565,7665
2010,233,Estonia,Philippines,17,4,13
2010,234,Faroe Islands,Philippines,61,16,45
2010,246,Finland,Philippines,2228,464,1764
2010,352,Iceland,Philippines,1433,471,962
2010,372,Ireland,Philippines,14989,5634,9355
2010,428,Latvia,Philippines,5,2,3
2010,578,Norway,Philippines,13458,3039,10419
2010,752,Sweden,Philippines,9826,2195,7631
2010,826,United Kingdom,Philippines,115812,43573,72239
2010,20,Andorra,Philippines,443,234,209
2010,191,Croatia,Philippines,75,15,60
2010,300,Greece,Philippines,9006,2374,6632
2010,380,Italy,Philippines,137814,54051,83763
2010,470,Malta,Philippines,391,71,320
2010,620,Portugal,Philippines,419,86,333
2010,688,Serbia,Philippines,45,6,39
2010,705,Slovenia,Philippines,63,13,50
2010,724,Spain,Philippines,38863,14532,24331
2010,40,Austria,Philippines,11847,3912,7935
2010,56,Belgium,Philippines,8449,1938,6511
2010,250,France,Philippines,14295,3667,10628
2010,276,Germany,Philippines,45508,12693,32815
2010,438,Liechtenstein,Philippines,37,4,33
2010,442,Luxembourg,Philippines,124,37,87
2010,528,Netherlands,Philippines,10636,2438,8198
2010,756,Switzerland,Philippines,12046,2710,9336
2010,60,Bermuda,Philippines,406,223,183
2010,124,Canada,Philippines,454340,185151,269189
2010,304,Greenland,Philippines,50,18,32
2010,840,United States of America,Philippines,1843117,710587,1132530
2015,690,Seychelles,Philippines,705,526,179
2015,516,Namibia,Philippines,240,89,151
2015,710,South Africa,Philippines,2336,857,1479
2015,288,Ghana,Philippines,28,15,13
2015,324,Guinea,Philippines,3,3,0
2015,818,Egypt,Philippines,763,341,422
2015,434,Libya,Philippines,4410,2419,1991
2015,48,Bahrain,Philippines,48059,35449,12610
2015,196,Cyprus,Philippines,7544,494,7050
2015,400,Jordan,Philippines,3728,230,3498
2015,414,Kuwait,Philippines,181462,124304,57158
2015,422,Lebanon,Philippines,1007,482,525
2015,512,Oman,Philippines,36168,18136,18032
2015,634,Qatar,Philippines,148496,126604,21892
2015,682,Saudi Arabia,Philippines,516223,285263,230960
2015,792,Turkey,Philippines,585,182,403
2015,784,United Arab Emirates,Philippines,518041,389810,128231
2015,64,Bhutan,Philippines,19,15,4
2015,462,Maldives,Philippines,910,303,607
2015,156,China,Philippines,73070,39924,33146
2015,344,"China, Hong Kong SAR",Philippines,117914,11792,106122
2015,446,"China, Macao SAR",Philippines,28124,10308,17816
2015,408,Dem. People's Republic of Korea,Philippines,2925,1132,1793
2015,392,Japan,Philippines,229595,102406,127189
2015,496,Mongolia,Philippines,170,126,44
2015,410,Republic of Korea,Philippines,45706,26404,19302
2015,96,Brunei Darussalam,Philippines,13457,5749,7708
2015,116,Cambodia,Philippines,152,86,66
2015,360,Indonesia,Philippines,4025,2335,1690
2015,458,Malaysia,Philippines,111343,47346,63997
2015,702,Singapore,Philippines,15392,2415,12977
2015,764,Thailand,Philippines,1311,607,704
2015,626,Timor-Leste,Philippines,377,248,129
2015,704,Viet Nam,Philippines,113,69,44
2015,533,Aruba,Philippines,1004,493,511
2015,44,Bahamas,Philippines,1117,542,575
2015,136,Cayman Islands,Philippines,1884,1004,880
2015,214,Dominican Republic,Philippines,50,26,24
2015,630,Puerto Rico,Philippines,140,65,75
2015,662,Saint Lucia,Philippines,23,12,11
2015,780,Trinidad and Tobago,Philippines,346,173,173
2015,188,Costa Rica,Philippines,139,50,89
2015,222,El Salvador,Philippines,19,11,8
2015,320,Guatemala,Philippines,67,16,51
2015,484,Mexico,Philippines,529,267,262
2015,591,Panama,Philippines,1601,1518,83
2015,32,Argentina,Philippines,58,21,37
2015,68,Bolivia (Plurinational State of),Philippines,47,20,27
2015,76,Brazil,Philippines,426,203,223
2015,152,Chile,Philippines,596,453,143
2015,170,Colombia,Philippines,100,53,47
2015,218,Ecuador,Philippines,125,87,38
2015,604,Peru,Philippines,328,215,113
2015,862,Venezuela (Bolivarian Republic of),Philippines,161,66,95
2015,36,Australia,Philippines,241130,96365,144765
2015,554,New Zealand,Philippines,38756,18742,20014
2015,598,Papua New Guinea,Philippines,1459,1051,408
2015,90,Solomon Islands,Philippines,120,68,52
2015,316,Guam,Philippines,29289,15107,14182
2015,584,Marshall Islands,Philippines,541,311,230
2015,583,Micronesia (Fed. States of),Philippines,125,68,57
2015,520,Nauru,Philippines,57,41,16
2015,580,Northern Mariana Islands,Philippines,11045,5260,5785
2015,585,Palau,Philippines,2919,1848,1071
2015,16,American Samoa,Philippines,1115,622,493
2015,100,Bulgaria,Philippines,82,10,72
2015,203,Czechia,Philippines,509,106,403
2015,348,Hungary,Philippines,301,80,221
2015,616,Poland,Philippines,194,37,157
2015,642,Romania,Philippines,40,11,29
2015,643,Russian Federation,Philippines,147,61,86
2015,703,Slovakia,Philippines,34,11,23
2015,208,Denmark,Philippines,11325,1896,9429
2015,233,Estonia,Philippines,56,17,39
2015,234,Faroe Islands,Philippines,130,25,105
2015,246,Finland,Philippines,3995,1046,2949
2015,352,Iceland,Philippines,1565,534,1031
2015,372,Ireland,Philippines,15312,5637,9675
2015,428,Latvia,Philippines,108,106,2
2015,578,Norway,Philippines,20741,4764,15977
2015,752,Sweden,Philippines,12406,2807,9599
2015,826,United Kingdom,Philippines,130500,49845,80655
2015,20,Andorra,Philippines,425,231,194
2015,191,Croatia,Philippines,75,14,61
2015,300,Greece,Philippines,8452,1962,6490
2015,380,Italy,Philippines,143234,56901,86333
2015,470,Malta,Philippines,664,157,507
2015,620,Portugal,Philippines,474,78,396
2015,688,Serbia,Philippines,43,5,38
2015,705,Slovenia,Philippines,114,22,92
2015,724,Spain,Philippines,42659,15840,26819
2015,40,Austria,Philippines,13856,4626,9230
2015,56,Belgium,Philippines,10423,2384,8039
2015,250,France,Philippines,15836,3740,12096
2015,276,Germany,Philippines,47417,13145,34272
2015,438,Liechtenstein,Philippines,38,3,35
2015,442,Luxembourg,Philippines,189,59,130
2015,528,Netherlands,Philippines,12381,2915,9466
2015,756,Switzerland,Philippines,13436,2980,10456
2015,60,Bermuda,Philippines,411,225,186
2015,124,Canada,Philippines,584697,245426,339271
2015,304,Greenland,Philippines,125,49,76
2015,840,United States of America,Philippines,1982369,754986,1227383
2019,690,Seychelles,Philippines,712,532,180
2019,516,Namibia,Philippines,254,95,159
2019,710,South Africa,Philippines,2617,962,1655
2019,288,Ghana,Philippines,31,17,14
2019,324,Guinea,Philippines,2,2,0
2019,818,Egypt,Philippines,1087,415,672
2019,434,Libya,Philippines,4679,2567,2112
2019,48,Bahrain,Philippines,50585,37312,13273
2019,196,Cyprus,Philippines,7540,566,6974
2019,400,Jordan,Philippines,4009,248,3761
2019,414,Kuwait,Philippines,192143,131621,60522
2019,422,Lebanon,Philippines,951,456,495
2019,512,Oman,Philippines,44546,22337,22209
2019,634,Qatar,Philippines,168461,131852,36609
2019,682,Saudi Arabia,Philippines,628894,341323,287571
2019,792,Turkey,Philippines,791,252,539
2019,784,United Arab Emirates,Philippines,556407,418656,137751
2019,64,Bhutan,Philippines,19,15,4
2019,462,Maldives,Philippines,980,327,653
2019,156,China,Philippines,77016,42080,34936
2019,344,"China, Hong Kong SAR",Philippines,152771,11151,141620
2019,446,"China, Macao SAR",Philippines,29881,10952,18929
2019,408,Dem. People's Republic of Korea,Philippines,2981,1154,1827
2019,392,Japan,Philippines,255530,113974,141556
2019,496,Mongolia,Philippines,180,134,46
2019,410,Republic of Korea,Philippines,46528,26872,19656
2019,96,Brunei Darussalam,Philippines,14492,6191,8301
2019,116,Cambodia,Philippines,161,91,70
2019,360,Indonesia,Philippines,4203,2438,1765
2019,458,Malaysia,Philippines,116423,49997,66426
2019,702,Singapore,Philippines,13044,2033,11011
2019,764,Thailand,Philippines,1366,632,734
2019,626,Timor-Leste,Philippines,372,245,127
2019,704,Viet Nam,Philippines,118,73,45
2019,533,Aruba,Philippines,1015,499,516
2019,44,Bahamas,Philippines,1185,575,610
2019,136,Cayman Islands,Philippines,2086,1112,974
2019,214,Dominican Republic,Philippines,51,27,24
2019,630,Puerto Rico,Philippines,133,62,71
2019,662,Saint Lucia,Philippines,22,12,10
2019,780,Trinidad and Tobago,Philippines,372,195,177
2019,188,Costa Rica,Philippines,141,52,89
2019,222,El Salvador,Philippines,19,11,8
2019,320,Guatemala,Philippines,68,16,52
2019,484,Mexico,Philippines,545,275,270
2019,591,Panama,Philippines,1703,1617,86
2019,32,Argentina,Philippines,59,22,37
2019,68,Bolivia (Plurinational State of),Philippines,51,22,29
2019,76,Brazil,Philippines,479,228,251
2019,152,Chile,Philippines,796,595,201
2019,170,Colombia,Philippines,102,54,48
2019,218,Ecuador,Philippines,123,86,37
2019,604,Peru,Philippines,390,262,128
2019,862,Venezuela (Bolivarian Republic of),Philippines,157,64,93
2019,36,Australia,Philippines,281216,111562,169654
2019,554,New Zealand,Philippines,39837,19265,20572
2019,598,Papua New Guinea,Philippines,1471,1061,410
2019,90,Solomon Islands,Philippines,117,67,50
2019,316,Guam,Philippines,30741,15854,14887
2019,584,Marshall Islands,Philippines,542,312,230
2019,583,Micronesia (Fed. States of),Philippines,127,69,58
2019,520,Nauru,Philippines,63,46,17
2019,580,Northern Mariana Islands,Philippines,11130,5301,5829
2019,585,Palau,Philippines,2999,1786,1213
2019,16,American Samoa,Philippines,1116,623,493
2019,100,Bulgaria,Philippines,118,14,104
2019,203,Czechia,Philippines,868,195,673
2019,348,Hungary,Philippines,380,101,279
2019,616,Poland,Philippines,205,46,159
2019,642,Romania,Philippines,402,65,337
2019,643,Russian Federation,Philippines,146,61,85
2019,703,Slovakia,Philippines,52,18,34
2019,208,Denmark,Philippines,12610,2053,10557
2019,233,Estonia,Philippines,67,20,47
2019,234,Faroe Islands,Philippines,196,36,160
2019,246,Finland,Philippines,5324,1411,3913
2019,352,Iceland,Philippines,1945,690,1255
2019,372,Ireland,Philippines,16810,6221,10589
2019,428,Latvia,Philippines,9,6,3
2019,578,Norway,Philippines,24098,5524,18574
2019,752,Sweden,Philippines,15214,3388,11826
2019,826,United Kingdom,Philippines,148196,56836,91360
2019,20,Andorra,Philippines,453,248,205
2019,191,Croatia,Philippines,69,13,56
2019,300,Greece,Philippines,8254,2156,6098
2019,380,Italy,Philippines,153280,61930,91350
2019,470,Malta,Philippines,1071,259,812
2019,620,Portugal,Philippines,482,81,401
2019,688,Serbia,Philippines,43,5,38
2019,705,Slovenia,Philippines,140,29,111
2019,724,Spain,Philippines,46322,16829,29493
2019,40,Austria,Philippines,16356,5648,10708
2019,56,Belgium,Philippines,11581,2690,8891
2019,250,France,Philippines,16762,3930,12832
2019,276,Germany,Philippines,52014,17618,34396
2019,438,Liechtenstein,Philippines,50,6,44
2019,442,Luxembourg,Philippines,802,181,621
2019,528,Netherlands,Philippines,14492,3511,10981
2019,756,Switzerland,Philippines,14345,3253,11092
2019,60,Bermuda,Philippines,415,227,188
2019,124,Canada,Philippines,626569,263002,363567
2019,304,Greenland,Philippines,122,48,74
2019,840,United States of America,Philippines,2047269,777280,1269989
1990,516,Namibia,Poland,249,85,164
1990,710,South Africa,Poland,1622,779,843
1990,288,Ghana,Poland,34,16,18
1990,818,Egypt,Poland,407,236,171
1990,434,Libya,Poland,1163,678,485
1990,196,Cyprus,Poland,176,49,127
1990,268,Georgia,Poland,3794,1465,2329
1990,376,Israel,Poland,95566,44020,51546
1990,400,Jordan,Poland,85,31,54
1990,792,Turkey,Poland,826,414,412
1990,417,Kyrgyzstan,Poland,6934,2524,4410
1990,762,Tajikistan,Poland,58,26,32
1990,392,Japan,Poland,359,183,176
1990,496,Mongolia,Poland,5,3,2
1990,608,Philippines,Poland,12,9,3
1990,44,Bahamas,Poland,12,6,6
1990,192,Cuba,Poland,211,76,135
1990,214,Dominican Republic,Poland,475,70,405
1990,630,Puerto Rico,Poland,36,17,19
1990,188,Costa Rica,Poland,329,160,169
1990,484,Mexico,Poland,1693,573,1120
1990,591,Panama,Poland,67,45,22
1990,32,Argentina,Poland,29520,14204,15316
1990,68,Bolivia (Plurinational State of),Poland,193,108,85
1990,76,Brazil,Poland,13225,6305,6920
1990,152,Chile,Poland,465,231,234
1990,170,Colombia,Poland,495,239,256
1990,218,Ecuador,Poland,104,52,52
1990,600,Paraguay,Poland,696,352,344
1990,604,Peru,Poland,123,63,60
1990,858,Uruguay,Poland,4067,1867,2200
1990,862,Venezuela (Bolivarian Republic of),Poland,803,353,450
1990,36,Australia,Poland,74954,38304,36650
1990,554,New Zealand,Poland,572,311,261
1990,112,Belarus,Poland,235,133,102
1990,100,Bulgaria,Poland,423,128,295
1990,203,Czechia,Poland,6082,2264,3818
1990,348,Hungary,Poland,3647,1620,2027
1990,498,Republic of Moldova,Poland,794,402,392
1990,642,Romania,Poland,538,206,332
1990,643,Russian Federation,Poland,31333,15375,15958
1990,703,Slovakia,Poland,1207,360,847
1990,804,Ukraine,Poland,3718,1577,2141
1990,208,Denmark,Poland,8085,3035,5050
1990,233,Estonia,Poland,236,92,144
1990,234,Faroe Islands,Poland,23,9,14
1990,246,Finland,Poland,1027,473,554
1990,352,Iceland,Poland,265,113,152
1990,372,Ireland,Poland,3168,1556,1612
1990,428,Latvia,Poland,30550,11857,18693
1990,440,Lithuania,Poland,4372,1855,2517
1990,578,Norway,Poland,4367,1982,2385
1990,752,Sweden,Poland,31527,11143,20384
1990,826,United Kingdom,Poland,71908,41357,30551
1990,191,Croatia,Poland,655,114,541
1990,300,Greece,Poland,29946,12030,17916
1990,380,Italy,Poland,24516,6428,18088
1990,470,Malta,Poland,20,7,13
1990,807,North Macedonia,Poland,101,42,59
1990,620,Portugal,Poland,104,50,54
1990,674,San Marino,Poland,18,2,16
1990,688,Serbia,Poland,81,14,67
1990,705,Slovenia,Poland,62,31,31
1990,724,Spain,Poland,4206,2101,2105
1990,40,Austria,Poland,33851,14262,19589
1990,56,Belgium,Poland,5537,2560,2977
1990,250,France,Poland,135061,48005,87056
1990,276,Germany,Poland,248610,140476,108134
1990,438,Liechtenstein,Poland,11,11,0
1990,442,Luxembourg,Poland,722,309,413
1990,528,Netherlands,Poland,9026,2795,6231
1990,756,Switzerland,Poland,9473,3758,5715
1990,60,Bermuda,Poland,25,14,11
1990,124,Canada,Poland,177219,86275,90944
1990,304,Greenland,Poland,8,2,6
1990,840,United States of America,Poland,388328,178287,210041
1995,516,Namibia,Poland,238,83,155
1995,710,South Africa,Poland,2497,1301,1196
1995,288,Ghana,Poland,34,18,16
1995,818,Egypt,Poland,329,176,153
1995,434,Libya,Poland,824,421,403
1995,196,Cyprus,Poland,249,62,187
1995,268,Georgia,Poland,350,98,252
1995,376,Israel,Poland,93907,42436,51471
1995,400,Jordan,Poland,93,35,58
1995,792,Turkey,Poland,1999,960,1039
1995,417,Kyrgyzstan,Poland,6242,2344,3898
1995,762,Tajikistan,Poland,47,22,25
1995,392,Japan,Poland,585,281,304
1995,496,Mongolia,Poland,4,3,1
1995,608,Philippines,Poland,16,12,4
1995,44,Bahamas,Poland,10,3,7
1995,192,Cuba,Poland,160,53,107
1995,214,Dominican Republic,Poland,528,67,461
1995,630,Puerto Rico,Poland,37,18,19
1995,188,Costa Rica,Poland,224,106,118
1995,484,Mexico,Poland,1514,535,979
1995,591,Panama,Poland,71,48,23
1995,32,Argentina,Poland,21429,9891,11538
1995,68,Bolivia (Plurinational State of),Poland,182,97,85
1995,76,Brazil,Poland,10351,4766,5585
1995,152,Chile,Poland,450,216,234
1995,170,Colombia,Poland,404,196,208
1995,218,Ecuador,Poland,117,58,59
1995,600,Paraguay,Poland,842,440,402
1995,604,Peru,Poland,124,63,61
1995,858,Uruguay,Poland,2465,1092,1373
1995,862,Venezuela (Bolivarian Republic of),Poland,793,349,444
1995,36,Australia,Poland,74618,37149,37469
1995,554,New Zealand,Poland,762,401,361
1995,112,Belarus,Poland,365,180,185
1995,100,Bulgaria,Poland,558,168,390
1995,203,Czechia,Poland,9124,3556,5568
1995,348,Hungary,Poland,3200,1265,1935
1995,498,Republic of Moldova,Poland,536,264,272
1995,642,Romania,Poland,480,189,291
1995,643,Russian Federation,Poland,32973,16123,16850
1995,703,Slovakia,Poland,2476,920,1556
1995,804,Ukraine,Poland,3597,1585,2012
1995,208,Denmark,Poland,9520,3413,6107
1995,233,Estonia,Poland,366,144,222
1995,234,Faroe Islands,Poland,20,12,8
1995,246,Finland,Poland,1007,477,530
1995,352,Iceland,Poland,878,389,489
1995,372,Ireland,Poland,17186,8183,9003
1995,428,Latvia,Poland,16038,6218,9820
1995,440,Lithuania,Poland,4890,2086,2804
1995,578,Norway,Poland,5157,1919,3238
1995,752,Sweden,Poland,37413,13040,24373
1995,826,United Kingdom,Poland,64757,34255,30502
1995,191,Croatia,Poland,660,111,549
1995,300,Greece,Poland,22454,9400,13054
1995,380,Italy,Poland,33838,8007,25831
1995,470,Malta,Poland,24,9,15
1995,807,North Macedonia,Poland,94,39,55
1995,620,Portugal,Poland,224,106,118
1995,674,San Marino,Poland,19,2,17
1995,688,Serbia,Poland,517,78,439
1995,705,Slovenia,Poland,133,37,96
1995,724,Spain,Poland,5725,2836,2889
1995,40,Austria,Poland,38190,16452,21738
1995,56,Belgium,Poland,6931,2757,4174
1995,250,France,Poland,139427,48044,91383
1995,276,Germany,Poland,459633,211890,247743
1995,438,Liechtenstein,Poland,13,13,0
1995,442,Luxembourg,Poland,642,261,381
1995,528,Netherlands,Poland,12398,3655,8743
1995,756,Switzerland,Poland,12836,5569,7267
1995,60,Bermuda,Poland,27,10,17
1995,124,Canada,Poland,176548,85546,91002
1995,304,Greenland,Poland,2,2,0
1995,840,United States of America,Poland,433257,199761,233496
2000,516,Namibia,Poland,222,77,145
2000,710,South Africa,Poland,4141,2169,1972
2000,288,Ghana,Poland,38,18,20
2000,818,Egypt,Poland,278,131,147
2000,434,Libya,Poland,499,179,320
2000,196,Cyprus,Poland,322,75,247
2000,268,Georgia,Poland,175,49,126
2000,376,Israel,Poland,86990,39029,47961
2000,400,Jordan,Poland,100,39,61
2000,792,Turkey,Poland,3181,1509,1672
2000,417,Kyrgyzstan,Poland,5368,2087,3281
2000,762,Tajikistan,Poland,41,20,21
2000,392,Japan,Poland,742,343,399
2000,496,Mongolia,Poland,5,3,2
2000,608,Philippines,Poland,75,25,50
2000,44,Bahamas,Poland,9,2,7
2000,192,Cuba,Poland,109,31,78
2000,214,Dominican Republic,Poland,580,64,516
2000,630,Puerto Rico,Poland,40,19,21
2000,188,Costa Rica,Poland,231,101,130
2000,484,Mexico,Poland,1401,525,876
2000,591,Panama,Poland,80,54,26
2000,32,Argentina,Poland,13338,5578,7760
2000,68,Bolivia (Plurinational State of),Poland,170,85,85
2000,76,Brazil,Poland,7477,3228,4249
2000,152,Chile,Poland,435,207,228
2000,170,Colombia,Poland,312,153,159
2000,218,Ecuador,Poland,130,65,65
2000,600,Paraguay,Poland,986,524,462
2000,604,Peru,Poland,145,73,72
2000,858,Uruguay,Poland,1318,581,737
2000,862,Venezuela (Bolivarian Republic of),Poland,779,343,436
2000,36,Australia,Poland,66880,31865,35015
2000,554,New Zealand,Poland,1884,916,968
2000,112,Belarus,Poland,495,228,267
2000,100,Bulgaria,Poland,693,208,485
2000,203,Czechia,Poland,12165,4848,7317
2000,348,Hungary,Poland,2752,909,1843
2000,498,Republic of Moldova,Poland,362,173,189
2000,642,Romania,Poland,419,169,250
2000,643,Russian Federation,Poland,33418,16292,17126
2000,703,Slovakia,Poland,4425,1731,2694
2000,804,Ukraine,Poland,3520,1611,1909
2000,208,Denmark,Poland,10954,3790,7164
2000,233,Estonia,Poland,496,196,300
2000,234,Faroe Islands,Poland,49,29,20
2000,246,Finland,Poland,987,481,506
2000,352,Iceland,Poland,1491,665,826
2000,372,Ireland,Poland,40650,20024,20626
2000,428,Latvia,Poland,1526,579,947
2000,440,Lithuania,Poland,3830,1630,2200
2000,578,Norway,Poland,5738,1975,3763
2000,752,Sweden,Poland,40123,13814,26309
2000,826,United Kingdom,Poland,58696,27650,31046
2000,191,Croatia,Poland,595,103,492
2000,300,Greece,Poland,15330,6687,8643
2000,380,Italy,Poland,43160,9586,33574
2000,470,Malta,Poland,61,23,38
2000,807,North Macedonia,Poland,88,37,51
2000,620,Portugal,Poland,355,168,187
2000,674,San Marino,Poland,22,2,20
2000,688,Serbia,Poland,704,94,610
2000,705,Slovenia,Poland,254,60,194
2000,724,Spain,Poland,9707,4869,4838
2000,40,Austria,Poland,42528,18641,23887
2000,56,Belgium,Poland,8125,2891,5234
2000,250,France,Poland,143793,48084,95709
2000,276,Germany,Poland,670656,283305,387351
2000,438,Liechtenstein,Poland,15,15,0
2000,442,Luxembourg,Poland,570,217,353
2000,528,Netherlands,Poland,16189,4615,11574
2000,756,Switzerland,Poland,16247,7422,8825
2000,60,Bermuda,Poland,28,6,22
2000,124,Canada,Poland,180074,86869,93205
2000,304,Greenland,Poland,7,2,5
2000,840,United States of America,Poland,478593,221734,256859
2005,516,Namibia,Poland,175,60,115
2005,710,South Africa,Poland,5447,2738,2709
2005,288,Ghana,Poland,53,27,26
2005,818,Egypt,Poland,331,167,164
2005,434,Libya,Poland,550,260,290
2005,196,Cyprus,Poland,471,107,364
2005,268,Georgia,Poland,166,47,119
2005,376,Israel,Poland,71802,31965,39837
2005,400,Jordan,Poland,143,66,77
2005,792,Turkey,Poland,3278,1517,1761
2005,417,Kyrgyzstan,Poland,4539,1754,2785
2005,762,Tajikistan,Poland,39,19,20
2005,392,Japan,Poland,922,420,502
2005,496,Mongolia,Poland,7,5,2
2005,608,Philippines,Poland,60,21,39
2005,44,Bahamas,Poland,14,4,10
2005,192,Cuba,Poland,73,21,52
2005,214,Dominican Republic,Poland,312,46,266
2005,630,Puerto Rico,Poland,31,15,16
2005,188,Costa Rica,Poland,151,65,86
2005,484,Mexico,Poland,1063,400,663
2005,591,Panama,Poland,120,78,42
2005,32,Argentina,Poland,9839,4205,5634
2005,68,Bolivia (Plurinational State of),Poland,179,90,89
2005,76,Brazil,Poland,5504,2467,3037
2005,152,Chile,Poland,652,316,336
2005,170,Colombia,Poland,253,126,127
2005,218,Ecuador,Poland,153,78,75
2005,600,Paraguay,Poland,939,499,440
2005,604,Peru,Poland,170,86,84
2005,858,Uruguay,Poland,1220,538,682
2005,862,Venezuela (Bolivarian Republic of),Poland,819,362,457
2005,36,Australia,Poland,63280,29130,34150
2005,554,New Zealand,Poland,1916,930,986
2005,112,Belarus,Poland,476,219,257
2005,100,Bulgaria,Poland,939,299,640
2005,203,Czechia,Poland,16032,7160,8872
2005,348,Hungary,Poland,3399,1163,2236
2005,498,Republic of Moldova,Poland,250,117,133
2005,642,Romania,Poland,411,170,241
2005,643,Russian Federation,Poland,31362,15137,16225
2005,703,Slovakia,Poland,4962,1992,2970
2005,804,Ukraine,Poland,3216,1475,1741
2005,208,Denmark,Poland,19008,8647,10361
2005,233,Estonia,Poland,550,240,310
2005,234,Faroe Islands,Poland,69,50,19
2005,246,Finland,Poland,1939,996,943
2005,352,Iceland,Poland,5895,3259,2636
2005,372,Ireland,Poland,90158,52402,37756
2005,428,Latvia,Poland,1397,586,811
2005,440,Lithuania,Poland,3467,1491,1976
2005,578,Norway,Poland,8303,3392,4911
2005,752,Sweden,Poland,46203,16698,29505
2005,826,United Kingdom,Poland,328865,161023,167842
2005,191,Croatia,Poland,664,126,538
2005,300,Greece,Poland,15669,6230,9439
2005,380,Italy,Poland,80891,19418,61473
2005,470,Malta,Poland,97,36,61
2005,807,North Macedonia,Poland,90,38,52
2005,620,Portugal,Poland,661,226,435
2005,674,San Marino,Poland,23,3,20
2005,688,Serbia,Poland,695,86,609
2005,705,Slovenia,Poland,244,63,181
2005,724,Spain,Poland,33371,16835,16536
2005,40,Austria,Poland,49475,22206,27269
2005,56,Belgium,Poland,24032,11497,12535
2005,250,France,Poland,101024,36152,64872
2005,276,Germany,Poland,1157821,528338,629483
2005,438,Liechtenstein,Poland,30,12,18
2005,442,Luxembourg,Poland,1310,498,812
2005,528,Netherlands,Poland,24970,7716,17254
2005,756,Switzerland,Poland,19170,8362,10808
2005,60,Bermuda,Poland,31,13,18
2005,124,Canada,Poland,160218,75013,85205
2005,304,Greenland,Poland,5,3,2
2005,840,United States of America,Poland,475678,221795,253883
2010,516,Namibia,Poland,168,58,110
2010,710,South Africa,Poland,8532,4273,4259
2010,288,Ghana,Poland,39,18,21
2010,818,Egypt,Poland,357,173,184
2010,434,Libya,Poland,602,288,314
2010,196,Cyprus,Poland,771,183,588
2010,268,Georgia,Poland,167,47,120
2010,376,Israel,Poland,57485,25208,32277
2010,400,Jordan,Poland,183,89,94
2010,792,Turkey,Poland,3377,1522,1855
2010,417,Kyrgyzstan,Poland,3647,1389,2258
2010,762,Tajikistan,Poland,38,19,19
2010,392,Japan,Poland,978,439,539
2010,496,Mongolia,Poland,11,8,3
2010,608,Philippines,Poland,108,32,76
2010,44,Bahamas,Poland,18,6,12
2010,192,Cuba,Poland,40,11,29
2010,214,Dominican Republic,Poland,42,28,14
2010,630,Puerto Rico,Poland,19,9,10
2010,188,Costa Rica,Poland,298,129,169
2010,484,Mexico,Poland,849,322,527
2010,591,Panama,Poland,167,106,61
2010,32,Argentina,Poland,6339,2832,3507
2010,68,Bolivia (Plurinational State of),Poland,187,94,93
2010,76,Brazil,Poland,3452,1668,1784
2010,152,Chile,Poland,870,425,445
2010,170,Colombia,Poland,238,123,115
2010,218,Ecuador,Poland,215,107,108
2010,600,Paraguay,Poland,894,474,420
2010,604,Peru,Poland,190,96,94
2010,858,Uruguay,Poland,1130,493,637
2010,862,Venezuela (Bolivarian Republic of),Poland,870,385,485
2010,36,Australia,Poland,58940,26123,32817
2010,554,New Zealand,Poland,1983,962,1021
2010,112,Belarus,Poland,456,210,246
2010,100,Bulgaria,Poland,1146,377,769
2010,203,Czechia,Poland,18409,9183,9226
2010,348,Hungary,Poland,4045,1416,2629
2010,498,Republic of Moldova,Poland,178,85,93
2010,642,Romania,Poland,460,190,270
2010,643,Russian Federation,Poland,28661,13680,14981
2010,703,Slovakia,Poland,5564,2279,3285
2010,804,Ukraine,Poland,3068,1410,1658
2010,208,Denmark,Poland,26585,13273,13312
2010,233,Estonia,Poland,599,281,318
2010,234,Faroe Islands,Poland,75,52,23
2010,246,Finland,Poland,3382,1642,1740
2010,352,Iceland,Poland,10282,5846,4436
2010,372,Ireland,Poland,124820,71364,53456
2010,428,Latvia,Poland,1233,566,667
2010,440,Lithuania,Poland,2633,1048,1585
2010,578,Norway,Poland,49518,32620,16898
2010,752,Sweden,Poland,70253,30094,40159
2010,826,United Kingdom,Poland,537859,272733,265126
2010,191,Croatia,Poland,732,148,584
2010,300,Greece,Poland,16654,6009,10645
2010,380,Italy,Poland,124693,31430,93263
2010,470,Malta,Poland,203,69,134
2010,499,Montenegro,Poland,94,68,26
2010,807,North Macedonia,Poland,93,39,54
2010,620,Portugal,Poland,859,248,611
2010,674,San Marino,Poland,25,3,22
2010,688,Serbia,Poland,680,84,596
2010,705,Slovenia,Poland,380,131,249
2010,724,Spain,Poland,74329,38321,36008
2010,40,Austria,Poland,56421,25770,30651
2010,56,Belgium,Poland,51743,22293,29450
2010,250,France,Poland,104843,38692,66151
2010,276,Germany,Poland,1535428,724224,811204
2010,438,Liechtenstein,Poland,47,10,37
2010,442,Luxembourg,Poland,2065,784,1281
2010,528,Netherlands,Poland,58215,24846,33369
2010,756,Switzerland,Poland,21465,8512,12953
2010,60,Bermuda,Poland,33,19,14
2010,124,Canada,Poland,152285,68935,83350
2010,304,Greenland,Poland,27,25,2
2010,840,United States of America,Poland,487297,223634,263663
2015,516,Namibia,Poland,164,57,107
2015,710,South Africa,Poland,15390,7317,8073
2015,288,Ghana,Poland,47,22,25
2015,324,Guinea,Poland,1,0,1
2015,818,Egypt,Poland,264,146,118
2015,434,Libya,Poland,678,320,358
2015,196,Cyprus,Poland,740,179,561
2015,268,Georgia,Poland,175,50,125
2015,376,Israel,Poland,59286,25835,33451
2015,400,Jordan,Poland,79,30,49
2015,792,Turkey,Poland,3428,1503,1925
2015,417,Kyrgyzstan,Poland,3212,1212,2000
2015,762,Tajikistan,Poland,37,19,18
2015,392,Japan,Poland,1653,738,915
2015,496,Mongolia,Poland,13,9,4
2015,608,Philippines,Poland,110,33,77
2015,44,Bahamas,Poland,20,7,13
2015,192,Cuba,Poland,32,9,23
2015,214,Dominican Republic,Poland,44,30,14
2015,630,Puerto Rico,Poland,18,9,9
2015,188,Costa Rica,Poland,302,130,172
2015,484,Mexico,Poland,692,330,362
2015,591,Panama,Poland,196,125,71
2015,32,Argentina,Poland,7315,3266,4049
2015,68,Bolivia (Plurinational State of),Poland,218,110,108
2015,76,Brazil,Poland,4157,2009,2148
2015,152,Chile,Poland,1318,630,688
2015,170,Colombia,Poland,266,139,127
2015,218,Ecuador,Poland,312,154,158
2015,600,Paraguay,Poland,872,462,410
2015,604,Peru,Poland,201,105,96
2015,858,Uruguay,Poland,1166,508,658
2015,862,Venezuela (Bolivarian Republic of),Poland,911,396,515
2015,36,Australia,Poland,54530,23997,30533
2015,554,New Zealand,Poland,2019,977,1042
2015,112,Belarus,Poland,478,221,257
2015,100,Bulgaria,Poland,1648,564,1084
2015,203,Czechia,Poland,18796,9503,9293
2015,348,Hungary,Poland,3227,1170,2057
2015,498,Republic of Moldova,Poland,133,64,69
2015,642,Romania,Poland,170,101,69
2015,643,Russian Federation,Poland,29207,13864,15343
2015,703,Slovakia,Poland,6721,3119,3602
2015,804,Ukraine,Poland,3078,1417,1661
2015,208,Denmark,Poland,33748,16912,16836
2015,233,Estonia,Poland,790,416,374
2015,234,Faroe Islands,Poland,72,52,20
2015,246,Finland,Poland,5148,2716,2432
2015,352,Iceland,Poland,10967,5839,5128
2015,372,Ireland,Poland,127507,69919,57588
2015,428,Latvia,Poland,832,372,460
2015,440,Lithuania,Poland,2167,848,1319
2015,578,Norway,Poland,91361,59491,31870
2015,752,Sweden,Poland,85517,38610,46907
2015,826,United Kingdom,Poland,804877,380168,424709
2015,191,Croatia,Poland,737,148,589
2015,300,Greece,Poland,15630,5213,10417
2015,380,Italy,Poland,114950,26878,88072
2015,470,Malta,Poland,344,132,212
2015,499,Montenegro,Poland,98,71,27
2015,807,North Macedonia,Poland,100,42,58
2015,620,Portugal,Poland,974,246,728
2015,674,San Marino,Poland,31,3,28
2015,688,Serbia,Poland,664,80,584
2015,705,Slovenia,Poland,413,155,258
2015,724,Spain,Poland,63864,29642,34222
2015,40,Austria,Poland,65989,30336,35653
2015,56,Belgium,Poland,73447,32007,41440
2015,250,France,Poland,100587,38758,61829
2015,276,Germany,Poland,1592694,748977,843717
2015,438,Liechtenstein,Poland,60,13,47
2015,442,Luxembourg,Poland,3150,1226,1924
2015,528,Netherlands,Poland,98435,44338,54097
2015,756,Switzerland,Poland,37132,17188,19944
2015,60,Bermuda,Poland,33,19,14
2015,124,Canada,Poland,145571,66006,79565
2015,304,Greenland,Poland,29,22,7
2015,840,United States of America,Poland,419332,190716,228616
2019,516,Namibia,Poland,173,60,113
2019,710,South Africa,Poland,17250,8210,9040
2019,288,Ghana,Poland,52,24,28
2019,818,Egypt,Poland,376,188,188
2019,434,Libya,Poland,719,340,379
2019,196,Cyprus,Poland,739,184,555
2019,268,Georgia,Poland,180,52,128
2019,376,Israel,Poland,57653,25123,32530
2019,400,Jordan,Poland,84,32,52
2019,792,Turkey,Poland,4635,2058,2577
2019,417,Kyrgyzstan,Poland,3147,1188,1959
2019,762,Tajikistan,Poland,36,19,17
2019,392,Japan,Poland,1489,665,824
2019,496,Mongolia,Poland,13,9,4
2019,608,Philippines,Poland,113,34,79
2019,44,Bahamas,Poland,21,8,13
2019,192,Cuba,Poland,29,8,21
2019,214,Dominican Republic,Poland,45,31,14
2019,630,Puerto Rico,Poland,17,9,8
2019,188,Costa Rica,Poland,306,133,173
2019,484,Mexico,Poland,713,340,373
2019,591,Panama,Poland,207,133,74
2019,32,Argentina,Poland,7443,3317,4126
2019,68,Bolivia (Plurinational State of),Poland,238,121,117
2019,76,Brazil,Poland,4681,2262,2419
2019,152,Chile,Poland,1760,790,970
2019,170,Colombia,Poland,272,143,129
2019,218,Ecuador,Poland,307,152,155
2019,600,Paraguay,Poland,894,474,420
2019,604,Peru,Poland,238,129,109
2019,858,Uruguay,Poland,1205,527,678
2019,862,Venezuela (Bolivarian Republic of),Poland,892,386,506
2019,36,Australia,Poland,56275,24621,31654
2019,554,New Zealand,Poland,2075,1004,1071
2019,112,Belarus,Poland,472,219,253
2019,100,Bulgaria,Poland,2043,721,1322
2019,203,Czechia,Poland,19442,9923,9519
2019,348,Hungary,Poland,3322,1140,2182
2019,498,Republic of Moldova,Poland,130,63,67
2019,642,Romania,Poland,717,383,334
2019,643,Russian Federation,Poland,29200,13861,15339
2019,703,Slovakia,Poland,7096,3390,3706
2019,804,Ukraine,Poland,3108,1431,1677
2019,208,Denmark,Poland,43640,23210,20430
2019,233,Estonia,Poland,729,373,356
2019,234,Faroe Islands,Poland,85,58,27
2019,246,Finland,Poland,6226,3323,2903
2019,352,Iceland,Poland,15629,9055,6574
2019,372,Ireland,Poland,139986,76955,63031
2019,428,Latvia,Poland,742,336,406
2019,440,Lithuania,Poland,1818,735,1083
2019,578,Norway,Poland,105843,67733,38110
2019,752,Sweden,Poland,96994,46273,50721
2019,826,United Kingdom,Poland,914022,432939,481083
2019,191,Croatia,Poland,680,135,545
2019,300,Greece,Poland,15264,5477,9787
2019,380,Italy,Poland,118588,28350,90238
2019,470,Malta,Poland,555,216,339
2019,499,Montenegro,Poland,98,72,26
2019,807,North Macedonia,Poland,100,42,58
2019,620,Portugal,Poland,990,252,738
2019,674,San Marino,Poland,32,2,30
2019,688,Serbia,Poland,674,82,592
2019,705,Slovenia,Poland,385,111,274
2019,724,Spain,Poland,62811,28109,34702
2019,40,Austria,Poland,77899,36536,41363
2019,56,Belgium,Poland,80564,35234,45330
2019,250,France,Poland,106472,40877,65595
2019,276,Germany,Poland,1784839,922678,862161
2019,438,Liechtenstein,Poland,69,21,48
2019,442,Luxembourg,Poland,5151,2189,2962
2019,528,Netherlands,Poland,135775,63404,72371
2019,756,Switzerland,Poland,42095,19772,22323
2019,60,Bermuda,Poland,33,19,14
2019,124,Canada,Poland,155996,70733,85263
2019,304,Greenland,Poland,28,22,6
2019,840,United States of America,Poland,426937,193735,233202
1990,508,Mozambique,Portugal,1667,1135,532
1990,24,Angola,Portugal,5298,3379,1919
1990,178,Congo,Portugal,442,252,190
1990,678,Sao Tome and Principe,Portugal,206,111,95
1990,72,Botswana,Portugal,137,85,52
1990,516,Namibia,Portugal,641,377,264
1990,710,South Africa,Portugal,19125,8491,10634
1990,132,Cabo Verde,Portugal,1132,566,566
1990,324,Guinea,Portugal,237,116,121
1990,624,Guinea-Bissau,Portugal,528,287,241
1990,818,Egypt,Portugal,44,20,24
1990,196,Cyprus,Portugal,16,5,11
1990,792,Turkey,Portugal,54,28,26
1990,356,India,Portugal,454,182,272
1990,344,"China, Hong Kong SAR",Portugal,73,35,38
1990,446,"China, Macao SAR",Portugal,3489,1847,1642
1990,392,Japan,Portugal,319,163,156
1990,608,Philippines,Portugal,25,16,9
1990,764,Thailand,Portugal,53,35,18
1990,626,Timor-Leste,Portugal,258,123,135
1990,533,Aruba,Portugal,177,90,87
1990,44,Bahamas,Portugal,1,0,1
1990,535,"Bonaire, Sint Eustatius and Saba",Portugal,1328,696,632
1990,214,Dominican Republic,Portugal,160,111,49
1990,312,Guadeloupe,Portugal,186,90,96
1990,630,Puerto Rico,Portugal,68,32,36
1990,188,Costa Rica,Portugal,57,35,22
1990,222,El Salvador,Portugal,20,15,5
1990,320,Guatemala,Portugal,14,7,7
1990,484,Mexico,Portugal,163,128,35
1990,591,Panama,Portugal,177,125,52
1990,32,Argentina,Portugal,13551,7221,6330
1990,68,Bolivia (Plurinational State of),Portugal,37,24,13
1990,76,Brazil,Portugal,274924,145746,129178
1990,152,Chile,Portugal,127,66,61
1990,170,Colombia,Portugal,133,70,63
1990,218,Ecuador,Portugal,122,76,46
1990,604,Peru,Portugal,79,52,27
1990,858,Uruguay,Portugal,1216,352,864
1990,862,Venezuela (Bolivarian Republic of),Portugal,71582,41868,29714
1990,36,Australia,Portugal,19115,10098,9017
1990,100,Bulgaria,Portugal,3,3,0
1990,203,Czechia,Portugal,10,6,4
1990,348,Hungary,Portugal,21,9,12
1990,616,Poland,Portugal,85,52,33
1990,498,Republic of Moldova,Portugal,401,241,160
1990,642,Romania,Portugal,48,21,27
1990,643,Russian Federation,Portugal,129,63,66
1990,703,Slovakia,Portugal,1,1,0
1990,830,Channel Islands,Portugal,3380,1590,1790
1990,208,Denmark,Portugal,441,228,213
1990,246,Finland,Portugal,92,59,33
1990,352,Iceland,Portugal,45,28,17
1990,372,Ireland,Portugal,122,60,62
1990,428,Latvia,Portugal,1,1,0
1990,440,Lithuania,Portugal,3,2,1
1990,578,Norway,Portugal,600,359,241
1990,752,Sweden,Portugal,1975,1091,884
1990,826,United Kingdom,Portugal,19323,8925,10398
1990,20,Andorra,Portugal,3957,2117,1840
1990,300,Greece,Portugal,731,342,389
1990,380,Italy,Portugal,6791,1347,5444
1990,470,Malta,Portugal,3,1,2
1990,688,Serbia,Portugal,4,3,1
1990,705,Slovenia,Portugal,3,2,1
1990,724,Spain,Portugal,35909,17052,18857
1990,40,Austria,Portugal,949,556,393
1990,56,Belgium,Portugal,12386,6562,5824
1990,250,France,Portugal,781382,405398,375984
1990,276,Germany,Portugal,92782,50574,42208
1990,438,Liechtenstein,Portugal,134,72,62
1990,442,Luxembourg,Portugal,30614,16464,14150
1990,528,Netherlands,Portugal,7814,4086,3728
1990,756,Switzerland,Portugal,89576,48698,40878
1990,60,Bermuda,Portugal,1530,187,1343
1990,124,Canada,Portugal,154655,75290,79365
1990,840,United States of America,Portugal,210122,99365,110757
1995,508,Mozambique,Portugal,2294,1565,729
1995,24,Angola,Portugal,6156,3833,2323
1995,178,Congo,Portugal,511,281,230
1995,678,Sao Tome and Principe,Portugal,212,113,99
1995,72,Botswana,Portugal,132,82,50
1995,516,Namibia,Portugal,613,363,250
1995,710,South Africa,Portugal,16592,8348,8244
1995,132,Cabo Verde,Portugal,1031,526,505
1995,324,Guinea,Portugal,273,149,124
1995,624,Guinea-Bissau,Portugal,678,375,303
1995,818,Egypt,Portugal,38,17,21
1995,196,Cyprus,Portugal,23,7,16
1995,792,Turkey,Portugal,131,65,66
1995,356,India,Portugal,323,136,187
1995,344,"China, Hong Kong SAR",Portugal,82,39,43
1995,446,"China, Macao SAR",Portugal,3827,1995,1832
1995,392,Japan,Portugal,345,166,179
1995,608,Philippines,Portugal,33,21,12
1995,764,Thailand,Portugal,88,57,31
1995,626,Timor-Leste,Portugal,281,133,148
1995,533,Aruba,Portugal,183,97,86
1995,44,Bahamas,Portugal,5,2,3
1995,535,"Bonaire, Sint Eustatius and Saba",Portugal,1147,583,564
1995,214,Dominican Republic,Portugal,178,122,56
1995,312,Guadeloupe,Portugal,248,117,131
1995,630,Puerto Rico,Portugal,71,34,37
1995,188,Costa Rica,Portugal,46,28,18
1995,222,El Salvador,Portugal,16,12,4
1995,320,Guatemala,Portugal,16,11,5
1995,484,Mexico,Portugal,276,174,102
1995,591,Panama,Portugal,152,108,44
1995,32,Argentina,Portugal,11298,5840,5458
1995,68,Bolivia (Plurinational State of),Portugal,38,23,15
1995,76,Brazil,Portugal,244319,128497,115822
1995,152,Chile,Portugal,187,86,101
1995,170,Colombia,Portugal,121,66,55
1995,218,Ecuador,Portugal,137,85,52
1995,604,Peru,Portugal,80,51,29
1995,858,Uruguay,Portugal,877,365,512
1995,862,Venezuela (Bolivarian Republic of),Portugal,62567,36459,26108
1995,36,Australia,Portugal,18951,9974,8977
1995,100,Bulgaria,Portugal,24,14,10
1995,203,Czechia,Portugal,15,9,6
1995,348,Hungary,Portugal,123,72,51
1995,616,Poland,Portugal,72,44,28
1995,498,Republic of Moldova,Portugal,271,160,111
1995,642,Romania,Portugal,79,40,39
1995,643,Russian Federation,Portugal,125,66,59
1995,703,Slovakia,Portugal,46,31,15
1995,830,Channel Islands,Portugal,3318,1561,1757
1995,208,Denmark,Portugal,561,295,266
1995,246,Finland,Portugal,106,70,36
1995,352,Iceland,Portugal,71,45,26
1995,372,Ireland,Portugal,432,206,226
1995,428,Latvia,Portugal,1,1,0
1995,440,Lithuania,Portugal,4,3,1
1995,578,Norway,Portugal,630,364,266
1995,752,Sweden,Portugal,2344,1286,1058
1995,826,United Kingdom,Portugal,27105,12849,14256
1995,20,Andorra,Portugal,5364,2833,2531
1995,191,Croatia,Portugal,13,4,9
1995,300,Greece,Portugal,506,213,293
1995,380,Italy,Portugal,6018,1443,4575
1995,470,Malta,Portugal,4,1,3
1995,688,Serbia,Portugal,29,18,11
1995,705,Slovenia,Portugal,6,4,2
1995,724,Spain,Portugal,42238,20510,21728
1995,40,Austria,Portugal,1071,635,436
1995,56,Belgium,Portugal,16854,8687,8167
1995,250,France,Portugal,806641,411971,394670
1995,276,Germany,Portugal,111027,60713,50314
1995,438,Liechtenstein,Portugal,390,196,194
1995,442,Luxembourg,Portugal,40221,21035,19186
1995,528,Netherlands,Portugal,8561,4402,4159
1995,756,Switzerland,Portugal,109787,62375,47412
1995,60,Bermuda,Portugal,1647,158,1489
1995,124,Canada,Portugal,152654,73971,78683
1995,840,United States of America,Portugal,209386,99914,109472
2000,508,Mozambique,Portugal,2669,1793,876
2000,24,Angola,Portugal,7014,4287,2727
2000,178,Congo,Portugal,716,384,332
2000,678,Sao Tome and Principe,Portugal,218,113,105
2000,72,Botswana,Portugal,141,87,54
2000,516,Namibia,Portugal,570,337,233
2000,710,South Africa,Portugal,19048,10370,8678
2000,132,Cabo Verde,Portugal,929,486,443
2000,324,Guinea,Portugal,295,158,137
2000,624,Guinea-Bissau,Portugal,827,462,365
2000,818,Egypt,Portugal,34,15,19
2000,196,Cyprus,Portugal,29,8,21
2000,792,Turkey,Portugal,209,101,108
2000,356,India,Portugal,191,89,102
2000,144,Sri Lanka,Portugal,2,1,1
2000,344,"China, Hong Kong SAR",Portugal,90,43,47
2000,446,"China, Macao SAR",Portugal,1594,958,636
2000,392,Japan,Portugal,370,171,199
2000,608,Philippines,Portugal,82,40,42
2000,764,Thailand,Portugal,143,90,53
2000,626,Timor-Leste,Portugal,308,145,163
2000,533,Aruba,Portugal,188,103,85
2000,44,Bahamas,Portugal,9,4,5
2000,535,"Bonaire, Sint Eustatius and Saba",Portugal,967,470,497
2000,214,Dominican Republic,Portugal,195,133,62
2000,312,Guadeloupe,Portugal,310,144,166
2000,630,Puerto Rico,Portugal,76,36,40
2000,188,Costa Rica,Portugal,59,34,25
2000,222,El Salvador,Portugal,11,8,3
2000,320,Guatemala,Portugal,17,14,3
2000,484,Mexico,Portugal,401,228,173
2000,591,Panama,Portugal,137,97,40
2000,32,Argentina,Portugal,9046,4460,4586
2000,68,Bolivia (Plurinational State of),Portugal,39,22,17
2000,76,Brazil,Portugal,213713,111247,102466
2000,152,Chile,Portugal,247,112,135
2000,170,Colombia,Portugal,109,62,47
2000,218,Ecuador,Portugal,152,95,57
2000,604,Peru,Portugal,94,60,34
2000,858,Uruguay,Portugal,633,329,304
2000,862,Venezuela (Bolivarian Republic of),Portugal,54176,31422,22754
2000,36,Australia,Portugal,17990,9375,8615
2000,100,Bulgaria,Portugal,44,25,19
2000,203,Czechia,Portugal,19,11,8
2000,348,Hungary,Portugal,224,134,90
2000,616,Poland,Portugal,62,37,25
2000,498,Republic of Moldova,Portugal,183,106,77
2000,642,Romania,Portugal,113,60,53
2000,643,Russian Federation,Portugal,117,67,50
2000,703,Slovakia,Portugal,104,68,36
2000,830,Channel Islands,Portugal,3525,1657,1868
2000,208,Denmark,Portugal,681,362,319
2000,246,Finland,Portugal,119,81,38
2000,352,Iceland,Portugal,97,62,35
2000,372,Ireland,Portugal,979,483,496
2000,428,Latvia,Portugal,2,2,0
2000,440,Lithuania,Portugal,3,3,0
2000,578,Norway,Portugal,708,391,317
2000,752,Sweden,Portugal,2514,1372,1142
2000,826,United Kingdom,Portugal,35344,16953,18391
2000,20,Andorra,Portugal,6771,3549,3222
2000,191,Croatia,Portugal,25,9,16
2000,300,Greece,Portugal,289,81,208
2000,380,Italy,Portugal,5245,1539,3706
2000,470,Malta,Portugal,10,2,8
2000,688,Serbia,Portugal,40,24,16
2000,705,Slovenia,Portugal,13,4,9
2000,724,Spain,Portugal,65690,32952,32738
2000,40,Austria,Portugal,1192,713,479
2000,56,Belgium,Portugal,20834,10592,10242
2000,250,France,Portugal,831900,418544,413356
2000,276,Germany,Portugal,129271,70851,58420
2000,438,Liechtenstein,Portugal,640,315,325
2000,442,Luxembourg,Portugal,50254,25859,24395
2000,528,Netherlands,Portugal,9606,4859,4747
2000,756,Switzerland,Portugal,130398,76418,53980
2000,60,Bermuda,Portugal,1763,129,1634
2000,124,Canada,Portugal,154283,74428,79855
2000,840,United States of America,Portugal,208276,100422,107854
2005,508,Mozambique,Portugal,3610,2315,1295
2005,24,Angola,Portugal,6663,3332,3331
2005,178,Congo,Portugal,455,294,161
2005,678,Sao Tome and Principe,Portugal,171,88,83
2005,72,Botswana,Portugal,270,165,105
2005,516,Namibia,Portugal,450,265,185
2005,710,South Africa,Portugal,25060,13142,11918
2005,132,Cabo Verde,Portugal,1023,510,513
2005,324,Guinea,Portugal,206,206,0
2005,624,Guinea-Bissau,Portugal,802,421,381
2005,818,Egypt,Portugal,40,19,21
2005,196,Cyprus,Portugal,42,11,31
2005,792,Turkey,Portugal,215,102,113
2005,356,India,Portugal,177,82,95
2005,144,Sri Lanka,Portugal,6,2,4
2005,344,"China, Hong Kong SAR",Portugal,98,44,54
2005,446,"China, Macao SAR",Portugal,1848,1128,720
2005,392,Japan,Portugal,439,200,239
2005,608,Philippines,Portugal,66,33,33
2005,764,Thailand,Portugal,306,176,130
2005,626,Timor-Leste,Portugal,327,157,170
2005,533,Aruba,Portugal,174,92,82
2005,44,Bahamas,Portugal,12,8,4
2005,535,"Bonaire, Sint Eustatius and Saba",Portugal,1030,501,529
2005,214,Dominican Republic,Portugal,149,98,51
2005,312,Guadeloupe,Portugal,380,174,206
2005,630,Puerto Rico,Portugal,59,28,31
2005,188,Costa Rica,Portugal,39,23,16
2005,222,El Salvador,Portugal,12,9,3
2005,320,Guatemala,Portugal,21,18,3
2005,484,Mexico,Portugal,397,236,161
2005,591,Panama,Portugal,172,117,55
2005,32,Argentina,Portugal,6673,3344,3329
2005,68,Bolivia (Plurinational State of),Portugal,95,58,37
2005,76,Brazil,Portugal,176510,90969,85541
2005,152,Chile,Portugal,370,171,199
2005,170,Colombia,Portugal,99,58,41
2005,218,Ecuador,Portugal,179,114,65
2005,604,Peru,Portugal,111,71,40
2005,858,Uruguay,Portugal,586,305,281
2005,862,Venezuela (Bolivarian Republic of),Portugal,53646,31265,22381
2005,36,Australia,Portugal,18160,9421,8739
2005,100,Bulgaria,Portugal,71,40,31
2005,203,Czechia,Portugal,78,53,25
2005,348,Hungary,Portugal,277,168,109
2005,616,Poland,Portugal,100,65,35
2005,498,Republic of Moldova,Portugal,127,72,55
2005,642,Romania,Portugal,346,163,183
2005,643,Russian Federation,Portugal,174,98,76
2005,703,Slovakia,Portugal,117,77,40
2005,830,Channel Islands,Portugal,8293,3942,4351
2005,208,Denmark,Portugal,943,518,425
2005,246,Finland,Portugal,246,171,75
2005,352,Iceland,Portugal,358,236,122
2005,372,Ireland,Portugal,1860,1069,791
2005,428,Latvia,Portugal,27,19,8
2005,440,Lithuania,Portugal,33,25,8
2005,578,Norway,Portugal,748,412,336
2005,752,Sweden,Portugal,2589,1403,1186
2005,826,United Kingdom,Portugal,59305,29053,30252
2005,20,Andorra,Portugal,10722,5666,5056
2005,191,Croatia,Portugal,38,18,20
2005,300,Greece,Portugal,311,99,212
2005,380,Italy,Portugal,5830,1889,3941
2005,470,Malta,Portugal,19,5,14
2005,688,Serbia,Portugal,40,24,16
2005,705,Slovenia,Portugal,19,9,10
2005,724,Spain,Portugal,75768,40776,34992
2005,40,Austria,Portugal,1333,785,548
2005,56,Belgium,Portugal,22251,11307,10944
2005,250,France,Portugal,586242,298974,287268
2005,276,Germany,Portugal,102455,55960,46495
2005,438,Liechtenstein,Portugal,513,258,255
2005,442,Luxembourg,Portugal,55878,28709,27169
2005,528,Netherlands,Portugal,12052,6198,5854
2005,756,Switzerland,Portugal,151328,85593,65735
2005,60,Bermuda,Portugal,1682,478,1204
2005,124,Canada,Portugal,141057,68492,72565
2005,840,United States of America,Portugal,200363,97180,103183
2010,508,Mozambique,Portugal,4181,2681,1500
2010,24,Angola,Portugal,6329,3165,3164
2010,178,Congo,Portugal,1084,645,439
2010,678,Sao Tome and Principe,Portugal,134,69,65
2010,72,Botswana,Portugal,400,243,157
2010,516,Namibia,Portugal,433,256,177
2010,710,South Africa,Portugal,39257,20517,18740
2010,132,Cabo Verde,Portugal,1116,534,582
2010,324,Guinea,Portugal,144,144,0
2010,624,Guinea-Bissau,Portugal,776,379,397
2010,818,Egypt,Portugal,43,19,24
2010,196,Cyprus,Portugal,68,18,50
2010,792,Turkey,Portugal,221,102,119
2010,356,India,Portugal,162,75,87
2010,144,Sri Lanka,Portugal,13,5,8
2010,344,"China, Hong Kong SAR",Portugal,107,46,61
2010,446,"China, Macao SAR",Portugal,1790,1082,708
2010,392,Japan,Portugal,465,209,256
2010,608,Philippines,Portugal,59,29,30
2010,764,Thailand,Portugal,491,277,214
2010,626,Timor-Leste,Portugal,334,162,172
2010,533,Aruba,Portugal,156,78,78
2010,44,Bahamas,Portugal,15,12,3
2010,535,"Bonaire, Sint Eustatius and Saba",Portugal,42,28,14
2010,531,Curaçao,Portugal,846,412,434
2010,214,Dominican Republic,Portugal,101,61,40
2010,312,Guadeloupe,Portugal,450,205,245
2010,630,Puerto Rico,Portugal,36,17,19
2010,188,Costa Rica,Portugal,77,45,32
2010,222,El Salvador,Portugal,12,9,3
2010,320,Guatemala,Portugal,25,23,2
2010,484,Mexico,Portugal,440,271,169
2010,591,Panama,Portugal,216,144,72
2010,32,Argentina,Portugal,4299,2227,2072
2010,68,Bolivia (Plurinational State of),Portugal,150,94,56
2010,76,Brazil,Portugal,136775,69287,67488
2010,152,Chile,Portugal,494,231,263
2010,170,Colombia,Portugal,107,65,42
2010,218,Ecuador,Portugal,252,158,94
2010,604,Peru,Portugal,124,80,44
2010,858,Uruguay,Portugal,543,281,262
2010,862,Venezuela (Bolivarian Republic of),Portugal,53659,31444,22215
2010,36,Australia,Portugal,18470,9500,8970
2010,100,Bulgaria,Portugal,95,53,42
2010,203,Czechia,Portugal,129,90,39
2010,348,Hungary,Portugal,330,202,128
2010,616,Poland,Portugal,142,95,47
2010,498,Republic of Moldova,Portugal,377,217,160
2010,642,Romania,Portugal,637,288,349
2010,643,Russian Federation,Portugal,228,126,102
2010,703,Slovakia,Portugal,131,87,44
2010,830,Channel Islands,Portugal,13060,6226,6834
2010,208,Denmark,Portugal,1183,663,520
2010,233,Estonia,Portugal,43,29,14
2010,246,Finland,Portugal,432,297,135
2010,352,Iceland,Portugal,618,410,208
2010,372,Ireland,Portugal,2434,1377,1057
2010,428,Latvia,Portugal,52,36,16
2010,440,Lithuania,Portugal,59,43,16
2010,578,Norway,Portugal,1107,620,487
2010,752,Sweden,Portugal,2936,1595,1341
2010,826,United Kingdom,Portugal,129340,58366,70974
2010,20,Andorra,Portugal,13686,7227,6459
2010,191,Croatia,Portugal,50,27,23
2010,300,Greece,Portugal,345,121,224
2010,380,Italy,Portugal,7080,2481,4599
2010,470,Malta,Portugal,47,26,21
2010,688,Serbia,Portugal,40,24,16
2010,705,Slovenia,Portugal,36,16,20
2010,724,Spain,Portugal,134592,81148,53444
2010,40,Austria,Portugal,1473,856,617
2010,56,Belgium,Portugal,27532,14036,13496
2010,250,France,Portugal,669693,338063,331630
2010,276,Germany,Portugal,79661,42788,36873
2010,438,Liechtenstein,Portugal,387,199,188
2010,442,Luxembourg,Portugal,62068,31903,30165
2010,528,Netherlands,Portugal,14679,7720,6959
2010,756,Switzerland,Portugal,172274,93048,79226
2010,60,Bermuda,Portugal,1600,826,774
2010,124,Canada,Portugal,138520,67954,70566
2010,840,United States of America,Portugal,198400,94823,103577
2015,508,Mozambique,Portugal,4390,2816,1574
2015,24,Angola,Portugal,6012,3006,3006
2015,178,Congo,Portugal,1441,833,608
2015,678,Sao Tome and Principe,Portugal,118,61,57
2015,72,Botswana,Portugal,436,265,171
2015,516,Namibia,Portugal,423,251,172
2015,710,South Africa,Portugal,42487,21173,21314
2015,132,Cabo Verde,Portugal,1159,553,606
2015,324,Guinea,Portugal,14,14,0
2015,624,Guinea-Bissau,Portugal,823,398,425
2015,818,Egypt,Portugal,31,16,15
2015,196,Cyprus,Portugal,65,18,47
2015,792,Turkey,Portugal,224,101,123
2015,356,India,Portugal,156,72,84
2015,144,Sri Lanka,Portugal,33,16,17
2015,344,"China, Hong Kong SAR",Portugal,109,44,65
2015,446,"China, Macao SAR",Portugal,1960,1045,915
2015,392,Japan,Portugal,467,209,258
2015,608,Philippines,Portugal,60,29,31
2015,764,Thailand,Portugal,530,298,232
2015,626,Timor-Leste,Portugal,276,156,120
2015,533,Aruba,Portugal,164,82,82
2015,44,Bahamas,Portugal,16,13,3
2015,535,"Bonaire, Sint Eustatius and Saba",Portugal,47,32,15
2015,531,Curaçao,Portugal,919,449,470
2015,214,Dominican Republic,Portugal,106,64,42
2015,312,Guadeloupe,Portugal,467,210,257
2015,630,Puerto Rico,Portugal,35,16,19
2015,188,Costa Rica,Portugal,78,46,32
2015,222,El Salvador,Portugal,13,10,3
2015,320,Guatemala,Portugal,29,27,2
2015,484,Mexico,Portugal,578,406,172
2015,591,Panama,Portugal,254,169,85
2015,32,Argentina,Portugal,4961,2569,2392
2015,68,Bolivia (Plurinational State of),Portugal,175,110,65
2015,76,Brazil,Portugal,164705,82935,81770
2015,152,Chile,Portugal,748,342,406
2015,170,Colombia,Portugal,119,73,46
2015,218,Ecuador,Portugal,366,229,137
2015,604,Peru,Portugal,131,85,46
2015,858,Uruguay,Portugal,560,290,270
2015,862,Venezuela (Bolivarian Republic of),Portugal,54591,31672,22919
2015,36,Australia,Portugal,19140,9921,9219
2015,100,Bulgaria,Portugal,387,194,193
2015,203,Czechia,Portugal,310,220,90
2015,348,Hungary,Portugal,465,281,184
2015,616,Poland,Portugal,136,92,44
2015,498,Republic of Moldova,Portugal,683,393,290
2015,642,Romania,Portugal,364,214,150
2015,643,Russian Federation,Portugal,232,127,105
2015,703,Slovakia,Portugal,172,119,53
2015,830,Channel Islands,Portugal,13856,6623,7233
2015,208,Denmark,Portugal,1623,878,745
2015,233,Estonia,Portugal,138,101,37
2015,246,Finland,Portugal,672,444,228
2015,352,Iceland,Portugal,576,362,214
2015,372,Ireland,Portugal,2486,1393,1093
2015,428,Latvia,Portugal,48,31,17
2015,440,Lithuania,Portugal,65,48,17
2015,578,Norway,Portugal,2885,1672,1213
2015,752,Sweden,Portugal,3583,1929,1654
2015,826,United Kingdom,Portugal,129340,58366,70974
2015,20,Andorra,Portugal,10697,5716,4981
2015,191,Croatia,Portugal,50,27,23
2015,300,Greece,Portugal,323,104,219
2015,380,Italy,Portugal,6224,2103,4121
2015,470,Malta,Portugal,79,47,32
2015,688,Serbia,Portugal,39,24,15
2015,705,Slovenia,Portugal,52,28,24
2015,724,Spain,Portugal,112032,64253,47779
2015,40,Austria,Portugal,1723,1005,718
2015,56,Belgium,Portugal,34303,17499,16804
2015,250,France,Portugal,649528,332208,317320
2015,276,Germany,Portugal,83003,44493,38510
2015,438,Liechtenstein,Portugal,424,223,201
2015,442,Luxembourg,Portugal,94732,49385,45347
2015,528,Netherlands,Portugal,16750,8738,8012
2015,756,Switzerland,Portugal,223088,120778,102310
2015,60,Bermuda,Portugal,1622,839,783
2015,124,Canada,Portugal,138589,67695,70894
2015,840,United States of America,Portugal,176803,83799,93004
2019,508,Mozambique,Portugal,4565,2929,1636
2019,24,Angola,Portugal,5711,2856,2855
2019,178,Congo,Portugal,1485,858,627
2019,678,Sao Tome and Principe,Portugal,107,56,51
2019,72,Botswana,Portugal,466,283,183
2019,516,Namibia,Portugal,447,265,182
2019,710,South Africa,Portugal,47622,23755,23867
2019,132,Cabo Verde,Portugal,1216,581,635
2019,324,Guinea,Portugal,13,13,0
2019,624,Guinea-Bissau,Portugal,903,437,466
2019,818,Egypt,Portugal,44,21,23
2019,196,Cyprus,Portugal,64,18,46
2019,792,Turkey,Portugal,302,138,164
2019,356,India,Portugal,153,71,82
2019,144,Sri Lanka,Portugal,33,16,17
2019,344,"China, Hong Kong SAR",Portugal,141,55,86
2019,446,"China, Macao SAR",Portugal,2082,1110,972
2019,392,Japan,Portugal,522,234,288
2019,608,Philippines,Portugal,61,30,31
2019,764,Thailand,Portugal,552,311,241
2019,626,Timor-Leste,Portugal,272,154,118
2019,533,Aruba,Portugal,165,83,82
2019,44,Bahamas,Portugal,16,13,3
2019,535,"Bonaire, Sint Eustatius and Saba",Portugal,55,38,17
2019,531,Curaçao,Portugal,998,488,510
2019,214,Dominican Republic,Portugal,109,66,43
2019,312,Guadeloupe,Portugal,474,214,260
2019,630,Puerto Rico,Portugal,33,16,17
2019,188,Costa Rica,Portugal,79,47,32
2019,222,El Salvador,Portugal,13,10,3
2019,320,Guatemala,Portugal,29,27,2
2019,484,Mexico,Portugal,595,418,177
2019,591,Panama,Portugal,270,181,89
2019,32,Argentina,Portugal,5047,2610,2437
2019,68,Bolivia (Plurinational State of),Portugal,191,121,70
2019,76,Brazil,Portugal,185489,93398,92091
2019,152,Chile,Portugal,999,427,572
2019,170,Colombia,Portugal,121,74,47
2019,218,Ecuador,Portugal,360,226,134
2019,604,Peru,Portugal,155,103,52
2019,858,Uruguay,Portugal,579,301,278
2019,862,Venezuela (Bolivarian Republic of),Portugal,53473,30923,22550
2019,36,Australia,Portugal,20186,10415,9771
2019,100,Bulgaria,Portugal,540,274,266
2019,203,Czechia,Portugal,382,273,109
2019,348,Hungary,Portugal,527,309,218
2019,616,Poland,Portugal,144,100,44
2019,498,Republic of Moldova,Portugal,672,387,285
2019,642,Romania,Portugal,1510,909,601
2019,643,Russian Federation,Portugal,231,127,104
2019,703,Slovakia,Portugal,235,165,70
2019,830,Channel Islands,Portugal,14112,6746,7366
2019,208,Denmark,Portugal,2860,1598,1262
2019,233,Estonia,Portugal,150,91,59
2019,246,Finland,Portugal,764,499,265
2019,352,Iceland,Portugal,834,533,301
2019,372,Ireland,Portugal,2729,1533,1196
2019,428,Latvia,Portugal,33,24,9
2019,440,Lithuania,Portugal,82,65,17
2019,578,Norway,Portugal,3602,2100,1502
2019,752,Sweden,Portugal,4416,2366,2050
2019,826,United Kingdom,Portugal,146879,66485,80394
2019,20,Andorra,Portugal,11415,6139,5276
2019,191,Croatia,Portugal,46,25,21
2019,300,Greece,Portugal,315,110,205
2019,380,Italy,Portugal,6700,2397,4303
2019,470,Malta,Portugal,127,76,51
2019,688,Serbia,Portugal,39,24,15
2019,705,Slovenia,Portugal,59,37,22
2019,724,Spain,Portugal,109184,61234,47950
2019,40,Austria,Portugal,2033,1200,833
2019,56,Belgium,Portugal,38096,19649,18447
2019,250,France,Portugal,687530,350878,336652
2019,276,Germany,Portugal,127409,71043,56366
2019,438,Liechtenstein,Portugal,441,235,206
2019,442,Luxembourg,Portugal,83666,44073,39593
2019,528,Netherlands,Portugal,19005,10023,8982
2019,756,Switzerland,Portugal,226361,122801,103560
2019,60,Bermuda,Portugal,1639,848,791
2019,124,Canada,Portugal,148513,72542,75971
2019,840,United States of America,Portugal,176315,83393,92922
1990,196,Cyprus,Puerto Rico,1,1,0
1990,608,Philippines,Puerto Rico,8,6,2
1990,28,Antigua and Barbuda,Puerto Rico,30,14,16
1990,92,British Virgin Islands,Puerto Rico,32,16,16
1990,535,"Bonaire, Sint Eustatius and Saba",Puerto Rico,23,10,13
1990,136,Cayman Islands,Puerto Rico,14,7,7
1990,192,Cuba,Puerto Rico,272,127,145
1990,212,Dominica,Puerto Rico,6,5,1
1990,214,Dominican Republic,Puerto Rico,8767,4118,4649
1990,332,Haiti,Puerto Rico,1546,703,843
1990,662,Saint Lucia,Puerto Rico,7,5,2
1990,850,United States Virgin Islands,Puerto Rico,3974,1971,2003
1990,188,Costa Rica,Puerto Rico,268,151,117
1990,222,El Salvador,Puerto Rico,109,55,54
1990,320,Guatemala,Puerto Rico,69,25,44
1990,340,Honduras,Puerto Rico,98,62,36
1990,484,Mexico,Puerto Rico,1287,629,658
1990,558,Nicaragua,Puerto Rico,54,24,30
1990,591,Panama,Puerto Rico,253,157,96
1990,32,Argentina,Puerto Rico,210,106,104
1990,68,Bolivia (Plurinational State of),Puerto Rico,33,20,13
1990,152,Chile,Puerto Rico,121,52,69
1990,170,Colombia,Puerto Rico,432,219,213
1990,218,Ecuador,Puerto Rico,167,86,81
1990,604,Peru,Puerto Rico,84,39,45
1990,862,Venezuela (Bolivarian Republic of),Puerto Rico,912,418,494
1990,36,Australia,Puerto Rico,46,24,22
1990,316,Guam,Puerto Rico,194,111,83
1990,580,Northern Mariana Islands,Puerto Rico,923,444,479
1990,208,Denmark,Puerto Rico,5,2,3
1990,300,Greece,Puerto Rico,18,9,9
1990,40,Austria,Puerto Rico,3,1,2
1990,250,France,Puerto Rico,290,149,141
1990,124,Canada,Puerto Rico,182,89,93
1990,840,United States of America,Puerto Rico,1180383,565005,615378
1995,196,Cyprus,Puerto Rico,2,2,0
1995,608,Philippines,Puerto Rico,10,8,2
1995,28,Antigua and Barbuda,Puerto Rico,37,18,19
1995,92,British Virgin Islands,Puerto Rico,38,19,19
1995,535,"Bonaire, Sint Eustatius and Saba",Puerto Rico,48,20,28
1995,136,Cayman Islands,Puerto Rico,28,13,15
1995,192,Cuba,Puerto Rico,206,91,115
1995,212,Dominica,Puerto Rico,8,7,1
1995,214,Dominican Republic,Puerto Rico,9738,4449,5289
1995,332,Haiti,Puerto Rico,1468,668,800
1995,662,Saint Lucia,Puerto Rico,9,7,2
1995,850,United States Virgin Islands,Puerto Rico,4141,2054,2087
1995,188,Costa Rica,Puerto Rico,216,128,88
1995,222,El Salvador,Puerto Rico,84,43,41
1995,320,Guatemala,Puerto Rico,67,29,38
1995,340,Honduras,Puerto Rico,97,60,37
1995,484,Mexico,Puerto Rico,1888,873,1015
1995,558,Nicaragua,Puerto Rico,43,19,24
1995,591,Panama,Puerto Rico,285,179,106
1995,32,Argentina,Puerto Rico,184,86,98
1995,68,Bolivia (Plurinational State of),Puerto Rico,37,22,15
1995,152,Chile,Puerto Rico,151,70,81
1995,170,Colombia,Puerto Rico,444,229,215
1995,218,Ecuador,Puerto Rico,188,97,91
1995,604,Peru,Puerto Rico,85,39,46
1995,862,Venezuela (Bolivarian Republic of),Puerto Rico,701,327,374
1995,36,Australia,Puerto Rico,85,33,52
1995,316,Guam,Puerto Rico,194,102,92
1995,580,Northern Mariana Islands,Puerto Rico,1133,568,565
1995,208,Denmark,Puerto Rico,3,1,2
1995,352,Iceland,Puerto Rico,1,1,0
1995,300,Greece,Puerto Rico,19,10,9
1995,40,Austria,Puerto Rico,4,2,2
1995,250,France,Puerto Rico,300,152,148
1995,124,Canada,Puerto Rico,217,105,112
1995,840,United States of America,Puerto Rico,1384103,627381,756722
2000,196,Cyprus,Puerto Rico,2,2,0
2000,608,Philippines,Puerto Rico,54,25,29
2000,28,Antigua and Barbuda,Puerto Rico,44,22,22
2000,92,British Virgin Islands,Puerto Rico,44,22,22
2000,535,"Bonaire, Sint Eustatius and Saba",Puerto Rico,73,30,43
2000,136,Cayman Islands,Puerto Rico,49,22,27
2000,192,Cuba,Puerto Rico,140,56,84
2000,212,Dominica,Puerto Rico,10,9,1
2000,214,Dominican Republic,Puerto Rico,10708,4780,5928
2000,332,Haiti,Puerto Rico,1394,635,759
2000,662,Saint Lucia,Puerto Rico,13,10,3
2000,850,United States Virgin Islands,Puerto Rico,4316,2140,2176
2000,188,Costa Rica,Puerto Rico,272,166,106
2000,222,El Salvador,Puerto Rico,58,31,27
2000,320,Guatemala,Puerto Rico,65,33,32
2000,340,Honduras,Puerto Rico,96,58,38
2000,484,Mexico,Puerto Rico,2572,1161,1411
2000,558,Nicaragua,Puerto Rico,46,23,23
2000,591,Panama,Puerto Rico,335,210,125
2000,32,Argentina,Puerto Rico,159,68,91
2000,68,Bolivia (Plurinational State of),Puerto Rico,41,24,17
2000,152,Chile,Puerto Rico,181,83,98
2000,170,Colombia,Puerto Rico,455,238,217
2000,218,Ecuador,Puerto Rico,208,107,101
2000,604,Peru,Puerto Rico,100,46,54
2000,862,Venezuela (Bolivarian Republic of),Puerto Rico,534,253,281
2000,36,Australia,Puerto Rico,140,54,86
2000,316,Guam,Puerto Rico,193,92,101
2000,580,Northern Mariana Islands,Puerto Rico,1413,693,720
2000,352,Iceland,Puerto Rico,1,1,0
2000,578,Norway,Puerto Rico,13,7,6
2000,300,Greece,Puerto Rico,20,10,10
2000,40,Austria,Puerto Rico,4,2,2
2000,250,France,Puerto Rico,309,154,155
2000,124,Canada,Puerto Rico,258,124,134
2000,840,United States of America,Puerto Rico,1576432,677124,899308
2005,196,Cyprus,Puerto Rico,3,3,0
2005,608,Philippines,Puerto Rico,43,20,23
2005,28,Antigua and Barbuda,Puerto Rico,47,23,24
2005,92,British Virgin Islands,Puerto Rico,51,26,25
2005,535,"Bonaire, Sint Eustatius and Saba",Puerto Rico,77,32,45
2005,136,Cayman Islands,Puerto Rico,44,20,24
2005,192,Cuba,Puerto Rico,93,37,56
2005,212,Dominica,Puerto Rico,12,11,1
2005,214,Dominican Republic,Puerto Rico,8265,3958,4307
2005,332,Haiti,Puerto Rico,1324,603,721
2005,662,Saint Lucia,Puerto Rico,11,9,2
2005,534,Sint Maarten (Dutch part),Puerto Rico,12,6,6
2005,850,United States Virgin Islands,Puerto Rico,4190,2089,2101
2005,188,Costa Rica,Puerto Rico,178,108,70
2005,222,El Salvador,Puerto Rico,59,32,27
2005,320,Guatemala,Puerto Rico,77,42,35
2005,340,Honduras,Puerto Rico,94,57,37
2005,484,Mexico,Puerto Rico,1846,883,963
2005,558,Nicaragua,Puerto Rico,51,27,24
2005,591,Panama,Puerto Rico,463,294,169
2005,32,Argentina,Puerto Rico,117,51,66
2005,68,Bolivia (Plurinational State of),Puerto Rico,37,20,17
2005,152,Chile,Puerto Rico,271,127,144
2005,170,Colombia,Puerto Rico,447,237,210
2005,218,Ecuador,Puerto Rico,245,128,117
2005,604,Peru,Puerto Rico,118,54,64
2005,862,Venezuela (Bolivarian Republic of),Puerto Rico,480,225,255
2005,36,Australia,Puerto Rico,160,71,89
2005,316,Guam,Puerto Rico,2054,1056,998
2005,580,Northern Mariana Islands,Puerto Rico,1419,642,777
2005,352,Iceland,Puerto Rico,1,1,0
2005,578,Norway,Puerto Rico,16,7,9
2005,300,Greece,Puerto Rico,10,5,5
2005,40,Austria,Puerto Rico,5,2,3
2005,250,France,Puerto Rico,51,26,25
2005,124,Canada,Puerto Rico,328,147,181
2005,840,United States of America,Puerto Rico,1618157,700147,918010
2010,196,Cyprus,Puerto Rico,4,4,0
2010,608,Philippines,Puerto Rico,51,23,28
2010,28,Antigua and Barbuda,Puerto Rico,50,25,25
2010,92,British Virgin Islands,Puerto Rico,469,239,230
2010,535,"Bonaire, Sint Eustatius and Saba",Puerto Rico,9,6,3
2010,136,Cayman Islands,Puerto Rico,45,20,25
2010,192,Cuba,Puerto Rico,51,20,31
2010,531,Curaçao,Puerto Rico,14,3,11
2010,212,Dominica,Puerto Rico,14,13,1
2010,214,Dominican Republic,Puerto Rico,5763,3107,2656
2010,332,Haiti,Puerto Rico,1390,633,757
2010,662,Saint Lucia,Puerto Rico,9,7,2
2010,534,Sint Maarten (Dutch part),Puerto Rico,25,12,13
2010,850,United States Virgin Islands,Puerto Rico,4065,2037,2028
2010,188,Costa Rica,Puerto Rico,351,213,138
2010,222,El Salvador,Puerto Rico,59,33,26
2010,320,Guatemala,Puerto Rico,88,51,37
2010,340,Honduras,Puerto Rico,92,57,35
2010,484,Mexico,Puerto Rico,1335,709,626
2010,558,Nicaragua,Puerto Rico,54,29,25
2010,591,Panama,Puerto Rico,614,395,219
2010,32,Argentina,Puerto Rico,75,34,41
2010,68,Bolivia (Plurinational State of),Puerto Rico,33,17,16
2010,152,Chile,Puerto Rico,362,171,191
2010,170,Colombia,Puerto Rico,516,280,236
2010,218,Ecuador,Puerto Rico,344,176,168
2010,604,Peru,Puerto Rico,131,59,72
2010,862,Venezuela (Bolivarian Republic of),Puerto Rico,437,203,234
2010,36,Australia,Puerto Rico,150,71,79
2010,316,Guam,Puerto Rico,3915,2021,1894
2010,580,Northern Mariana Islands,Puerto Rico,1018,416,602
2010,578,Norway,Puerto Rico,23,11,12
2010,40,Austria,Puerto Rico,5,2,3
2010,250,France,Puerto Rico,48,23,25
2010,124,Canada,Puerto Rico,380,164,216
2010,840,United States of America,Puerto Rico,1710665,726821,983844
2015,196,Cyprus,Puerto Rico,3,3,0
2015,608,Philippines,Puerto Rico,51,23,28
2015,28,Antigua and Barbuda,Puerto Rico,53,26,27
2015,92,British Virgin Islands,Puerto Rico,525,268,257
2015,535,"Bonaire, Sint Eustatius and Saba",Puerto Rico,10,7,3
2015,136,Cayman Islands,Puerto Rico,48,22,26
2015,192,Cuba,Puerto Rico,40,15,25
2015,531,Curaçao,Puerto Rico,15,4,11
2015,212,Dominica,Puerto Rico,16,15,1
2015,214,Dominican Republic,Puerto Rico,4578,2552,2026
2015,332,Haiti,Puerto Rico,1459,665,794
2015,662,Saint Lucia,Puerto Rico,8,7,1
2015,534,Sint Maarten (Dutch part),Puerto Rico,26,13,13
2015,850,United States Virgin Islands,Puerto Rico,4067,2037,2030
2015,188,Costa Rica,Puerto Rico,356,216,140
2015,222,El Salvador,Puerto Rico,62,35,27
2015,320,Guatemala,Puerto Rico,101,59,42
2015,340,Honduras,Puerto Rico,129,80,49
2015,484,Mexico,Puerto Rico,1136,660,476
2015,558,Nicaragua,Puerto Rico,58,32,26
2015,591,Panama,Puerto Rico,721,463,258
2015,32,Argentina,Puerto Rico,75,34,41
2015,68,Bolivia (Plurinational State of),Puerto Rico,38,19,19
2015,152,Chile,Puerto Rico,548,253,295
2015,170,Colombia,Puerto Rico,577,316,261
2015,218,Ecuador,Puerto Rico,500,254,246
2015,604,Peru,Puerto Rico,139,65,74
2015,862,Venezuela (Bolivarian Republic of),Puerto Rico,419,191,228
2015,36,Australia,Puerto Rico,170,96,74
2015,316,Guam,Puerto Rico,3950,2038,1912
2015,580,Northern Mariana Islands,Puerto Rico,911,369,542
2015,40,Austria,Puerto Rico,6,3,3
2015,250,France,Puerto Rico,53,25,28
2015,124,Canada,Puerto Rico,501,193,308
2015,840,United States of America,Puerto Rico,1695637,831150,864487
2019,196,Cyprus,Puerto Rico,2,2,0
2019,608,Philippines,Puerto Rico,52,24,28
2019,28,Antigua and Barbuda,Puerto Rico,55,27,28
2019,92,British Virgin Islands,Puerto Rico,570,291,279
2019,535,"Bonaire, Sint Eustatius and Saba",Puerto Rico,11,8,3
2019,136,Cayman Islands,Puerto Rico,53,25,28
2019,192,Cuba,Puerto Rico,36,13,23
2019,531,Curaçao,Puerto Rico,16,5,11
2019,212,Dominica,Puerto Rico,16,15,1
2019,214,Dominican Republic,Puerto Rico,4731,2638,2093
2019,332,Haiti,Puerto Rico,1517,692,825
2019,662,Saint Lucia,Puerto Rico,7,7,0
2019,534,Sint Maarten (Dutch part),Puerto Rico,26,13,13
2019,850,United States Virgin Islands,Puerto Rico,4068,2038,2030
2019,188,Costa Rica,Puerto Rico,361,220,141
2019,222,El Salvador,Puerto Rico,62,35,27
2019,320,Guatemala,Puerto Rico,103,60,43
2019,340,Honduras,Puerto Rico,131,82,49
2019,484,Mexico,Puerto Rico,1171,681,490
2019,558,Nicaragua,Puerto Rico,60,33,27
2019,591,Panama,Puerto Rico,766,493,273
2019,32,Argentina,Puerto Rico,76,35,41
2019,68,Bolivia (Plurinational State of),Puerto Rico,41,21,20
2019,152,Chile,Puerto Rico,732,316,416
2019,170,Colombia,Puerto Rico,590,324,266
2019,218,Ecuador,Puerto Rico,492,250,242
2019,604,Peru,Puerto Rico,165,81,84
2019,862,Venezuela (Bolivarian Republic of),Puerto Rico,410,186,224
2019,36,Australia,Puerto Rico,201,107,94
2019,316,Guam,Puerto Rico,4145,2139,2006
2019,580,Northern Mariana Islands,Puerto Rico,918,372,546
2019,40,Austria,Puerto Rico,7,4,3
2019,250,France,Puerto Rico,56,27,29
2019,124,Canada,Puerto Rico,536,206,330
2019,840,United States of America,Puerto Rico,1830275,895379,934896
1990,818,Egypt,Qatar,287,159,128
1990,434,Libya,Qatar,819,456,363
1990,48,Bahrain,Qatar,8,1,7
1990,196,Cyprus,Qatar,3,2,1
1990,400,Jordan,Qatar,102,66,36
1990,414,Kuwait,Qatar,49,5,44
1990,512,Oman,Qatar,27,11,16
1990,275,State of Palestine,Qatar,9870,4803,5067
1990,792,Turkey,Qatar,7,5,2
1990,784,United Arab Emirates,Qatar,61,10,51
1990,144,Sri Lanka,Qatar,3,2,1
1990,608,Philippines,Qatar,27,15,12
1990,188,Costa Rica,Qatar,2,1,1
1990,68,Bolivia (Plurinational State of),Qatar,6,5,1
1990,152,Chile,Qatar,29,10,19
1990,36,Australia,Qatar,97,55,42
1990,100,Bulgaria,Qatar,2,2,0
1990,203,Czechia,Qatar,7,3,4
1990,348,Hungary,Qatar,30,18,12
1990,616,Poland,Qatar,9,6,3
1990,643,Russian Federation,Qatar,115,56,59
1990,208,Denmark,Qatar,5,2,3
1990,246,Finland,Qatar,3,1,2
1990,352,Iceland,Qatar,1,0,1
1990,372,Ireland,Qatar,7,4,3
1990,752,Sweden,Qatar,18,8,10
1990,826,United Kingdom,Qatar,148,96,52
1990,300,Greece,Qatar,6,3,3
1990,724,Spain,Qatar,5,3,2
1990,40,Austria,Qatar,15,9,6
1990,250,France,Qatar,151,71,80
1990,528,Netherlands,Qatar,15,7,8
1990,756,Switzerland,Qatar,11,7,4
1990,124,Canada,Qatar,259,126,133
1995,818,Egypt,Qatar,278,160,118
1995,434,Libya,Qatar,921,598,323
1995,48,Bahrain,Qatar,13,3,10
1995,196,Cyprus,Qatar,4,2,2
1995,400,Jordan,Qatar,187,132,55
1995,414,Kuwait,Qatar,60,10,50
1995,512,Oman,Qatar,77,33,44
1995,275,State of Palestine,Qatar,9645,4669,4976
1995,792,Turkey,Qatar,18,12,6
1995,784,United Arab Emirates,Qatar,131,35,96
1995,144,Sri Lanka,Qatar,34,28,6
1995,608,Philippines,Qatar,36,20,16
1995,188,Costa Rica,Qatar,2,1,1
1995,68,Bolivia (Plurinational State of),Qatar,6,5,1
1995,152,Chile,Qatar,27,10,17
1995,36,Australia,Qatar,183,105,78
1995,100,Bulgaria,Qatar,3,2,1
1995,203,Czechia,Qatar,10,4,6
1995,348,Hungary,Qatar,27,16,11
1995,616,Poland,Qatar,7,5,2
1995,643,Russian Federation,Qatar,107,59,48
1995,208,Denmark,Qatar,18,6,12
1995,246,Finland,Qatar,4,2,2
1995,352,Iceland,Qatar,2,0,2
1995,372,Ireland,Qatar,18,9,9
1995,752,Sweden,Qatar,21,9,12
1995,826,United Kingdom,Qatar,582,320,262
1995,300,Greece,Qatar,9,7,2
1995,380,Italy,Qatar,1,1,0
1995,724,Spain,Qatar,8,5,3
1995,40,Austria,Qatar,17,10,7
1995,250,France,Qatar,156,72,84
1995,528,Netherlands,Qatar,22,9,13
1995,756,Switzerland,Qatar,29,19,10
1995,124,Canada,Qatar,666,322,344
2000,818,Egypt,Qatar,292,174,118
2000,434,Libya,Qatar,1040,758,282
2000,48,Bahrain,Qatar,19,4,15
2000,196,Cyprus,Qatar,5,3,2
2000,400,Jordan,Qatar,272,199,73
2000,414,Kuwait,Qatar,96,19,77
2000,512,Oman,Qatar,106,50,56
2000,275,State of Palestine,Qatar,9420,4535,4885
2000,792,Turkey,Qatar,30,19,11
2000,784,United Arab Emirates,Qatar,210,62,148
2000,144,Sri Lanka,Qatar,67,48,19
2000,608,Philippines,Qatar,126,64,62
2000,188,Costa Rica,Qatar,2,1,1
2000,68,Bolivia (Plurinational State of),Qatar,5,4,1
2000,152,Chile,Qatar,26,9,17
2000,36,Australia,Qatar,250,145,105
2000,100,Bulgaria,Qatar,4,3,1
2000,203,Czechia,Qatar,13,5,8
2000,348,Hungary,Qatar,23,13,10
2000,616,Poland,Qatar,6,4,2
2000,643,Russian Federation,Qatar,97,60,37
2000,208,Denmark,Qatar,31,10,21
2000,246,Finland,Qatar,4,2,2
2000,352,Iceland,Qatar,2,0,2
2000,372,Ireland,Qatar,40,21,19
2000,578,Norway,Qatar,12,8,4
2000,752,Sweden,Qatar,23,10,13
2000,826,United Kingdom,Qatar,1026,548,478
2000,300,Greece,Qatar,12,10,2
2000,380,Italy,Qatar,2,2,0
2000,724,Spain,Qatar,99,59,40
2000,40,Austria,Qatar,18,11,7
2000,250,France,Qatar,160,72,88
2000,528,Netherlands,Qatar,31,11,20
2000,756,Switzerland,Qatar,48,30,18
2000,124,Canada,Qatar,1089,525,564
2005,818,Egypt,Qatar,348,216,132
2005,434,Libya,Qatar,1146,891,255
2005,48,Bahrain,Qatar,99,33,66
2005,196,Cyprus,Qatar,7,4,3
2005,400,Jordan,Qatar,392,301,91
2005,414,Kuwait,Qatar,141,36,105
2005,512,Oman,Qatar,127,85,42
2005,275,State of Palestine,Qatar,9815,4699,5116
2005,792,Turkey,Qatar,30,19,11
2005,784,United Arab Emirates,Qatar,824,292,532
2005,144,Sri Lanka,Qatar,134,74,60
2005,608,Philippines,Qatar,101,52,49
2005,188,Costa Rica,Qatar,1,0,1
2005,68,Bolivia (Plurinational State of),Qatar,3,2,1
2005,152,Chile,Qatar,39,14,25
2005,36,Australia,Qatar,440,261,179
2005,100,Bulgaria,Qatar,6,4,2
2005,203,Czechia,Qatar,10,4,6
2005,348,Hungary,Qatar,28,16,12
2005,616,Poland,Qatar,15,7,8
2005,643,Russian Federation,Qatar,61,37,24
2005,208,Denmark,Qatar,50,17,33
2005,246,Finland,Qatar,9,6,3
2005,352,Iceland,Qatar,2,0,2
2005,372,Ireland,Qatar,40,22,18
2005,578,Norway,Qatar,21,10,11
2005,752,Sweden,Qatar,46,22,24
2005,826,United Kingdom,Qatar,1650,983,667
2005,300,Greece,Qatar,570,267,303
2005,380,Italy,Qatar,41,21,20
2005,724,Spain,Qatar,48,28,20
2005,40,Austria,Qatar,20,12,8
2005,250,France,Qatar,64,40,24
2005,528,Netherlands,Qatar,35,15,20
2005,756,Switzerland,Qatar,53,32,21
2005,124,Canada,Qatar,1361,709,652
2010,818,Egypt,Qatar,376,228,148
2010,434,Libya,Qatar,1255,979,276
2010,48,Bahrain,Qatar,201,69,132
2010,196,Cyprus,Qatar,11,7,4
2010,400,Jordan,Qatar,504,394,110
2010,414,Kuwait,Qatar,223,65,158
2010,512,Oman,Qatar,170,136,34
2010,275,State of Palestine,Qatar,10211,4864,5347
2010,792,Turkey,Qatar,30,19,11
2010,784,United Arab Emirates,Qatar,2244,875,1369
2010,144,Sri Lanka,Qatar,270,150,120
2010,608,Philippines,Qatar,119,60,59
2010,188,Costa Rica,Qatar,3,2,1
2010,68,Bolivia (Plurinational State of),Qatar,1,1,0
2010,152,Chile,Qatar,52,19,33
2010,36,Australia,Qatar,660,380,280
2010,100,Bulgaria,Qatar,8,6,2
2010,203,Czechia,Qatar,6,3,3
2010,348,Hungary,Qatar,33,19,14
2010,616,Poland,Qatar,26,11,15
2010,643,Russian Federation,Qatar,25,14,11
2010,208,Denmark,Qatar,67,24,43
2010,233,Estonia,Qatar,1,1,0
2010,246,Finland,Qatar,13,8,5
2010,352,Iceland,Qatar,2,0,2
2010,372,Ireland,Qatar,34,17,17
2010,578,Norway,Qatar,32,17,15
2010,752,Sweden,Qatar,74,42,32
2010,826,United Kingdom,Qatar,1738,1050,688
2010,300,Greece,Qatar,1172,544,628
2010,380,Italy,Qatar,77,37,40
2010,705,Slovenia,Qatar,1,1,0
2010,724,Spain,Qatar,52,31,21
2010,40,Austria,Qatar,22,13,9
2010,250,France,Qatar,139,61,78
2010,528,Netherlands,Qatar,56,26,30
2010,756,Switzerland,Qatar,64,37,27
2010,124,Canada,Qatar,1650,903,747
2015,818,Egypt,Qatar,278,183,95
2015,434,Libya,Qatar,1414,1099,315
2015,48,Bahrain,Qatar,346,116,230
2015,196,Cyprus,Qatar,10,7,3
2015,400,Jordan,Qatar,216,158,58
2015,414,Kuwait,Qatar,623,121,502
2015,512,Oman,Qatar,386,321,65
2015,275,State of Palestine,Qatar,10111,4804,5307
2015,792,Turkey,Qatar,30,19,11
2015,784,United Arab Emirates,Qatar,2452,898,1554
2015,144,Sri Lanka,Qatar,274,150,124
2015,608,Philippines,Qatar,120,60,60
2015,188,Costa Rica,Qatar,3,2,1
2015,68,Bolivia (Plurinational State of),Qatar,1,1,0
2015,152,Chile,Qatar,78,28,50
2015,36,Australia,Qatar,1100,606,494
2015,100,Bulgaria,Qatar,32,23,9
2015,203,Czechia,Qatar,4,2,2
2015,348,Hungary,Qatar,56,34,22
2015,616,Poland,Qatar,25,11,14
2015,643,Russian Federation,Qatar,26,14,12
2015,208,Denmark,Qatar,93,34,59
2015,233,Estonia,Qatar,1,1,0
2015,246,Finland,Qatar,19,14,5
2015,352,Iceland,Qatar,2,0,2
2015,372,Ireland,Qatar,35,17,18
2015,428,Latvia,Qatar,1,0,1
2015,578,Norway,Qatar,68,35,33
2015,752,Sweden,Qatar,176,90,86
2015,826,United Kingdom,Qatar,2222,1317,905
2015,300,Greece,Qatar,1100,486,614
2015,380,Italy,Qatar,458,174,284
2015,705,Slovenia,Qatar,1,1,0
2015,724,Spain,Qatar,91,60,31
2015,40,Austria,Qatar,25,15,10
2015,250,France,Qatar,153,65,88
2015,528,Netherlands,Qatar,101,52,49
2015,756,Switzerland,Qatar,109,57,52
2015,124,Canada,Qatar,2474,1256,1218
2019,818,Egypt,Qatar,396,245,151
2019,434,Libya,Qatar,1500,1166,334
2019,48,Bahrain,Qatar,364,122,242
2019,196,Cyprus,Qatar,9,7,2
2019,400,Jordan,Qatar,232,170,62
2019,414,Kuwait,Qatar,659,128,531
2019,512,Oman,Qatar,475,395,80
2019,275,State of Palestine,Qatar,10040,4770,5270
2019,792,Turkey,Qatar,40,26,14
2019,784,United Arab Emirates,Qatar,2633,964,1669
2019,144,Sri Lanka,Qatar,276,152,124
2019,608,Philippines,Qatar,123,62,61
2019,188,Costa Rica,Qatar,3,2,1
2019,68,Bolivia (Plurinational State of),Qatar,1,1,0
2019,152,Chile,Qatar,104,34,70
2019,36,Australia,Qatar,1481,784,697
2019,100,Bulgaria,Qatar,48,35,13
2019,203,Czechia,Qatar,10,5,5
2019,348,Hungary,Qatar,93,54,39
2019,616,Poland,Qatar,26,12,14
2019,643,Russian Federation,Qatar,25,14,11
2019,208,Denmark,Qatar,175,76,99
2019,246,Finland,Qatar,25,17,8
2019,352,Iceland,Qatar,3,1,2
2019,372,Ireland,Qatar,38,19,19
2019,428,Latvia,Qatar,2,1,1
2019,578,Norway,Qatar,91,46,45
2019,752,Sweden,Qatar,398,196,202
2019,826,United Kingdom,Qatar,2523,1498,1025
2019,300,Greece,Qatar,1074,498,576
2019,380,Italy,Qatar,135,62,73
2019,705,Slovenia,Qatar,3,2,1
2019,724,Spain,Qatar,94,62,32
2019,40,Austria,Qatar,29,18,11
2019,250,France,Qatar,161,68,93
2019,528,Netherlands,Qatar,258,126,132
2019,756,Switzerland,Qatar,114,59,55
2019,124,Canada,Qatar,2651,1346,1305
1990,800,Uganda,Republic of Korea,59,10,49
1990,266,Gabon,Republic of Korea,60,37,23
1990,516,Namibia,Republic of Korea,52,21,31
1990,710,South Africa,Republic of Korea,1625,624,1001
1990,324,Guinea,Republic of Korea,138,84,54
1990,478,Mauritania,Republic of Korea,63,17,46
1990,694,Sierra Leone,Republic of Korea,15,9,6
1990,818,Egypt,Republic of Korea,282,199,83
1990,434,Libya,Republic of Korea,806,570,236
1990,196,Cyprus,Republic of Korea,2,0,2
1990,400,Jordan,Republic of Korea,96,48,48
1990,792,Turkey,Republic of Korea,124,58,66
1990,398,Kazakhstan,Republic of Korea,41045,19644,21401
1990,417,Kyrgyzstan,Republic of Korea,1459,639,820
1990,64,Bhutan,Republic of Korea,15,7,8
1990,144,Sri Lanka,Republic of Korea,7,4,3
1990,156,China,Republic of Korea,148141,81853,66288
1990,344,"China, Hong Kong SAR",Republic of Korea,3238,1478,1760
1990,408,Dem. People's Republic of Korea,Republic of Korea,5873,2991,2882
1990,392,Japan,Republic of Korea,687832,343142,344690
1990,496,Mongolia,Republic of Korea,276,142,134
1990,96,Brunei Darussalam,Republic of Korea,138,71,67
1990,116,Cambodia,Republic of Korea,26,17,9
1990,360,Indonesia,Republic of Korea,10866,6710,4156
1990,458,Malaysia,Republic of Korea,1194,944,250
1990,608,Philippines,Republic of Korea,593,369,224
1990,764,Thailand,Republic of Korea,469,307,162
1990,704,Viet Nam,Republic of Korea,25,16,9
1990,214,Dominican Republic,Republic of Korea,548,321,227
1990,630,Puerto Rico,Republic of Korea,72,34,38
1990,188,Costa Rica,Republic of Korea,148,79,69
1990,222,El Salvador,Republic of Korea,208,126,82
1990,320,Guatemala,Republic of Korea,290,122,168
1990,340,Honduras,Republic of Korea,53,34,19
1990,484,Mexico,Republic of Korea,128,82,46
1990,558,Nicaragua,Republic of Korea,20,10,10
1990,591,Panama,Republic of Korea,96,54,42
1990,32,Argentina,Republic of Korea,10229,5059,5170
1990,68,Bolivia (Plurinational State of),Republic of Korea,555,290,265
1990,152,Chile,Republic of Korea,663,349,314
1990,170,Colombia,Republic of Korea,143,79,64
1990,218,Ecuador,Republic of Korea,270,135,135
1990,600,Paraguay,Republic of Korea,5162,2620,2542
1990,604,Peru,Republic of Korea,414,228,186
1990,862,Venezuela (Bolivarian Republic of),Republic of Korea,245,142,103
1990,36,Australia,Republic of Korea,23735,11674,12061
1990,554,New Zealand,Republic of Korea,783,384,399
1990,598,Papua New Guinea,Republic of Korea,87,29,58
1990,90,Solomon Islands,Republic of Korea,38,27,11
1990,316,Guam,Republic of Korea,3582,2115,1467
1990,583,Micronesia (Fed. States of),Republic of Korea,65,38,27
1990,580,Northern Mariana Islands,Republic of Korea,2422,901,1521
1990,585,Palau,Republic of Korea,11,8,3
1990,16,American Samoa,Republic of Korea,201,106,95
1990,112,Belarus,Republic of Korea,22,14,8
1990,100,Bulgaria,Republic of Korea,33,19,14
1990,203,Czechia,Republic of Korea,19,9,10
1990,348,Hungary,Republic of Korea,1076,586,490
1990,616,Poland,Republic of Korea,53,24,29
1990,642,Romania,Republic of Korea,10,7,3
1990,643,Russian Federation,Republic of Korea,2014,988,1026
1990,208,Denmark,Republic of Korea,6527,2049,4478
1990,234,Faroe Islands,Republic of Korea,63,25,38
1990,246,Finland,Republic of Korea,52,21,31
1990,352,Iceland,Republic of Korea,27,10,17
1990,372,Ireland,Republic of Korea,37,15,22
1990,428,Latvia,Republic of Korea,9,5,4
1990,578,Norway,Republic of Korea,4821,1576,3245
1990,752,Sweden,Republic of Korea,7205,2663,4542
1990,826,United Kingdom,Republic of Korea,1717,983,734
1990,300,Greece,Republic of Korea,15,7,8
1990,380,Italy,Republic of Korea,630,219,411
1990,620,Portugal,Republic of Korea,21,9,12
1990,688,Serbia,Republic of Korea,2,2,0
1990,724,Spain,Republic of Korea,1257,630,627
1990,40,Austria,Republic of Korea,69,36,33
1990,56,Belgium,Republic of Korea,271,133,138
1990,250,France,Republic of Korea,18230,7568,10662
1990,276,Germany,Republic of Korea,20119,9742,10377
1990,442,Luxembourg,Republic of Korea,49,23,26
1990,528,Netherlands,Republic of Korea,4145,1767,2378
1990,756,Switzerland,Republic of Korea,1430,491,939
1990,124,Canada,Republic of Korea,31722,15443,16279
1990,840,United States of America,Republic of Korea,568397,278026,290371
1995,800,Uganda,Republic of Korea,55,7,48
1995,266,Gabon,Republic of Korea,80,50,30
1995,516,Namibia,Republic of Korea,49,20,29
1995,710,South Africa,Republic of Korea,1013,440,573
1995,324,Guinea,Republic of Korea,159,104,55
1995,478,Mauritania,Republic of Korea,67,23,44
1995,694,Sierra Leone,Republic of Korea,14,8,6
1995,818,Egypt,Republic of Korea,240,163,77
1995,434,Libya,Republic of Korea,661,448,213
1995,196,Cyprus,Republic of Korea,3,0,3
1995,400,Jordan,Republic of Korea,106,56,50
1995,792,Turkey,Republic of Korea,299,132,167
1995,398,Kazakhstan,Republic of Korea,32244,15563,16681
1995,417,Kyrgyzstan,Republic of Korea,1067,472,595
1995,64,Bhutan,Republic of Korea,18,9,9
1995,144,Sri Lanka,Republic of Korea,77,61,16
1995,156,China,Republic of Korea,141332,78456,62876
1995,344,"China, Hong Kong SAR",Republic of Korea,3614,1636,1978
1995,408,Dem. People's Republic of Korea,Republic of Korea,5201,2654,2547
1995,392,Japan,Republic of Korea,660554,339998,320556
1995,496,Mongolia,Republic of Korea,304,164,140
1995,96,Brunei Darussalam,Republic of Korea,141,73,68
1995,116,Cambodia,Republic of Korea,68,44,24
1995,360,Indonesia,Republic of Korea,7189,4511,2678
1995,458,Malaysia,Republic of Korea,1366,1081,285
1995,608,Philippines,Republic of Korea,798,491,307
1995,764,Thailand,Republic of Korea,784,504,280
1995,704,Viet Nam,Republic of Korea,75,44,31
1995,214,Dominican Republic,Republic of Korea,609,351,258
1995,630,Puerto Rico,Republic of Korea,78,39,39
1995,188,Costa Rica,Republic of Korea,136,75,61
1995,222,El Salvador,Republic of Korea,161,97,64
1995,320,Guatemala,Republic of Korea,709,373,336
1995,340,Honduras,Republic of Korea,53,33,20
1995,484,Mexico,Republic of Korea,300,166,134
1995,558,Nicaragua,Republic of Korea,16,8,8
1995,591,Panama,Republic of Korea,139,79,60
1995,32,Argentina,Republic of Korea,9078,4566,4512
1995,68,Bolivia (Plurinational State of),Republic of Korea,564,302,262
1995,152,Chile,Republic of Korea,856,436,420
1995,170,Colombia,Republic of Korea,172,98,74
1995,218,Ecuador,Republic of Korea,303,151,152
1995,600,Paraguay,Republic of Korea,4026,2074,1952
1995,604,Peru,Republic of Korea,415,226,189
1995,862,Venezuela (Bolivarian Republic of),Republic of Korea,242,141,101
1995,36,Australia,Republic of Korea,28782,13772,15010
1995,554,New Zealand,Republic of Korea,11855,5913,5942
1995,598,Papua New Guinea,Republic of Korea,89,43,46
1995,90,Solomon Islands,Republic of Korea,38,27,11
1995,316,Guam,Republic of Korea,3411,1880,1531
1995,583,Micronesia (Fed. States of),Republic of Korea,58,38,20
1995,580,Northern Mariana Islands,Republic of Korea,1938,865,1073
1995,585,Palau,Republic of Korea,19,13,6
1995,16,American Samoa,Republic of Korea,192,100,92
1995,112,Belarus,Republic of Korea,26,14,12
1995,100,Bulgaria,Republic of Korea,43,22,21
1995,203,Czechia,Republic of Korea,28,14,14
1995,348,Hungary,Republic of Korea,953,512,441
1995,616,Poland,Republic of Korea,44,19,25
1995,642,Romania,Republic of Korea,8,6,2
1995,643,Russian Federation,Republic of Korea,2017,1036,981
1995,703,Slovakia,Republic of Korea,152,89,63
1995,208,Denmark,Republic of Korea,7400,2404,4996
1995,234,Faroe Islands,Republic of Korea,53,21,32
1995,246,Finland,Republic of Korea,82,35,47
1995,352,Iceland,Republic of Korea,29,11,18
1995,372,Ireland,Republic of Korea,102,38,64
1995,428,Latvia,Republic of Korea,13,7,6
1995,578,Norway,Republic of Korea,5355,1875,3480
1995,752,Sweden,Republic of Korea,8550,3119,5431
1995,826,United Kingdom,Republic of Korea,6750,3075,3675
1995,300,Greece,Republic of Korea,108,45,63
1995,380,Italy,Republic of Korea,2263,834,1429
1995,620,Portugal,Republic of Korea,46,19,27
1995,688,Serbia,Republic of Korea,19,15,4
1995,724,Spain,Republic of Korea,1496,751,745
1995,40,Austria,Republic of Korea,78,41,37
1995,56,Belgium,Republic of Korea,229,115,114
1995,250,France,Republic of Korea,18820,7628,11192
1995,276,Germany,Republic of Korea,20781,9370,11411
1995,442,Luxembourg,Republic of Korea,46,22,24
1995,528,Netherlands,Republic of Korea,4521,1881,2640
1995,756,Switzerland,Republic of Korea,1894,732,1162
1995,124,Canada,Republic of Korea,56171,27163,29008
1995,840,United States of America,Republic of Korea,725849,356510,369339
2000,800,Uganda,Republic of Korea,160,35,125
2000,266,Gabon,Republic of Korea,100,62,38
2000,516,Namibia,Republic of Korea,48,20,28
2000,710,South Africa,Republic of Korea,700,362,338
2000,324,Guinea,Republic of Korea,172,112,60
2000,478,Mauritania,Republic of Korea,69,29,40
2000,694,Sierra Leone,Republic of Korea,13,7,6
2000,818,Egypt,Republic of Korea,218,140,78
2000,434,Libya,Republic of Korea,527,338,189
2000,196,Cyprus,Republic of Korea,4,0,4
2000,400,Jordan,Republic of Korea,115,64,51
2000,792,Turkey,Republic of Korea,477,207,270
2000,398,Kazakhstan,Republic of Korea,23442,11482,11960
2000,417,Kyrgyzstan,Republic of Korea,648,291,357
2000,64,Bhutan,Republic of Korea,21,11,10
2000,144,Sri Lanka,Republic of Korea,149,101,48
2000,156,China,Republic of Korea,134524,75060,59464
2000,344,"China, Hong Kong SAR",Republic of Korea,3989,1794,2195
2000,408,Dem. People's Republic of Korea,Republic of Korea,4528,2316,2212
2000,392,Japan,Republic of Korea,635194,311245,323949
2000,496,Mongolia,Republic of Korea,336,188,148
2000,96,Brunei Darussalam,Republic of Korea,144,76,68
2000,116,Cambodia,Republic of Korea,110,72,38
2000,360,Indonesia,Republic of Korea,3513,2313,1200
2000,458,Malaysia,Republic of Korea,1927,1523,404
2000,608,Philippines,Republic of Korea,1827,984,843
2000,764,Thailand,Republic of Korea,1262,799,463
2000,704,Viet Nam,Republic of Korea,196,119,77
2000,214,Dominican Republic,Republic of Korea,669,380,289
2000,630,Puerto Rico,Republic of Korea,85,43,42
2000,188,Costa Rica,Republic of Korea,193,106,87
2000,222,El Salvador,Republic of Korea,114,69,45
2000,320,Guatemala,Republic of Korea,1127,624,503
2000,340,Honduras,Republic of Korea,52,32,20
2000,484,Mexico,Republic of Korea,487,259,228
2000,558,Nicaragua,Republic of Korea,34,20,14
2000,591,Panama,Republic of Korea,191,108,83
2000,32,Argentina,Republic of Korea,7927,4074,3853
2000,68,Bolivia (Plurinational State of),Republic of Korea,568,311,257
2000,152,Chile,Republic of Korea,1049,531,518
2000,170,Colombia,Republic of Korea,201,117,84
2000,218,Ecuador,Republic of Korea,336,168,168
2000,600,Paraguay,Republic of Korea,2877,1510,1367
2000,604,Peru,Republic of Korea,486,261,225
2000,862,Venezuela (Bolivarian Republic of),Republic of Korea,237,138,99
2000,36,Australia,Republic of Korea,36180,16966,19214
2000,554,New Zealand,Republic of Korea,17448,8481,8967
2000,598,Papua New Guinea,Republic of Korea,66,36,30
2000,90,Solomon Islands,Republic of Korea,37,26,11
2000,316,Guam,Republic of Korea,3240,1645,1595
2000,583,Micronesia (Fed. States of),Republic of Korea,54,32,22
2000,580,Northern Mariana Islands,Republic of Korea,1573,817,756
2000,585,Palau,Republic of Korea,141,108,33
2000,16,American Samoa,Republic of Korea,182,94,88
2000,112,Belarus,Republic of Korea,29,14,15
2000,100,Bulgaria,Republic of Korea,53,25,28
2000,203,Czechia,Republic of Korea,37,19,18
2000,348,Hungary,Republic of Korea,830,438,392
2000,616,Poland,Republic of Korea,38,16,22
2000,642,Romania,Republic of Korea,8,6,2
2000,643,Russian Federation,Republic of Korea,1948,1047,901
2000,703,Slovakia,Republic of Korea,346,202,144
2000,208,Denmark,Republic of Korea,8273,2760,5513
2000,234,Faroe Islands,Republic of Korea,37,14,23
2000,246,Finland,Republic of Korea,111,49,62
2000,352,Iceland,Republic of Korea,31,12,19
2000,372,Ireland,Republic of Korea,224,88,136
2000,428,Latvia,Republic of Korea,18,10,8
2000,578,Norway,Republic of Korea,5966,2203,3763
2000,752,Sweden,Republic of Korea,9170,3307,5863
2000,826,United Kingdom,Republic of Korea,11898,5209,6689
2000,300,Greece,Republic of Korea,202,81,121
2000,380,Italy,Republic of Korea,3896,1449,2447
2000,620,Portugal,Republic of Korea,73,29,44
2000,688,Serbia,Republic of Korea,27,21,6
2000,724,Spain,Republic of Korea,2379,1214,1165
2000,40,Austria,Republic of Korea,87,47,40
2000,56,Belgium,Republic of Korea,174,90,84
2000,250,France,Republic of Korea,19409,7687,11722
2000,276,Germany,Republic of Korea,21442,8998,12444
2000,442,Luxembourg,Republic of Korea,44,20,24
2000,528,Netherlands,Republic of Korea,5056,2052,3004
2000,756,Switzerland,Republic of Korea,2366,979,1387
2000,124,Canada,Republic of Korea,81955,39535,42420
2000,840,United States of America,Republic of Korea,886067,436917,449150
2005,800,Uganda,Republic of Korea,154,31,123
2005,266,Gabon,Republic of Korea,110,70,40
2005,516,Namibia,Republic of Korea,37,15,22
2005,710,South Africa,Republic of Korea,920,456,464
2005,324,Guinea,Republic of Korea,313,180,133
2005,478,Mauritania,Republic of Korea,69,31,38
2005,694,Sierra Leone,Republic of Korea,9,5,4
2005,818,Egypt,Republic of Korea,260,173,87
2005,434,Libya,Republic of Korea,580,409,171
2005,196,Cyprus,Republic of Korea,6,0,6
2005,400,Jordan,Republic of Korea,166,101,65
2005,792,Turkey,Republic of Korea,491,207,284
2005,398,Kazakhstan,Republic of Korea,26725,13452,13273
2005,417,Kyrgyzstan,Republic of Korea,460,209,251
2005,64,Bhutan,Republic of Korea,26,13,13
2005,144,Sri Lanka,Republic of Korea,296,145,151
2005,156,China,Republic of Korea,148413,89711,58702
2005,344,"China, Hong Kong SAR",Republic of Korea,4355,1838,2517
2005,408,Dem. People's Republic of Korea,Republic of Korea,4697,2373,2324
2005,392,Japan,Republic of Korea,532475,255852,276623
2005,496,Mongolia,Republic of Korea,866,496,370
2005,96,Brunei Darussalam,Republic of Korea,147,78,69
2005,116,Cambodia,Republic of Korea,86,57,29
2005,360,Indonesia,Republic of Korea,15679,9440,6239
2005,458,Malaysia,Republic of Korea,2582,2068,514
2005,608,Philippines,Republic of Korea,1478,807,671
2005,764,Thailand,Republic of Korea,1015,639,376
2005,704,Viet Nam,Republic of Korea,639,394,245
2005,214,Dominican Republic,Republic of Korea,604,343,261
2005,630,Puerto Rico,Republic of Korea,102,50,52
2005,188,Costa Rica,Republic of Korea,127,69,58
2005,222,El Salvador,Republic of Korea,119,72,47
2005,320,Guatemala,Republic of Korea,1340,789,551
2005,340,Honduras,Republic of Korea,51,31,20
2005,484,Mexico,Republic of Korea,2101,1173,928
2005,558,Nicaragua,Republic of Korea,54,33,21
2005,591,Panama,Republic of Korea,260,152,108
2005,32,Argentina,Republic of Korea,7497,3801,3696
2005,68,Bolivia (Plurinational State of),Republic of Korea,502,271,231
2005,76,Brazil,Republic of Korea,4251,2004,2247
2005,152,Chile,Republic of Korea,1574,810,764
2005,170,Colombia,Republic of Korea,210,124,86
2005,218,Ecuador,Republic of Korea,397,203,194
2005,600,Paraguay,Republic of Korea,2740,1438,1302
2005,604,Peru,Republic of Korea,571,314,257
2005,862,Venezuela (Bolivarian Republic of),Republic of Korea,249,146,103
2005,36,Australia,Republic of Korea,51150,23576,27574
2005,554,New Zealand,Republic of Korea,27550,13373,14177
2005,598,Papua New Guinea,Republic of Korea,76,44,32
2005,90,Solomon Islands,Republic of Korea,34,22,12
2005,316,Guam,Republic of Korea,2964,1516,1448
2005,583,Micronesia (Fed. States of),Republic of Korea,50,29,21
2005,580,Northern Mariana Islands,Republic of Korea,1855,885,970
2005,585,Palau,Republic of Korea,80,49,31
2005,16,American Samoa,Republic of Korea,239,123,116
2005,112,Belarus,Republic of Korea,28,13,15
2005,100,Bulgaria,Republic of Korea,43,22,21
2005,203,Czechia,Republic of Korea,553,285,268
2005,348,Hungary,Republic of Korea,1025,549,476
2005,616,Poland,Republic of Korea,78,36,42
2005,642,Romania,Republic of Korea,6,5,1
2005,643,Russian Federation,Republic of Korea,2828,1606,1222
2005,703,Slovakia,Republic of Korea,388,229,159
2005,208,Denmark,Republic of Korea,8532,2919,5613
2005,234,Faroe Islands,Republic of Korea,42,21,21
2005,246,Finland,Republic of Korea,251,107,144
2005,352,Iceland,Republic of Korea,16,6,10
2005,372,Ireland,Republic of Korea,225,97,128
2005,428,Latvia,Republic of Korea,27,14,13
2005,578,Norway,Republic of Korea,6576,2560,4016
2005,752,Sweden,Republic of Korea,9798,3685,6113
2005,826,United Kingdom,Republic of Korea,8610,3745,4865
2005,191,Croatia,Republic of Korea,14,5,9
2005,300,Greece,Republic of Korea,209,82,127
2005,380,Italy,Republic of Korea,3913,1517,2396
2005,620,Portugal,Republic of Korea,101,43,58
2005,688,Serbia,Republic of Korea,27,21,6
2005,724,Spain,Republic of Korea,2975,1378,1597
2005,40,Austria,Republic of Korea,97,51,46
2005,56,Belgium,Republic of Korea,1918,766,1152
2005,250,France,Republic of Korea,17773,6885,10888
2005,276,Germany,Republic of Korea,22655,8928,13727
2005,442,Luxembourg,Republic of Korea,37,18,19
2005,528,Netherlands,Republic of Korea,5899,2427,3472
2005,756,Switzerland,Republic of Korea,2698,1019,1679
2005,124,Canada,Republic of Korea,102474,48336,54138
2005,840,United States of America,Republic of Korea,990111,490995,499116
2010,800,Uganda,Republic of Korea,154,29,125
2010,266,Gabon,Republic of Korea,127,80,47
2010,516,Namibia,Republic of Korea,35,14,21
2010,710,South Africa,Republic of Korea,1441,712,729
2010,324,Guinea,Republic of Korea,486,267,219
2010,478,Mauritania,Republic of Korea,69,32,37
2010,694,Sierra Leone,Republic of Korea,6,4,2
2010,818,Egypt,Republic of Korea,281,184,97
2010,434,Libya,Republic of Korea,635,450,185
2010,196,Cyprus,Republic of Korea,9,0,9
2010,400,Jordan,Republic of Korea,214,134,80
2010,792,Turkey,Republic of Korea,505,206,299
2010,398,Kazakhstan,Republic of Korea,30007,15421,14586
2010,417,Kyrgyzstan,Republic of Korea,265,121,144
2010,64,Bhutan,Republic of Korea,31,15,16
2010,144,Sri Lanka,Republic of Korea,596,297,299
2010,156,China,Republic of Korea,162303,104362,57941
2010,344,"China, Hong Kong SAR",Republic of Korea,4732,1888,2844
2010,408,Dem. People's Republic of Korea,Republic of Korea,4866,2431,2435
2010,392,Japan,Republic of Korea,565989,264657,301332
2010,496,Mongolia,Republic of Korea,1497,901,596
2010,96,Brunei Darussalam,Republic of Korea,150,80,70
2010,116,Cambodia,Republic of Korea,62,42,20
2010,360,Indonesia,Republic of Korea,28850,16497,12353
2010,458,Malaysia,Republic of Korea,3073,2507,566
2010,608,Philippines,Republic of Korea,6799,3585,3214
2010,764,Thailand,Republic of Korea,841,532,309
2010,704,Viet Nam,Republic of Korea,1495,890,605
2010,214,Dominican Republic,Republic of Korea,535,304,231
2010,630,Puerto Rico,Republic of Korea,107,50,57
2010,188,Costa Rica,Republic of Korea,250,137,113
2010,222,El Salvador,Republic of Korea,123,75,48
2010,320,Guatemala,Republic of Korea,1553,955,598
2010,340,Honduras,Republic of Korea,49,30,19
2010,484,Mexico,Republic of Korea,3960,2224,1736
2010,558,Nicaragua,Republic of Korea,57,35,22
2010,591,Panama,Republic of Korea,343,206,137
2010,32,Argentina,Republic of Korea,7066,3528,3538
2010,68,Bolivia (Plurinational State of),Republic of Korea,434,230,204
2010,76,Brazil,Republic of Korea,8503,4009,4494
2010,152,Chile,Republic of Korea,2099,1088,1011
2010,170,Colombia,Republic of Korea,256,154,102
2010,218,Ecuador,Republic of Korea,557,278,279
2010,600,Paraguay,Republic of Korea,2610,1367,1243
2010,604,Peru,Republic of Korea,1078,698,380
2010,862,Venezuela (Bolivarian Republic of),Republic of Korea,265,155,110
2010,36,Australia,Republic of Korea,84150,39744,44406
2010,554,New Zealand,Republic of Korea,27818,13482,14336
2010,598,Papua New Guinea,Republic of Korea,64,34,30
2010,90,Solomon Islands,Republic of Korea,34,20,14
2010,316,Guam,Republic of Korea,2687,1387,1300
2010,583,Micronesia (Fed. States of),Republic of Korea,48,28,20
2010,580,Northern Mariana Islands,Republic of Korea,1604,710,894
2010,585,Palau,Republic of Korea,76,45,31
2010,16,American Samoa,Republic of Korea,296,152,144
2010,112,Belarus,Republic of Korea,27,13,14
2010,100,Bulgaria,Republic of Korea,53,22,31
2010,203,Czechia,Republic of Korea,1013,532,481
2010,348,Hungary,Republic of Korea,1220,660,560
2010,616,Poland,Republic of Korea,122,57,65
2010,642,Romania,Republic of Korea,26,22,4
2010,643,Russian Federation,Republic of Korea,3651,2133,1518
2010,703,Slovakia,Republic of Korea,435,259,176
2010,208,Denmark,Republic of Korea,8635,3026,5609
2010,233,Estonia,Republic of Korea,19,7,12
2010,234,Faroe Islands,Republic of Korea,47,25,22
2010,246,Finland,Republic of Korea,443,168,275
2010,352,Iceland,Republic of Korea,35,10,25
2010,372,Ireland,Republic of Korea,189,74,115
2010,428,Latvia,Republic of Korea,37,18,19
2010,578,Norway,Republic of Korea,7082,2843,4239
2010,752,Sweden,Republic of Korea,10398,4026,6372
2010,826,United Kingdom,Republic of Korea,9070,4051,5019
2010,191,Croatia,Republic of Korea,27,9,18
2010,300,Greece,Republic of Korea,224,87,137
2010,380,Italy,Republic of Korea,4683,1993,2690
2010,620,Portugal,Republic of Korea,113,50,63
2010,688,Serbia,Republic of Korea,27,21,6
2010,724,Spain,Republic of Korea,3641,1706,1935
2010,40,Austria,Republic of Korea,107,56,51
2010,56,Belgium,Republic of Korea,4210,1479,2731
2010,250,France,Republic of Korea,19439,7434,12005
2010,276,Germany,Republic of Korea,23592,8823,14769
2010,442,Luxembourg,Republic of Korea,32,16,16
2010,528,Netherlands,Republic of Korea,6426,2633,3793
2010,756,Switzerland,Republic of Korea,3126,1090,2036
2010,124,Canada,Republic of Korea,112400,52382,60018
2010,840,United States of America,Republic of Korea,1127266,551192,576074
2015,800,Uganda,Republic of Korea,154,28,126
2015,266,Gabon,Republic of Korea,177,120,57
2015,516,Namibia,Republic of Korea,34,14,20
2015,710,South Africa,Republic of Korea,2598,1217,1381
2015,324,Guinea,Republic of Korea,426,276,150
2015,478,Mauritania,Republic of Korea,69,33,36
2015,694,Sierra Leone,Republic of Korea,4,3,1
2015,818,Egypt,Republic of Korea,208,146,62
2015,434,Libya,Republic of Korea,715,504,211
2015,196,Cyprus,Republic of Korea,8,0,8
2015,400,Jordan,Republic of Korea,91,50,41
2015,792,Turkey,Republic of Korea,512,202,310
2015,398,Kazakhstan,Republic of Korea,31916,16656,15260
2015,417,Kyrgyzstan,Republic of Korea,233,106,127
2015,64,Bhutan,Republic of Korea,33,16,17
2015,144,Sri Lanka,Republic of Korea,607,297,310
2015,156,China,Republic of Korea,186786,123150,63636
2015,344,"China, Hong Kong SAR",Republic of Korea,4832,1814,3018
2015,408,Dem. People's Republic of Korea,Republic of Korea,5358,2693,2665
2015,392,Japan,Republic of Korea,457772,225162,232610
2015,496,Mongolia,Republic of Korea,1853,913,940
2015,96,Brunei Darussalam,Republic of Korea,153,82,71
2015,116,Cambodia,Republic of Korea,56,38,18
2015,360,Indonesia,Republic of Korea,31940,18560,13380
2015,458,Malaysia,Republic of Korea,3747,3058,689
2015,608,Philippines,Republic of Korea,6906,3647,3259
2015,764,Thailand,Republic of Korea,909,574,335
2015,704,Viet Nam,Republic of Korea,1805,1067,738
2015,214,Dominican Republic,Republic of Korea,564,321,243
2015,630,Puerto Rico,Republic of Korea,114,54,60
2015,188,Costa Rica,Republic of Korea,253,138,115
2015,222,El Salvador,Republic of Korea,128,78,50
2015,320,Guatemala,Republic of Korea,1786,1108,678
2015,340,Honduras,Republic of Korea,68,42,26
2015,484,Mexico,Republic of Korea,1890,1044,846
2015,558,Nicaragua,Republic of Korea,61,38,23
2015,591,Panama,Republic of Korea,402,240,162
2015,32,Argentina,Republic of Korea,8154,4069,4085
2015,68,Bolivia (Plurinational State of),Republic of Korea,505,267,238
2015,76,Brazil,Republic of Korea,10239,4827,5412
2015,152,Chile,Republic of Korea,3179,1615,1564
2015,170,Colombia,Republic of Korea,286,173,113
2015,218,Ecuador,Republic of Korea,810,402,408
2015,600,Paraguay,Republic of Korea,2547,1333,1214
2015,604,Peru,Republic of Korea,1691,1127,564
2015,862,Venezuela (Bolivarian Republic of),Republic of Korea,277,160,117
2015,36,Australia,Republic of Korea,106550,50650,55900
2015,554,New Zealand,Republic of Korea,27640,13366,14274
2015,598,Papua New Guinea,Republic of Korea,64,35,29
2015,90,Solomon Islands,Republic of Korea,31,18,13
2015,316,Guam,Republic of Korea,2711,1399,1312
2015,583,Micronesia (Fed. States of),Republic of Korea,47,28,19
2015,580,Northern Mariana Islands,Republic of Korea,1436,631,805
2015,585,Palau,Republic of Korea,68,42,26
2015,16,American Samoa,Republic of Korea,295,151,144
2015,112,Belarus,Republic of Korea,29,14,15
2015,100,Bulgaria,Republic of Korea,159,78,81
2015,203,Czechia,Republic of Korea,1428,744,684
2015,348,Hungary,Republic of Korea,1240,680,560
2015,616,Poland,Republic of Korea,117,56,61
2015,642,Romania,Republic of Korea,23,15,8
2015,643,Russian Federation,Republic of Korea,3721,2166,1555
2015,703,Slovakia,Republic of Korea,534,338,196
2015,208,Denmark,Republic of Korea,9550,3447,6103
2015,233,Estonia,Republic of Korea,69,21,48
2015,234,Faroe Islands,Republic of Korea,53,28,25
2015,246,Finland,Republic of Korea,689,258,431
2015,352,Iceland,Republic of Korea,37,12,25
2015,372,Ireland,Republic of Korea,193,74,119
2015,428,Latvia,Republic of Korea,30,21,9
2015,578,Norway,Republic of Korea,7496,3042,4454
2015,752,Sweden,Republic of Korea,10690,4213,6477
2015,826,United Kingdom,Republic of Korea,11599,4991,6608
2015,191,Croatia,Republic of Korea,27,9,18
2015,300,Greece,Republic of Korea,210,76,134
2015,380,Italy,Republic of Korea,3803,1453,2350
2015,620,Portugal,Republic of Korea,129,54,75
2015,688,Serbia,Republic of Korea,26,21,5
2015,724,Spain,Republic of Korea,4189,1854,2335
2015,40,Austria,Republic of Korea,125,66,59
2015,56,Belgium,Republic of Korea,4306,1512,2794
2015,250,France,Republic of Korea,21535,7871,13664
2015,276,Germany,Republic of Korea,24582,9157,15425
2015,442,Luxembourg,Republic of Korea,48,24,24
2015,528,Netherlands,Republic of Korea,7092,2832,4260
2015,756,Switzerland,Republic of Korea,3916,1240,2676
2015,124,Canada,Republic of Korea,122548,56784,65764
2015,840,United States of America,Republic of Korea,1060019,514190,545829
2019,800,Uganda,Republic of Korea,154,28,126
2019,266,Gabon,Republic of Korea,192,130,62
2019,516,Namibia,Republic of Korea,35,14,21
2019,710,South Africa,Republic of Korea,2911,1365,1546
2019,324,Guinea,Republic of Korea,406,264,142
2019,478,Mauritania,Republic of Korea,71,34,37
2019,694,Sierra Leone,Republic of Korea,3,3,0
2019,818,Egypt,Republic of Korea,296,198,98
2019,434,Libya,Republic of Korea,758,535,223
2019,196,Cyprus,Republic of Korea,7,0,7
2019,400,Jordan,Republic of Korea,97,53,44
2019,792,Turkey,Republic of Korea,692,277,415
2019,398,Kazakhstan,Republic of Korea,33351,17405,15946
2019,417,Kyrgyzstan,Republic of Korea,228,104,124
2019,64,Bhutan,Republic of Korea,34,17,17
2019,144,Sri Lanka,Republic of Korea,611,299,312
2019,156,China,Republic of Korea,196874,129802,67072
2019,344,"China, Hong Kong SAR",Republic of Korea,6260,2233,4027
2019,408,Dem. People's Republic of Korea,Republic of Korea,5461,2745,2716
2019,392,Japan,Republic of Korea,475166,233718,241448
2019,496,Mongolia,Republic of Korea,1968,970,998
2019,96,Brunei Darussalam,Republic of Korea,164,88,76
2019,116,Cambodia,Republic of Korea,59,40,19
2019,360,Indonesia,Republic of Korea,33357,19384,13973
2019,458,Malaysia,Republic of Korea,3917,3202,715
2019,608,Philippines,Republic of Korea,7123,3762,3361
2019,764,Thailand,Republic of Korea,947,598,349
2019,704,Viet Nam,Republic of Korea,1887,1116,771
2019,214,Dominican Republic,Republic of Korea,582,331,251
2019,630,Puerto Rico,Republic of Korea,4,2,2
2019,188,Costa Rica,Republic of Korea,256,141,115
2019,222,El Salvador,Republic of Korea,129,79,50
2019,320,Guatemala,Republic of Korea,1833,1138,695
2019,340,Honduras,Republic of Korea,69,43,26
2019,484,Mexico,Republic of Korea,1948,1076,872
2019,558,Nicaragua,Republic of Korea,63,39,24
2019,591,Panama,Republic of Korea,427,256,171
2019,32,Argentina,Republic of Korea,8296,4133,4163
2019,68,Bolivia (Plurinational State of),Republic of Korea,551,292,259
2019,76,Brazil,Republic of Korea,11531,5436,6095
2019,152,Chile,Republic of Korea,4247,2041,2206
2019,170,Colombia,Republic of Korea,292,177,115
2019,218,Ecuador,Republic of Korea,797,396,401
2019,600,Paraguay,Republic of Korea,2613,1368,1245
2019,604,Peru,Republic of Korea,2015,1371,644
2019,862,Venezuela (Bolivarian Republic of),Republic of Korea,271,156,115
2019,36,Australia,Republic of Korea,121204,57818,63386
2019,554,New Zealand,Republic of Korea,28411,13739,14672
2019,598,Papua New Guinea,Republic of Korea,64,35,29
2019,90,Solomon Islands,Republic of Korea,30,18,12
2019,316,Guam,Republic of Korea,2844,1468,1376
2019,583,Micronesia (Fed. States of),Republic of Korea,48,29,19
2019,580,Northern Mariana Islands,Republic of Korea,1447,636,811
2019,585,Palau,Republic of Korea,69,40,29
2019,16,American Samoa,Republic of Korea,295,151,144
2019,112,Belarus,Republic of Korea,28,14,14
2019,100,Bulgaria,Republic of Korea,219,109,110
2019,203,Czechia,Republic of Korea,1989,1001,988
2019,348,Hungary,Republic of Korea,1123,557,566
2019,616,Poland,Republic of Korea,123,61,62
2019,642,Romania,Republic of Korea,354,236,118
2019,643,Russian Federation,Republic of Korea,3720,2166,1554
2019,703,Slovakia,Republic of Korea,579,368,211
2019,208,Denmark,Republic of Korea,9392,3301,6091
2019,233,Estonia,Republic of Korea,69,24,45
2019,234,Faroe Islands,Republic of Korea,58,31,27
2019,246,Finland,Republic of Korea,848,303,545
2019,352,Iceland,Republic of Korea,43,14,29
2019,372,Ireland,Republic of Korea,211,81,130
2019,428,Latvia,Republic of Korea,23,14,9
2019,578,Norway,Republic of Korea,8193,3315,4878
2019,752,Sweden,Republic of Korea,11484,4529,6955
2019,826,United Kingdom,Republic of Korea,13171,5686,7485
2019,191,Croatia,Republic of Korea,24,8,16
2019,300,Greece,Republic of Korea,205,80,125
2019,380,Italy,Republic of Korea,4264,1645,2619
2019,620,Portugal,Republic of Korea,131,55,76
2019,688,Serbia,Republic of Korea,26,21,5
2019,724,Spain,Republic of Korea,4340,1863,2477
2019,40,Austria,Republic of Korea,147,79,68
2019,56,Belgium,Republic of Korea,4645,1660,2985
2019,250,France,Republic of Korea,22794,8298,14496
2019,276,Germany,Republic of Korea,26965,11197,15768
2019,442,Luxembourg,Republic of Korea,1051,546,505
2019,528,Netherlands,Republic of Korea,8392,3390,5002
2019,756,Switzerland,Republic of Korea,4275,1367,2908
2019,124,Canada,Republic of Korea,131324,60851,70473
2019,840,United States of America,Republic of Korea,1083794,524667,559127
1990,818,Egypt,Republic of Moldova,48,42,6
1990,31,Azerbaijan,Republic of Moldova,386,45,341
1990,196,Cyprus,Republic of Moldova,234,52,182
1990,268,Georgia,Republic of Moldova,4413,1972,2441
1990,376,Israel,Republic of Moldova,28570,13506,15064
1990,400,Jordan,Republic of Moldova,2,1,1
1990,792,Turkey,Republic of Moldova,564,114,450
1990,398,Kazakhstan,Republic of Moldova,13149,6620,6529
1990,417,Kyrgyzstan,Republic of Moldova,8066,3446,4620
1990,762,Tajikistan,Republic of Moldova,2071,905,1166
1990,214,Dominican Republic,Republic of Moldova,6,3,3
1990,188,Costa Rica,Republic of Moldova,3,2,1
1990,32,Argentina,Republic of Moldova,1003,425,578
1990,152,Chile,Republic of Moldova,3,2,1
1990,36,Australia,Republic of Moldova,15,9,6
1990,112,Belarus,Republic of Moldova,8826,4703,4123
1990,100,Bulgaria,Republic of Moldova,582,236,346
1990,203,Czechia,Republic of Moldova,202,120,82
1990,348,Hungary,Republic of Moldova,56,23,33
1990,616,Poland,Republic of Moldova,467,179,288
1990,642,Romania,Republic of Moldova,52248,20865,31383
1990,643,Russian Federation,Republic of Moldova,292807,143684,149123
1990,703,Slovakia,Republic of Moldova,8,2,6
1990,804,Ukraine,Republic of Moldova,180029,77142,102887
1990,208,Denmark,Republic of Moldova,59,20,39
1990,233,Estonia,Republic of Moldova,1543,940,603
1990,372,Ireland,Republic of Moldova,113,55,58
1990,428,Latvia,Republic of Moldova,1629,953,676
1990,440,Lithuania,Republic of Moldova,1763,1004,759
1990,578,Norway,Republic of Moldova,3,0,3
1990,752,Sweden,Republic of Moldova,58,21,37
1990,826,United Kingdom,Republic of Moldova,61,37,24
1990,300,Greece,Republic of Moldova,9177,5083,4094
1990,380,Italy,Republic of Moldova,84,29,55
1990,470,Malta,Republic of Moldova,6,0,6
1990,620,Portugal,Republic of Moldova,887,732,155
1990,688,Serbia,Republic of Moldova,28,5,23
1990,705,Slovenia,Republic of Moldova,17,9,8
1990,724,Spain,Republic of Moldova,17,7,10
1990,40,Austria,Republic of Moldova,980,374,606
1990,56,Belgium,Republic of Moldova,46,17,29
1990,250,France,Republic of Moldova,861,465,396
1990,276,Germany,Republic of Moldova,1218,252,966
1990,528,Netherlands,Republic of Moldova,4,3,1
1990,756,Switzerland,Republic of Moldova,155,47,108
1990,124,Canada,Republic of Moldova,2284,1112,1172
1990,840,United States of America,Republic of Moldova,10932,5348,5584
1995,818,Egypt,Republic of Moldova,45,40,5
1995,31,Azerbaijan,Republic of Moldova,339,58,281
1995,196,Cyprus,Republic of Moldova,331,63,268
1995,268,Georgia,Republic of Moldova,3659,1671,1988
1995,376,Israel,Republic of Moldova,26793,12457,14336
1995,400,Jordan,Republic of Moldova,23,0,23
1995,792,Turkey,Republic of Moldova,1366,232,1134
1995,398,Kazakhstan,Republic of Moldova,10999,5489,5510
1995,417,Kyrgyzstan,Republic of Moldova,6653,2922,3731
1995,762,Tajikistan,Republic of Moldova,1389,548,841
1995,214,Dominican Republic,Republic of Moldova,7,3,4
1995,188,Costa Rica,Republic of Moldova,2,1,1
1995,32,Argentina,Republic of Moldova,979,420,559
1995,68,Bolivia (Plurinational State of),Republic of Moldova,1,0,1
1995,152,Chile,Republic of Moldova,6,3,3
1995,36,Australia,Republic of Moldova,316,153,163
1995,112,Belarus,Republic of Moldova,8361,4474,3887
1995,100,Bulgaria,Republic of Moldova,821,303,518
1995,203,Czechia,Republic of Moldova,303,183,120
1995,348,Hungary,Republic of Moldova,103,41,62
1995,616,Poland,Republic of Moldova,399,149,250
1995,642,Romania,Republic of Moldova,45512,17989,27523
1995,643,Russian Federation,Republic of Moldova,289707,150599,139108
1995,703,Slovakia,Republic of Moldova,35,16,19
1995,804,Ukraine,Republic of Moldova,174541,77261,97280
1995,208,Denmark,Republic of Moldova,63,21,42
1995,233,Estonia,Republic of Moldova,1207,709,498
1995,246,Finland,Republic of Moldova,7,4,3
1995,352,Iceland,Republic of Moldova,1,1,0
1995,372,Ireland,Republic of Moldova,616,290,326
1995,428,Latvia,Republic of Moldova,2027,1116,911
1995,440,Lithuania,Republic of Moldova,1081,617,464
1995,578,Norway,Republic of Moldova,4,0,4
1995,752,Sweden,Republic of Moldova,69,25,44
1995,826,United Kingdom,Republic of Moldova,243,121,122
1995,300,Greece,Republic of Moldova,7674,3468,4206
1995,380,Italy,Republic of Moldova,3371,911,2460
1995,470,Malta,Republic of Moldova,8,1,7
1995,620,Portugal,Republic of Moldova,1915,1580,335
1995,688,Serbia,Republic of Moldova,179,29,150
1995,705,Slovenia,Republic of Moldova,36,18,18
1995,724,Spain,Republic of Moldova,94,43,51
1995,40,Austria,Republic of Moldova,1106,433,673
1995,56,Belgium,Republic of Moldova,46,17,29
1995,250,France,Republic of Moldova,889,473,416
1995,276,Germany,Republic of Moldova,8538,4029,4509
1995,528,Netherlands,Republic of Moldova,5,4,1
1995,756,Switzerland,Republic of Moldova,451,146,305
1995,124,Canada,Republic of Moldova,2294,1112,1182
1995,840,United States of America,Republic of Moldova,15422,7628,7794
2000,818,Egypt,Republic of Moldova,46,41,5
2000,31,Azerbaijan,Republic of Moldova,342,55,287
2000,196,Cyprus,Republic of Moldova,428,75,353
2000,268,Georgia,Republic of Moldova,466,87,379
2000,376,Israel,Republic of Moldova,23516,10865,12651
2000,400,Jordan,Republic of Moldova,44,0,44
2000,792,Turkey,Republic of Moldova,2173,347,1826
2000,398,Kazakhstan,Republic of Moldova,8849,4359,4490
2000,417,Kyrgyzstan,Republic of Moldova,5058,2312,2746
2000,762,Tajikistan,Republic of Moldova,833,318,515
2000,214,Dominican Republic,Republic of Moldova,7,3,4
2000,188,Costa Rica,Republic of Moldova,3,2,1
2000,32,Argentina,Republic of Moldova,955,416,539
2000,68,Bolivia (Plurinational State of),Republic of Moldova,2,1,1
2000,152,Chile,Republic of Moldova,9,4,5
2000,36,Australia,Republic of Moldova,570,273,297
2000,112,Belarus,Republic of Moldova,7895,4244,3651
2000,100,Bulgaria,Republic of Moldova,1059,369,690
2000,203,Czechia,Republic of Moldova,403,245,158
2000,348,Hungary,Republic of Moldova,150,59,91
2000,616,Poland,Republic of Moldova,341,124,217
2000,642,Romania,Republic of Moldova,38405,14966,23439
2000,643,Russian Federation,Republic of Moldova,276101,152104,123997
2000,703,Slovakia,Republic of Moldova,73,34,39
2000,804,Ukraine,Republic of Moldova,171185,78324,92861
2000,208,Denmark,Republic of Moldova,67,22,45
2000,233,Estonia,Republic of Moldova,870,478,392
2000,246,Finland,Republic of Moldova,13,8,5
2000,352,Iceland,Republic of Moldova,1,1,0
2000,372,Ireland,Republic of Moldova,1457,711,746
2000,428,Latvia,Republic of Moldova,2426,1279,1147
2000,440,Lithuania,Republic of Moldova,846,482,364
2000,578,Norway,Republic of Moldova,23,4,19
2000,752,Sweden,Republic of Moldova,74,26,48
2000,826,United Kingdom,Republic of Moldova,430,207,223
2000,300,Greece,Republic of Moldova,6297,1833,4464
2000,380,Italy,Republic of Moldova,6658,1794,4864
2000,470,Malta,Republic of Moldova,20,3,17
2000,620,Portugal,Republic of Moldova,3022,2494,528
2000,688,Serbia,Republic of Moldova,244,35,209
2000,705,Slovenia,Republic of Moldova,41,19,22
2000,724,Spain,Republic of Moldova,213,99,114
2000,40,Austria,Republic of Moldova,1231,492,739
2000,56,Belgium,Republic of Moldova,44,16,28
2000,250,France,Republic of Moldova,916,481,435
2000,276,Germany,Republic of Moldova,15857,7805,8052
2000,528,Netherlands,Republic of Moldova,9,5,4
2000,756,Switzerland,Republic of Moldova,750,247,503
2000,124,Canada,Republic of Moldova,2358,1138,1220
2000,840,United States of America,Republic of Moldova,20002,9965,10037
2005,818,Egypt,Republic of Moldova,55,49,6
2005,31,Azerbaijan,Republic of Moldova,324,43,281
2005,196,Cyprus,Republic of Moldova,626,106,520
2005,268,Georgia,Republic of Moldova,442,82,360
2005,376,Israel,Republic of Moldova,16945,7784,9161
2005,400,Jordan,Republic of Moldova,64,9,55
2005,792,Turkey,Republic of Moldova,2239,315,1924
2005,398,Kazakhstan,Republic of Moldova,10088,5105,4983
2005,417,Kyrgyzstan,Republic of Moldova,4070,1849,2221
2005,762,Tajikistan,Republic of Moldova,803,290,513
2005,214,Dominican Republic,Republic of Moldova,9,4,5
2005,188,Costa Rica,Republic of Moldova,2,1,1
2005,32,Argentina,Republic of Moldova,705,313,392
2005,68,Bolivia (Plurinational State of),Republic of Moldova,5,3,2
2005,152,Chile,Republic of Moldova,13,6,7
2005,36,Australia,Republic of Moldova,810,373,437
2005,112,Belarus,Republic of Moldova,7786,4184,3602
2005,100,Bulgaria,Republic of Moldova,1467,521,946
2005,203,Czechia,Republic of Moldova,5361,3383,1978
2005,348,Hungary,Republic of Moldova,185,75,110
2005,616,Poland,Republic of Moldova,450,189,261
2005,642,Romania,Republic of Moldova,40681,16880,23801
2005,643,Russian Federation,Republic of Moldova,285390,154470,130920
2005,703,Slovakia,Republic of Moldova,82,39,43
2005,804,Ukraine,Republic of Moldova,156418,71686,84732
2005,208,Denmark,Republic of Moldova,188,74,114
2005,233,Estonia,Republic of Moldova,881,480,401
2005,246,Finland,Republic of Moldova,54,26,28
2005,352,Iceland,Republic of Moldova,7,3,4
2005,372,Ireland,Republic of Moldova,2814,1498,1316
2005,428,Latvia,Republic of Moldova,2261,1192,1069
2005,440,Lithuania,Republic of Moldova,834,488,346
2005,578,Norway,Republic of Moldova,169,56,113
2005,752,Sweden,Republic of Moldova,219,74,145
2005,826,United Kingdom,Republic of Moldova,1668,712,956
2005,191,Croatia,Republic of Moldova,57,7,50
2005,300,Greece,Republic of Moldova,8283,2443,5840
2005,380,Italy,Republic of Moldova,86725,28457,58268
2005,470,Malta,Republic of Moldova,33,5,28
2005,620,Portugal,Republic of Moldova,11135,6952,4183
2005,688,Serbia,Republic of Moldova,241,32,209
2005,705,Slovenia,Republic of Moldova,142,54,88
2005,724,Spain,Republic of Moldova,8519,4835,3684
2005,40,Austria,Republic of Moldova,1376,530,846
2005,56,Belgium,Republic of Moldova,108,41,67
2005,250,France,Republic of Moldova,3891,1721,2170
2005,276,Germany,Republic of Moldova,17473,8284,9189
2005,528,Netherlands,Republic of Moldova,37,18,19
2005,756,Switzerland,Republic of Moldova,875,254,621
2005,124,Canada,Republic of Moldova,7202,3602,3600
2005,840,United States of America,Republic of Moldova,25387,12719,12668
2010,818,Egypt,Republic of Moldova,59,52,7
2010,31,Azerbaijan,Republic of Moldova,297,49,248
2010,196,Cyprus,Republic of Moldova,1025,185,840
2010,268,Georgia,Republic of Moldova,446,83,363
2010,376,Israel,Republic of Moldova,10580,4779,5801
2010,400,Jordan,Republic of Moldova,83,16,67
2010,792,Turkey,Republic of Moldova,2307,280,2027
2010,398,Kazakhstan,Republic of Moldova,11327,5851,5476
2010,417,Kyrgyzstan,Republic of Moldova,3020,1353,1667
2010,762,Tajikistan,Republic of Moldova,801,292,509
2010,214,Dominican Republic,Republic of Moldova,11,5,6
2010,188,Costa Rica,Republic of Moldova,4,3,1
2010,32,Argentina,Republic of Moldova,454,210,244
2010,68,Bolivia (Plurinational State of),Republic of Moldova,7,5,2
2010,152,Chile,Republic of Moldova,18,9,9
2010,36,Australia,Republic of Moldova,1000,441,559
2010,112,Belarus,Republic of Moldova,7676,4124,3552
2010,100,Bulgaria,Republic of Moldova,1814,651,1163
2010,203,Czechia,Republic of Moldova,9786,6264,3522
2010,348,Hungary,Republic of Moldova,220,91,129
2010,616,Poland,Republic of Moldova,575,259,316
2010,642,Romania,Republic of Moldova,50455,22259,28196
2010,643,Russian Federation,Republic of Moldova,288805,153735,135070
2010,703,Slovakia,Republic of Moldova,92,44,48
2010,804,Ukraine,Republic of Moldova,149246,68511,80735
2010,208,Denmark,Republic of Moldova,302,123,179
2010,233,Estonia,Republic of Moldova,884,475,409
2010,246,Finland,Republic of Moldova,104,47,57
2010,352,Iceland,Republic of Moldova,13,6,7
2010,372,Ireland,Republic of Moldova,3707,1870,1837
2010,428,Latvia,Republic of Moldova,2039,1059,980
2010,440,Lithuania,Republic of Moldova,710,410,300
2010,578,Norway,Republic of Moldova,303,98,205
2010,752,Sweden,Republic of Moldova,446,153,293
2010,826,United Kingdom,Republic of Moldova,1757,771,986
2010,191,Croatia,Republic of Moldova,113,13,100
2010,300,Greece,Republic of Moldova,10684,3179,7505
2010,380,Italy,Republic of Moldova,159899,52489,107410
2010,470,Malta,Republic of Moldova,28,5,23
2010,620,Portugal,Republic of Moldova,17400,10265,7135
2010,688,Serbia,Republic of Moldova,236,31,205
2010,705,Slovenia,Republic of Moldova,287,108,179
2010,724,Spain,Republic of Moldova,17111,8777,8334
2010,40,Austria,Republic of Moldova,1521,569,952
2010,56,Belgium,Republic of Moldova,244,123,121
2010,250,France,Republic of Moldova,6160,3169,2991
2010,276,Germany,Republic of Moldova,18766,8653,10113
2010,528,Netherlands,Republic of Moldova,61,32,29
2010,756,Switzerland,Republic of Moldova,991,252,739
2010,124,Canada,Republic of Moldova,12195,6149,6046
2010,840,United States of America,Republic of Moldova,31694,15662,16032
2015,324,Guinea,Republic of Moldova,3,2,1
2015,818,Egypt,Republic of Moldova,43,39,4
2015,31,Azerbaijan,Republic of Moldova,283,51,232
2015,196,Cyprus,Republic of Moldova,984,183,801
2015,268,Georgia,Republic of Moldova,468,87,381
2015,376,Israel,Republic of Moldova,10911,4899,6012
2015,400,Jordan,Republic of Moldova,35,0,35
2015,792,Turkey,Republic of Moldova,2341,237,2104
2015,398,Kazakhstan,Republic of Moldova,12048,6319,5729
2015,417,Kyrgyzstan,Republic of Moldova,2660,1183,1477
2015,762,Tajikistan,Republic of Moldova,787,284,503
2015,214,Dominican Republic,Republic of Moldova,11,5,6
2015,188,Costa Rica,Republic of Moldova,4,3,1
2015,32,Argentina,Republic of Moldova,456,211,245
2015,68,Bolivia (Plurinational State of),Republic of Moldova,8,6,2
2015,152,Chile,Republic of Moldova,27,14,13
2015,36,Australia,Republic of Moldova,1160,529,631
2015,112,Belarus,Republic of Moldova,7608,4089,3519
2015,100,Bulgaria,Republic of Moldova,2363,880,1483
2015,203,Czechia,Republic of Moldova,6849,3986,2863
2015,348,Hungary,Republic of Moldova,222,91,131
2015,616,Poland,Republic of Moldova,554,256,298
2015,642,Romania,Republic of Moldova,109623,53295,56328
2015,643,Russian Federation,Republic of Moldova,294314,155978,138336
2015,703,Slovakia,Republic of Moldova,125,67,58
2015,804,Ukraine,Republic of Moldova,149745,68852,80893
2015,208,Denmark,Republic of Moldova,443,190,253
2015,233,Estonia,Republic of Moldova,905,489,416
2015,246,Finland,Republic of Moldova,202,87,115
2015,352,Iceland,Republic of Moldova,21,9,12
2015,372,Ireland,Republic of Moldova,3787,1887,1900
2015,428,Latvia,Republic of Moldova,1705,851,854
2015,440,Lithuania,Republic of Moldova,563,308,255
2015,578,Norway,Republic of Moldova,781,352,429
2015,752,Sweden,Republic of Moldova,836,312,524
2015,826,United Kingdom,Republic of Moldova,2246,948,1298
2015,191,Croatia,Republic of Moldova,114,13,101
2015,300,Greece,Republic of Moldova,10027,2683,7344
2015,380,Italy,Republic of Moldova,171345,54974,116371
2015,470,Malta,Republic of Moldova,47,11,36
2015,620,Portugal,Republic of Moldova,19726,11222,8504
2015,688,Serbia,Republic of Moldova,230,30,200
2015,705,Slovenia,Republic of Moldova,338,120,218
2015,724,Spain,Republic of Moldova,17084,8050,9034
2015,40,Austria,Republic of Moldova,1779,672,1107
2015,56,Belgium,Republic of Moldova,775,386,389
2015,250,France,Republic of Moldova,6823,3420,3403
2015,276,Germany,Republic of Moldova,19553,8991,10562
2015,528,Netherlands,Republic of Moldova,173,85,88
2015,756,Switzerland,Republic of Moldova,1918,606,1312
2015,124,Canada,Republic of Moldova,17497,8544,8953
2015,840,United States of America,Republic of Moldova,43928,21593,22335
2019,324,Guinea,Republic of Moldova,2,2,0
2019,818,Egypt,Republic of Moldova,61,55,6
2019,31,Azerbaijan,Republic of Moldova,271,49,222
2019,196,Cyprus,Republic of Moldova,983,191,792
2019,268,Georgia,Republic of Moldova,482,90,392
2019,376,Israel,Republic of Moldova,10610,4764,5846
2019,400,Jordan,Republic of Moldova,37,0,37
2019,792,Turkey,Republic of Moldova,3165,349,2816
2019,398,Kazakhstan,Republic of Moldova,12589,6603,5986
2019,417,Kyrgyzstan,Republic of Moldova,2606,1159,1447
2019,762,Tajikistan,Republic of Moldova,784,283,501
2019,214,Dominican Republic,Republic of Moldova,11,5,6
2019,188,Costa Rica,Republic of Moldova,4,3,1
2019,32,Argentina,Republic of Moldova,463,214,249
2019,68,Bolivia (Plurinational State of),Republic of Moldova,8,6,2
2019,152,Chile,Republic of Moldova,36,18,18
2019,36,Australia,Republic of Moldova,1248,545,703
2019,112,Belarus,Republic of Moldova,7513,4038,3475
2019,100,Bulgaria,Republic of Moldova,2990,1126,1864
2019,203,Czechia,Republic of Moldova,8254,4841,3413
2019,348,Hungary,Republic of Moldova,248,115,133
2019,616,Poland,Republic of Moldova,586,283,303
2019,642,Romania,Republic of Moldova,177482,92047,85435
2019,643,Russian Federation,Republic of Moldova,294245,155942,138303
2019,703,Slovakia,Republic of Moldova,153,88,65
2019,804,Ukraine,Republic of Moldova,151242,69541,81701
2019,208,Denmark,Republic of Moldova,906,450,456
2019,233,Estonia,Republic of Moldova,940,531,409
2019,246,Finland,Republic of Moldova,266,117,149
2019,352,Iceland,Republic of Moldova,49,25,24
2019,372,Ireland,Republic of Moldova,4157,2078,2079
2019,428,Latvia,Republic of Moldova,1594,794,800
2019,440,Lithuania,Republic of Moldova,615,411,204
2019,578,Norway,Republic of Moldova,1071,499,572
2019,752,Sweden,Republic of Moldova,1378,565,813
2019,826,United Kingdom,Republic of Moldova,2550,1080,1470
2019,191,Croatia,Republic of Moldova,105,12,93
2019,300,Greece,Republic of Moldova,9792,2892,6900
2019,380,Italy,Republic of Moldova,188923,61437,127486
2019,470,Malta,Republic of Moldova,75,18,57
2019,620,Portugal,Republic of Moldova,20061,11432,8629
2019,688,Serbia,Republic of Moldova,233,30,203
2019,705,Slovenia,Republic of Moldova,347,121,226
2019,724,Spain,Republic of Moldova,19031,8691,10340
2019,40,Austria,Republic of Moldova,2100,816,1284
2019,56,Belgium,Republic of Moldova,1327,643,684
2019,250,France,Republic of Moldova,7222,3612,3610
2019,276,Germany,Republic of Moldova,21448,9724,11724
2019,528,Netherlands,Republic of Moldova,490,235,255
2019,756,Switzerland,Republic of Moldova,2586,913,1673
2019,124,Canada,Republic of Moldova,18750,9156,9594
2019,840,United States of America,Republic of Moldova,47437,23060,24377
1990,174,Comoros,Réunion,957,507,450
1990,710,South Africa,Réunion,1143,618,525
1990,312,Guadeloupe,Réunion,244,117,127
1990,474,Martinique,Réunion,253,77,176
1990,254,French Guiana,Réunion,365,188,177
1990,36,Australia,Réunion,51,26,25
1990,208,Denmark,Réunion,5,3,2
1990,826,United Kingdom,Réunion,1,1,0
1990,300,Greece,Réunion,5,3,2
1990,124,Canada,Réunion,63,31,32
1995,174,Comoros,Réunion,948,500,448
1995,710,South Africa,Réunion,561,283,278
1995,312,Guadeloupe,Réunion,294,138,156
1995,474,Martinique,Réunion,309,93,216
1995,152,Chile,Réunion,1,1,0
1995,254,French Guiana,Réunion,381,188,193
1995,36,Australia,Réunion,52,14,38
1995,208,Denmark,Réunion,3,2,1
1995,826,United Kingdom,Réunion,7,6,1
1995,300,Greece,Réunion,5,3,2
1995,124,Canada,Réunion,63,30,33
2000,174,Comoros,Réunion,938,493,445
2000,710,South Africa,Réunion,141,17,124
2000,312,Guadeloupe,Réunion,344,160,184
2000,474,Martinique,Réunion,366,110,256
2000,152,Chile,Réunion,2,0,2
2000,254,French Guiana,Réunion,396,187,209
2000,36,Australia,Réunion,90,45,45
2000,826,United Kingdom,Réunion,15,12,3
2000,300,Greece,Réunion,6,3,3
2000,124,Canada,Réunion,64,30,34
2005,174,Comoros,Réunion,898,475,423
2005,710,South Africa,Réunion,185,14,171
2005,312,Guadeloupe,Réunion,364,131,233
2005,474,Martinique,Réunion,383,108,275
2005,152,Chile,Réunion,3,1,2
2005,254,French Guiana,Réunion,374,176,198
2005,36,Australia,Réunion,140,54,86
2005,826,United Kingdom,Réunion,13,10,3
2005,300,Greece,Réunion,3,1,2
2005,124,Canada,Réunion,196,99,97
2010,174,Comoros,Réunion,857,457,400
2010,710,South Africa,Réunion,289,21,268
2010,312,Guadeloupe,Réunion,383,101,282
2010,474,Martinique,Réunion,400,106,294
2010,152,Chile,Réunion,4,1,3
2010,254,French Guiana,Réunion,351,164,187
2010,36,Australia,Réunion,210,96,114
2010,233,Estonia,Réunion,1,1,0
2010,826,United Kingdom,Réunion,13,10,3
2010,124,Canada,Réunion,265,137,128
2015,174,Comoros,Réunion,850,455,395
2015,710,South Africa,Réunion,520,13,507
2015,312,Guadeloupe,Réunion,397,102,295
2015,474,Martinique,Réunion,414,107,307
2015,152,Chile,Réunion,6,2,4
2015,254,French Guiana,Réunion,353,163,190
2015,36,Australia,Réunion,220,99,121
2015,826,United Kingdom,Réunion,16,13,3
2015,124,Canada,Réunion,293,144,149
2019,174,Comoros,Réunion,846,453,393
2019,710,South Africa,Réunion,582,15,567
2019,312,Guadeloupe,Réunion,403,104,299
2019,474,Martinique,Réunion,413,107,306
2019,152,Chile,Réunion,8,3,5
2019,254,French Guiana,Réunion,390,180,210
2019,36,Australia,Réunion,264,122,142
2019,826,United Kingdom,Réunion,18,15,3
2019,124,Canada,Réunion,313,154,159
1990,516,Namibia,Romania,45,24,21
1990,710,South Africa,Romania,773,367,406
1990,818,Egypt,Romania,226,119,107
1990,434,Libya,Romania,645,343,302
1990,196,Cyprus,Romania,1345,423,922
1990,268,Georgia,Romania,390,180,210
1990,376,Israel,Romania,128886,58736,70150
1990,400,Jordan,Romania,310,22,288
1990,792,Turkey,Romania,5018,2190,2828
1990,417,Kyrgyzstan,Romania,713,314,399
1990,608,Philippines,Romania,2,2,0
1990,192,Cuba,Romania,153,48,105
1990,214,Dominican Republic,Romania,30,16,14
1990,188,Costa Rica,Romania,62,26,36
1990,484,Mexico,Romania,278,174,104
1990,591,Panama,Romania,38,24,14
1990,32,Argentina,Romania,3713,1537,2176
1990,68,Bolivia (Plurinational State of),Romania,61,23,38
1990,76,Brazil,Romania,6604,3231,3373
1990,152,Chile,Romania,435,220,215
1990,170,Colombia,Romania,458,258,200
1990,218,Ecuador,Romania,101,45,56
1990,604,Peru,Romania,113,52,61
1990,858,Uruguay,Romania,811,420,391
1990,862,Venezuela (Bolivarian Republic of),Romania,774,354,420
1990,36,Australia,Romania,12241,6650,5591
1990,554,New Zealand,Romania,271,148,123
1990,112,Belarus,Romania,10,6,4
1990,100,Bulgaria,Romania,143,55,88
1990,203,Czechia,Romania,2945,1476,1469
1990,348,Hungary,Romania,194128,86252,107876
1990,616,Poland,Romania,4748,2073,2675
1990,498,Republic of Moldova,Romania,5138,2595,2543
1990,643,Russian Federation,Romania,3936,1931,2005
1990,703,Slovakia,Romania,1115,515,600
1990,208,Denmark,Romania,877,428,449
1990,234,Faroe Islands,Romania,1,1,0
1990,246,Finland,Romania,157,104,53
1990,352,Iceland,Romania,1,1,0
1990,372,Ireland,Romania,430,211,219
1990,428,Latvia,Romania,3562,1677,1885
1990,440,Lithuania,Romania,35,19,16
1990,578,Norway,Romania,286,150,136
1990,752,Sweden,Romania,9253,4282,4971
1990,826,United Kingdom,Romania,3873,2045,1828
1990,70,Bosnia and Herzegovina,Romania,624,107,517
1990,300,Greece,Romania,5983,2940,3043
1990,380,Italy,Romania,40066,11674,28392
1990,470,Malta,Romania,76,31,45
1990,807,North Macedonia,Romania,24,10,14
1990,620,Portugal,Romania,818,598,220
1990,674,San Marino,Romania,43,14,29
1990,688,Serbia,Romania,443,87,356
1990,705,Slovenia,Romania,63,27,36
1990,724,Spain,Romania,2145,1111,1034
1990,40,Austria,Romania,24968,9408,15560
1990,56,Belgium,Romania,2261,882,1379
1990,250,France,Romania,31928,15536,16392
1990,276,Germany,Romania,176920,93373,83547
1990,438,Liechtenstein,Romania,2,0,2
1990,442,Luxembourg,Romania,106,45,61
1990,528,Netherlands,Romania,1665,691,974
1990,756,Switzerland,Romania,6255,2572,3683
1990,60,Bermuda,Romania,14,8,6
1990,124,Canada,Romania,32422,15784,16638
1990,840,United States of America,Romania,91106,42684,48422
1995,516,Namibia,Romania,43,24,19
1995,710,South Africa,Romania,631,311,320
1995,818,Egypt,Romania,194,92,102
1995,434,Libya,Romania,537,247,290
1995,196,Cyprus,Romania,1902,546,1356
1995,268,Georgia,Romania,396,185,211
1995,376,Israel,Romania,131109,58689,72420
1995,400,Jordan,Romania,320,44,276
1995,792,Turkey,Romania,12145,5014,7131
1995,417,Kyrgyzstan,Romania,718,324,394
1995,608,Philippines,Romania,2,2,0
1995,44,Bahamas,Romania,12,12,0
1995,192,Cuba,Romania,116,33,83
1995,214,Dominican Republic,Romania,34,18,16
1995,188,Costa Rica,Romania,55,25,30
1995,484,Mexico,Romania,310,154,156
1995,591,Panama,Romania,52,32,20
1995,32,Argentina,Romania,2985,1264,1721
1995,68,Bolivia (Plurinational State of),Romania,31,12,19
1995,76,Brazil,Romania,5069,2432,2637
1995,152,Chile,Romania,393,202,191
1995,170,Colombia,Romania,370,206,164
1995,218,Ecuador,Romania,114,51,63
1995,604,Peru,Romania,114,52,62
1995,858,Uruguay,Romania,748,373,375
1995,862,Venezuela (Bolivarian Republic of),Romania,764,349,415
1995,36,Australia,Romania,13159,6992,6167
1995,554,New Zealand,Romania,360,190,170
1995,112,Belarus,Romania,17,8,9
1995,100,Bulgaria,Romania,1393,552,841
1995,203,Czechia,Romania,4417,2275,2142
1995,348,Hungary,Romania,170168,76685,93483
1995,616,Poland,Romania,4061,1739,2322
1995,498,Republic of Moldova,Romania,3468,1707,1761
1995,643,Russian Federation,Romania,4284,2027,2257
1995,703,Slovakia,Romania,2843,1570,1273
1995,208,Denmark,Romania,1435,623,812
1995,234,Faroe Islands,Romania,1,1,0
1995,246,Finland,Romania,375,228,147
1995,352,Iceland,Romania,34,24,10
1995,372,Ireland,Romania,2334,1108,1226
1995,428,Latvia,Romania,1815,857,958
1995,440,Lithuania,Romania,40,22,18
1995,578,Norway,Romania,577,240,337
1995,752,Sweden,Romania,10980,5035,5945
1995,826,United Kingdom,Romania,5579,2719,2860
1995,70,Bosnia and Herzegovina,Romania,524,97,427
1995,191,Croatia,Romania,166,53,113
1995,300,Greece,Romania,16015,8334,7681
1995,380,Italy,Romania,79401,31244,48157
1995,470,Malta,Romania,89,37,52
1995,807,North Macedonia,Romania,22,9,13
1995,620,Portugal,Romania,1766,1289,477
1995,674,San Marino,Romania,71,16,55
1995,688,Serbia,Romania,2815,504,2311
1995,705,Slovenia,Romania,93,30,63
1995,724,Spain,Romania,4375,2336,2039
1995,40,Austria,Romania,28168,10901,17267
1995,56,Belgium,Romania,2714,1072,1642
1995,250,France,Romania,32961,15754,17207
1995,276,Germany,Romania,249921,131710,118211
1995,438,Liechtenstein,Romania,5,1,4
1995,442,Luxembourg,Romania,203,73,130
1995,528,Netherlands,Romania,2804,1124,1680
1995,756,Switzerland,Romania,7770,3220,4550
1995,60,Bermuda,Romania,17,14,3
1995,124,Canada,Romania,46036,22276,23760
1995,840,United States of America,Romania,115055,54506,60549
2000,516,Namibia,Romania,41,21,20
2000,710,South Africa,Romania,680,336,344
2000,818,Egypt,Romania,177,71,106
2000,434,Libya,Romania,438,161,277
2000,196,Cyprus,Romania,2459,669,1790
2000,268,Georgia,Romania,213,51,162
2000,376,Israel,Romania,125991,56133,69858
2000,400,Jordan,Romania,330,68,262
2000,792,Turkey,Romania,19316,7843,11473
2000,417,Kyrgyzstan,Romania,701,324,377
2000,608,Philippines,Romania,154,82,72
2000,44,Bahamas,Romania,25,25,0
2000,192,Cuba,Romania,79,19,60
2000,214,Dominican Republic,Romania,37,19,18
2000,188,Costa Rica,Romania,76,37,39
2000,484,Mexico,Romania,357,142,215
2000,591,Panama,Romania,71,42,29
2000,32,Argentina,Romania,2257,992,1265
2000,76,Brazil,Romania,3534,1633,1901
2000,152,Chile,Romania,352,180,172
2000,170,Colombia,Romania,281,153,128
2000,218,Ecuador,Romania,126,56,70
2000,604,Peru,Romania,134,61,73
2000,858,Uruguay,Romania,690,330,360
2000,862,Venezuela (Bolivarian Republic of),Romania,748,341,407
2000,36,Australia,Romania,14180,7219,6961
2000,554,New Zealand,Romania,892,434,458
2000,112,Belarus,Romania,23,10,13
2000,100,Bulgaria,Romania,2642,1049,1593
2000,203,Czechia,Romania,5889,3074,2815
2000,348,Hungary,Romania,146208,67119,79089
2000,616,Poland,Romania,3475,1458,2017
2000,498,Republic of Moldova,Romania,2341,1121,1220
2000,643,Russian Federation,Romania,4477,2049,2428
2000,703,Slovakia,Romania,5353,3079,2274
2000,208,Denmark,Romania,1993,819,1174
2000,234,Faroe Islands,Romania,11,7,4
2000,246,Finland,Romania,593,353,240
2000,352,Iceland,Romania,66,46,20
2000,372,Ireland,Romania,5520,2711,2809
2000,428,Latvia,Romania,69,38,31
2000,440,Lithuania,Romania,31,17,14
2000,578,Norway,Romania,1082,431,651
2000,752,Sweden,Romania,11776,5359,6417
2000,826,United Kingdom,Romania,7379,3431,3948
2000,70,Bosnia and Herzegovina,Romania,424,88,336
2000,191,Croatia,Romania,314,102,212
2000,300,Greece,Romania,26311,13726,12585
2000,380,Italy,Romania,118736,50814,67922
2000,470,Malta,Romania,224,93,131
2000,807,North Macedonia,Romania,21,9,12
2000,620,Portugal,Romania,2787,2035,752
2000,674,San Marino,Romania,100,18,82
2000,688,Serbia,Romania,3828,619,3209
2000,705,Slovenia,Romania,135,41,94
2000,724,Spain,Romania,8489,4621,3868
2000,40,Austria,Romania,31368,12394,18974
2000,56,Belgium,Romania,2712,1092,1620
2000,250,France,Romania,33993,15972,18021
2000,276,Germany,Romania,322922,170047,152875
2000,438,Liechtenstein,Romania,8,1,7
2000,442,Luxembourg,Romania,303,101,202
2000,528,Netherlands,Romania,4036,1588,2448
2000,756,Switzerland,Romania,9315,3894,5421
2000,60,Bermuda,Romania,19,19,0
2000,124,Canada,Romania,60745,29304,31441
2000,840,United States of America,Romania,139418,66621,72797
2005,516,Namibia,Romania,32,17,15
2005,710,South Africa,Romania,894,421,473
2005,818,Egypt,Romania,211,93,118
2005,434,Libya,Romania,483,233,250
2005,196,Cyprus,Romania,3599,962,2637
2005,268,Georgia,Romania,202,49,153
2005,376,Israel,Romania,112577,50026,62551
2005,400,Jordan,Romania,476,144,332
2005,792,Turkey,Romania,19905,7815,12090
2005,417,Kyrgyzstan,Romania,628,289,339
2005,608,Philippines,Romania,124,67,57
2005,44,Bahamas,Romania,60,58,2
2005,192,Cuba,Romania,52,12,40
2005,214,Dominican Republic,Romania,39,18,21
2005,188,Costa Rica,Romania,50,24,26
2005,484,Mexico,Romania,356,136,220
2005,591,Panama,Romania,109,75,34
2005,32,Argentina,Romania,1666,747,919
2005,68,Bolivia (Plurinational State of),Romania,31,13,18
2005,76,Brazil,Romania,2631,1193,1438
2005,152,Chile,Romania,528,275,253
2005,170,Colombia,Romania,225,120,105
2005,218,Ecuador,Romania,148,67,81
2005,604,Peru,Romania,157,72,85
2005,858,Uruguay,Romania,639,306,333
2005,862,Venezuela (Bolivarian Republic of),Romania,786,359,427
2005,36,Australia,Romania,15680,7840,7840
2005,554,New Zealand,Romania,2180,1059,1121
2005,112,Belarus,Romania,22,9,13
2005,100,Bulgaria,Romania,4308,1771,2537
2005,203,Czechia,Romania,5109,2865,2244
2005,348,Hungary,Romania,180592,84639,95953
2005,616,Poland,Romania,2977,1243,1734
2005,498,Republic of Moldova,Romania,1617,758,859
2005,643,Russian Federation,Romania,4200,1890,2310
2005,703,Slovakia,Romania,6003,3496,2507
2005,208,Denmark,Romania,4233,2030,2203
2005,234,Faroe Islands,Romania,48,25,23
2005,246,Finland,Romania,1164,661,503
2005,352,Iceland,Romania,137,82,55
2005,372,Ireland,Romania,13632,6949,6683
2005,428,Latvia,Romania,191,157,34
2005,440,Lithuania,Romania,130,111,19
2005,578,Norway,Romania,1656,568,1088
2005,752,Sweden,Romania,12748,5607,7141
2005,826,United Kingdom,Romania,41778,20825,20953
2005,70,Bosnia and Herzegovina,Romania,323,67,256
2005,191,Croatia,Romania,405,135,270
2005,300,Greece,Romania,36759,17068,19691
2005,380,Italy,Romania,570087,240599,329488
2005,470,Malta,Romania,351,147,204
2005,807,North Macedonia,Romania,21,9,12
2005,620,Portugal,Romania,12468,6818,5650
2005,674,San Marino,Romania,104,20,84
2005,688,Serbia,Romania,3776,575,3201
2005,705,Slovenia,Romania,194,54,140
2005,724,Spain,Romania,292379,159248,133131
2005,40,Austria,Romania,45724,19423,26301
2005,56,Belgium,Romania,10777,5224,5553
2005,250,France,Romania,43381,19875,23506
2005,276,Germany,Romania,407829,199981,207848
2005,438,Liechtenstein,Romania,13,3,10
2005,442,Luxembourg,Romania,717,238,479
2005,528,Netherlands,Romania,6314,2285,4029
2005,756,Switzerland,Romania,10869,4221,6648
2005,60,Bermuda,Romania,23,18,5
2005,124,Canada,Romania,69035,33167,35868
2005,304,Greenland,Romania,8,8,0
2005,840,United States of America,Romania,152171,73155,79016
2010,516,Namibia,Romania,30,16,14
2010,710,South Africa,Romania,1400,657,743
2010,818,Egypt,Romania,228,96,132
2010,434,Libya,Romania,529,258,271
2010,196,Cyprus,Romania,5893,1629,4264
2010,268,Georgia,Romania,204,50,154
2010,376,Israel,Romania,100528,44398,56130
2010,400,Jordan,Romania,611,209,402
2010,792,Turkey,Romania,20512,7772,12740
2010,417,Kyrgyzstan,Romania,547,248,299
2010,608,Philippines,Romania,34,18,16
2010,44,Bahamas,Romania,94,90,4
2010,192,Cuba,Romania,28,6,22
2010,214,Dominican Republic,Romania,41,18,23
2010,188,Costa Rica,Romania,98,47,51
2010,484,Mexico,Romania,397,146,251
2010,591,Panama,Romania,154,112,42
2010,32,Argentina,Romania,1074,502,572
2010,68,Bolivia (Plurinational State of),Romania,62,26,36
2010,76,Brazil,Romania,1691,734,957
2010,152,Chile,Romania,704,369,335
2010,170,Colombia,Romania,207,109,98
2010,218,Ecuador,Romania,208,92,116
2010,604,Peru,Romania,176,81,95
2010,858,Uruguay,Romania,592,281,311
2010,862,Venezuela (Bolivarian Republic of),Romania,834,382,452
2010,36,Australia,Romania,16650,8112,8538
2010,554,New Zealand,Romania,2267,1099,1168
2010,112,Belarus,Romania,20,7,13
2010,100,Bulgaria,Romania,5792,2417,3375
2010,203,Czechia,Romania,3872,2498,1374
2010,348,Hungary,Romania,214976,102159,112817
2010,616,Poland,Romania,2573,1055,1518
2010,498,Republic of Moldova,Romania,1648,785,863
2010,643,Russian Federation,Romania,3837,1693,2144
2010,703,Slovakia,Romania,6731,3958,2773
2010,208,Denmark,Romania,6358,3185,3173
2010,233,Estonia,Romania,64,40,24
2010,234,Faroe Islands,Romania,81,43,38
2010,246,Finland,Romania,1924,1002,922
2010,352,Iceland,Romania,206,118,88
2010,372,Ireland,Romania,19499,9196,10303
2010,428,Latvia,Romania,310,272,38
2010,440,Lithuania,Romania,213,190,23
2010,578,Norway,Romania,4390,2225,2165
2010,752,Sweden,Romania,19741,9415,10326
2010,826,United Kingdom,Romania,173039,90644,82395
2010,70,Bosnia and Herzegovina,Romania,409,88,321
2010,191,Croatia,Romania,496,168,328
2010,300,Greece,Romania,49116,21246,27870
2010,380,Italy,Romania,1016949,433624,583325
2010,470,Malta,Romania,554,243,311
2010,499,Montenegro,Romania,101,46,55
2010,807,North Macedonia,Romania,22,10,12
2010,620,Portugal,Romania,20079,10481,9598
2010,674,San Marino,Romania,109,20,89
2010,688,Serbia,Romania,3691,559,3132
2010,705,Slovenia,Romania,283,90,193
2010,724,Spain,Romania,727521,384181,343340
2010,40,Austria,Romania,60079,26451,33628
2010,56,Belgium,Romania,30641,15252,15389
2010,250,France,Romania,84320,39358,44962
2010,276,Germany,Romania,477488,225119,252369
2010,438,Liechtenstein,Romania,19,4,15
2010,442,Luxembourg,Romania,1140,378,762
2010,528,Netherlands,Romania,11094,4075,7019
2010,756,Switzerland,Romania,12307,4350,7957
2010,60,Bermuda,Romania,26,17,9
2010,124,Canada,Romania,82595,39658,42937
2010,304,Greenland,Romania,10,10,0
2010,840,United States of America,Romania,169928,80478,89450
2015,516,Namibia,Romania,29,16,13
2015,710,South Africa,Romania,2524,1117,1407
2015,324,Guinea,Romania,5,4,1
2015,818,Egypt,Romania,169,84,85
2015,434,Libya,Romania,596,287,309
2015,196,Cyprus,Romania,5661,1592,4069
2015,268,Georgia,Romania,214,53,161
2015,376,Israel,Romania,103678,45507,58171
2015,400,Jordan,Romania,262,51,211
2015,792,Turkey,Romania,20822,7597,13225
2015,417,Kyrgyzstan,Romania,482,217,265
2015,608,Philippines,Romania,35,19,16
2015,44,Bahamas,Romania,102,98,4
2015,192,Cuba,Romania,22,5,17
2015,214,Dominican Republic,Romania,43,19,24
2015,188,Costa Rica,Romania,99,47,52
2015,484,Mexico,Romania,421,153,268
2015,591,Panama,Romania,182,133,49
2015,32,Argentina,Romania,1078,504,574
2015,68,Bolivia (Plurinational State of),Romania,72,30,42
2015,76,Brazil,Romania,2036,884,1152
2015,152,Chile,Romania,1066,548,518
2015,170,Colombia,Romania,231,123,108
2015,218,Ecuador,Romania,302,133,169
2015,604,Peru,Romania,186,89,97
2015,858,Uruguay,Romania,611,290,321
2015,862,Venezuela (Bolivarian Republic of),Romania,874,394,480
2015,36,Australia,Romania,17070,8292,8778
2015,554,New Zealand,Romania,2319,1122,1197
2015,112,Belarus,Romania,23,10,13
2015,100,Bulgaria,Romania,4612,1879,2733
2015,203,Czechia,Romania,5446,3678,1768
2015,348,Hungary,Romania,203407,98993,104414
2015,616,Poland,Romania,2480,1045,1435
2015,498,Republic of Moldova,Romania,1915,918,997
2015,643,Russian Federation,Romania,3911,1715,2196
2015,703,Slovakia,Romania,8299,5156,3143
2015,208,Denmark,Romania,14570,8083,6487
2015,233,Estonia,Romania,369,314,55
2015,234,Faroe Islands,Romania,62,32,30
2015,246,Finland,Romania,3203,1668,1535
2015,352,Iceland,Romania,400,211,189
2015,372,Ireland,Romania,19919,9264,10655
2015,428,Latvia,Romania,68,36,32
2015,440,Lithuania,Romania,211,190,21
2015,578,Norway,Romania,12137,6667,5470
2015,752,Sweden,Romania,26358,12891,13467
2015,826,United Kingdom,Romania,173039,90644,82395
2015,70,Bosnia and Herzegovina,Romania,406,87,319
2015,191,Croatia,Romania,499,168,331
2015,300,Greece,Romania,46098,18825,27273
2015,380,Italy,Romania,1016008,416601,599407
2015,470,Malta,Romania,940,448,492
2015,499,Montenegro,Romania,105,48,57
2015,807,North Macedonia,Romania,23,10,13
2015,620,Portugal,Romania,22763,11323,11440
2015,674,San Marino,Romania,135,20,115
2015,688,Serbia,Romania,3607,538,3069
2015,705,Slovenia,Romania,466,219,247
2015,724,Spain,Romania,646181,322609,323572
2015,40,Austria,Romania,70267,31151,39116
2015,56,Belgium,Romania,65150,33921,31229
2015,250,France,Romania,117373,57058,60315
2015,276,Germany,Romania,497518,233943,263575
2015,438,Liechtenstein,Romania,29,7,22
2015,442,Luxembourg,Romania,1739,595,1144
2015,528,Netherlands,Romania,14757,5493,9264
2015,756,Switzerland,Romania,21062,7389,13673
2015,60,Bermuda,Romania,26,17,9
2015,124,Canada,Romania,89756,42516,47240
2015,304,Greenland,Romania,14,13,1
2015,840,United States of America,Romania,177831,83741,94090
2019,516,Namibia,Romania,30,17,13
2019,710,South Africa,Romania,2828,1254,1574
2019,324,Guinea,Romania,4,4,0
2019,818,Egypt,Romania,240,105,135
2019,434,Libya,Romania,632,305,327
2019,196,Cyprus,Romania,5658,1633,4025
2019,268,Georgia,Romania,220,55,165
2019,376,Israel,Romania,100823,44254,56569
2019,400,Jordan,Romania,281,55,226
2019,792,Turkey,Romania,28155,10451,17704
2019,417,Kyrgyzstan,Romania,472,213,259
2019,608,Philippines,Romania,36,20,16
2019,44,Bahamas,Romania,108,104,4
2019,192,Cuba,Romania,20,5,15
2019,214,Dominican Republic,Romania,44,20,24
2019,188,Costa Rica,Romania,100,48,52
2019,484,Mexico,Romania,434,158,276
2019,591,Panama,Romania,190,140,50
2019,32,Argentina,Romania,1096,511,585
2019,68,Bolivia (Plurinational State of),Romania,78,33,45
2019,76,Brazil,Romania,2292,995,1297
2019,152,Chile,Romania,1424,694,730
2019,170,Colombia,Romania,236,126,110
2019,218,Ecuador,Romania,297,131,166
2019,604,Peru,Romania,218,108,110
2019,858,Uruguay,Romania,631,301,330
2019,862,Venezuela (Bolivarian Republic of),Romania,856,384,472
2019,36,Australia,Romania,17954,8648,9306
2019,554,New Zealand,Romania,2383,1153,1230
2019,112,Belarus,Romania,22,10,12
2019,100,Bulgaria,Romania,4556,1868,2688
2019,203,Czechia,Romania,7051,4897,2154
2019,348,Hungary,Romania,205472,99253,106219
2019,616,Poland,Romania,2626,1165,1461
2019,498,Republic of Moldova,Romania,1885,905,980
2019,643,Russian Federation,Romania,3910,1715,2195
2019,703,Slovakia,Romania,9214,5870,3344
2019,208,Denmark,Romania,28150,16149,12001
2019,233,Estonia,Romania,308,251,57
2019,234,Faroe Islands,Romania,112,75,37
2019,246,Finland,Romania,4253,2294,1959
2019,352,Iceland,Romania,793,466,327
2019,372,Ireland,Romania,21868,10206,11662
2019,428,Latvia,Romania,64,39,25
2019,440,Lithuania,Romania,266,239,27
2019,578,Norway,Romania,15264,8345,6919
2019,752,Sweden,Romania,33042,16797,16245
2019,826,United Kingdom,Romania,196503,103172,93331
2019,70,Bosnia and Herzegovina,Romania,376,81,295
2019,191,Croatia,Romania,460,154,306
2019,300,Greece,Romania,45020,19394,25626
2019,380,Italy,Romania,1074382,438539,635843
2019,470,Malta,Romania,1516,728,788
2019,499,Montenegro,Romania,105,49,56
2019,807,North Macedonia,Romania,23,10,13
2019,620,Portugal,Romania,23149,11540,11609
2019,674,San Marino,Romania,143,16,127
2019,688,Serbia,Romania,3664,549,3115
2019,705,Slovenia,Romania,460,208,252
2019,724,Spain,Romania,622555,304295,318260
2019,40,Austria,Romania,82949,37568,45381
2019,56,Belgium,Romania,81588,43401,38187
2019,250,France,Romania,124240,60251,63989
2019,276,Germany,Romania,545759,292414,253345
2019,438,Liechtenstein,Romania,34,9,25
2019,442,Luxembourg,Romania,4850,1911,2939
2019,528,Netherlands,Romania,21654,9209,12445
2019,756,Switzerland,Romania,26008,9750,16258
2019,60,Bermuda,Romania,26,17,9
2019,124,Canada,Romania,96183,45560,50623
2019,304,Greenland,Romania,13,13,0
2019,840,United States of America,Romania,192040,89339,102701
1990,480,Mauritius,Russian Federation,34,9,25
1990,690,Seychelles,Russian Federation,79,33,46
1990,800,Uganda,Russian Federation,295,141,154
1990,140,Central African Republic,Russian Federation,163,81,82
1990,178,Congo,Russian Federation,790,304,486
1990,516,Namibia,Russian Federation,672,392,280
1990,710,South Africa,Russian Federation,1193,737,456
1990,132,Cabo Verde,Russian Federation,55,26,29
1990,288,Ghana,Russian Federation,47,20,27
1990,324,Guinea,Russian Federation,478,298,180
1990,466,Mali,Russian Federation,384,182,202
1990,478,Mauritania,Russian Federation,56,39,17
1990,694,Sierra Leone,Russian Federation,75,25,50
1990,12,Algeria,Russian Federation,6287,2328,3959
1990,818,Egypt,Russian Federation,9311,3206,6105
1990,434,Libya,Russian Federation,26586,9251,17335
1990,51,Armenia,Russian Federation,62218,20135,42083
1990,31,Azerbaijan,Russian Federation,39234,10717,28517
1990,196,Cyprus,Russian Federation,3235,1407,1828
1990,268,Georgia,Russian Federation,151090,63383,87707
1990,368,Iraq,Russian Federation,210,142,68
1990,376,Israel,Russian Federation,175938,80450,95488
1990,400,Jordan,Russian Federation,581,138,443
1990,422,Lebanon,Russian Federation,265,63,202
1990,792,Turkey,Russian Federation,11430,6336,5094
1990,398,Kazakhstan,Russian Federation,2474111,1122461,1351650
1990,417,Kyrgyzstan,Russian Federation,349174,145262,203912
1990,762,Tajikistan,Russian Federation,363565,159266,204299
1990,795,Turkmenistan,Russian Federation,118324,48039,70285
1990,860,Uzbekistan,Russian Federation,1267201,548390,718811
1990,356,India,Russian Federation,3445,1691,1754
1990,144,Sri Lanka,Russian Federation,1,1,0
1990,156,China,Russian Federation,1080,615,465
1990,344,"China, Hong Kong SAR",Russian Federation,59,13,46
1990,408,Dem. People's Republic of Korea,Russian Federation,43,23,20
1990,392,Japan,Russian Federation,440,224,216
1990,496,Mongolia,Russian Federation,2755,1278,1477
1990,410,Republic of Korea,Russian Federation,37,21,16
1990,116,Cambodia,Russian Federation,14,6,8
1990,608,Philippines,Russian Federation,23,11,12
1990,44,Bahamas,Russian Federation,4,1,3
1990,192,Cuba,Russian Federation,4491,1728,2763
1990,214,Dominican Republic,Russian Federation,287,115,172
1990,188,Costa Rica,Russian Federation,519,182,337
1990,222,El Salvador,Russian Federation,29,13,16
1990,340,Honduras,Russian Federation,19,11,8
1990,484,Mexico,Russian Federation,1171,560,611
1990,558,Nicaragua,Russian Federation,387,148,239
1990,591,Panama,Russian Federation,408,169,239
1990,32,Argentina,Russian Federation,5016,2125,2891
1990,68,Bolivia (Plurinational State of),Russian Federation,106,41,65
1990,76,Brazil,Russian Federation,11249,4922,6327
1990,152,Chile,Russian Federation,449,219,230
1990,170,Colombia,Russian Federation,493,222,271
1990,218,Ecuador,Russian Federation,498,180,318
1990,604,Peru,Russian Federation,391,144,247
1990,862,Venezuela (Bolivarian Republic of),Russian Federation,597,257,340
1990,36,Australia,Russian Federation,8365,3315,5050
1990,554,New Zealand,Russian Federation,1072,529,543
1990,598,Papua New Guinea,Russian Federation,41,26,15
1990,112,Belarus,Russian Federation,791522,349598,441924
1990,100,Bulgaria,Russian Federation,6899,1559,5340
1990,203,Czechia,Russian Federation,3282,1435,1847
1990,348,Hungary,Russian Federation,38081,16919,21162
1990,616,Poland,Russian Federation,76953,29105,47848
1990,498,Republic of Moldova,Russian Federation,225571,94242,131329
1990,642,Romania,Russian Federation,7224,2354,4870
1990,703,Slovakia,Russian Federation,622,197,425
1990,804,Ukraine,Russian Federation,5018098,2150244,2867854
1990,208,Denmark,Russian Federation,1595,586,1009
1990,233,Estonia,Russian Federation,283457,120984,162473
1990,234,Faroe Islands,Russian Federation,2,0,2
1990,246,Finland,Russian Federation,10252,3218,7034
1990,352,Iceland,Russian Federation,37,15,22
1990,372,Ireland,Russian Federation,229,112,117
1990,428,Latvia,Russian Federation,473207,211544,261663
1990,440,Lithuania,Russian Federation,158448,73239,85209
1990,578,Norway,Russian Federation,61,21,40
1990,752,Sweden,Russian Federation,5125,1770,3355
1990,826,United Kingdom,Russian Federation,4247,2632,1615
1990,70,Bosnia and Herzegovina,Russian Federation,271,54,217
1990,300,Greece,Russian Federation,28345,15699,12646
1990,380,Italy,Russian Federation,7359,672,6687
1990,470,Malta,Russian Federation,129,33,96
1990,807,North Macedonia,Russian Federation,217,90,127
1990,620,Portugal,Russian Federation,680,404,276
1990,674,San Marino,Russian Federation,7,4,3
1990,688,Serbia,Russian Federation,361,109,252
1990,705,Slovenia,Russian Federation,171,86,85
1990,724,Spain,Russian Federation,3120,1306,1814
1990,40,Austria,Russian Federation,17059,7491,9568
1990,56,Belgium,Russian Federation,190,99,91
1990,250,France,Russian Federation,21377,7320,14057
1990,276,Germany,Russian Federation,77318,37999,39319
1990,438,Liechtenstein,Russian Federation,6,1,5
1990,442,Luxembourg,Russian Federation,377,97,280
1990,528,Netherlands,Russian Federation,2561,998,1563
1990,756,Switzerland,Russian Federation,5876,2120,3756
1990,124,Canada,Russian Federation,95333,46411,48922
1990,840,United States of America,Russian Federation,190654,93257,97397
1995,480,Mauritius,Russian Federation,28,10,18
1995,690,Seychelles,Russian Federation,45,19,26
1995,800,Uganda,Russian Federation,279,129,150
1995,140,Central African Republic,Russian Federation,193,102,91
1995,178,Congo,Russian Federation,913,325,588
1995,516,Namibia,Russian Federation,642,376,266
1995,710,South Africa,Russian Federation,1138,642,496
1995,132,Cabo Verde,Russian Federation,74,37,37
1995,288,Ghana,Russian Federation,47,23,24
1995,324,Guinea,Russian Federation,551,367,184
1995,466,Mali,Russian Federation,240,114,126
1995,478,Mauritania,Russian Federation,59,43,16
1995,694,Sierra Leone,Russian Federation,73,23,50
1995,12,Algeria,Russian Federation,3545,1340,2205
1995,818,Egypt,Russian Federation,7112,2479,4633
1995,434,Libya,Russian Federation,15828,5967,9861
1995,51,Armenia,Russian Federation,36037,11100,24937
1995,31,Azerbaijan,Russian Federation,34436,10920,23516
1995,196,Cyprus,Russian Federation,4574,1885,2689
1995,268,Georgia,Russian Federation,89180,38080,51100
1995,368,Iraq,Russian Federation,248,148,100
1995,376,Israel,Russian Federation,173915,77862,96053
1995,400,Jordan,Russian Federation,653,161,492
1995,422,Lebanon,Russian Federation,297,62,235
1995,792,Turkey,Russian Federation,14936,6798,8138
1995,398,Kazakhstan,Russian Federation,2253497,1020754,1232743
1995,417,Kyrgyzstan,Russian Federation,284678,117891,166787
1995,762,Tajikistan,Russian Federation,294449,126308,168141
1995,795,Turkmenistan,Russian Federation,98709,46465,52244
1995,860,Uzbekistan,Russian Federation,1161963,498572,663391
1995,356,India,Russian Federation,2547,1244,1303
1995,144,Sri Lanka,Russian Federation,18,14,4
1995,156,China,Russian Federation,1607,887,720
1995,344,"China, Hong Kong SAR",Russian Federation,66,14,52
1995,408,Dem. People's Republic of Korea,Russian Federation,58,30,28
1995,392,Japan,Russian Federation,2199,1055,1144
1995,496,Mongolia,Russian Federation,3042,1491,1551
1995,410,Republic of Korea,Russian Federation,1266,250,1016
1995,116,Cambodia,Russian Federation,37,16,21
1995,608,Philippines,Russian Federation,30,14,16
1995,44,Bahamas,Russian Federation,14,6,8
1995,192,Cuba,Russian Federation,3404,1223,2181
1995,214,Dominican Republic,Russian Federation,319,123,196
1995,188,Costa Rica,Russian Federation,390,141,249
1995,222,El Salvador,Russian Federation,23,10,13
1995,340,Honduras,Russian Federation,19,11,8
1995,484,Mexico,Russian Federation,1503,602,901
1995,558,Nicaragua,Russian Federation,307,116,191
1995,591,Panama,Russian Federation,396,166,230
1995,32,Argentina,Russian Federation,4483,1944,2539
1995,68,Bolivia (Plurinational State of),Russian Federation,54,21,33
1995,76,Brazil,Russian Federation,8882,3760,5122
1995,152,Chile,Russian Federation,514,235,279
1995,170,Colombia,Russian Federation,518,219,299
1995,218,Ecuador,Russian Federation,559,202,357
1995,604,Peru,Russian Federation,392,141,251
1995,862,Venezuela (Bolivarian Republic of),Russian Federation,589,254,335
1995,36,Australia,Russian Federation,12971,5234,7737
1995,554,New Zealand,Russian Federation,2580,1323,1257
1995,598,Papua New Guinea,Russian Federation,42,27,15
1995,112,Belarus,Russian Federation,749767,333116,416651
1995,100,Bulgaria,Russian Federation,8936,1996,6940
1995,203,Czechia,Russian Federation,4924,2231,2693
1995,348,Hungary,Russian Federation,20575,9000,11575
1995,616,Poland,Russian Federation,65827,24273,41554
1995,498,Republic of Moldova,Russian Federation,152253,61320,90933
1995,642,Romania,Russian Federation,7431,2442,4989
1995,703,Slovakia,Russian Federation,1073,308,765
1995,804,Ukraine,Russian Federation,4355392,1829955,2525437
1995,208,Denmark,Russian Federation,2544,867,1677
1995,233,Estonia,Russian Federation,236214,96687,139527
1995,234,Faroe Islands,Russian Federation,1,0,1
1995,246,Finland,Russian Federation,33877,13063,20814
1995,352,Iceland,Russian Federation,273,118,155
1995,372,Ireland,Russian Federation,1244,590,654
1995,428,Latvia,Russian Federation,354000,151461,202539
1995,440,Lithuania,Russian Federation,121622,56468,65154
1995,578,Norway,Russian Federation,820,289,531
1995,752,Sweden,Russian Federation,6082,2070,4012
1995,826,United Kingdom,Russian Federation,9605,4122,5483
1995,70,Bosnia and Herzegovina,Russian Federation,228,49,179
1995,300,Greece,Russian Federation,49780,23039,26741
1995,380,Italy,Russian Federation,11088,1281,9807
1995,470,Malta,Russian Federation,151,41,110
1995,807,North Macedonia,Russian Federation,203,84,119
1995,620,Portugal,Russian Federation,1468,872,596
1995,674,San Marino,Russian Federation,16,3,13
1995,688,Serbia,Russian Federation,2297,669,1628
1995,705,Slovenia,Russian Federation,372,119,253
1995,724,Spain,Russian Federation,4699,1990,2709
1995,40,Austria,Russian Federation,19246,8628,10618
1995,56,Belgium,Russian Federation,546,226,320
1995,250,France,Russian Federation,22069,7313,14756
1995,276,Germany,Russian Federation,490548,199409,291139
1995,438,Liechtenstein,Russian Federation,13,3,10
1995,442,Luxembourg,Russian Federation,358,91,267
1995,528,Netherlands,Russian Federation,8559,3181,5378
1995,756,Switzerland,Russian Federation,9048,3507,5541
1995,124,Canada,Russian Federation,71978,34927,37051
1995,840,United States of America,Russian Federation,268967,132138,136829
2000,480,Mauritius,Russian Federation,38,12,26
2000,690,Seychelles,Russian Federation,11,5,6
2000,800,Uganda,Russian Federation,279,119,160
2000,140,Central African Republic,Russian Federation,207,114,93
2000,178,Congo,Russian Federation,1280,430,850
2000,516,Namibia,Russian Federation,597,350,247
2000,710,South Africa,Russian Federation,1427,717,710
2000,132,Cabo Verde,Russian Federation,92,47,45
2000,288,Ghana,Russian Federation,52,22,30
2000,324,Guinea,Russian Federation,596,393,203
2000,466,Mali,Russian Federation,92,44,48
2000,478,Mauritania,Russian Federation,60,46,14
2000,694,Sierra Leone,Russian Federation,71,21,50
2000,12,Algeria,Russian Federation,802,351,451
2000,818,Egypt,Russian Federation,5477,1950,3527
2000,434,Libya,Russian Federation,5331,3014,2317
2000,51,Armenia,Russian Federation,20363,5616,14747
2000,31,Azerbaijan,Russian Federation,34703,10666,24037
2000,196,Cyprus,Russian Federation,5913,2363,3550
2000,268,Georgia,Russian Federation,35672,15232,20440
2000,368,Iraq,Russian Federation,235,117,118
2000,376,Israel,Russian Federation,162154,71946,90208
2000,400,Jordan,Russian Federation,724,187,537
2000,422,Lebanon,Russian Federation,329,61,268
2000,792,Turkey,Russian Federation,18497,7269,11228
2000,398,Kazakhstan,Russian Federation,2032883,919047,1113836
2000,417,Kyrgyzstan,Russian Federation,212391,87030,125361
2000,762,Tajikistan,Russian Federation,252099,108670,143429
2000,795,Turkmenistan,Russian Federation,79212,36079,43133
2000,860,Uzbekistan,Russian Federation,1067247,454169,613078
2000,356,India,Russian Federation,1649,797,852
2000,144,Sri Lanka,Russian Federation,36,23,13
2000,156,China,Russian Federation,2135,1159,976
2000,344,"China, Hong Kong SAR",Russian Federation,72,15,57
2000,408,Dem. People's Republic of Korea,Russian Federation,72,36,36
2000,392,Japan,Russian Federation,4893,2261,2632
2000,496,Mongolia,Russian Federation,3362,1731,1631
2000,410,Republic of Korea,Russian Federation,2899,623,2276
2000,116,Cambodia,Russian Federation,59,25,34
2000,608,Philippines,Russian Federation,80,66,14
2000,44,Bahamas,Russian Federation,25,13,12
2000,192,Cuba,Russian Federation,2317,719,1598
2000,214,Dominican Republic,Russian Federation,351,132,219
2000,188,Costa Rica,Russian Federation,457,160,297
2000,222,El Salvador,Russian Federation,16,7,9
2000,340,Honduras,Russian Federation,19,11,8
2000,484,Mexico,Russian Federation,1901,676,1225
2000,558,Nicaragua,Russian Federation,235,91,144
2000,591,Panama,Russian Federation,409,172,237
2000,32,Argentina,Russian Federation,3951,1765,2186
2000,68,Bolivia (Plurinational State of),Russian Federation,1,0,1
2000,76,Brazil,Russian Federation,6515,2599,3916
2000,152,Chile,Russian Federation,579,262,317
2000,170,Colombia,Russian Federation,542,216,326
2000,218,Ecuador,Russian Federation,620,225,395
2000,604,Peru,Russian Federation,459,166,293
2000,862,Venezuela (Bolivarian Republic of),Russian Federation,576,247,329
2000,36,Australia,Russian Federation,16800,6877,9923
2000,554,New Zealand,Russian Federation,2837,1380,1457
2000,598,Papua New Guinea,Russian Federation,31,22,9
2000,112,Belarus,Russian Federation,708011,316633,391378
2000,100,Bulgaria,Russian Federation,10972,2433,8539
2000,203,Czechia,Russian Federation,6565,3026,3539
2000,348,Hungary,Russian Federation,3069,1081,1988
2000,616,Poland,Russian Federation,56310,20222,36088
2000,498,Republic of Moldova,Russian Federation,102749,39801,62948
2000,642,Romania,Russian Federation,7654,2535,5119
2000,703,Slovakia,Russian Federation,1819,503,1316
2000,804,Ukraine,Russian Federation,3745842,1531998,2213844
2000,208,Denmark,Russian Federation,3493,1149,2344
2000,233,Estonia,Russian Federation,188970,72390,116580
2000,234,Faroe Islands,Russian Federation,9,3,6
2000,246,Finland,Russian Federation,57502,22909,34593
2000,352,Iceland,Russian Federation,508,221,287
2000,372,Ireland,Russian Federation,2943,1444,1499
2000,428,Latvia,Russian Federation,234753,91368,143385
2000,440,Lithuania,Russian Federation,95271,44131,51140
2000,578,Norway,Russian Federation,3114,967,2147
2000,752,Sweden,Russian Federation,6523,2192,4331
2000,826,United Kingdom,Russian Federation,15125,5667,9458
2000,70,Bosnia and Herzegovina,Russian Federation,185,44,141
2000,300,Greece,Russian Federation,72032,30273,41759
2000,380,Italy,Russian Federation,14816,1890,12926
2000,470,Malta,Russian Federation,382,106,276
2000,807,North Macedonia,Russian Federation,189,78,111
2000,620,Portugal,Russian Federation,2317,1378,939
2000,674,San Marino,Russian Federation,26,1,25
2000,688,Serbia,Russian Federation,3123,849,2274
2000,705,Slovenia,Russian Federation,664,191,473
2000,724,Spain,Russian Federation,8300,3603,4697
2000,40,Austria,Russian Federation,21433,9766,11667
2000,56,Belgium,Russian Federation,886,349,537
2000,250,France,Russian Federation,22760,7306,15454
2000,276,Germany,Russian Federation,903777,360818,542959
2000,438,Liechtenstein,Russian Federation,20,4,16
2000,442,Luxembourg,Russian Federation,344,87,257
2000,528,Netherlands,Russian Federation,14823,5447,9376
2000,756,Switzerland,Russian Federation,12253,4923,7330
2000,124,Canada,Russian Federation,50335,24283,26052
2000,840,United States of America,Russian Federation,348815,172002,176813
2005,480,Mauritius,Russian Federation,39,14,25
2005,690,Seychelles,Russian Federation,48,18,30
2005,800,Uganda,Russian Federation,270,113,157
2005,140,Central African Republic,Russian Federation,158,87,71
2005,178,Congo,Russian Federation,814,401,413
2005,516,Namibia,Russian Federation,472,276,196
2005,710,South Africa,Russian Federation,1877,902,975
2005,132,Cabo Verde,Russian Federation,382,178,204
2005,288,Ghana,Russian Federation,73,33,40
2005,324,Guinea,Russian Federation,298,238,60
2005,466,Mali,Russian Federation,374,176,198
2005,478,Mauritania,Russian Federation,60,47,13
2005,694,Sierra Leone,Russian Federation,56,27,29
2005,12,Algeria,Russian Federation,633,278,355
2005,818,Egypt,Russian Federation,6521,2582,3939
2005,434,Libya,Russian Federation,5874,3777,2097
2005,51,Armenia,Russian Federation,13469,4032,9437
2005,31,Azerbaijan,Russian Federation,32933,9420,23513
2005,196,Cyprus,Russian Federation,8655,3426,5229
2005,268,Georgia,Russian Federation,33888,14471,19417
2005,368,Iraq,Russian Federation,269,172,97
2005,376,Israel,Russian Federation,135827,59557,76270
2005,400,Jordan,Russian Federation,1045,363,682
2005,422,Lebanon,Russian Federation,258,56,202
2005,792,Turkey,Russian Federation,19061,7229,11832
2005,398,Kazakhstan,Russian Federation,2122379,988127,1134252
2005,417,Kyrgyzstan,Russian Federation,170969,69539,101430
2005,762,Tajikistan,Russian Federation,238699,101013,137686
2005,795,Turkmenistan,Russian Federation,78008,35908,42100
2005,860,Uzbekistan,Russian Federation,980674,429565,551109
2005,356,India,Russian Federation,1524,735,789
2005,144,Sri Lanka,Russian Federation,72,27,45
2005,156,China,Russian Federation,2355,1392,963
2005,344,"China, Hong Kong SAR",Russian Federation,79,14,65
2005,408,Dem. People's Republic of Korea,Russian Federation,102,53,49
2005,392,Japan,Russian Federation,7370,3357,4013
2005,496,Mongolia,Russian Federation,2740,1273,1467
2005,410,Republic of Korea,Russian Federation,2710,753,1957
2005,116,Cambodia,Russian Federation,46,20,26
2005,608,Philippines,Russian Federation,64,53,11
2005,44,Bahamas,Russian Federation,39,12,27
2005,192,Cuba,Russian Federation,1551,481,1070
2005,214,Dominican Republic,Russian Federation,405,160,245
2005,188,Costa Rica,Russian Federation,299,102,197
2005,222,El Salvador,Russian Federation,17,7,10
2005,340,Honduras,Russian Federation,19,11,8
2005,484,Mexico,Russian Federation,1641,581,1060
2005,558,Nicaragua,Russian Federation,169,66,103
2005,591,Panama,Russian Federation,613,347,266
2005,32,Argentina,Russian Federation,2915,1328,1587
2005,68,Bolivia (Plurinational State of),Russian Federation,142,58,84
2005,76,Brazil,Russian Federation,3974,1576,2398
2005,152,Chile,Russian Federation,869,401,468
2005,170,Colombia,Russian Federation,538,210,328
2005,218,Ecuador,Russian Federation,732,276,456
2005,604,Peru,Russian Federation,539,196,343
2005,862,Venezuela (Bolivarian Republic of),Russian Federation,605,260,345
2005,36,Australia,Russian Federation,18110,7148,10962
2005,554,New Zealand,Russian Federation,4380,2126,2254
2005,598,Papua New Guinea,Russian Federation,31,23,8
2005,112,Belarus,Russian Federation,698192,312157,386035
2005,100,Bulgaria,Russian Federation,14768,3578,11190
2005,203,Czechia,Russian Federation,18399,8277,10122
2005,348,Hungary,Russian Federation,3791,1379,2412
2005,616,Poland,Russian Federation,47197,16556,30641
2005,498,Republic of Moldova,Russian Federation,70947,26674,44273
2005,642,Romania,Russian Federation,7475,2576,4899
2005,703,Slovakia,Russian Federation,2040,589,1451
2005,804,Ukraine,Russian Federation,3422713,1402646,2020067
2005,208,Denmark,Russian Federation,4232,1307,2925
2005,233,Estonia,Russian Federation,172571,65471,107100
2005,234,Faroe Islands,Russian Federation,30,11,19
2005,246,Finland,Russian Federation,58429,22786,35643
2005,352,Iceland,Russian Federation,406,165,241
2005,372,Ireland,Russian Federation,5108,2565,2543
2005,428,Latvia,Russian Federation,201748,77739,124009
2005,440,Lithuania,Russian Federation,88849,40804,48045
2005,578,Norway,Russian Federation,8913,2973,5940
2005,752,Sweden,Russian Federation,10951,3615,7336
2005,826,United Kingdom,Russian Federation,25439,8720,16719
2005,70,Bosnia and Herzegovina,Russian Federation,141,33,108
2005,191,Croatia,Russian Federation,652,123,529
2005,300,Greece,Russian Federation,63706,25102,38604
2005,380,Italy,Russian Federation,47776,10185,37591
2005,470,Malta,Russian Federation,598,170,428
2005,807,North Macedonia,Russian Federation,194,80,114
2005,620,Portugal,Russian Federation,3993,1863,2130
2005,674,San Marino,Russian Federation,27,2,25
2005,688,Serbia,Russian Federation,3081,812,2269
2005,705,Slovenia,Russian Federation,804,222,582
2005,724,Spain,Russian Federation,39783,14885,24898
2005,40,Austria,Russian Federation,23957,10605,13352
2005,56,Belgium,Russian Federation,2583,1157,1426
2005,250,France,Russian Federation,34476,12408,22068
2005,276,Germany,Russian Federation,889324,384844,504480
2005,438,Liechtenstein,Russian Federation,31,8,23
2005,442,Luxembourg,Russian Federation,298,89,209
2005,528,Netherlands,Russian Federation,30788,11582,19206
2005,756,Switzerland,Russian Federation,14172,5257,8915
2005,124,Canada,Russian Federation,59964,27735,32229
2005,840,United States of America,Russian Federation,371254,184106,187148
2010,480,Mauritius,Russian Federation,43,18,25
2010,690,Seychelles,Russian Federation,86,32,54
2010,800,Uganda,Russian Federation,271,112,159
2010,140,Central African Republic,Russian Federation,156,86,70
2010,178,Congo,Russian Federation,1938,814,1124
2010,516,Namibia,Russian Federation,454,266,188
2010,710,South Africa,Russian Federation,2940,1408,1532
2010,132,Cabo Verde,Russian Federation,672,309,363
2010,288,Ghana,Russian Federation,55,24,31
2010,324,Guinea,Russian Federation,149,119,30
2010,466,Mali,Russian Federation,313,151,162
2010,478,Mauritania,Russian Federation,60,48,12
2010,694,Sierra Leone,Russian Federation,61,34,27
2010,12,Algeria,Russian Federation,695,288,407
2010,818,Egypt,Russian Federation,7038,2625,4413
2010,434,Libya,Russian Federation,6427,4158,2269
2010,51,Armenia,Russian Federation,11216,3622,7594
2010,31,Azerbaijan,Russian Federation,30151,9405,20746
2010,196,Cyprus,Russian Federation,14173,5717,8456
2010,268,Georgia,Russian Federation,34226,14616,19610
2010,368,Iraq,Russian Federation,272,180,92
2010,376,Israel,Russian Federation,111148,47736,63412
2010,400,Jordan,Russian Federation,1344,517,827
2010,422,Lebanon,Russian Federation,186,51,135
2010,792,Turkey,Russian Federation,19647,7177,12470
2010,398,Kazakhstan,Russian Federation,2211875,1057208,1154667
2010,417,Kyrgyzstan,Russian Federation,126897,50685,76212
2010,762,Tajikistan,Russian Federation,238142,101335,136807
2010,795,Turkmenistan,Russian Federation,75465,33208,42257
2010,860,Uzbekistan,Russian Federation,913652,412203,501449
2010,356,India,Russian Federation,1398,672,726
2010,144,Sri Lanka,Russian Federation,147,56,91
2010,156,China,Russian Federation,2575,1624,951
2010,344,"China, Hong Kong SAR",Russian Federation,86,12,74
2010,408,Dem. People's Republic of Korea,Russian Federation,132,70,62
2010,392,Japan,Russian Federation,7814,3514,4300
2010,496,Mongolia,Russian Federation,2433,1119,1314
2010,410,Republic of Korea,Russian Federation,3594,1062,2532
2010,116,Cambodia,Russian Federation,33,15,18
2010,608,Philippines,Russian Federation,65,54,11
2010,44,Bahamas,Russian Federation,52,10,42
2010,192,Cuba,Russian Federation,862,264,598
2010,214,Dominican Republic,Russian Federation,457,188,269
2010,188,Costa Rica,Russian Federation,590,203,387
2010,222,El Salvador,Russian Federation,17,7,10
2010,340,Honduras,Russian Federation,18,10,8
2010,484,Mexico,Russian Federation,1572,555,1017
2010,558,Nicaragua,Russian Federation,180,71,109
2010,591,Panama,Russian Federation,848,543,305
2010,32,Argentina,Russian Federation,1878,891,987
2010,68,Bolivia (Plurinational State of),Russian Federation,282,116,166
2010,76,Brazil,Russian Federation,1375,527,848
2010,152,Chile,Russian Federation,1159,540,619
2010,170,Colombia,Russian Federation,628,246,382
2010,218,Ecuador,Russian Federation,1028,371,657
2010,604,Peru,Russian Federation,603,218,385
2010,862,Venezuela (Bolivarian Republic of),Russian Federation,643,278,365
2010,36,Australia,Russian Federation,20780,8071,12709
2010,554,New Zealand,Russian Federation,5070,2457,2613
2010,598,Papua New Guinea,Russian Federation,26,20,6
2010,112,Belarus,Russian Federation,688372,307680,380692
2010,100,Bulgaria,Russian Federation,17940,4563,13377
2010,203,Czechia,Russian Federation,28453,13147,15306
2010,348,Hungary,Russian Federation,4513,1678,2835
2010,616,Poland,Russian Federation,39565,13208,26357
2010,498,Republic of Moldova,Russian Federation,52125,19687,32438
2010,642,Romania,Russian Federation,8135,2878,5257
2010,703,Slovakia,Russian Federation,2287,683,1604
2010,804,Ukraine,Russian Federation,3265811,1341012,1924799
2010,208,Denmark,Russian Federation,4883,1442,3441
2010,233,Estonia,Russian Federation,154721,57566,97155
2010,234,Faroe Islands,Russian Federation,39,14,25
2010,246,Finland,Russian Federation,9540,3774,5766
2010,352,Iceland,Russian Federation,303,109,194
2010,372,Ireland,Russian Federation,6432,2941,3491
2010,428,Latvia,Russian Federation,163606,60300,103306
2010,440,Lithuania,Russian Federation,70305,29502,40803
2010,578,Norway,Russian Federation,13813,4762,9051
2010,752,Sweden,Russian Federation,15511,5085,10426
2010,826,United Kingdom,Russian Federation,26798,9547,17251
2010,70,Bosnia and Herzegovina,Russian Federation,179,44,135
2010,191,Croatia,Russian Federation,1303,245,1058
2010,300,Greece,Russian Federation,57621,20751,36870
2010,380,Italy,Russian Federation,79608,17293,62315
2010,470,Malta,Russian Federation,775,233,542
2010,499,Montenegro,Russian Federation,823,345,478
2010,807,North Macedonia,Russian Federation,199,82,117
2010,620,Portugal,Russian Federation,5006,2042,2964
2010,674,San Marino,Russian Federation,29,2,27
2010,688,Serbia,Russian Federation,3012,792,2220
2010,705,Slovenia,Russian Federation,928,289,639
2010,724,Spain,Russian Federation,58461,20285,38176
2010,40,Austria,Russian Federation,26481,11444,15037
2010,56,Belgium,Russian Federation,4578,2418,2160
2010,250,France,Russian Federation,60093,21111,38982
2010,276,Germany,Russian Federation,861106,394669,466437
2010,438,Liechtenstein,Russian Federation,44,12,32
2010,442,Luxembourg,Russian Federation,256,91,165
2010,528,Netherlands,Russian Federation,35615,12585,23030
2010,756,Switzerland,Russian Federation,16189,5430,10759
2010,124,Canada,Russian Federation,73025,32863,40162
2010,840,United States of America,Russian Federation,405679,177633,228046
2015,480,Mauritius,Russian Federation,49,22,27
2015,690,Seychelles,Russian Federation,96,39,57
2015,800,Uganda,Russian Federation,272,111,161
2015,140,Central African Republic,Russian Federation,136,74,62
2015,178,Congo,Russian Federation,2576,1018,1558
2015,516,Namibia,Russian Federation,444,261,183
2015,710,South Africa,Russian Federation,5302,2399,2903
2015,132,Cabo Verde,Russian Federation,698,320,378
2015,288,Ghana,Russian Federation,67,29,38
2015,324,Guinea,Russian Federation,39,31,8
2015,466,Mali,Russian Federation,387,187,200
2015,478,Mauritania,Russian Federation,60,49,11
2015,694,Sierra Leone,Russian Federation,67,41,26
2015,12,Algeria,Russian Federation,767,318,449
2015,818,Egypt,Russian Federation,5218,2370,2848
2015,434,Libya,Russian Federation,7246,4653,2593
2015,51,Armenia,Russian Federation,19170,6191,12979
2015,31,Azerbaijan,Russian Federation,28760,9398,19362
2015,196,Cyprus,Russian Federation,13617,5547,8070
2015,268,Georgia,Russian Federation,35936,15346,20590
2015,368,Iraq,Russian Federation,273,195,78
2015,376,Israel,Russian Federation,114630,48912,65718
2015,400,Jordan,Russian Federation,578,142,436
2015,422,Lebanon,Russian Federation,157,76,81
2015,792,Turkey,Russian Federation,19944,7000,12944
2015,398,Kazakhstan,Russian Federation,2352598,1144573,1208025
2015,417,Kyrgyzstan,Russian Federation,111753,44251,67502
2015,762,Tajikistan,Russian Federation,234154,98688,135466
2015,795,Turkmenistan,Russian Federation,75153,33534,41619
2015,860,Uzbekistan,Russian Federation,877690,403502,474188
2015,356,India,Russian Federation,1346,647,699
2015,144,Sri Lanka,Russian Federation,149,56,93
2015,156,China,Russian Federation,2963,1919,1044
2015,344,"China, Hong Kong SAR",Russian Federation,88,9,79
2015,408,Dem. People's Republic of Korea,Russian Federation,145,77,68
2015,392,Japan,Russian Federation,8092,3610,4482
2015,496,Mongolia,Russian Federation,3012,938,2074
2015,410,Republic of Korea,Russian Federation,4465,1246,3219
2015,116,Cambodia,Russian Federation,30,14,16
2015,608,Philippines,Russian Federation,67,56,11
2015,44,Bahamas,Russian Federation,56,10,46
2015,192,Cuba,Russian Federation,689,206,483
2015,214,Dominican Republic,Russian Federation,482,198,284
2015,188,Costa Rica,Russian Federation,599,204,395
2015,222,El Salvador,Russian Federation,18,8,10
2015,340,Honduras,Russian Federation,25,15,10
2015,484,Mexico,Russian Federation,1688,612,1076
2015,558,Nicaragua,Russian Federation,194,78,116
2015,591,Panama,Russian Federation,995,635,360
2015,32,Argentina,Russian Federation,1884,893,991
2015,68,Bolivia (Plurinational State of),Russian Federation,328,135,193
2015,76,Brazil,Russian Federation,1656,635,1021
2015,152,Chile,Russian Federation,1755,798,957
2015,170,Colombia,Russian Federation,703,280,423
2015,218,Ecuador,Russian Federation,1495,533,962
2015,604,Peru,Russian Federation,641,243,398
2015,862,Venezuela (Bolivarian Republic of),Russian Federation,674,286,388
2015,36,Australia,Russian Federation,25760,10028,15732
2015,554,New Zealand,Russian Federation,5679,2747,2932
2015,598,Papua New Guinea,Russian Federation,26,21,5
2015,112,Belarus,Russian Federation,682362,305167,377195
2015,100,Bulgaria,Russian Federation,24416,7125,17291
2015,203,Czechia,Russian Federation,32735,14606,18129
2015,348,Hungary,Russian Federation,3702,1451,2251
2015,616,Poland,Russian Federation,38147,13215,24932
2015,498,Republic of Moldova,Russian Federation,40760,15318,25442
2015,642,Romania,Russian Federation,5269,1725,3544
2015,703,Slovakia,Russian Federation,2780,975,1805
2015,804,Ukraine,Russian Federation,3275758,1347176,1928582
2015,208,Denmark,Russian Federation,5999,1840,4159
2015,233,Estonia,Russian Federation,129187,47405,81782
2015,234,Faroe Islands,Russian Federation,30,8,22
2015,246,Finland,Russian Federation,14922,6201,8721
2015,352,Iceland,Russian Federation,364,131,233
2015,372,Ireland,Russian Federation,6570,2960,3610
2015,428,Latvia,Russian Federation,136409,49893,86516
2015,440,Lithuania,Russian Federation,58511,23913,34598
2015,578,Norway,Russian Federation,17310,5977,11333
2015,752,Sweden,Russian Federation,19450,6622,12828
2015,826,United Kingdom,Russian Federation,34270,11555,22715
2015,70,Bosnia and Herzegovina,Russian Federation,177,43,134
2015,191,Croatia,Russian Federation,1311,243,1068
2015,300,Greece,Russian Federation,54081,18001,36080
2015,380,Italy,Russian Federation,79300,17692,61608
2015,470,Malta,Russian Federation,1315,457,858
2015,499,Montenegro,Russian Federation,925,391,534
2015,807,North Macedonia,Russian Federation,215,88,127
2015,620,Portugal,Russian Federation,5674,2142,3532
2015,674,San Marino,Russian Federation,36,1,35
2015,688,Serbia,Russian Federation,2944,769,2175
2015,705,Slovenia,Russian Federation,2082,809,1273
2015,724,Spain,Russian Federation,79255,28586,50669
2015,40,Austria,Russian Federation,30972,13482,17490
2015,56,Belgium,Russian Federation,6904,3593,3311
2015,250,France,Russian Federation,66569,22196,44373
2015,276,Germany,Russian Federation,893657,408262,485395
2015,438,Liechtenstein,Russian Federation,53,12,41
2015,442,Luxembourg,Russian Federation,390,143,247
2015,528,Netherlands,Russian Federation,56841,20991,35850
2015,756,Switzerland,Russian Federation,22407,7496,14911
2015,124,Canada,Russian Federation,78202,34035,44167
2015,840,United States of America,Russian Federation,386529,189469,197060
2019,480,Mauritius,Russian Federation,49,22,27
2019,690,Seychelles,Russian Federation,97,40,57
2019,800,Uganda,Russian Federation,272,110,162
2019,140,Central African Republic,Russian Federation,151,83,68
2019,178,Congo,Russian Federation,2655,1049,1606
2019,516,Namibia,Russian Federation,469,276,193
2019,710,South Africa,Russian Federation,5942,2692,3250
2019,132,Cabo Verde,Russian Federation,732,336,396
2019,288,Ghana,Russian Federation,75,33,42
2019,324,Guinea,Russian Federation,37,30,7
2019,466,Mali,Russian Federation,430,208,222
2019,478,Mauritania,Russian Federation,62,51,11
2019,694,Sierra Leone,Russian Federation,69,44,25
2019,12,Algeria,Russian Federation,797,331,466
2019,818,Egypt,Russian Federation,7437,2899,4538
2019,434,Libya,Russian Federation,7688,4937,2751
2019,51,Armenia,Russian Federation,19065,6270,12795
2019,31,Azerbaijan,Russian Federation,27633,9030,18603
2019,196,Cyprus,Russian Federation,13610,5627,7983
2019,268,Georgia,Russian Federation,37060,15810,21250
2019,368,Iraq,Russian Federation,279,200,79
2019,376,Israel,Russian Federation,111474,47566,63908
2019,400,Jordan,Russian Federation,621,153,468
2019,422,Lebanon,Russian Federation,148,72,76
2019,792,Turkey,Russian Federation,26967,9639,17328
2019,398,Kazakhstan,Russian Federation,2458414,1196055,1262359
2019,417,Kyrgyzstan,Russian Federation,109511,43355,66156
2019,762,Tajikistan,Russian Federation,233297,98339,134958
2019,795,Turkmenistan,Russian Federation,74675,33834,40841
2019,860,Uzbekistan,Russian Federation,875824,403014,472810
2019,356,India,Russian Federation,1323,636,687
2019,144,Sri Lanka,Russian Federation,150,57,93
2019,156,China,Russian Federation,3123,2023,1100
2019,344,"China, Hong Kong SAR",Russian Federation,114,9,105
2019,408,Dem. People's Republic of Korea,Russian Federation,147,78,69
2019,392,Japan,Russian Federation,8710,3886,4824
2019,496,Mongolia,Russian Federation,3200,997,2203
2019,410,Republic of Korea,Russian Federation,4545,1267,3278
2019,116,Cambodia,Russian Federation,31,14,17
2019,608,Philippines,Russian Federation,69,58,11
2019,44,Bahamas,Russian Federation,59,11,48
2019,192,Cuba,Russian Federation,633,187,446
2019,214,Dominican Republic,Russian Federation,498,205,293
2019,188,Costa Rica,Russian Federation,607,209,398
2019,222,El Salvador,Russian Federation,18,8,10
2019,340,Honduras,Russian Federation,25,15,10
2019,484,Mexico,Russian Federation,1740,631,1109
2019,558,Nicaragua,Russian Federation,203,82,121
2019,591,Panama,Russian Federation,1056,675,381
2019,32,Argentina,Russian Federation,1917,907,1010
2019,68,Bolivia (Plurinational State of),Russian Federation,358,148,210
2019,76,Brazil,Russian Federation,1865,716,1149
2019,152,Chile,Russian Federation,2344,995,1349
2019,170,Colombia,Russian Federation,719,287,432
2019,218,Ecuador,Russian Federation,1471,524,947
2019,604,Peru,Russian Federation,763,309,454
2019,862,Venezuela (Bolivarian Republic of),Russian Federation,660,279,381
2019,36,Australia,Russian Federation,28735,11022,17713
2019,554,New Zealand,Russian Federation,5837,2824,3013
2019,598,Papua New Guinea,Russian Federation,26,21,5
2019,112,Belarus,Russian Federation,673880,301354,372526
2019,100,Bulgaria,Russian Federation,31679,9805,21874
2019,203,Czechia,Russian Federation,36218,15927,20291
2019,348,Hungary,Russian Federation,4044,1557,2487
2019,616,Poland,Russian Federation,40399,15009,25390
2019,498,Republic of Moldova,Russian Federation,40123,15100,25023
2019,642,Romania,Russian Federation,6648,2354,4294
2019,703,Slovakia,Russian Federation,2952,1063,1889
2019,804,Ukraine,Russian Federation,3308515,1360648,1947867
2019,208,Denmark,Russian Federation,6777,2072,4705
2019,233,Estonia,Russian Federation,121568,45244,76324
2019,234,Faroe Islands,Russian Federation,34,9,25
2019,246,Finland,Russian Federation,18369,7668,10701
2019,352,Iceland,Russian Federation,449,173,276
2019,372,Ireland,Russian Federation,7213,3262,3951
2019,428,Latvia,Russian Federation,119832,43798,76034
2019,440,Lithuania,Russian Federation,48338,19238,29100
2019,578,Norway,Russian Federation,19175,6417,12758
2019,752,Sweden,Russian Federation,22470,7733,14737
2019,826,United Kingdom,Russian Federation,38917,13187,25730
2019,70,Bosnia and Herzegovina,Russian Federation,163,39,124
2019,191,Croatia,Russian Federation,1210,221,989
2019,300,Greece,Russian Federation,52816,18915,33901
2019,380,Italy,Russian Federation,83260,19478,63782
2019,470,Malta,Russian Federation,2122,747,1375
2019,499,Montenegro,Russian Federation,928,395,533
2019,807,North Macedonia,Russian Federation,215,88,127
2019,620,Portugal,Russian Federation,5770,2186,3584
2019,674,San Marino,Russian Federation,38,0,38
2019,688,Serbia,Russian Federation,2990,783,2207
2019,705,Slovenia,Russian Federation,2780,1156,1624
2019,724,Spain,Russian Federation,87373,30673,56700
2019,40,Austria,Russian Federation,36562,16271,20291
2019,56,Belgium,Russian Federation,7757,4012,3745
2019,250,France,Russian Federation,70463,23387,47076
2019,276,Germany,Russian Federation,999162,430754,568408
2019,438,Liechtenstein,Russian Federation,60,14,46
2019,442,Luxembourg,Russian Federation,2575,841,1734
2019,528,Netherlands,Russian Federation,64997,24485,40512
2019,756,Switzerland,Russian Federation,24539,8267,16272
2019,124,Canada,Russian Federation,83802,36472,47330
2019,840,United States of America,Russian Federation,411537,201331,210206
1990,108,Burundi,Rwanda,221943,108772,113171
1990,232,Eritrea,Rwanda,991,540,451
1990,231,Ethiopia,Rwanda,71,37,34
1990,404,Kenya,Rwanda,3874,2155,1719
1990,454,Malawi,Rwanda,2249,821,1428
1990,800,Uganda,Rwanda,214634,112201,102433
1990,834,United Republic of Tanzania,Rwanda,68609,35018,33591
1990,24,Angola,Rwanda,46,22,24
1990,180,Democratic Republic of the Congo,Rwanda,22972,11058,11914
1990,266,Gabon,Rwanda,65,33,32
1990,748,Eswatini,Rwanda,2,2,0
1990,516,Namibia,Rwanda,530,294,236
1990,710,South Africa,Rwanda,2094,814,1280
1990,288,Ghana,Rwanda,268,94,174
1990,768,Togo,Rwanda,880,433,447
1990,818,Egypt,Rwanda,59,46,13
1990,188,Costa Rica,Rwanda,1,0,1
1990,68,Bolivia (Plurinational State of),Rwanda,2,0,2
1990,152,Chile,Rwanda,1,0,1
1990,36,Australia,Rwanda,44,27,17
1990,203,Czechia,Rwanda,3,2,1
1990,348,Hungary,Rwanda,1,1,0
1990,643,Russian Federation,Rwanda,177,87,90
1990,208,Denmark,Rwanda,11,6,5
1990,246,Finland,Rwanda,2,1,1
1990,372,Ireland,Rwanda,15,6,9
1990,428,Latvia,Rwanda,1,1,0
1990,578,Norway,Rwanda,6,3,3
1990,752,Sweden,Rwanda,88,46,42
1990,826,United Kingdom,Rwanda,331,192,139
1990,300,Greece,Rwanda,174,96,78
1990,380,Italy,Rwanda,126,44,82
1990,724,Spain,Rwanda,23,15,8
1990,40,Austria,Rwanda,117,65,52
1990,56,Belgium,Rwanda,2580,1546,1034
1990,250,France,Rwanda,3150,1480,1670
1990,276,Germany,Rwanda,324,246,78
1990,442,Luxembourg,Rwanda,24,9,15
1990,528,Netherlands,Rwanda,304,170,134
1990,756,Switzerland,Rwanda,619,300,319
1990,124,Canada,Rwanda,307,149,158
1995,108,Burundi,Rwanda,160197,78063,82134
1995,232,Eritrea,Rwanda,703,366,337
1995,231,Ethiopia,Rwanda,93,55,38
1995,404,Kenya,Rwanda,5861,3107,2754
1995,454,Malawi,Rwanda,5138,2725,2413
1995,800,Uganda,Rwanda,131974,68451,63523
1995,834,United Republic of Tanzania,Rwanda,600656,294994,305662
1995,894,Zambia,Rwanda,2285,1220,1065
1995,24,Angola,Rwanda,115,52,63
1995,178,Congo,Rwanda,5503,2890,2613
1995,180,Democratic Republic of the Congo,Rwanda,1132791,562103,570688
1995,266,Gabon,Rwanda,87,45,42
1995,748,Eswatini,Rwanda,52,31,21
1995,516,Namibia,Rwanda,506,282,224
1995,710,South Africa,Rwanda,1512,679,833
1995,288,Ghana,Rwanda,267,110,157
1995,686,Senegal,Rwanda,300,132,168
1995,768,Togo,Rwanda,899,434,465
1995,818,Egypt,Rwanda,44,34,10
1995,188,Costa Rica,Rwanda,1,0,1
1995,68,Bolivia (Plurinational State of),Rwanda,2,1,1
1995,152,Chile,Rwanda,3,2,1
1995,36,Australia,Rwanda,27,14,13
1995,100,Bulgaria,Rwanda,1,1,0
1995,203,Czechia,Rwanda,5,4,1
1995,348,Hungary,Rwanda,7,4,3
1995,643,Russian Federation,Rwanda,168,91,77
1995,208,Denmark,Rwanda,70,34,36
1995,246,Finland,Rwanda,13,6,7
1995,352,Iceland,Rwanda,1,1,0
1995,372,Ireland,Rwanda,42,16,26
1995,428,Latvia,Rwanda,1,1,0
1995,578,Norway,Rwanda,33,16,17
1995,752,Sweden,Rwanda,105,55,50
1995,826,United Kingdom,Rwanda,1301,601,700
1995,300,Greece,Rwanda,148,94,54
1995,380,Italy,Rwanda,379,159,220
1995,724,Spain,Rwanda,36,23,13
1995,40,Austria,Rwanda,132,74,58
1995,56,Belgium,Rwanda,2462,1349,1113
1995,250,France,Rwanda,3252,1499,1753
1995,276,Germany,Rwanda,599,370,229
1995,442,Luxembourg,Rwanda,22,9,13
1995,528,Netherlands,Rwanda,447,245,202
1995,756,Switzerland,Rwanda,673,333,340
1995,124,Canada,Rwanda,1453,701,752
2000,108,Burundi,Rwanda,66415,32288,34127
2000,232,Eritrea,Rwanda,414,191,223
2000,231,Ethiopia,Rwanda,132,83,49
2000,404,Kenya,Rwanda,3273,1630,1643
2000,454,Malawi,Rwanda,4947,2617,2330
2000,800,Uganda,Rwanda,70387,35711,34676
2000,834,United Republic of Tanzania,Rwanda,49366,25508,23858
2000,894,Zambia,Rwanda,5662,1868,3794
2000,24,Angola,Rwanda,183,81,102
2000,178,Congo,Rwanda,12480,6547,5933
2000,180,Democratic Republic of the Congo,Rwanda,85936,42148,43788
2000,266,Gabon,Rwanda,108,55,53
2000,748,Eswatini,Rwanda,112,55,57
2000,516,Namibia,Rwanda,471,263,208
2000,710,South Africa,Rwanda,1311,703,608
2000,288,Ghana,Rwanda,299,108,191
2000,686,Senegal,Rwanda,351,155,196
2000,768,Togo,Rwanda,1452,653,799
2000,818,Egypt,Rwanda,33,26,7
2000,764,Thailand,Rwanda,1,0,1
2000,188,Costa Rica,Rwanda,1,0,1
2000,68,Bolivia (Plurinational State of),Rwanda,1,1,0
2000,152,Chile,Rwanda,5,3,2
2000,36,Australia,Rwanda,50,25,25
2000,100,Bulgaria,Rwanda,1,1,0
2000,203,Czechia,Rwanda,7,6,1
2000,348,Hungary,Rwanda,12,6,6
2000,643,Russian Federation,Rwanda,154,92,62
2000,208,Denmark,Rwanda,129,62,67
2000,246,Finland,Rwanda,24,11,13
2000,352,Iceland,Rwanda,1,1,0
2000,372,Ireland,Rwanda,93,38,55
2000,428,Latvia,Rwanda,1,1,0
2000,578,Norway,Rwanda,148,67,81
2000,752,Sweden,Rwanda,113,58,55
2000,826,United Kingdom,Rwanda,2294,1019,1275
2000,300,Greece,Rwanda,125,93,32
2000,380,Italy,Rwanda,631,273,358
2000,724,Spain,Rwanda,444,301,143
2000,40,Austria,Rwanda,146,82,64
2000,56,Belgium,Rwanda,2270,1113,1157
2000,250,France,Rwanda,3354,1518,1836
2000,276,Germany,Rwanda,873,493,380
2000,442,Luxembourg,Rwanda,22,9,13
2000,528,Netherlands,Rwanda,606,328,278
2000,756,Switzerland,Rwanda,731,368,363
2000,124,Canada,Rwanda,2634,1270,1364
2005,108,Burundi,Rwanda,57104,26926,30178
2005,232,Eritrea,Rwanda,436,202,234
2005,231,Ethiopia,Rwanda,111,64,47
2005,404,Kenya,Rwanda,4059,2097,1962
2005,454,Malawi,Rwanda,4714,2487,2227
2005,800,Uganda,Rwanda,75091,37577,37514
2005,834,United Republic of Tanzania,Rwanda,13231,6780,6451
2005,894,Zambia,Rwanda,6873,3517,3356
2005,24,Angola,Rwanda,527,223,304
2005,178,Congo,Rwanda,7936,5052,2884
2005,180,Democratic Republic of the Congo,Rwanda,82016,40226,41790
2005,266,Gabon,Rwanda,119,61,58
2005,748,Eswatini,Rwanda,195,93,102
2005,516,Namibia,Rwanda,372,207,165
2005,710,South Africa,Rwanda,2611,1059,1552
2005,288,Ghana,Rwanda,420,168,252
2005,686,Senegal,Rwanda,324,146,178
2005,694,Sierra Leone,Rwanda,2,2,0
2005,768,Togo,Rwanda,1409,638,771
2005,818,Egypt,Rwanda,39,31,8
2005,764,Thailand,Rwanda,2,1,1
2005,188,Costa Rica,Rwanda,1,0,1
2005,68,Bolivia (Plurinational State of),Rwanda,1,0,1
2005,152,Chile,Rwanda,7,5,2
2005,36,Australia,Rwanda,180,84,96
2005,100,Bulgaria,Rwanda,2,1,1
2005,203,Czechia,Rwanda,6,5,1
2005,348,Hungary,Rwanda,15,8,7
2005,643,Russian Federation,Rwanda,100,60,40
2005,208,Denmark,Rwanda,227,102,125
2005,246,Finland,Rwanda,137,68,69
2005,352,Iceland,Rwanda,1,1,0
2005,372,Ireland,Rwanda,93,41,52
2005,578,Norway,Rwanda,319,152,167
2005,752,Sweden,Rwanda,242,125,117
2005,826,United Kingdom,Rwanda,3147,1394,1753
2005,300,Greece,Rwanda,112,85,27
2005,380,Italy,Rwanda,705,317,388
2005,724,Spain,Rwanda,214,144,70
2005,40,Austria,Rwanda,164,90,74
2005,56,Belgium,Rwanda,9891,4647,5244
2005,250,France,Rwanda,4950,2319,2631
2005,276,Germany,Rwanda,943,499,444
2005,442,Luxembourg,Rwanda,19,9,10
2005,528,Netherlands,Rwanda,1486,764,722
2005,756,Switzerland,Rwanda,820,390,430
2005,124,Canada,Rwanda,3830,1753,2077
2010,108,Burundi,Rwanda,52794,23881,28913
2010,232,Eritrea,Rwanda,459,213,246
2010,231,Ethiopia,Rwanda,122,64,58
2010,404,Kenya,Rwanda,6201,3067,3134
2010,454,Malawi,Rwanda,4631,2440,2191
2010,800,Uganda,Rwanda,70951,35404,35547
2010,834,United Republic of Tanzania,Rwanda,5246,2277,2969
2010,894,Zambia,Rwanda,7462,3859,3603
2010,24,Angola,Rwanda,871,365,506
2010,178,Congo,Rwanda,18900,11054,7846
2010,180,Democratic Republic of the Congo,Rwanda,124070,59727,64343
2010,266,Gabon,Rwanda,137,71,66
2010,748,Eswatini,Rwanda,229,106,123
2010,516,Namibia,Rwanda,358,200,158
2010,710,South Africa,Rwanda,4090,1651,2439
2010,288,Ghana,Rwanda,311,110,201
2010,466,Mali,Rwanda,388,226,162
2010,686,Senegal,Rwanda,297,154,143
2010,694,Sierra Leone,Rwanda,1,1,0
2010,768,Togo,Rwanda,746,367,379
2010,818,Egypt,Rwanda,42,33,9
2010,764,Thailand,Rwanda,4,2,2
2010,188,Costa Rica,Rwanda,1,0,1
2010,68,Bolivia (Plurinational State of),Rwanda,1,0,1
2010,76,Brazil,Rwanda,13,13,0
2010,152,Chile,Rwanda,10,7,3
2010,36,Australia,Rwanda,620,295,325
2010,100,Bulgaria,Rwanda,2,1,1
2010,203,Czechia,Rwanda,6,5,1
2010,348,Hungary,Rwanda,18,10,8
2010,643,Russian Federation,Rwanda,45,27,18
2010,208,Denmark,Rwanda,318,139,179
2010,233,Estonia,Rwanda,1,0,1
2010,246,Finland,Rwanda,224,97,127
2010,352,Iceland,Rwanda,4,3,1
2010,372,Ireland,Rwanda,78,31,47
2010,578,Norway,Rwanda,533,249,284
2010,752,Sweden,Rwanda,397,186,211
2010,826,United Kingdom,Rwanda,3315,1507,1808
2010,300,Greece,Rwanda,103,81,22
2010,380,Italy,Rwanda,791,380,411
2010,724,Spain,Rwanda,254,145,109
2010,40,Austria,Rwanda,181,98,83
2010,56,Belgium,Rwanda,12000,5399,6601
2010,250,France,Rwanda,5816,2562,3254
2010,276,Germany,Rwanda,998,502,496
2010,442,Luxembourg,Rwanda,17,9,8
2010,528,Netherlands,Rwanda,1145,565,580
2010,756,Switzerland,Rwanda,966,432,534
2010,124,Canada,Rwanda,4920,2197,2723
2015,108,Burundi,Rwanda,64363,29140,35223
2015,232,Eritrea,Rwanda,467,220,247
2015,231,Ethiopia,Rwanda,150,76,74
2015,404,Kenya,Rwanda,6330,3142,3188
2015,454,Malawi,Rwanda,6576,3409,3167
2015,800,Uganda,Rwanda,72393,35609,36784
2015,834,United Republic of Tanzania,Rwanda,581,379,202
2015,894,Zambia,Rwanda,6573,3387,3186
2015,24,Angola,Rwanda,1215,507,708
2015,178,Congo,Rwanda,25119,14246,10873
2015,180,Democratic Republic of the Congo,Rwanda,280052,139392,140660
2015,266,Gabon,Rwanda,191,112,79
2015,748,Eswatini,Rwanda,342,170,172
2015,516,Namibia,Rwanda,350,196,154
2015,710,South Africa,Rwanda,7377,2754,4623
2015,288,Ghana,Rwanda,382,135,247
2015,324,Guinea,Rwanda,39,23,16
2015,466,Mali,Rwanda,480,280,200
2015,686,Senegal,Rwanda,283,146,137
2015,768,Togo,Rwanda,665,321,344
2015,818,Egypt,Rwanda,31,26,5
2015,764,Thailand,Rwanda,4,2,2
2015,188,Costa Rica,Rwanda,1,0,1
2015,68,Bolivia (Plurinational State of),Rwanda,1,0,1
2015,76,Brazil,Rwanda,16,16,0
2015,152,Chile,Rwanda,15,11,4
2015,36,Australia,Rwanda,980,480,500
2015,100,Bulgaria,Rwanda,2,1,1
2015,203,Czechia,Rwanda,8,6,2
2015,348,Hungary,Rwanda,19,11,8
2015,643,Russian Federation,Rwanda,45,27,18
2015,208,Denmark,Rwanda,410,185,225
2015,233,Estonia,Rwanda,1,1,0
2015,246,Finland,Rwanda,563,269,294
2015,352,Iceland,Rwanda,2,2,0
2015,372,Ireland,Rwanda,80,31,49
2015,428,Latvia,Rwanda,1,1,0
2015,578,Norway,Rwanda,618,284,334
2015,752,Sweden,Rwanda,592,289,303
2015,826,United Kingdom,Rwanda,4239,1859,2380
2015,300,Greece,Rwanda,96,75,21
2015,380,Italy,Rwanda,774,345,429
2015,705,Slovenia,Rwanda,11,5,6
2015,724,Spain,Rwanda,283,154,129
2015,40,Austria,Rwanda,211,115,96
2015,56,Belgium,Rwanda,13990,6332,7658
2015,250,France,Rwanda,6442,2738,3704
2015,276,Germany,Rwanda,1040,522,518
2015,442,Luxembourg,Rwanda,25,13,12
2015,528,Netherlands,Rwanda,1157,565,592
2015,756,Switzerland,Rwanda,1048,454,594
2015,124,Canada,Rwanda,6067,2836,3231
2019,108,Burundi,Rwanda,71294,32276,39018
2019,232,Eritrea,Rwanda,471,222,249
2019,231,Ethiopia,Rwanda,161,82,79
2019,404,Kenya,Rwanda,5869,2916,2953
2019,454,Malawi,Rwanda,7108,3665,3443
2019,800,Uganda,Rwanda,70635,34425,36210
2019,834,United Republic of Tanzania,Rwanda,521,339,182
2019,894,Zambia,Rwanda,8470,4375,4095
2019,24,Angola,Rwanda,1286,578,708
2019,178,Congo,Rwanda,25891,14678,11213
2019,180,Democratic Republic of the Congo,Rwanda,254225,126606,127619
2019,266,Gabon,Rwanda,207,122,85
2019,748,Eswatini,Rwanda,382,189,193
2019,516,Namibia,Rwanda,370,207,163
2019,710,South Africa,Rwanda,8268,3092,5176
2019,288,Ghana,Rwanda,429,152,277
2019,324,Guinea,Rwanda,37,22,15
2019,466,Mali,Rwanda,534,312,222
2019,686,Senegal,Rwanda,285,147,138
2019,768,Togo,Rwanda,669,325,344
2019,818,Egypt,Rwanda,44,37,7
2019,764,Thailand,Rwanda,4,2,2
2019,188,Costa Rica,Rwanda,1,0,1
2019,68,Bolivia (Plurinational State of),Rwanda,1,0,1
2019,76,Brazil,Rwanda,18,18,0
2019,152,Chile,Rwanda,20,15,5
2019,36,Australia,Rwanda,1153,537,616
2019,100,Bulgaria,Rwanda,2,1,1
2019,203,Czechia,Rwanda,13,8,5
2019,348,Hungary,Rwanda,17,9,8
2019,643,Russian Federation,Rwanda,44,27,17
2019,208,Denmark,Rwanda,425,197,228
2019,233,Estonia,Rwanda,1,1,0
2019,246,Finland,Rwanda,650,308,342
2019,352,Iceland,Rwanda,1,1,0
2019,372,Ireland,Rwanda,87,34,53
2019,428,Latvia,Rwanda,1,1,0
2019,578,Norway,Rwanda,685,308,377
2019,752,Sweden,Rwanda,818,403,415
2019,826,United Kingdom,Rwanda,4813,2118,2695
2019,300,Greece,Rwanda,93,74,19
2019,380,Italy,Rwanda,815,364,451
2019,705,Slovenia,Rwanda,2,1,1
2019,724,Spain,Rwanda,293,157,136
2019,40,Austria,Rwanda,249,138,111
2019,56,Belgium,Rwanda,14930,6765,8165
2019,250,France,Rwanda,6818,2889,3929
2019,276,Germany,Rwanda,1140,610,530
2019,442,Luxembourg,Rwanda,213,94,119
2019,528,Netherlands,Rwanda,1157,563,594
2019,756,Switzerland,Rwanda,1092,478,614
2019,124,Canada,Rwanda,6501,3039,3462
1990,710,South Africa,Saint Helena,220,37,183
1990,214,Dominican Republic,Saint Helena,94,48,46
1990,238,Falkland Islands (Malvinas),Saint Helena,31,18,13
1990,36,Australia,Saint Helena,31,12,19
1990,372,Ireland,Saint Helena,1,0,1
1990,826,United Kingdom,Saint Helena,480,256,224
1990,300,Greece,Saint Helena,26,15,11
1990,250,France,Saint Helena,1,0,1
1995,710,South Africa,Saint Helena,137,32,105
1995,214,Dominican Republic,Saint Helena,105,52,53
1995,152,Chile,Saint Helena,164,64,100
1995,238,Falkland Islands (Malvinas),Saint Helena,32,19,13
1995,36,Australia,Saint Helena,21,7,14
1995,372,Ireland,Saint Helena,4,1,3
1995,826,United Kingdom,Saint Helena,1888,765,1123
1995,300,Greece,Saint Helena,19,11,8
1995,250,France,Saint Helena,1,0,1
2000,710,South Africa,Saint Helena,95,33,62
2000,214,Dominican Republic,Saint Helena,115,56,59
2000,152,Chile,Saint Helena,328,126,202
2000,238,Falkland Islands (Malvinas),Saint Helena,133,79,54
2000,36,Australia,Saint Helena,21,7,14
2000,372,Ireland,Saint Helena,8,2,6
2000,826,United Kingdom,Saint Helena,3329,1284,2045
2000,300,Greece,Saint Helena,13,7,6
2000,250,France,Saint Helena,1,0,1
2005,710,South Africa,Saint Helena,124,40,84
2005,214,Dominican Republic,Saint Helena,104,51,53
2005,152,Chile,Saint Helena,492,194,298
2005,238,Falkland Islands (Malvinas),Saint Helena,153,88,65
2005,36,Australia,Saint Helena,21,7,14
2005,372,Ireland,Saint Helena,8,2,6
2005,826,United Kingdom,Saint Helena,2847,1128,1719
2005,300,Greece,Saint Helena,9,5,4
2005,250,France,Saint Helena,8,1,7
2010,710,South Africa,Saint Helena,194,63,131
2010,214,Dominican Republic,Saint Helena,92,45,47
2010,152,Chile,Saint Helena,656,262,394
2010,238,Falkland Islands (Malvinas),Saint Helena,295,167,128
2010,36,Australia,Saint Helena,21,7,14
2010,372,Ireland,Saint Helena,7,1,6
2010,826,United Kingdom,Saint Helena,2999,1226,1773
2010,300,Greece,Saint Helena,4,3,1
2010,250,France,Saint Helena,1,0,1
2015,710,South Africa,Saint Helena,349,102,247
2015,214,Dominican Republic,Saint Helena,97,48,49
2015,152,Chile,Saint Helena,993,384,609
2015,238,Falkland Islands (Malvinas),Saint Helena,323,181,142
2015,36,Australia,Saint Helena,21,13,8
2015,372,Ireland,Saint Helena,7,1,6
2015,826,United Kingdom,Saint Helena,3835,1501,2334
2015,300,Greece,Saint Helena,3,3,0
2015,250,France,Saint Helena,1,0,1
2019,710,South Africa,Saint Helena,390,114,276
2019,214,Dominican Republic,Saint Helena,100,50,50
2019,152,Chile,Saint Helena,1326,467,859
2019,238,Falkland Islands (Malvinas),Saint Helena,391,220,171
2019,36,Australia,Saint Helena,21,13,8
2019,372,Ireland,Saint Helena,7,1,6
2019,826,United Kingdom,Saint Helena,4355,1712,2643
2019,300,Greece,Saint Helena,2,2,0
2019,250,France,Saint Helena,4,3,1
1990,710,South Africa,Saint Kitts and Nevis,26,14,12
1990,660,Anguilla,Saint Kitts and Nevis,426,281,145
1990,28,Antigua and Barbuda,Saint Kitts and Nevis,469,225,244
1990,44,Bahamas,Saint Kitts and Nevis,13,6,7
1990,92,British Virgin Islands,Saint Kitts and Nevis,1555,810,745
1990,535,"Bonaire, Sint Eustatius and Saba",Saint Kitts and Nevis,2083,826,1257
1990,212,Dominica,Saint Kitts and Nevis,23,9,14
1990,214,Dominican Republic,Saint Kitts and Nevis,76,56,20
1990,308,Grenada,Saint Kitts and Nevis,9,5,4
1990,388,Jamaica,Saint Kitts and Nevis,75,37,38
1990,500,Montserrat,Saint Kitts and Nevis,176,75,101
1990,662,Saint Lucia,Saint Kitts and Nevis,19,8,11
1990,670,Saint Vincent and the Grenadines,Saint Kitts and Nevis,35,10,25
1990,850,United States Virgin Islands,Saint Kitts and Nevis,5828,2643,3185
1990,188,Costa Rica,Saint Kitts and Nevis,1,0,1
1990,68,Bolivia (Plurinational State of),Saint Kitts and Nevis,1,1,0
1990,152,Chile,Saint Kitts and Nevis,13,6,7
1990,36,Australia,Saint Kitts and Nevis,17,6,11
1990,203,Czechia,Saint Kitts and Nevis,1,1,0
1990,348,Hungary,Saint Kitts and Nevis,12,3,9
1990,826,United Kingdom,Saint Kitts and Nevis,910,542,368
1990,300,Greece,Saint Kitts and Nevis,6,3,3
1990,380,Italy,Saint Kitts and Nevis,2,1,1
1990,40,Austria,Saint Kitts and Nevis,1,0,1
1990,250,France,Saint Kitts and Nevis,5,1,4
1990,528,Netherlands,Saint Kitts and Nevis,21,12,9
1990,124,Canada,Saint Kitts and Nevis,1464,713,751
1990,840,United States of America,Saint Kitts and Nevis,7447,3240,4207
1995,710,South Africa,Saint Kitts and Nevis,16,9,7
1995,660,Anguilla,Saint Kitts and Nevis,549,358,191
1995,28,Antigua and Barbuda,Saint Kitts and Nevis,430,204,226
1995,44,Bahamas,Saint Kitts and Nevis,12,5,7
1995,92,British Virgin Islands,Saint Kitts and Nevis,1828,930,898
1995,535,"Bonaire, Sint Eustatius and Saba",Saint Kitts and Nevis,1312,509,803
1995,212,Dominica,Saint Kitts and Nevis,30,12,18
1995,214,Dominican Republic,Saint Kitts and Nevis,85,62,23
1995,308,Grenada,Saint Kitts and Nevis,11,6,5
1995,388,Jamaica,Saint Kitts and Nevis,89,43,46
1995,500,Montserrat,Saint Kitts and Nevis,141,60,81
1995,662,Saint Lucia,Saint Kitts and Nevis,25,11,14
1995,670,Saint Vincent and the Grenadines,Saint Kitts and Nevis,36,10,26
1995,850,United States Virgin Islands,Saint Kitts and Nevis,6435,2919,3516
1995,188,Costa Rica,Saint Kitts and Nevis,1,0,1
1995,68,Bolivia (Plurinational State of),Saint Kitts and Nevis,1,1,0
1995,152,Chile,Saint Kitts and Nevis,12,7,5
1995,36,Australia,Saint Kitts and Nevis,19,9,10
1995,203,Czechia,Saint Kitts and Nevis,2,2,0
1995,348,Hungary,Saint Kitts and Nevis,8,2,6
1995,246,Finland,Saint Kitts and Nevis,1,1,0
1995,372,Ireland,Saint Kitts and Nevis,1,1,0
1995,826,United Kingdom,Saint Kitts and Nevis,3575,1728,1847
1995,300,Greece,Saint Kitts and Nevis,6,3,3
1995,380,Italy,Saint Kitts and Nevis,6,1,5
1995,40,Austria,Saint Kitts and Nevis,2,0,2
1995,250,France,Saint Kitts and Nevis,6,2,4
1995,528,Netherlands,Saint Kitts and Nevis,29,15,14
1995,124,Canada,Saint Kitts and Nevis,1944,941,1003
1995,840,United States of America,Saint Kitts and Nevis,9374,4131,5243
2000,710,South Africa,Saint Kitts and Nevis,11,7,4
2000,660,Anguilla,Saint Kitts and Nevis,672,435,237
2000,28,Antigua and Barbuda,Saint Kitts and Nevis,391,183,208
2000,44,Bahamas,Saint Kitts and Nevis,12,6,6
2000,92,British Virgin Islands,Saint Kitts and Nevis,2100,1050,1050
2000,535,"Bonaire, Sint Eustatius and Saba",Saint Kitts and Nevis,541,191,350
2000,212,Dominica,Saint Kitts and Nevis,36,15,21
2000,214,Dominican Republic,Saint Kitts and Nevis,93,67,26
2000,308,Grenada,Saint Kitts and Nevis,14,8,6
2000,388,Jamaica,Saint Kitts and Nevis,103,50,53
2000,500,Montserrat,Saint Kitts and Nevis,107,46,61
2000,662,Saint Lucia,Saint Kitts and Nevis,34,15,19
2000,670,Saint Vincent and the Grenadines,Saint Kitts and Nevis,37,10,27
2000,850,United States Virgin Islands,Saint Kitts and Nevis,7054,3198,3856
2000,188,Costa Rica,Saint Kitts and Nevis,1,0,1
2000,152,Chile,Saint Kitts and Nevis,12,6,6
2000,36,Australia,Saint Kitts and Nevis,19,9,10
2000,203,Czechia,Saint Kitts and Nevis,3,3,0
2000,348,Hungary,Saint Kitts and Nevis,3,1,2
2000,246,Finland,Saint Kitts and Nevis,1,1,0
2000,372,Ireland,Saint Kitts and Nevis,3,2,1
2000,752,Sweden,Saint Kitts and Nevis,2,1,1
2000,826,United Kingdom,Saint Kitts and Nevis,6302,2940,3362
2000,300,Greece,Saint Kitts and Nevis,6,3,3
2000,380,Italy,Saint Kitts and Nevis,9,1,8
2000,40,Austria,Saint Kitts and Nevis,2,0,2
2000,250,France,Saint Kitts and Nevis,6,2,4
2000,528,Netherlands,Saint Kitts and Nevis,41,20,21
2000,124,Canada,Saint Kitts and Nevis,2471,1192,1279
2000,840,United States of America,Saint Kitts and Nevis,11334,5044,6290
2005,710,South Africa,Saint Kitts and Nevis,14,9,5
2005,660,Anguilla,Saint Kitts and Nevis,774,502,272
2005,28,Antigua and Barbuda,Saint Kitts and Nevis,420,196,224
2005,44,Bahamas,Saint Kitts and Nevis,22,9,13
2005,52,Barbados,Saint Kitts and Nevis,78,35,43
2005,92,British Virgin Islands,Saint Kitts and Nevis,2405,1202,1203
2005,535,"Bonaire, Sint Eustatius and Saba",Saint Kitts and Nevis,576,203,373
2005,212,Dominica,Saint Kitts and Nevis,44,18,26
2005,214,Dominican Republic,Saint Kitts and Nevis,112,73,39
2005,308,Grenada,Saint Kitts and Nevis,14,8,6
2005,388,Jamaica,Saint Kitts and Nevis,101,49,52
2005,500,Montserrat,Saint Kitts and Nevis,110,47,63
2005,662,Saint Lucia,Saint Kitts and Nevis,37,16,21
2005,670,Saint Vincent and the Grenadines,Saint Kitts and Nevis,37,11,26
2005,534,Sint Maarten (Dutch part),Saint Kitts and Nevis,500,180,320
2005,850,United States Virgin Islands,Saint Kitts and Nevis,7074,3227,3847
2005,188,Costa Rica,Saint Kitts and Nevis,1,0,1
2005,152,Chile,Saint Kitts and Nevis,18,10,8
2005,36,Australia,Saint Kitts and Nevis,19,9,10
2005,203,Czechia,Saint Kitts and Nevis,2,2,0
2005,348,Hungary,Saint Kitts and Nevis,4,2,2
2005,246,Finland,Saint Kitts and Nevis,1,1,0
2005,372,Ireland,Saint Kitts and Nevis,3,2,1
2005,752,Sweden,Saint Kitts and Nevis,2,1,1
2005,826,United Kingdom,Saint Kitts and Nevis,5622,2602,3020
2005,300,Greece,Saint Kitts and Nevis,4,2,2
2005,380,Italy,Saint Kitts and Nevis,7,1,6
2005,40,Austria,Saint Kitts and Nevis,2,0,2
2005,250,France,Saint Kitts and Nevis,114,40,74
2005,528,Netherlands,Saint Kitts and Nevis,71,29,42
2005,124,Canada,Saint Kitts and Nevis,2192,942,1250
2005,840,United States of America,Saint Kitts and Nevis,13543,6070,7473
2010,710,South Africa,Saint Kitts and Nevis,21,14,7
2010,660,Anguilla,Saint Kitts and Nevis,843,548,295
2010,28,Antigua and Barbuda,Saint Kitts and Nevis,448,209,239
2010,44,Bahamas,Saint Kitts and Nevis,31,12,19
2010,52,Barbados,Saint Kitts and Nevis,104,46,58
2010,92,British Virgin Islands,Saint Kitts and Nevis,1214,607,607
2010,535,"Bonaire, Sint Eustatius and Saba",Saint Kitts and Nevis,23,6,17
2010,531,Curaçao,Saint Kitts and Nevis,167,38,129
2010,212,Dominica,Saint Kitts and Nevis,54,22,32
2010,214,Dominican Republic,Saint Kitts and Nevis,130,78,52
2010,308,Grenada,Saint Kitts and Nevis,15,8,7
2010,388,Jamaica,Saint Kitts and Nevis,98,48,50
2010,500,Montserrat,Saint Kitts and Nevis,113,48,65
2010,662,Saint Lucia,Saint Kitts and Nevis,38,16,22
2010,670,Saint Vincent and the Grenadines,Saint Kitts and Nevis,39,13,26
2010,534,Sint Maarten (Dutch part),Saint Kitts and Nevis,1001,361,640
2010,850,United States Virgin Islands,Saint Kitts and Nevis,7096,3256,3840
2010,188,Costa Rica,Saint Kitts and Nevis,1,0,1
2010,76,Brazil,Saint Kitts and Nevis,30,26,4
2010,152,Chile,Saint Kitts and Nevis,24,13,11
2010,36,Australia,Saint Kitts and Nevis,19,9,10
2010,203,Czechia,Saint Kitts and Nevis,3,3,0
2010,348,Hungary,Saint Kitts and Nevis,5,4,1
2010,233,Estonia,Saint Kitts and Nevis,1,0,1
2010,246,Finland,Saint Kitts and Nevis,1,1,0
2010,372,Ireland,Saint Kitts and Nevis,2,1,1
2010,826,United Kingdom,Saint Kitts and Nevis,5922,2806,3116
2010,300,Greece,Saint Kitts and Nevis,2,1,1
2010,380,Italy,Saint Kitts and Nevis,4,1,3
2010,40,Austria,Saint Kitts and Nevis,2,0,2
2010,250,France,Saint Kitts and Nevis,3,0,3
2010,528,Netherlands,Saint Kitts and Nevis,73,28,45
2010,124,Canada,Saint Kitts and Nevis,2085,768,1317
2010,840,United States of America,Saint Kitts and Nevis,16226,7150,9076
2015,710,South Africa,Saint Kitts and Nevis,36,24,12
2015,660,Anguilla,Saint Kitts and Nevis,903,588,315
2015,28,Antigua and Barbuda,Saint Kitts and Nevis,476,222,254
2015,44,Bahamas,Saint Kitts and Nevis,34,13,21
2015,52,Barbados,Saint Kitts and Nevis,109,49,60
2015,92,British Virgin Islands,Saint Kitts and Nevis,1360,680,680
2015,535,"Bonaire, Sint Eustatius and Saba",Saint Kitts and Nevis,26,7,19
2015,531,Curaçao,Saint Kitts and Nevis,181,42,139
2015,212,Dominica,Saint Kitts and Nevis,63,26,37
2015,214,Dominican Republic,Saint Kitts and Nevis,137,83,54
2015,308,Grenada,Saint Kitts and Nevis,15,8,7
2015,388,Jamaica,Saint Kitts and Nevis,96,47,49
2015,500,Montserrat,Saint Kitts and Nevis,118,51,67
2015,662,Saint Lucia,Saint Kitts and Nevis,36,16,20
2015,670,Saint Vincent and the Grenadines,Saint Kitts and Nevis,39,10,29
2015,534,Sint Maarten (Dutch part),Saint Kitts and Nevis,1042,374,668
2015,850,United States Virgin Islands,Saint Kitts and Nevis,7100,3257,3843
2015,188,Costa Rica,Saint Kitts and Nevis,1,0,1
2015,76,Brazil,Saint Kitts and Nevis,36,31,5
2015,152,Chile,Saint Kitts and Nevis,36,20,16
2015,36,Australia,Saint Kitts and Nevis,19,12,7
2015,203,Czechia,Saint Kitts and Nevis,4,4,0
2015,233,Estonia,Saint Kitts and Nevis,1,0,1
2015,246,Finland,Saint Kitts and Nevis,1,1,0
2015,372,Ireland,Saint Kitts and Nevis,2,1,1
2015,752,Sweden,Saint Kitts and Nevis,1,1,0
2015,826,United Kingdom,Saint Kitts and Nevis,7573,3470,4103
2015,300,Greece,Saint Kitts and Nevis,1,1,0
2015,380,Italy,Saint Kitts and Nevis,4,1,3
2015,40,Austria,Saint Kitts and Nevis,2,0,2
2015,250,France,Saint Kitts and Nevis,3,0,3
2015,528,Netherlands,Saint Kitts and Nevis,77,26,51
2015,124,Canada,Saint Kitts and Nevis,2092,929,1163
2015,840,United States of America,Saint Kitts and Nevis,19107,8366,10741
2019,710,South Africa,Saint Kitts and Nevis,39,26,13
2019,660,Anguilla,Saint Kitts and Nevis,937,611,326
2019,28,Antigua and Barbuda,Saint Kitts and Nevis,495,231,264
2019,44,Bahamas,Saint Kitts and Nevis,36,14,22
2019,52,Barbados,Saint Kitts and Nevis,110,50,60
2019,92,British Virgin Islands,Saint Kitts and Nevis,1477,739,738
2019,535,"Bonaire, Sint Eustatius and Saba",Saint Kitts and Nevis,30,8,22
2019,531,Curaçao,Saint Kitts and Nevis,196,45,151
2019,212,Dominica,Saint Kitts and Nevis,64,27,37
2019,214,Dominican Republic,Saint Kitts and Nevis,141,86,55
2019,308,Grenada,Saint Kitts and Nevis,15,8,7
2019,388,Jamaica,Saint Kitts and Nevis,97,48,49
2019,500,Montserrat,Saint Kitts and Nevis,120,52,68
2019,662,Saint Lucia,Saint Kitts and Nevis,34,16,18
2019,670,Saint Vincent and the Grenadines,Saint Kitts and Nevis,38,9,29
2019,534,Sint Maarten (Dutch part),Saint Kitts and Nevis,1078,387,691
2019,850,United States Virgin Islands,Saint Kitts and Nevis,7103,3259,3844
2019,188,Costa Rica,Saint Kitts and Nevis,1,0,1
2019,76,Brazil,Saint Kitts and Nevis,40,35,5
2019,152,Chile,Saint Kitts and Nevis,48,26,22
2019,36,Australia,Saint Kitts and Nevis,19,12,7
2019,203,Czechia,Saint Kitts and Nevis,6,6,0
2019,246,Finland,Saint Kitts and Nevis,1,1,0
2019,372,Ireland,Saint Kitts and Nevis,2,1,1
2019,826,United Kingdom,Saint Kitts and Nevis,8599,3952,4647
2019,380,Italy,Saint Kitts and Nevis,10,5,5
2019,40,Austria,Saint Kitts and Nevis,2,0,2
2019,250,France,Saint Kitts and Nevis,5,2,3
2019,528,Netherlands,Saint Kitts and Nevis,71,25,46
2019,124,Canada,Saint Kitts and Nevis,2241,995,1246
2019,840,United States of America,Saint Kitts and Nevis,20632,8909,11723
1990,28,Antigua and Barbuda,Saint Lucia,392,188,204
1990,44,Bahamas,Saint Lucia,25,10,15
1990,52,Barbados,Saint Lucia,3317,1222,2095
1990,92,British Virgin Islands,Saint Lucia,274,120,154
1990,535,"Bonaire, Sint Eustatius and Saba",Saint Lucia,1,0,1
1990,136,Cayman Islands,Saint Lucia,2,1,1
1990,212,Dominica,Saint Lucia,102,51,51
1990,308,Grenada,Saint Lucia,92,45,47
1990,312,Guadeloupe,Saint Lucia,273,138,135
1990,388,Jamaica,Saint Lucia,257,127,130
1990,474,Martinique,Saint Lucia,989,446,543
1990,659,Saint Kitts and Nevis,Saint Lucia,46,29,17
1990,670,Saint Vincent and the Grenadines,Saint Lucia,208,84,124
1990,780,Trinidad and Tobago,Saint Lucia,1306,673,633
1990,850,United States Virgin Islands,Saint Lucia,2533,1203,1330
1990,188,Costa Rica,Saint Lucia,2,1,1
1990,152,Chile,Saint Lucia,5,3,2
1990,254,French Guiana,Saint Lucia,1722,920,802
1990,328,Guyana,Saint Lucia,286,166,120
1990,862,Venezuela (Bolivarian Republic of),Saint Lucia,65,33,32
1990,36,Australia,Saint Lucia,16,12,4
1990,208,Denmark,Saint Lucia,3,2,1
1990,372,Ireland,Saint Lucia,1,1,0
1990,752,Sweden,Saint Lucia,22,16,6
1990,826,United Kingdom,Saint Lucia,1153,667,486
1990,380,Italy,Saint Lucia,1,0,1
1990,724,Spain,Saint Lucia,3,1,2
1990,40,Austria,Saint Lucia,8,5,3
1990,250,France,Saint Lucia,155,52,103
1990,528,Netherlands,Saint Lucia,20,12,8
1990,756,Switzerland,Saint Lucia,54,36,18
1990,124,Canada,Saint Lucia,1713,834,879
1990,840,United States of America,Saint Lucia,6959,2955,4004
1995,28,Antigua and Barbuda,Saint Lucia,474,214,260
1995,44,Bahamas,Saint Lucia,41,18,23
1995,52,Barbados,Saint Lucia,3621,1371,2250
1995,92,British Virgin Islands,Saint Lucia,323,137,186
1995,535,"Bonaire, Sint Eustatius and Saba",Saint Lucia,1,0,1
1995,136,Cayman Islands,Saint Lucia,6,3,3
1995,212,Dominica,Saint Lucia,135,67,68
1995,308,Grenada,Saint Lucia,119,59,60
1995,312,Guadeloupe,Saint Lucia,274,132,142
1995,388,Jamaica,Saint Lucia,305,150,155
1995,474,Martinique,Saint Lucia,1390,631,759
1995,659,Saint Kitts and Nevis,Saint Lucia,60,39,21
1995,670,Saint Vincent and the Grenadines,Saint Lucia,216,88,128
1995,780,Trinidad and Tobago,Saint Lucia,1185,610,575
1995,850,United States Virgin Islands,Saint Lucia,2990,1420,1570
1995,188,Costa Rica,Saint Lucia,1,0,1
1995,152,Chile,Saint Lucia,32,14,18
1995,254,French Guiana,Saint Lucia,1565,808,757
1995,328,Guyana,Saint Lucia,275,159,116
1995,862,Venezuela (Bolivarian Republic of),Saint Lucia,40,19,21
1995,36,Australia,Saint Lucia,13,11,2
1995,203,Czechia,Saint Lucia,1,1,0
1995,208,Denmark,Saint Lucia,2,1,1
1995,246,Finland,Saint Lucia,1,1,0
1995,372,Ireland,Saint Lucia,4,3,1
1995,752,Sweden,Saint Lucia,27,19,8
1995,826,United Kingdom,Saint Lucia,4534,2100,2434
1995,380,Italy,Saint Lucia,6,1,5
1995,724,Spain,Saint Lucia,6,3,3
1995,40,Austria,Saint Lucia,9,6,3
1995,250,France,Saint Lucia,160,52,108
1995,528,Netherlands,Saint Lucia,29,17,12
1995,756,Switzerland,Saint Lucia,47,30,17
1995,124,Canada,Saint Lucia,2435,1179,1256
1995,840,United States of America,Saint Lucia,10378,4473,5905
2000,28,Antigua and Barbuda,Saint Lucia,556,241,315
2000,44,Bahamas,Saint Lucia,57,27,30
2000,52,Barbados,Saint Lucia,3924,1520,2404
2000,92,British Virgin Islands,Saint Lucia,371,154,217
2000,535,"Bonaire, Sint Eustatius and Saba",Saint Lucia,2,0,2
2000,136,Cayman Islands,Saint Lucia,11,5,6
2000,212,Dominica,Saint Lucia,161,81,80
2000,308,Grenada,Saint Lucia,147,73,74
2000,312,Guadeloupe,Saint Lucia,274,126,148
2000,388,Jamaica,Saint Lucia,353,173,180
2000,474,Martinique,Saint Lucia,1792,817,975
2000,659,Saint Kitts and Nevis,Saint Lucia,82,54,28
2000,670,Saint Vincent and the Grenadines,Saint Lucia,224,91,133
2000,780,Trinidad and Tobago,Saint Lucia,976,479,497
2000,850,United States Virgin Islands,Saint Lucia,3454,1640,1814
2000,188,Costa Rica,Saint Lucia,1,0,1
2000,152,Chile,Saint Lucia,60,26,34
2000,254,French Guiana,Saint Lucia,1408,696,712
2000,328,Guyana,Saint Lucia,264,153,111
2000,862,Venezuela (Bolivarian Republic of),Saint Lucia,25,11,14
2000,36,Australia,Saint Lucia,13,11,2
2000,203,Czechia,Saint Lucia,1,1,0
2000,246,Finland,Saint Lucia,1,1,0
2000,372,Ireland,Saint Lucia,8,5,3
2000,752,Sweden,Saint Lucia,29,20,9
2000,826,United Kingdom,Saint Lucia,7993,3563,4430
2000,380,Italy,Saint Lucia,11,3,8
2000,724,Spain,Saint Lucia,81,38,43
2000,40,Austria,Saint Lucia,10,7,3
2000,250,France,Saint Lucia,165,52,113
2000,528,Netherlands,Saint Lucia,41,23,18
2000,756,Switzerland,Saint Lucia,42,25,17
2000,124,Canada,Saint Lucia,3214,1551,1663
2000,840,United States of America,Saint Lucia,13867,6030,7837
2005,28,Antigua and Barbuda,Saint Lucia,596,258,338
2005,44,Bahamas,Saint Lucia,65,32,33
2005,52,Barbados,Saint Lucia,2991,1168,1823
2005,92,British Virgin Islands,Saint Lucia,425,176,249
2005,535,"Bonaire, Sint Eustatius and Saba",Saint Lucia,2,0,2
2005,136,Cayman Islands,Saint Lucia,10,5,5
2005,212,Dominica,Saint Lucia,198,99,99
2005,308,Grenada,Saint Lucia,154,77,77
2005,312,Guadeloupe,Saint Lucia,336,154,182
2005,388,Jamaica,Saint Lucia,344,169,175
2005,474,Martinique,Saint Lucia,1876,831,1045
2005,659,Saint Kitts and Nevis,Saint Lucia,93,58,35
2005,670,Saint Vincent and the Grenadines,Saint Lucia,230,96,134
2005,534,Sint Maarten (Dutch part),Saint Lucia,233,106,127
2005,780,Trinidad and Tobago,Saint Lucia,1047,513,534
2005,850,United States Virgin Islands,Saint Lucia,3438,1642,1796
2005,188,Costa Rica,Saint Lucia,1,0,1
2005,152,Chile,Saint Lucia,90,40,50
2005,254,French Guiana,Saint Lucia,1327,651,676
2005,328,Guyana,Saint Lucia,226,132,94
2005,862,Venezuela (Bolivarian Republic of),Saint Lucia,15,8,7
2005,36,Australia,Saint Lucia,13,11,2
2005,203,Czechia,Saint Lucia,2,1,1
2005,208,Denmark,Saint Lucia,4,2,2
2005,246,Finland,Saint Lucia,2,1,1
2005,372,Ireland,Saint Lucia,8,5,3
2005,752,Sweden,Saint Lucia,25,19,6
2005,826,United Kingdom,Saint Lucia,8046,3616,4430
2005,380,Italy,Saint Lucia,17,8,9
2005,724,Spain,Saint Lucia,39,18,21
2005,40,Austria,Saint Lucia,11,7,4
2005,250,France,Saint Lucia,4341,1647,2694
2005,528,Netherlands,Saint Lucia,51,27,24
2005,756,Switzerland,Saint Lucia,46,27,19
2005,124,Canada,Saint Lucia,4135,1679,2456
2005,840,United States of America,Saint Lucia,16569,7257,9312
2010,28,Antigua and Barbuda,Saint Lucia,636,275,361
2010,44,Bahamas,Saint Lucia,72,36,36
2010,52,Barbados,Saint Lucia,2073,823,1250
2010,92,British Virgin Islands,Saint Lucia,461,192,269
2010,136,Cayman Islands,Saint Lucia,10,4,6
2010,212,Dominica,Saint Lucia,241,122,119
2010,308,Grenada,Saint Lucia,162,81,81
2010,312,Guadeloupe,Saint Lucia,398,182,216
2010,388,Jamaica,Saint Lucia,335,166,169
2010,474,Martinique,Saint Lucia,1960,844,1116
2010,659,Saint Kitts and Nevis,Saint Lucia,102,56,46
2010,670,Saint Vincent and the Grenadines,Saint Lucia,237,102,135
2010,534,Sint Maarten (Dutch part),Saint Lucia,467,213,254
2010,780,Trinidad and Tobago,Saint Lucia,850,403,447
2010,850,United States Virgin Islands,Saint Lucia,3423,1644,1779
2010,188,Costa Rica,Saint Lucia,1,0,1
2010,76,Brazil,Saint Lucia,144,48,96
2010,152,Chile,Saint Lucia,120,54,66
2010,254,French Guiana,Saint Lucia,1246,606,640
2010,328,Guyana,Saint Lucia,187,110,77
2010,862,Venezuela (Bolivarian Republic of),Saint Lucia,10,6,4
2010,36,Australia,Saint Lucia,13,11,2
2010,203,Czechia,Saint Lucia,3,2,1
2010,208,Denmark,Saint Lucia,6,3,3
2010,246,Finland,Saint Lucia,3,2,1
2010,372,Ireland,Saint Lucia,7,5,2
2010,752,Sweden,Saint Lucia,30,20,10
2010,826,United Kingdom,Saint Lucia,8476,3905,4571
2010,380,Italy,Saint Lucia,24,12,12
2010,724,Spain,Saint Lucia,60,33,27
2010,40,Austria,Saint Lucia,12,8,4
2010,250,France,Saint Lucia,4460,1337,3123
2010,528,Netherlands,Saint Lucia,53,29,24
2010,756,Switzerland,Saint Lucia,56,30,26
2010,124,Canada,Saint Lucia,4290,1549,2741
2010,840,United States of America,Saint Lucia,19852,8542,11310
2015,28,Antigua and Barbuda,Saint Lucia,676,292,384
2015,44,Bahamas,Saint Lucia,78,39,39
2015,52,Barbados,Saint Lucia,2177,864,1313
2015,92,British Virgin Islands,Saint Lucia,516,215,301
2015,136,Cayman Islands,Saint Lucia,9,4,5
2015,212,Dominica,Saint Lucia,281,142,139
2015,308,Grenada,Saint Lucia,163,81,82
2015,312,Guadeloupe,Saint Lucia,413,187,226
2015,388,Jamaica,Saint Lucia,328,163,165
2015,474,Martinique,Saint Lucia,2030,864,1166
2015,659,Saint Kitts and Nevis,Saint Lucia,102,57,45
2015,670,Saint Vincent and the Grenadines,Saint Lucia,240,103,137
2015,534,Sint Maarten (Dutch part),Saint Lucia,487,222,265
2015,780,Trinidad and Tobago,Saint Lucia,880,425,455
2015,850,United States Virgin Islands,Saint Lucia,3425,1645,1780
2015,188,Costa Rica,Saint Lucia,1,0,1
2015,76,Brazil,Saint Lucia,173,57,116
2015,152,Chile,Saint Lucia,181,80,101
2015,254,French Guiana,Saint Lucia,1253,601,652
2015,328,Guyana,Saint Lucia,219,129,90
2015,862,Venezuela (Bolivarian Republic of),Saint Lucia,6,4,2
2015,36,Australia,Saint Lucia,13,9,4
2015,203,Czechia,Saint Lucia,4,3,1
2015,208,Denmark,Saint Lucia,9,3,6
2015,246,Finland,Saint Lucia,4,3,1
2015,372,Ireland,Saint Lucia,7,5,2
2015,752,Sweden,Saint Lucia,35,23,12
2015,826,United Kingdom,Saint Lucia,10839,4821,6018
2015,380,Italy,Saint Lucia,20,11,9
2015,724,Spain,Saint Lucia,45,25,20
2015,40,Austria,Saint Lucia,14,10,4
2015,250,France,Saint Lucia,4940,1386,3554
2015,528,Netherlands,Saint Lucia,56,33,23
2015,756,Switzerland,Saint Lucia,52,27,25
2015,124,Canada,Saint Lucia,6057,2304,3753
2015,840,United States of America,Saint Lucia,23377,9991,13386
2019,28,Antigua and Barbuda,Saint Lucia,703,304,399
2019,44,Bahamas,Saint Lucia,82,41,41
2019,52,Barbados,Saint Lucia,2197,872,1325
2019,92,British Virgin Islands,Saint Lucia,560,234,326
2019,136,Cayman Islands,Saint Lucia,10,5,5
2019,212,Dominica,Saint Lucia,286,145,141
2019,308,Grenada,Saint Lucia,164,82,82
2019,312,Guadeloupe,Saint Lucia,419,190,229
2019,388,Jamaica,Saint Lucia,332,165,167
2019,474,Martinique,Saint Lucia,2027,863,1164
2019,659,Saint Kitts and Nevis,Saint Lucia,103,58,45
2019,670,Saint Vincent and the Grenadines,Saint Lucia,241,104,137
2019,534,Sint Maarten (Dutch part),Saint Lucia,504,230,274
2019,780,Trinidad and Tobago,Saint Lucia,947,480,467
2019,850,United States Virgin Islands,Saint Lucia,3426,1646,1780
2019,188,Costa Rica,Saint Lucia,1,0,1
2019,76,Brazil,Saint Lucia,194,64,130
2019,152,Chile,Saint Lucia,241,99,142
2019,254,French Guiana,Saint Lucia,1386,665,721
2019,328,Guyana,Saint Lucia,223,132,91
2019,862,Venezuela (Bolivarian Republic of),Saint Lucia,5,4,1
2019,36,Australia,Saint Lucia,13,9,4
2019,203,Czechia,Saint Lucia,6,5,1
2019,208,Denmark,Saint Lucia,12,6,6
2019,246,Finland,Saint Lucia,5,4,1
2019,372,Ireland,Saint Lucia,7,5,2
2019,752,Sweden,Saint Lucia,44,26,18
2019,826,United Kingdom,Saint Lucia,12308,5492,6816
2019,380,Italy,Saint Lucia,21,10,11
2019,724,Spain,Saint Lucia,46,25,21
2019,40,Austria,Saint Lucia,16,12,4
2019,250,France,Saint Lucia,5229,1459,3770
2019,528,Netherlands,Saint Lucia,68,37,31
2019,756,Switzerland,Saint Lucia,58,31,27
2019,124,Canada,Saint Lucia,6490,2469,4021
2019,840,United States of America,Saint Lucia,25244,10635,14609
1990,214,Dominican Republic,Saint Pierre and Miquelon,38,22,16
1990,188,Costa Rica,Saint Pierre and Miquelon,1,0,1
1990,591,Panama,Saint Pierre and Miquelon,11,5,6
1990,152,Chile,Saint Pierre and Miquelon,2,2,0
1990,300,Greece,Saint Pierre and Miquelon,11,6,5
1990,124,Canada,Saint Pierre and Miquelon,422,205,217
1995,214,Dominican Republic,Saint Pierre and Miquelon,43,25,18
1995,188,Costa Rica,Saint Pierre and Miquelon,1,1,0
1995,591,Panama,Saint Pierre and Miquelon,15,7,8
1995,152,Chile,Saint Pierre and Miquelon,2,2,0
1995,300,Greece,Saint Pierre and Miquelon,26,23,3
1995,124,Canada,Saint Pierre and Miquelon,392,190,202
2000,214,Dominican Republic,Saint Pierre and Miquelon,48,28,20
2000,188,Costa Rica,Saint Pierre and Miquelon,1,1,0
2000,591,Panama,Saint Pierre and Miquelon,22,11,11
2000,152,Chile,Saint Pierre and Miquelon,2,2,0
2000,300,Greece,Saint Pierre and Miquelon,41,40,1
2000,124,Canada,Saint Pierre and Miquelon,372,180,192
2005,214,Dominican Republic,Saint Pierre and Miquelon,55,32,23
2005,188,Costa Rica,Saint Pierre and Miquelon,1,1,0
2005,591,Panama,Saint Pierre and Miquelon,29,14,15
2005,152,Chile,Saint Pierre and Miquelon,3,3,0
2005,300,Greece,Saint Pierre and Miquelon,21,20,1
2005,124,Canada,Saint Pierre and Miquelon,320,151,169
2010,214,Dominican Republic,Saint Pierre and Miquelon,61,36,25
2010,188,Costa Rica,Saint Pierre and Miquelon,1,1,0
2010,591,Panama,Saint Pierre and Miquelon,39,19,20
2010,152,Chile,Saint Pierre and Miquelon,4,4,0
2010,300,Greece,Saint Pierre and Miquelon,1,0,1
2010,124,Canada,Saint Pierre and Miquelon,285,132,153
2015,214,Dominican Republic,Saint Pierre and Miquelon,64,38,26
2015,188,Costa Rica,Saint Pierre and Miquelon,1,1,0
2015,591,Panama,Saint Pierre and Miquelon,46,23,23
2015,152,Chile,Saint Pierre and Miquelon,6,6,0
2015,124,Canada,Saint Pierre and Miquelon,288,159,129
2019,214,Dominican Republic,Saint Pierre and Miquelon,66,40,26
2019,188,Costa Rica,Saint Pierre and Miquelon,1,1,0
2019,591,Panama,Saint Pierre and Miquelon,48,25,23
2019,152,Chile,Saint Pierre and Miquelon,8,8,0
2019,124,Canada,Saint Pierre and Miquelon,308,170,138
1990,28,Antigua and Barbuda,Saint Vincent and the Grenadines,478,230,248
1990,533,Aruba,Saint Vincent and the Grenadines,225,85,140
1990,44,Bahamas,Saint Vincent and the Grenadines,20,15,5
1990,52,Barbados,Saint Vincent and the Grenadines,3676,1528,2148
1990,92,British Virgin Islands,Saint Vincent and the Grenadines,1046,597,449
1990,535,"Bonaire, Sint Eustatius and Saba",Saint Vincent and the Grenadines,39,18,21
1990,136,Cayman Islands,Saint Vincent and the Grenadines,9,8,1
1990,212,Dominica,Saint Vincent and the Grenadines,45,25,20
1990,308,Grenada,Saint Vincent and the Grenadines,325,161,164
1990,388,Jamaica,Saint Vincent and the Grenadines,176,87,89
1990,500,Montserrat,Saint Vincent and the Grenadines,45,30,15
1990,659,Saint Kitts and Nevis,Saint Vincent and the Grenadines,74,36,38
1990,662,Saint Lucia,Saint Vincent and the Grenadines,182,79,103
1990,780,Trinidad and Tobago,Saint Vincent and the Grenadines,11629,5248,6381
1990,850,United States Virgin Islands,Saint Vincent and the Grenadines,432,216,216
1990,188,Costa Rica,Saint Vincent and the Grenadines,1,1,0
1990,328,Guyana,Saint Vincent and the Grenadines,103,55,48
1990,604,Peru,Saint Vincent and the Grenadines,13,4,9
1990,862,Venezuela (Bolivarian Republic of),Saint Vincent and the Grenadines,107,65,42
1990,36,Australia,Saint Vincent and the Grenadines,22,12,10
1990,208,Denmark,Saint Vincent and the Grenadines,8,7,1
1990,246,Finland,Saint Vincent and the Grenadines,1,1,0
1990,372,Ireland,Saint Vincent and the Grenadines,1,1,0
1990,752,Sweden,Saint Vincent and the Grenadines,10,8,2
1990,826,United Kingdom,Saint Vincent and the Grenadines,990,597,393
1990,300,Greece,Saint Vincent and the Grenadines,92,51,41
1990,40,Austria,Saint Vincent and the Grenadines,6,3,3
1990,250,France,Saint Vincent and the Grenadines,93,28,65
1990,528,Netherlands,Saint Vincent and the Grenadines,20,10,10
1990,124,Canada,Saint Vincent and the Grenadines,4357,2122,2235
1990,840,United States of America,Saint Vincent and the Grenadines,12824,6579,6245
1995,28,Antigua and Barbuda,Saint Vincent and the Grenadines,616,340,276
1995,533,Aruba,Saint Vincent and the Grenadines,178,63,115
1995,44,Bahamas,Saint Vincent and the Grenadines,21,14,7
1995,52,Barbados,Saint Vincent and the Grenadines,4014,1707,2307
1995,92,British Virgin Islands,Saint Vincent and the Grenadines,1230,689,541
1995,535,"Bonaire, Sint Eustatius and Saba",Saint Vincent and the Grenadines,80,36,44
1995,136,Cayman Islands,Saint Vincent and the Grenadines,18,14,4
1995,212,Dominica,Saint Vincent and the Grenadines,60,34,26
1995,308,Grenada,Saint Vincent and the Grenadines,333,120,213
1995,388,Jamaica,Saint Vincent and the Grenadines,209,102,107
1995,500,Montserrat,Saint Vincent and the Grenadines,35,24,11
1995,659,Saint Kitts and Nevis,Saint Vincent and the Grenadines,97,48,49
1995,662,Saint Lucia,Saint Vincent and the Grenadines,245,107,138
1995,780,Trinidad and Tobago,Saint Vincent and the Grenadines,10556,4751,5805
1995,850,United States Virgin Islands,Saint Vincent and the Grenadines,485,243,242
1995,188,Costa Rica,Saint Vincent and the Grenadines,1,1,0
1995,152,Chile,Saint Vincent and the Grenadines,2,1,1
1995,328,Guyana,Saint Vincent and the Grenadines,154,83,71
1995,604,Peru,Saint Vincent and the Grenadines,14,4,10
1995,862,Venezuela (Bolivarian Republic of),Saint Vincent and the Grenadines,105,64,41
1995,36,Australia,Saint Vincent and the Grenadines,47,37,10
1995,348,Hungary,Saint Vincent and the Grenadines,2,1,1
1995,208,Denmark,Saint Vincent and the Grenadines,8,7,1
1995,246,Finland,Saint Vincent and the Grenadines,2,2,0
1995,372,Ireland,Saint Vincent and the Grenadines,2,2,0
1995,752,Sweden,Saint Vincent and the Grenadines,12,10,2
1995,826,United Kingdom,Saint Vincent and the Grenadines,3889,1916,1973
1995,300,Greece,Saint Vincent and the Grenadines,102,73,29
1995,380,Italy,Saint Vincent and the Grenadines,3,1,2
1995,40,Austria,Saint Vincent and the Grenadines,7,4,3
1995,250,France,Saint Vincent and the Grenadines,96,27,69
1995,528,Netherlands,Saint Vincent and the Grenadines,28,13,15
1995,124,Canada,Saint Vincent and the Grenadines,6477,3134,3343
1995,840,United States of America,Saint Vincent and the Grenadines,16623,8610,8013
2000,28,Antigua and Barbuda,Saint Vincent and the Grenadines,754,451,303
2000,533,Aruba,Saint Vincent and the Grenadines,131,41,90
2000,44,Bahamas,Saint Vincent and the Grenadines,22,13,9
2000,52,Barbados,Saint Vincent and the Grenadines,4350,1886,2464
2000,92,British Virgin Islands,Saint Vincent and the Grenadines,1414,781,633
2000,535,"Bonaire, Sint Eustatius and Saba",Saint Vincent and the Grenadines,122,54,68
2000,136,Cayman Islands,Saint Vincent and the Grenadines,32,24,8
2000,212,Dominica,Saint Vincent and the Grenadines,72,41,31
2000,308,Grenada,Saint Vincent and the Grenadines,341,78,263
2000,388,Jamaica,Saint Vincent and the Grenadines,242,118,124
2000,500,Montserrat,Saint Vincent and the Grenadines,26,18,8
2000,659,Saint Kitts and Nevis,Saint Vincent and the Grenadines,136,69,67
2000,662,Saint Lucia,Saint Vincent and the Grenadines,336,148,188
2000,780,Trinidad and Tobago,Saint Vincent and the Grenadines,8384,3720,4664
2000,850,United States Virgin Islands,Saint Vincent and the Grenadines,539,269,270
2000,188,Costa Rica,Saint Vincent and the Grenadines,1,1,0
2000,152,Chile,Saint Vincent and the Grenadines,5,2,3
2000,328,Guyana,Saint Vincent and the Grenadines,205,112,93
2000,604,Peru,Saint Vincent and the Grenadines,17,5,12
2000,862,Venezuela (Bolivarian Republic of),Saint Vincent and the Grenadines,103,62,41
2000,36,Australia,Saint Vincent and the Grenadines,47,37,10
2000,348,Hungary,Saint Vincent and the Grenadines,3,1,2
2000,208,Denmark,Saint Vincent and the Grenadines,8,7,1
2000,246,Finland,Saint Vincent and the Grenadines,2,2,0
2000,372,Ireland,Saint Vincent and the Grenadines,3,2,1
2000,752,Sweden,Saint Vincent and the Grenadines,12,10,2
2000,826,United Kingdom,Saint Vincent and the Grenadines,6855,3263,3592
2000,300,Greece,Saint Vincent and the Grenadines,114,96,18
2000,380,Italy,Saint Vincent and the Grenadines,6,3,3
2000,40,Austria,Saint Vincent and the Grenadines,7,4,3
2000,250,France,Saint Vincent and the Grenadines,99,27,72
2000,528,Netherlands,Saint Vincent and the Grenadines,40,17,23
2000,124,Canada,Saint Vincent and the Grenadines,8751,4221,4530
2000,840,United States of America,Saint Vincent and the Grenadines,20491,10688,9803
2005,28,Antigua and Barbuda,Saint Vincent and the Grenadines,809,483,326
2005,533,Aruba,Saint Vincent and the Grenadines,120,33,87
2005,44,Bahamas,Saint Vincent and the Grenadines,30,20,10
2005,52,Barbados,Saint Vincent and the Grenadines,3648,1535,2113
2005,92,British Virgin Islands,Saint Vincent and the Grenadines,1619,894,725
2005,535,"Bonaire, Sint Eustatius and Saba",Saint Vincent and the Grenadines,130,58,72
2005,136,Cayman Islands,Saint Vincent and the Grenadines,29,22,7
2005,212,Dominica,Saint Vincent and the Grenadines,88,50,38
2005,308,Grenada,Saint Vincent and the Grenadines,357,83,274
2005,388,Jamaica,Saint Vincent and the Grenadines,236,116,120
2005,500,Montserrat,Saint Vincent and the Grenadines,28,19,9
2005,659,Saint Kitts and Nevis,Saint Vincent and the Grenadines,152,78,74
2005,662,Saint Lucia,Saint Vincent and the Grenadines,345,148,197
2005,534,Sint Maarten (Dutch part),Saint Vincent and the Grenadines,33,17,16
2005,780,Trinidad and Tobago,Saint Vincent and the Grenadines,8998,3982,5016
2005,850,United States Virgin Islands,Saint Vincent and the Grenadines,528,265,263
2005,188,Costa Rica,Saint Vincent and the Grenadines,1,1,0
2005,152,Chile,Saint Vincent and the Grenadines,7,3,4
2005,328,Guyana,Saint Vincent and the Grenadines,260,143,117
2005,604,Peru,Saint Vincent and the Grenadines,20,6,14
2005,862,Venezuela (Bolivarian Republic of),Saint Vincent and the Grenadines,108,65,43
2005,36,Australia,Saint Vincent and the Grenadines,47,37,10
2005,203,Czechia,Saint Vincent and the Grenadines,1,1,0
2005,348,Hungary,Saint Vincent and the Grenadines,4,2,2
2005,208,Denmark,Saint Vincent and the Grenadines,8,7,1
2005,246,Finland,Saint Vincent and the Grenadines,3,3,0
2005,372,Ireland,Saint Vincent and the Grenadines,3,2,1
2005,752,Sweden,Saint Vincent and the Grenadines,12,10,2
2005,826,United Kingdom,Saint Vincent and the Grenadines,6718,3219,3499
2005,300,Greece,Saint Vincent and the Grenadines,61,49,12
2005,380,Italy,Saint Vincent and the Grenadines,13,5,8
2005,40,Austria,Saint Vincent and the Grenadines,8,4,4
2005,250,France,Saint Vincent and the Grenadines,45,18,27
2005,528,Netherlands,Saint Vincent and the Grenadines,55,20,35
2005,124,Canada,Saint Vincent and the Grenadines,10317,4329,5988
2005,840,United States of America,Saint Vincent and the Grenadines,20921,10968,9953
2010,28,Antigua and Barbuda,Saint Vincent and the Grenadines,863,515,348
2010,533,Aruba,Saint Vincent and the Grenadines,107,24,83
2010,44,Bahamas,Saint Vincent and the Grenadines,37,27,10
2010,52,Barbados,Saint Vincent and the Grenadines,2964,1192,1772
2010,92,British Virgin Islands,Saint Vincent and the Grenadines,1968,1107,861
2010,535,"Bonaire, Sint Eustatius and Saba",Saint Vincent and the Grenadines,12,9,3
2010,136,Cayman Islands,Saint Vincent and the Grenadines,30,22,8
2010,531,Curaçao,Saint Vincent and the Grenadines,268,45,223
2010,212,Dominica,Saint Vincent and the Grenadines,107,60,47
2010,308,Grenada,Saint Vincent and the Grenadines,373,87,286
2010,388,Jamaica,Saint Vincent and the Grenadines,229,113,116
2010,500,Montserrat,Saint Vincent and the Grenadines,28,19,9
2010,659,Saint Kitts and Nevis,Saint Vincent and the Grenadines,166,86,80
2010,662,Saint Lucia,Saint Vincent and the Grenadines,329,138,191
2010,534,Sint Maarten (Dutch part),Saint Vincent and the Grenadines,67,35,32
2010,780,Trinidad and Tobago,Saint Vincent and the Grenadines,6207,2717,3490
2010,850,United States Virgin Islands,Saint Vincent and the Grenadines,518,261,257
2010,188,Costa Rica,Saint Vincent and the Grenadines,1,1,0
2010,76,Brazil,Saint Vincent and the Grenadines,29,0,29
2010,152,Chile,Saint Vincent and the Grenadines,10,5,5
2010,328,Guyana,Saint Vincent and the Grenadines,314,173,141
2010,604,Peru,Saint Vincent and the Grenadines,21,6,15
2010,862,Venezuela (Bolivarian Republic of),Saint Vincent and the Grenadines,115,70,45
2010,36,Australia,Saint Vincent and the Grenadines,47,37,10
2010,203,Czechia,Saint Vincent and the Grenadines,1,1,0
2010,348,Hungary,Saint Vincent and the Grenadines,5,3,2
2010,208,Denmark,Saint Vincent and the Grenadines,6,6,0
2010,246,Finland,Saint Vincent and the Grenadines,2,2,0
2010,372,Ireland,Saint Vincent and the Grenadines,2,1,1
2010,752,Sweden,Saint Vincent and the Grenadines,14,12,2
2010,826,United Kingdom,Saint Vincent and the Grenadines,7077,3467,3610
2010,300,Greece,Saint Vincent and the Grenadines,7,1,6
2010,380,Italy,Saint Vincent and the Grenadines,25,8,17
2010,40,Austria,Saint Vincent and the Grenadines,9,5,4
2010,250,France,Saint Vincent and the Grenadines,27,7,20
2010,528,Netherlands,Saint Vincent and the Grenadines,58,20,38
2010,124,Canada,Saint Vincent and the Grenadines,11495,4334,7161
2010,840,United States of America,Saint Vincent and the Grenadines,22007,11394,10613
2015,324,Guinea,Saint Vincent and the Grenadines,30,19,11
2015,28,Antigua and Barbuda,Saint Vincent and the Grenadines,918,548,370
2015,533,Aruba,Saint Vincent and the Grenadines,113,26,87
2015,44,Bahamas,Saint Vincent and the Grenadines,40,29,11
2015,52,Barbados,Saint Vincent and the Grenadines,3114,1252,1862
2015,92,British Virgin Islands,Saint Vincent and the Grenadines,2205,1241,964
2015,535,"Bonaire, Sint Eustatius and Saba",Saint Vincent and the Grenadines,13,10,3
2015,136,Cayman Islands,Saint Vincent and the Grenadines,31,24,7
2015,531,Curaçao,Saint Vincent and the Grenadines,291,50,241
2015,212,Dominica,Saint Vincent and the Grenadines,125,70,55
2015,308,Grenada,Saint Vincent and the Grenadines,377,88,289
2015,388,Jamaica,Saint Vincent and the Grenadines,224,110,114
2015,500,Montserrat,Saint Vincent and the Grenadines,29,20,9
2015,659,Saint Kitts and Nevis,Saint Vincent and the Grenadines,168,88,80
2015,662,Saint Lucia,Saint Vincent and the Grenadines,315,132,183
2015,534,Sint Maarten (Dutch part),Saint Vincent and the Grenadines,70,37,33
2015,780,Trinidad and Tobago,Saint Vincent and the Grenadines,6430,2873,3557
2015,850,United States Virgin Islands,Saint Vincent and the Grenadines,518,261,257
2015,188,Costa Rica,Saint Vincent and the Grenadines,1,1,0
2015,76,Brazil,Saint Vincent and the Grenadines,35,0,35
2015,152,Chile,Saint Vincent and the Grenadines,15,8,7
2015,328,Guyana,Saint Vincent and the Grenadines,368,203,165
2015,604,Peru,Saint Vincent and the Grenadines,22,6,16
2015,862,Venezuela (Bolivarian Republic of),Saint Vincent and the Grenadines,121,73,48
2015,36,Australia,Saint Vincent and the Grenadines,47,27,20
2015,203,Czechia,Saint Vincent and the Grenadines,1,1,0
2015,348,Hungary,Saint Vincent and the Grenadines,3,1,2
2015,208,Denmark,Saint Vincent and the Grenadines,6,4,2
2015,246,Finland,Saint Vincent and the Grenadines,2,2,0
2015,372,Ireland,Saint Vincent and the Grenadines,2,1,1
2015,752,Sweden,Saint Vincent and the Grenadines,16,12,4
2015,826,United Kingdom,Saint Vincent and the Grenadines,9050,4297,4753
2015,300,Greece,Saint Vincent and the Grenadines,6,1,5
2015,380,Italy,Saint Vincent and the Grenadines,19,7,12
2015,40,Austria,Saint Vincent and the Grenadines,10,6,4
2015,250,France,Saint Vincent and the Grenadines,29,7,22
2015,528,Netherlands,Saint Vincent and the Grenadines,67,25,42
2015,124,Canada,Saint Vincent and the Grenadines,12865,4816,8049
2015,840,United States of America,Saint Vincent and the Grenadines,25299,13037,12262
2019,324,Guinea,Saint Vincent and the Grenadines,28,18,10
2019,28,Antigua and Barbuda,Saint Vincent and the Grenadines,954,570,384
2019,533,Aruba,Saint Vincent and the Grenadines,114,26,88
2019,44,Bahamas,Saint Vincent and the Grenadines,42,31,11
2019,52,Barbados,Saint Vincent and the Grenadines,3143,1264,1879
2019,92,British Virgin Islands,Saint Vincent and the Grenadines,2394,1348,1046
2019,535,"Bonaire, Sint Eustatius and Saba",Saint Vincent and the Grenadines,15,12,3
2019,136,Cayman Islands,Saint Vincent and the Grenadines,34,26,8
2019,531,Curaçao,Saint Vincent and the Grenadines,316,55,261
2019,212,Dominica,Saint Vincent and the Grenadines,127,71,56
2019,308,Grenada,Saint Vincent and the Grenadines,380,89,291
2019,388,Jamaica,Saint Vincent and the Grenadines,226,111,115
2019,500,Montserrat,Saint Vincent and the Grenadines,29,20,9
2019,659,Saint Kitts and Nevis,Saint Vincent and the Grenadines,171,90,81
2019,662,Saint Lucia,Saint Vincent and the Grenadines,317,125,192
2019,534,Sint Maarten (Dutch part),Saint Vincent and the Grenadines,72,38,34
2019,780,Trinidad and Tobago,Saint Vincent and the Grenadines,6922,3270,3652
2019,850,United States Virgin Islands,Saint Vincent and the Grenadines,518,261,257
2019,188,Costa Rica,Saint Vincent and the Grenadines,1,1,0
2019,76,Brazil,Saint Vincent and the Grenadines,39,0,39
2019,152,Chile,Saint Vincent and the Grenadines,20,11,9
2019,328,Guyana,Saint Vincent and the Grenadines,375,207,168
2019,604,Peru,Saint Vincent and the Grenadines,26,9,17
2019,862,Venezuela (Bolivarian Republic of),Saint Vincent and the Grenadines,118,71,47
2019,36,Australia,Saint Vincent and the Grenadines,47,27,20
2019,203,Czechia,Saint Vincent and the Grenadines,1,1,0
2019,348,Hungary,Saint Vincent and the Grenadines,3,0,3
2019,208,Denmark,Saint Vincent and the Grenadines,5,3,2
2019,246,Finland,Saint Vincent and the Grenadines,2,2,0
2019,372,Ireland,Saint Vincent and the Grenadines,2,1,1
2019,752,Sweden,Saint Vincent and the Grenadines,19,10,9
2019,826,United Kingdom,Saint Vincent and the Grenadines,10277,4894,5383
2019,300,Greece,Saint Vincent and the Grenadines,5,1,4
2019,380,Italy,Saint Vincent and the Grenadines,16,5,11
2019,40,Austria,Saint Vincent and the Grenadines,11,7,4
2019,250,France,Saint Vincent and the Grenadines,30,7,23
2019,528,Netherlands,Saint Vincent and the Grenadines,69,25,44
2019,124,Canada,Saint Vincent and the Grenadines,13786,5161,8625
2019,840,United States of America,Saint Vincent and the Grenadines,27320,13937,13383
1990,36,Australia,Samoa,5709,2827,2882
1990,554,New Zealand,Samoa,42264,20165,22099
1990,242,Fiji,Samoa,271,144,127
1990,583,Micronesia (Fed. States of),Samoa,11,5,6
1990,16,American Samoa,Samoa,14674,7625,7049
1990,184,Cook Islands,Samoa,5,1,4
1990,570,Niue,Samoa,37,19,18
1990,772,Tokelau,Samoa,114,71,43
1990,776,Tonga,Samoa,170,61,109
1990,798,Tuvalu,Samoa,21,18,3
1990,100,Bulgaria,Samoa,1,0,1
1990,208,Denmark,Samoa,6,1,5
1990,246,Finland,Samoa,1,0,1
1990,372,Ireland,Samoa,3,1,2
1990,752,Sweden,Samoa,13,5,8
1990,826,United Kingdom,Samoa,38,26,12
1990,300,Greece,Samoa,2,2,0
1990,380,Italy,Samoa,13,5,8
1990,40,Austria,Samoa,3,1,2
1990,250,France,Samoa,27,8,19
1990,528,Netherlands,Samoa,7,5,2
1990,124,Canada,Samoa,63,31,32
1990,840,United States of America,Samoa,11408,5581,5827
1995,36,Australia,Samoa,9696,4721,4975
1995,554,New Zealand,Samoa,41030,19353,21677
1995,242,Fiji,Samoa,267,141,126
1995,583,Micronesia (Fed. States of),Samoa,14,7,7
1995,16,American Samoa,Samoa,16157,8321,7836
1995,184,Cook Islands,Samoa,5,1,4
1995,570,Niue,Samoa,27,14,13
1995,772,Tokelau,Samoa,114,68,46
1995,776,Tonga,Samoa,192,73,119
1995,798,Tuvalu,Samoa,11,10,1
1995,100,Bulgaria,Samoa,2,0,2
1995,203,Czechia,Samoa,1,0,1
1995,208,Denmark,Samoa,8,1,7
1995,246,Finland,Samoa,1,0,1
1995,372,Ireland,Samoa,7,3,4
1995,752,Sweden,Samoa,15,5,10
1995,826,United Kingdom,Samoa,149,87,62
1995,300,Greece,Samoa,4,3,1
1995,380,Italy,Samoa,40,15,25
1995,40,Austria,Samoa,3,1,2
1995,250,France,Samoa,28,8,20
1995,528,Netherlands,Samoa,9,6,3
1995,124,Canada,Samoa,63,30,33
1995,840,United States of America,Samoa,14109,6973,7136
2000,36,Australia,Samoa,13080,6342,6738
2000,554,New Zealand,Samoa,45849,22285,23564
2000,242,Fiji,Samoa,266,140,126
2000,583,Micronesia (Fed. States of),Samoa,16,9,7
2000,16,American Samoa,Samoa,17642,9015,8627
2000,184,Cook Islands,Samoa,5,1,4
2000,570,Niue,Samoa,16,7,9
2000,772,Tokelau,Samoa,98,48,50
2000,776,Tonga,Samoa,215,85,130
2000,798,Tuvalu,Samoa,6,5,1
2000,100,Bulgaria,Samoa,3,0,3
2000,203,Czechia,Samoa,1,0,1
2000,208,Denmark,Samoa,10,1,9
2000,372,Ireland,Samoa,15,6,9
2000,752,Sweden,Samoa,17,6,11
2000,826,United Kingdom,Samoa,264,149,115
2000,300,Greece,Samoa,6,3,3
2000,380,Italy,Samoa,67,26,41
2000,40,Austria,Samoa,3,1,2
2000,250,France,Samoa,29,8,21
2000,528,Netherlands,Samoa,14,7,7
2000,124,Canada,Samoa,64,30,34
2000,840,United States of America,Samoa,16855,8397,8458
2005,36,Australia,Samoa,16620,8111,8509
2005,554,New Zealand,Samoa,48436,23510,24926
2005,242,Fiji,Samoa,267,141,126
2005,583,Micronesia (Fed. States of),Samoa,17,8,9
2005,16,American Samoa,Samoa,16738,8508,8230
2005,184,Cook Islands,Samoa,7,1,6
2005,570,Niue,Samoa,18,9,9
2005,772,Tokelau,Samoa,98,47,51
2005,776,Tonga,Samoa,251,101,150
2005,798,Tuvalu,Samoa,4,3,1
2005,100,Bulgaria,Samoa,5,1,4
2005,203,Czechia,Samoa,1,0,1
2005,208,Denmark,Samoa,15,4,11
2005,246,Finland,Samoa,2,1,1
2005,372,Ireland,Samoa,15,6,9
2005,752,Sweden,Samoa,23,7,16
2005,826,United Kingdom,Samoa,226,129,97
2005,300,Greece,Samoa,233,109,124
2005,380,Italy,Samoa,68,29,39
2005,40,Austria,Samoa,4,1,3
2005,250,France,Samoa,5,4,1
2005,528,Netherlands,Samoa,16,7,9
2005,124,Canada,Samoa,85,47,38
2005,840,United States of America,Samoa,16079,8056,8023
2010,36,Australia,Samoa,20440,10091,10349
2010,554,New Zealand,Samoa,50946,24688,26258
2010,242,Fiji,Samoa,287,154,133
2010,583,Micronesia (Fed. States of),Samoa,22,10,12
2010,16,American Samoa,Samoa,15842,8003,7839
2010,184,Cook Islands,Samoa,9,1,8
2010,570,Niue,Samoa,46,26,20
2010,772,Tokelau,Samoa,165,75,90
2010,776,Tonga,Samoa,268,109,159
2010,798,Tuvalu,Samoa,3,2,1
2010,100,Bulgaria,Samoa,6,1,5
2010,203,Czechia,Samoa,1,0,1
2010,208,Denmark,Samoa,18,7,11
2010,246,Finland,Samoa,3,1,2
2010,372,Ireland,Samoa,13,4,9
2010,752,Sweden,Samoa,26,8,18
2010,826,United Kingdom,Samoa,238,138,100
2010,300,Greece,Samoa,477,223,254
2010,380,Italy,Samoa,78,38,40
2010,40,Austria,Samoa,4,1,3
2010,250,France,Samoa,17,5,12
2010,528,Netherlands,Samoa,19,6,13
2010,124,Canada,Samoa,110,67,43
2010,840,United States of America,Samoa,15779,7798,7981
2015,324,Guinea,Samoa,28,17,11
2015,36,Australia,Samoa,27780,14003,13777
2015,554,New Zealand,Samoa,52640,25456,27184
2015,242,Fiji,Samoa,296,161,135
2015,583,Micronesia (Fed. States of),Samoa,21,10,11
2015,16,American Samoa,Samoa,15813,7935,7878
2015,184,Cook Islands,Samoa,8,1,7
2015,570,Niue,Samoa,45,26,19
2015,772,Tokelau,Samoa,187,85,102
2015,776,Tonga,Samoa,230,95,135
2015,798,Tuvalu,Samoa,3,2,1
2015,100,Bulgaria,Samoa,5,1,4
2015,203,Czechia,Samoa,1,0,1
2015,208,Denmark,Samoa,19,8,11
2015,246,Finland,Samoa,3,1,2
2015,372,Ireland,Samoa,13,4,9
2015,752,Sweden,Samoa,23,10,13
2015,826,United Kingdom,Samoa,304,173,131
2015,300,Greece,Samoa,447,199,248
2015,380,Italy,Samoa,55,22,33
2015,40,Austria,Samoa,4,1,3
2015,250,France,Samoa,18,5,13
2015,528,Netherlands,Samoa,26,14,12
2015,124,Canada,Samoa,159,80,79
2015,840,United States of America,Samoa,18708,9198,9510
2019,324,Guinea,Samoa,26,16,10
2019,36,Australia,Samoa,32173,16209,15964
2019,554,New Zealand,Samoa,54108,26166,27942
2019,242,Fiji,Samoa,302,165,137
2019,583,Micronesia (Fed. States of),Samoa,21,10,11
2019,16,American Samoa,Samoa,15830,7944,7886
2019,184,Cook Islands,Samoa,8,1,7
2019,570,Niue,Samoa,45,26,19
2019,772,Tokelau,Samoa,193,88,105
2019,776,Tonga,Samoa,218,90,128
2019,798,Tuvalu,Samoa,3,2,1
2019,100,Bulgaria,Samoa,5,1,4
2019,203,Czechia,Samoa,1,0,1
2019,208,Denmark,Samoa,24,11,13
2019,246,Finland,Samoa,4,2,2
2019,372,Ireland,Samoa,14,5,9
2019,752,Sweden,Samoa,26,9,17
2019,826,United Kingdom,Samoa,345,197,148
2019,300,Greece,Samoa,436,203,233
2019,380,Italy,Samoa,61,21,40
2019,40,Austria,Samoa,4,1,3
2019,250,France,Samoa,19,6,13
2019,528,Netherlands,Samoa,29,16,13
2019,124,Canada,Samoa,170,86,84
2019,840,United States of America,Samoa,20201,9821,10380
1990,32,Argentina,San Marino,37,32,5
1990,152,Chile,San Marino,6,4,2
1990,100,Bulgaria,San Marino,1,0,1
1990,203,Czechia,San Marino,1,0,1
1990,643,Russian Federation,San Marino,31,15,16
1990,208,Denmark,San Marino,1,0,1
1990,752,Sweden,San Marino,7,5,2
1990,300,Greece,San Marino,9,4,5
1990,380,Italy,San Marino,1055,367,688
1990,724,Spain,San Marino,9,5,4
1990,40,Austria,San Marino,1,0,1
1990,56,Belgium,San Marino,13,10,3
1990,250,France,San Marino,248,130,118
1995,32,Argentina,San Marino,36,31,5
1995,152,Chile,San Marino,4,1,3
1995,100,Bulgaria,San Marino,2,0,2
1995,203,Czechia,San Marino,1,0,1
1995,643,Russian Federation,San Marino,36,16,20
1995,208,Denmark,San Marino,1,0,1
1995,752,Sweden,San Marino,6,4,2
1995,300,Greece,San Marino,9,4,5
1995,380,Italy,San Marino,2080,927,1153
1995,724,Spain,San Marino,15,8,7
1995,40,Austria,San Marino,1,0,1
1995,56,Belgium,San Marino,13,10,3
1995,250,France,San Marino,256,132,124
2000,32,Argentina,San Marino,35,30,5
2000,152,Chile,San Marino,2,0,2
2000,100,Bulgaria,San Marino,2,0,2
2000,203,Czechia,San Marino,1,0,1
2000,643,Russian Federation,San Marino,41,16,25
2000,752,Sweden,San Marino,6,4,2
2000,300,Greece,San Marino,9,3,6
2000,380,Italy,San Marino,3105,1487,1618
2000,724,Spain,San Marino,18,10,8
2000,40,Austria,San Marino,1,0,1
2000,56,Belgium,San Marino,12,9,3
2000,250,France,San Marino,264,134,130
2005,32,Argentina,San Marino,26,22,4
2005,152,Chile,San Marino,3,1,2
2005,100,Bulgaria,San Marino,3,0,3
2005,203,Czechia,San Marino,1,0,1
2005,643,Russian Federation,San Marino,43,16,27
2005,208,Denmark,San Marino,1,0,1
2005,752,Sweden,San Marino,5,3,2
2005,300,Greece,San Marino,5,1,4
2005,380,Italy,San Marino,2509,1118,1391
2005,724,Spain,San Marino,19,11,8
2005,40,Austria,San Marino,1,0,1
2005,56,Belgium,San Marino,16,12,4
2005,250,France,San Marino,278,115,163
2010,32,Argentina,San Marino,16,14,2
2010,76,Brazil,San Marino,34,0,34
2010,152,Chile,San Marino,4,1,3
2010,100,Bulgaria,San Marino,4,1,3
2010,203,Czechia,San Marino,1,0,1
2010,643,Russian Federation,San Marino,46,16,30
2010,752,Sweden,San Marino,5,3,2
2010,300,Greece,San Marino,1,0,1
2010,380,Italy,San Marino,1907,707,1200
2010,724,Spain,San Marino,24,13,11
2010,40,Austria,San Marino,1,0,1
2010,56,Belgium,San Marino,16,6,10
2010,250,France,San Marino,206,102,104
2015,32,Argentina,San Marino,16,14,2
2015,76,Brazil,San Marino,41,0,41
2015,152,Chile,San Marino,6,2,4
2015,100,Bulgaria,San Marino,6,1,5
2015,203,Czechia,San Marino,1,0,1
2015,643,Russian Federation,San Marino,46,16,30
2015,208,Denmark,San Marino,2,1,1
2015,752,Sweden,San Marino,4,1,3
2015,380,Italy,San Marino,3254,1088,2166
2015,724,Spain,San Marino,37,19,18
2015,40,Austria,San Marino,1,0,1
2015,56,Belgium,San Marino,14,7,7
2015,250,France,San Marino,228,109,119
2019,32,Argentina,San Marino,16,14,2
2019,76,Brazil,San Marino,46,0,46
2019,152,Chile,San Marino,8,3,5
2019,100,Bulgaria,San Marino,6,1,5
2019,203,Czechia,San Marino,1,0,1
2019,643,Russian Federation,San Marino,45,16,29
2019,208,Denmark,San Marino,2,0,2
2019,752,Sweden,San Marino,5,2,3
2019,380,Italy,San Marino,2001,801,1200
2019,724,Spain,San Marino,38,19,19
2019,40,Austria,San Marino,1,0,1
2019,56,Belgium,San Marino,15,9,6
2019,250,France,San Marino,241,115,126
1990,24,Angola,Sao Tome and Principe,3112,1609,1503
1990,140,Central African Republic,Sao Tome and Principe,88,41,47
1990,226,Equatorial Guinea,Sao Tome and Principe,378,226,152
1990,266,Gabon,Sao Tome and Principe,2012,940,1072
1990,132,Cabo Verde,Sao Tome and Principe,2475,1151,1324
1990,768,Togo,Sao Tome and Principe,19,9,10
1990,152,Chile,Sao Tome and Principe,12,6,6
1990,752,Sweden,Sao Tome and Principe,6,5,1
1990,826,United Kingdom,Sao Tome and Principe,11,5,6
1990,300,Greece,Sao Tome and Principe,3,1,2
1990,380,Italy,Sao Tome and Principe,9,3,6
1990,620,Portugal,Sao Tome and Principe,5581,2627,2954
1990,724,Spain,Sao Tome and Principe,14,6,8
1990,40,Austria,Sao Tome and Principe,1,0,1
1990,56,Belgium,Sao Tome and Principe,35,13,22
1990,250,France,Sao Tome and Principe,127,54,73
1990,528,Netherlands,Sao Tome and Principe,57,30,27
1990,756,Switzerland,Sao Tome and Principe,37,16,21
1995,24,Angola,Sao Tome and Principe,3617,1797,1820
1995,140,Central African Republic,Sao Tome and Principe,104,50,54
1995,226,Equatorial Guinea,Sao Tome and Principe,501,298,203
1995,266,Gabon,Sao Tome and Principe,2690,1255,1435
1995,132,Cabo Verde,Sao Tome and Principe,3111,1491,1620
1995,768,Togo,Sao Tome and Principe,21,10,11
1995,152,Chile,Sao Tome and Principe,11,7,4
1995,752,Sweden,Sao Tome and Principe,7,5,2
1995,826,United Kingdom,Sao Tome and Principe,48,14,34
1995,300,Greece,Sao Tome and Principe,3,1,2
1995,380,Italy,Sao Tome and Principe,26,6,20
1995,620,Portugal,Sao Tome and Principe,8820,4084,4736
1995,724,Spain,Sao Tome and Principe,22,10,12
1995,40,Austria,Sao Tome and Principe,2,1,1
1995,56,Belgium,Sao Tome and Principe,35,13,22
1995,250,France,Sao Tome and Principe,132,55,77
1995,528,Netherlands,Sao Tome and Principe,84,43,41
1995,756,Switzerland,Sao Tome and Principe,38,18,20
2000,24,Angola,Sao Tome and Principe,4121,1985,2136
2000,140,Central African Republic,Sao Tome and Principe,111,54,57
2000,226,Equatorial Guinea,Sao Tome and Principe,623,370,253
2000,266,Gabon,Sao Tome and Principe,3366,1585,1781
2000,132,Cabo Verde,Sao Tome and Principe,3747,1832,1915
2000,768,Togo,Sao Tome and Principe,23,11,12
2000,152,Chile,Sao Tome and Principe,11,6,5
2000,752,Sweden,Sao Tome and Principe,7,5,2
2000,826,United Kingdom,Sao Tome and Principe,87,24,63
2000,300,Greece,Sao Tome and Principe,4,2,2
2000,380,Italy,Sao Tome and Principe,43,9,34
2000,620,Portugal,Sao Tome and Principe,12417,5724,6693
2000,724,Spain,Sao Tome and Principe,272,137,135
2000,40,Austria,Sao Tome and Principe,2,1,1
2000,56,Belgium,Sao Tome and Principe,31,9,22
2000,250,France,Sao Tome and Principe,136,56,80
2000,528,Netherlands,Sao Tome and Principe,115,57,58
2000,756,Switzerland,Sao Tome and Principe,40,20,20
2005,24,Angola,Sao Tome and Principe,5329,2495,2834
2005,140,Central African Republic,Sao Tome and Principe,85,41,44
2005,226,Equatorial Guinea,Sao Tome and Principe,909,548,361
2005,266,Gabon,Sao Tome and Principe,3670,1747,1923
2005,132,Cabo Verde,Sao Tome and Principe,2698,1279,1419
2005,768,Togo,Sao Tome and Principe,26,13,13
2005,152,Chile,Sao Tome and Principe,16,9,7
2005,203,Czechia,Sao Tome and Principe,1,1,0
2005,752,Sweden,Sao Tome and Principe,10,7,3
2005,826,United Kingdom,Sao Tome and Principe,481,176,305
2005,300,Greece,Sao Tome and Principe,6,4,2
2005,380,Italy,Sao Tome and Principe,59,15,44
2005,620,Portugal,Sao Tome and Principe,15388,7018,8370
2005,724,Spain,Sao Tome and Principe,131,65,66
2005,40,Austria,Sao Tome and Principe,2,1,1
2005,56,Belgium,Sao Tome and Principe,44,18,26
2005,250,France,Sao Tome and Principe,757,359,398
2005,528,Netherlands,Sao Tome and Principe,134,67,67
2005,756,Switzerland,Sao Tome and Principe,44,20,24
2010,24,Angola,Sao Tome and Principe,6536,3005,3531
2010,140,Central African Republic,Sao Tome and Principe,84,40,44
2010,226,Equatorial Guinea,Sao Tome and Principe,1194,726,468
2010,266,Gabon,Sao Tome and Principe,4251,2066,2185
2010,132,Cabo Verde,Sao Tome and Principe,1649,726,923
2010,768,Togo,Sao Tome and Principe,37,19,18
2010,76,Brazil,Sao Tome and Principe,58,13,45
2010,152,Chile,Sao Tome and Principe,22,13,9
2010,203,Czechia,Sao Tome and Principe,1,1,0
2010,752,Sweden,Sao Tome and Principe,10,7,3
2010,826,United Kingdom,Sao Tome and Principe,506,192,314
2010,300,Greece,Sao Tome and Principe,7,5,2
2010,380,Italy,Sao Tome and Principe,77,23,54
2010,620,Portugal,Sao Tome and Principe,15804,7165,8639
2010,724,Spain,Sao Tome and Principe,203,99,104
2010,40,Austria,Sao Tome and Principe,2,1,1
2010,56,Belgium,Sao Tome and Principe,40,18,22
2010,250,France,Sao Tome and Principe,210,84,126
2010,528,Netherlands,Sao Tome and Principe,143,68,75
2010,756,Switzerland,Sao Tome and Principe,53,23,30
2015,24,Angola,Sao Tome and Principe,6601,3035,3566
2015,140,Central African Republic,Sao Tome and Principe,73,34,39
2015,226,Equatorial Guinea,Sao Tome and Principe,1493,915,578
2015,266,Gabon,Sao Tome and Principe,5944,3315,2629
2015,132,Cabo Verde,Sao Tome and Principe,1712,750,962
2015,324,Guinea,Sao Tome and Principe,33,20,13
2015,768,Togo,Sao Tome and Principe,41,21,20
2015,76,Brazil,Sao Tome and Principe,70,16,54
2015,152,Chile,Sao Tome and Principe,33,20,13
2015,203,Czechia,Sao Tome and Principe,2,2,0
2015,752,Sweden,Sao Tome and Principe,11,8,3
2015,826,United Kingdom,Sao Tome and Principe,647,234,413
2015,300,Greece,Sao Tome and Principe,6,5,1
2015,380,Italy,Sao Tome and Principe,71,18,53
2015,620,Portugal,Sao Tome and Principe,17915,7619,10296
2015,724,Spain,Sao Tome and Principe,189,94,95
2015,40,Austria,Sao Tome and Principe,2,1,1
2015,56,Belgium,Sao Tome and Principe,85,45,40
2015,250,France,Sao Tome and Principe,232,88,144
2015,528,Netherlands,Sao Tome and Principe,157,74,83
2015,756,Switzerland,Sao Tome and Principe,69,32,37
2019,24,Angola,Sao Tome and Principe,6990,3422,3568
2019,140,Central African Republic,Sao Tome and Principe,81,38,43
2019,226,Equatorial Guinea,Sao Tome and Principe,1642,1007,635
2019,266,Gabon,Sao Tome and Principe,6458,3600,2858
2019,132,Cabo Verde,Sao Tome and Principe,1796,787,1009
2019,324,Guinea,Sao Tome and Principe,31,19,12
2019,768,Togo,Sao Tome and Principe,41,21,20
2019,76,Brazil,Sao Tome and Principe,78,18,60
2019,152,Chile,Sao Tome and Principe,44,26,18
2019,203,Czechia,Sao Tome and Principe,2,2,0
2019,208,Denmark,Sao Tome and Principe,3,0,3
2019,752,Sweden,Sao Tome and Principe,10,7,3
2019,826,United Kingdom,Sao Tome and Principe,734,267,467
2019,300,Greece,Sao Tome and Principe,5,5,0
2019,380,Italy,Sao Tome and Principe,79,24,55
2019,620,Portugal,Sao Tome and Principe,18219,7771,10448
2019,724,Spain,Sao Tome and Principe,195,95,100
2019,40,Austria,Sao Tome and Principe,2,1,1
2019,56,Belgium,Sao Tome and Principe,112,61,51
2019,250,France,Sao Tome and Principe,245,93,152
2019,528,Netherlands,Sao Tome and Principe,172,84,88
2019,756,Switzerland,Sao Tome and Principe,74,34,40
1990,710,South Africa,Saudi Arabia,604,262,342
1990,324,Guinea,Saudi Arabia,682,349,333
1990,478,Mauritania,Saudi Arabia,273,133,140
1990,686,Senegal,Saudi Arabia,1177,556,621
1990,12,Algeria,Saudi Arabia,3068,1953,1115
1990,818,Egypt,Saudi Arabia,4546,2827,1719
1990,434,Libya,Saudi Arabia,12976,8096,4880
1990,48,Bahrain,Saudi Arabia,61,37,24
1990,196,Cyprus,Saudi Arabia,58,32,26
1990,368,Iraq,Saudi Arabia,519,366,153
1990,400,Jordan,Saudi Arabia,3495,1829,1666
1990,414,Kuwait,Saudi Arabia,380,172,208
1990,422,Lebanon,Saudi Arabia,1597,836,761
1990,512,Oman,Saudi Arabia,215,155,60
1990,634,Qatar,Saudi Arabia,14187,8727,5460
1990,275,State of Palestine,Saudi Arabia,21258,10345,10913
1990,792,Turkey,Saudi Arabia,3344,1762,1582
1990,784,United Arab Emirates,Saudi Arabia,465,279,186
1990,356,India,Saudi Arabia,6058,3015,3043
1990,144,Sri Lanka,Saudi Arabia,15,8,7
1990,360,Indonesia,Saudi Arabia,5544,2663,2881
1990,608,Philippines,Saudi Arabia,227,172,55
1990,214,Dominican Republic,Saudi Arabia,24,24,0
1990,188,Costa Rica,Saudi Arabia,6,4,2
1990,320,Guatemala,Saudi Arabia,27,7,20
1990,484,Mexico,Saudi Arabia,186,94,92
1990,591,Panama,Saudi Arabia,18,13,5
1990,32,Argentina,Saudi Arabia,175,107,68
1990,68,Bolivia (Plurinational State of),Saudi Arabia,12,8,4
1990,152,Chile,Saudi Arabia,25,17,8
1990,170,Colombia,Saudi Arabia,96,64,32
1990,218,Ecuador,Saudi Arabia,30,19,11
1990,604,Peru,Saudi Arabia,19,11,8
1990,862,Venezuela (Bolivarian Republic of),Saudi Arabia,894,617,277
1990,36,Australia,Saudi Arabia,586,302,284
1990,554,New Zealand,Saudi Arabia,51,29,22
1990,100,Bulgaria,Saudi Arabia,1,1,0
1990,203,Czechia,Saudi Arabia,4,3,1
1990,348,Hungary,Saudi Arabia,286,210,76
1990,616,Poland,Saudi Arabia,34,20,14
1990,642,Romania,Saudi Arabia,8,7,1
1990,643,Russian Federation,Saudi Arabia,317,156,161
1990,703,Slovakia,Saudi Arabia,2,2,0
1990,208,Denmark,Saudi Arabia,48,25,23
1990,246,Finland,Saudi Arabia,17,15,2
1990,352,Iceland,Saudi Arabia,1,0,1
1990,372,Ireland,Saudi Arabia,82,42,40
1990,578,Norway,Saudi Arabia,36,20,16
1990,752,Sweden,Saudi Arabia,656,341,315
1990,826,United Kingdom,Saudi Arabia,4198,2218,1980
1990,300,Greece,Saudi Arabia,532,300,232
1990,380,Italy,Saudi Arabia,17,6,11
1990,470,Malta,Saudi Arabia,11,5,6
1990,724,Spain,Saudi Arabia,157,97,60
1990,40,Austria,Saudi Arabia,263,154,109
1990,56,Belgium,Saudi Arabia,146,60,86
1990,250,France,Saudi Arabia,1246,693,553
1990,276,Germany,Saudi Arabia,1003,673,330
1990,528,Netherlands,Saudi Arabia,446,239,207
1990,756,Switzerland,Saudi Arabia,393,215,178
1990,124,Canada,Saudi Arabia,1732,843,889
1990,840,United States of America,Saudi Arabia,12632,5530,7102
1995,710,South Africa,Saudi Arabia,377,181,196
1995,324,Guinea,Saudi Arabia,786,444,342
1995,478,Mauritania,Saudi Arabia,291,156,135
1995,686,Senegal,Saudi Arabia,1230,577,653
1995,12,Algeria,Saudi Arabia,3497,2212,1285
1995,818,Egypt,Saudi Arabia,5065,3146,1919
1995,434,Libya,Saudi Arabia,19379,13182,6197
1995,48,Bahrain,Saudi Arabia,108,68,40
1995,196,Cyprus,Saudi Arabia,82,44,38
1995,368,Iraq,Saudi Arabia,612,387,225
1995,400,Jordan,Saudi Arabia,4802,2964,1838
1995,414,Kuwait,Saudi Arabia,466,259,207
1995,422,Lebanon,Saudi Arabia,2185,1305,880
1995,512,Oman,Saudi Arabia,595,428,167
1995,634,Qatar,Saudi Arabia,17817,12060,5757
1995,275,State of Palestine,Saudi Arabia,20773,10055,10718
1995,792,Turkey,Saudi Arabia,3712,1959,1753
1995,784,United Arab Emirates,Saudi Arabia,1005,652,353
1995,356,India,Saudi Arabia,5767,2950,2817
1995,144,Sri Lanka,Saudi Arabia,167,132,35
1995,360,Indonesia,Saudi Arabia,3668,1812,1856
1995,608,Philippines,Saudi Arabia,305,230,75
1995,214,Dominican Republic,Saudi Arabia,27,27,0
1995,188,Costa Rica,Saudi Arabia,6,4,2
1995,320,Guatemala,Saudi Arabia,24,11,13
1995,484,Mexico,Saudi Arabia,175,98,77
1995,591,Panama,Saudi Arabia,25,19,6
1995,32,Argentina,Saudi Arabia,171,105,66
1995,68,Bolivia (Plurinational State of),Saudi Arabia,9,5,4
1995,152,Chile,Saudi Arabia,21,12,9
1995,170,Colombia,Saudi Arabia,84,53,31
1995,218,Ecuador,Saudi Arabia,34,21,13
1995,604,Peru,Saudi Arabia,20,11,9
1995,862,Venezuela (Bolivarian Republic of),Saudi Arabia,1045,714,331
1995,36,Australia,Saudi Arabia,1090,567,523
1995,554,New Zealand,Saudi Arabia,95,56,39
1995,100,Bulgaria,Saudi Arabia,8,5,3
1995,203,Czechia,Saudi Arabia,6,5,1
1995,348,Hungary,Saudi Arabia,253,184,69
1995,616,Poland,Saudi Arabia,29,18,11
1995,642,Romania,Saudi Arabia,6,6,0
1995,643,Russian Federation,Saudi Arabia,278,163,115
1995,703,Slovakia,Saudi Arabia,10,10,0
1995,208,Denmark,Saudi Arabia,120,62,58
1995,246,Finland,Saudi Arabia,93,51,42
1995,352,Iceland,Saudi Arabia,2,0,2
1995,372,Ireland,Saudi Arabia,229,114,115
1995,578,Norway,Saudi Arabia,69,40,29
1995,752,Sweden,Saudi Arabia,779,402,377
1995,826,United Kingdom,Saudi Arabia,6294,3380,2914
1995,300,Greece,Saudi Arabia,490,278,212
1995,380,Italy,Saudi Arabia,55,26,29
1995,470,Malta,Saudi Arabia,13,6,7
1995,724,Spain,Saudi Arabia,194,122,72
1995,40,Austria,Saudi Arabia,297,176,121
1995,56,Belgium,Saudi Arabia,146,60,86
1995,250,France,Saudi Arabia,1286,705,581
1995,276,Germany,Saudi Arabia,875,577,298
1995,528,Netherlands,Saudi Arabia,656,345,311
1995,756,Switzerland,Saudi Arabia,513,289,224
1995,124,Canada,Saudi Arabia,5718,2762,2956
1995,840,United States of America,Saudi Arabia,17082,7577,9505
2000,710,South Africa,Saudi Arabia,260,144,116
2000,324,Guinea,Saudi Arabia,523,296,227
2000,478,Mauritania,Saudi Arabia,300,175,125
2000,686,Senegal,Saudi Arabia,1183,564,619
2000,12,Algeria,Saudi Arabia,3926,2472,1454
2000,818,Egypt,Saudi Arabia,5987,3716,2271
2000,434,Libya,Saudi Arabia,26101,18631,7470
2000,48,Bahrain,Saudi Arabia,156,99,57
2000,196,Cyprus,Saudi Arabia,106,56,50
2000,368,Iraq,Saudi Arabia,580,314,266
2000,400,Jordan,Saudi Arabia,6108,4107,2001
2000,414,Kuwait,Saudi Arabia,733,448,285
2000,422,Lebanon,Saudi Arabia,2773,1774,999
2000,512,Oman,Saudi Arabia,808,598,210
2000,634,Qatar,Saudi Arabia,18792,13626,5166
2000,275,State of Palestine,Saudi Arabia,20289,9766,10523
2000,792,Turkey,Saudi Arabia,4094,2160,1934
2000,784,United Arab Emirates,Saudi Arabia,1604,1058,546
2000,356,India,Saudi Arabia,5476,2886,2590
2000,144,Sri Lanka,Saudi Arabia,321,219,102
2000,360,Indonesia,Saudi Arabia,1792,960,832
2000,608,Philippines,Saudi Arabia,877,530,347
2000,214,Dominican Republic,Saudi Arabia,29,29,0
2000,188,Costa Rica,Saudi Arabia,10,7,3
2000,320,Guatemala,Saudi Arabia,20,14,6
2000,484,Mexico,Saudi Arabia,172,107,65
2000,591,Panama,Saudi Arabia,35,27,8
2000,32,Argentina,Saudi Arabia,167,104,63
2000,68,Bolivia (Plurinational State of),Saudi Arabia,6,3,3
2000,152,Chile,Saudi Arabia,17,9,8
2000,170,Colombia,Saudi Arabia,72,43,29
2000,218,Ecuador,Saudi Arabia,37,23,14
2000,604,Peru,Saudi Arabia,24,13,11
2000,862,Venezuela (Bolivarian Republic of),Saudi Arabia,1212,818,394
2000,36,Australia,Saudi Arabia,1530,799,731
2000,554,New Zealand,Saudi Arabia,250,122,128
2000,100,Bulgaria,Saudi Arabia,15,9,6
2000,203,Czechia,Saudi Arabia,8,7,1
2000,348,Hungary,Saudi Arabia,220,159,61
2000,616,Poland,Saudi Arabia,25,15,10
2000,642,Romania,Saudi Arabia,6,5,1
2000,643,Russian Federation,Saudi Arabia,229,164,65
2000,703,Slovakia,Saudi Arabia,22,22,0
2000,208,Denmark,Saudi Arabia,191,98,93
2000,246,Finland,Saudi Arabia,169,87,82
2000,352,Iceland,Saudi Arabia,2,0,2
2000,372,Ireland,Saudi Arabia,501,257,244
2000,578,Norway,Saudi Arabia,203,107,96
2000,752,Sweden,Saudi Arabia,836,429,407
2000,826,United Kingdom,Saudi Arabia,8497,4592,3905
2000,300,Greece,Saudi Arabia,456,256,200
2000,380,Italy,Saudi Arabia,92,46,46
2000,470,Malta,Saudi Arabia,15,7,8
2000,705,Slovenia,Saudi Arabia,3,3,0
2000,724,Spain,Saudi Arabia,316,201,115
2000,40,Austria,Saudi Arabia,331,198,133
2000,56,Belgium,Saudi Arabia,140,54,86
2000,250,France,Saudi Arabia,1326,718,608
2000,276,Germany,Saudi Arabia,747,481,266
2000,528,Netherlands,Saudi Arabia,890,462,428
2000,756,Switzerland,Saudi Arabia,635,364,271
2000,124,Canada,Saudi Arabia,9840,4747,5093
2000,840,United States of America,Saudi Arabia,21618,9678,11940
2005,710,South Africa,Saudi Arabia,342,184,158
2005,324,Guinea,Saudi Arabia,250,163,87
2005,478,Mauritania,Saudi Arabia,302,181,121
2005,686,Senegal,Saudi Arabia,1232,590,642
2005,12,Algeria,Saudi Arabia,3098,1951,1147
2005,818,Egypt,Saudi Arabia,7128,4591,2537
2005,434,Libya,Saudi Arabia,28761,22000,6761
2005,48,Bahrain,Saudi Arabia,291,195,96
2005,196,Cyprus,Saudi Arabia,155,82,73
2005,368,Iraq,Saudi Arabia,665,446,219
2005,400,Jordan,Saudi Arabia,8823,6283,2540
2005,414,Kuwait,Saudi Arabia,1087,701,386
2005,422,Lebanon,Saudi Arabia,2170,1420,750
2005,512,Oman,Saudi Arabia,714,516,198
2005,634,Qatar,Saudi Arabia,7059,4695,2364
2005,275,State of Palestine,Saudi Arabia,21144,10122,11022
2005,792,Turkey,Saudi Arabia,4218,2180,2038
2005,784,United Arab Emirates,Saudi Arabia,2395,1638,757
2005,356,India,Saudi Arabia,5060,2661,2399
2005,144,Sri Lanka,Saudi Arabia,635,312,323
2005,360,Indonesia,Saudi Arabia,1858,1083,775
2005,608,Philippines,Saudi Arabia,709,433,276
2005,214,Dominican Republic,Saudi Arabia,23,21,2
2005,188,Costa Rica,Saudi Arabia,7,5,2
2005,320,Guatemala,Saudi Arabia,24,19,5
2005,484,Mexico,Saudi Arabia,131,88,43
2005,591,Panama,Saudi Arabia,38,28,10
2005,32,Argentina,Saudi Arabia,124,78,46
2005,68,Bolivia (Plurinational State of),Saudi Arabia,9,6,3
2005,152,Chile,Saudi Arabia,25,14,11
2005,170,Colombia,Saudi Arabia,63,36,27
2005,218,Ecuador,Saudi Arabia,44,28,16
2005,604,Peru,Saudi Arabia,29,16,13
2005,862,Venezuela (Bolivarian Republic of),Saudi Arabia,1346,920,426
2005,36,Australia,Saudi Arabia,2960,1631,1329
2005,554,New Zealand,Saudi Arabia,599,291,308
2005,100,Bulgaria,Saudi Arabia,24,14,10
2005,203,Czechia,Saudi Arabia,36,33,3
2005,348,Hungary,Saudi Arabia,273,199,74
2005,616,Poland,Saudi Arabia,101,54,47
2005,642,Romania,Saudi Arabia,4,4,0
2005,643,Russian Federation,Saudi Arabia,223,159,64
2005,703,Slovakia,Saudi Arabia,25,24,1
2005,208,Denmark,Saudi Arabia,220,114,106
2005,246,Finland,Saudi Arabia,212,110,102
2005,352,Iceland,Saudi Arabia,3,1,2
2005,372,Ireland,Saudi Arabia,502,272,230
2005,428,Latvia,Saudi Arabia,1,1,0
2005,578,Norway,Saudi Arabia,239,122,117
2005,752,Sweden,Saudi Arabia,1023,524,499
2005,826,United Kingdom,Saudi Arabia,19541,11140,8401
2005,300,Greece,Saudi Arabia,446,240,206
2005,380,Italy,Saudi Arabia,527,281,246
2005,470,Malta,Saudi Arabia,20,9,11
2005,705,Slovenia,Saudi Arabia,1,1,0
2005,724,Spain,Saudi Arabia,458,290,168
2005,40,Austria,Saudi Arabia,370,218,152
2005,56,Belgium,Saudi Arabia,220,120,100
2005,250,France,Saudi Arabia,2165,1241,924
2005,276,Germany,Saudi Arabia,1993,1203,790
2005,528,Netherlands,Saudi Arabia,1080,561,519
2005,756,Switzerland,Saudi Arabia,733,405,328
2005,124,Canada,Saudi Arabia,15696,8643,7053
2005,840,United States of America,Saudi Arabia,27673,12474,15199
2010,710,South Africa,Saudi Arabia,535,287,248
2010,324,Guinea,Saudi Arabia,120,78,42
2010,466,Mali,Saudi Arabia,1188,519,669
2010,478,Mauritania,Saudi Arabia,304,185,119
2010,686,Senegal,Saudi Arabia,1340,653,687
2010,12,Algeria,Saudi Arabia,3404,2089,1315
2010,818,Egypt,Saudi Arabia,7693,4851,2842
2010,434,Libya,Saudi Arabia,31464,24152,7312
2010,48,Bahrain,Saudi Arabia,492,336,156
2010,196,Cyprus,Saudi Arabia,253,135,118
2010,368,Iraq,Saudi Arabia,672,464,208
2010,400,Jordan,Saudi Arabia,11346,8264,3082
2010,414,Kuwait,Saudi Arabia,1713,1133,580
2010,422,Lebanon,Saudi Arabia,1567,1066,501
2010,512,Oman,Saudi Arabia,736,527,209
2010,634,Qatar,Saudi Arabia,1054,850,204
2010,275,State of Palestine,Saudi Arabia,21993,10476,11517
2010,792,Turkey,Saudi Arabia,4347,2200,2147
2010,784,United Arab Emirates,Saudi Arabia,5524,3912,1612
2010,356,India,Saudi Arabia,4643,2436,2207
2010,144,Sri Lanka,Saudi Arabia,1280,641,639
2010,360,Indonesia,Saudi Arabia,2045,1192,853
2010,608,Philippines,Saudi Arabia,722,430,292
2010,764,Thailand,Saudi Arabia,1,1,0
2010,214,Dominican Republic,Saudi Arabia,17,14,3
2010,188,Costa Rica,Saudi Arabia,13,9,4
2010,320,Guatemala,Saudi Arabia,28,25,3
2010,484,Mexico,Saudi Arabia,106,78,28
2010,591,Panama,Saudi Arabia,43,29,14
2010,32,Argentina,Saudi Arabia,80,51,29
2010,68,Bolivia (Plurinational State of),Saudi Arabia,11,8,3
2010,76,Brazil,Saudi Arabia,325,236,89
2010,152,Chile,Saudi Arabia,34,19,15
2010,170,Colombia,Saudi Arabia,66,36,30
2010,218,Ecuador,Saudi Arabia,61,38,23
2010,604,Peru,Saudi Arabia,32,18,14
2010,862,Venezuela (Bolivarian Republic of),Saudi Arabia,1511,1045,466
2010,36,Australia,Saudi Arabia,12600,8048,4552
2010,554,New Zealand,Saudi Arabia,1285,623,662
2010,100,Bulgaria,Saudi Arabia,32,19,13
2010,203,Czechia,Saudi Arabia,61,56,5
2010,348,Hungary,Saudi Arabia,325,238,87
2010,616,Poland,Saudi Arabia,181,94,87
2010,642,Romania,Saudi Arabia,17,17,0
2010,643,Russian Federation,Saudi Arabia,214,152,62
2010,703,Slovakia,Saudi Arabia,28,27,1
2010,208,Denmark,Saudi Arabia,244,128,116
2010,233,Estonia,Saudi Arabia,1,0,1
2010,246,Finland,Saudi Arabia,308,146,162
2010,352,Iceland,Saudi Arabia,3,1,2
2010,372,Ireland,Saudi Arabia,420,213,207
2010,428,Latvia,Saudi Arabia,2,2,0
2010,578,Norway,Saudi Arabia,371,187,184
2010,752,Sweden,Saudi Arabia,1658,868,790
2010,826,United Kingdom,Saudi Arabia,20585,11917,8668
2010,300,Greece,Saudi Arabia,452,233,219
2010,380,Italy,Saudi Arabia,1018,538,480
2010,470,Malta,Saudi Arabia,21,11,10
2010,705,Slovenia,Saudi Arabia,8,7,1
2010,724,Spain,Saudi Arabia,527,332,195
2010,40,Austria,Saudi Arabia,408,237,171
2010,56,Belgium,Saudi Arabia,280,145,135
2010,250,France,Saudi Arabia,2337,1242,1095
2010,276,Germany,Saudi Arabia,3030,1817,1213
2010,528,Netherlands,Saudi Arabia,1433,761,672
2010,756,Switzerland,Saudi Arabia,840,442,398
2010,124,Canada,Saudi Arabia,13515,7858,5657
2010,840,United States of America,Saudi Arabia,34736,15396,19340
2015,710,South Africa,Saudi Arabia,964,495,469
2015,324,Guinea,Saudi Arabia,31,20,11
2015,466,Mali,Saudi Arabia,1471,643,828
2015,478,Mauritania,Saudi Arabia,305,187,118
2015,686,Senegal,Saudi Arabia,1430,697,733
2015,12,Algeria,Saudi Arabia,3757,2305,1452
2015,818,Egypt,Saudi Arabia,5704,3870,1834
2015,434,Libya,Saudi Arabia,35474,27117,8357
2015,48,Bahrain,Saudi Arabia,408,277,131
2015,196,Cyprus,Saudi Arabia,243,131,112
2015,368,Iraq,Saudi Arabia,674,498,176
2015,400,Jordan,Saudi Arabia,4884,3259,1625
2015,414,Kuwait,Saudi Arabia,2077,1277,800
2015,422,Lebanon,Saudi Arabia,1319,631,688
2015,512,Oman,Saudi Arabia,1673,1270,403
2015,634,Qatar,Saudi Arabia,897,735,162
2015,275,State of Palestine,Saudi Arabia,21778,10347,11431
2015,792,Turkey,Saudi Arabia,4416,2186,2230
2015,784,United Arab Emirates,Saudi Arabia,6036,4206,1830
2015,356,India,Saudi Arabia,4473,2345,2128
2015,144,Sri Lanka,Saudi Arabia,1406,744,662
2015,360,Indonesia,Saudi Arabia,2263,1340,923
2015,608,Philippines,Saudi Arabia,733,437,296
2015,764,Thailand,Saudi Arabia,1,1,0
2015,214,Dominican Republic,Saudi Arabia,17,14,3
2015,188,Costa Rica,Saudi Arabia,13,9,4
2015,320,Guatemala,Saudi Arabia,32,29,3
2015,484,Mexico,Saudi Arabia,112,83,29
2015,591,Panama,Saudi Arabia,50,33,17
2015,32,Argentina,Saudi Arabia,80,51,29
2015,68,Bolivia (Plurinational State of),Saudi Arabia,13,10,3
2015,76,Brazil,Saudi Arabia,391,284,107
2015,152,Chile,Saudi Arabia,51,29,22
2015,170,Colombia,Saudi Arabia,73,40,33
2015,218,Ecuador,Saudi Arabia,88,55,33
2015,604,Peru,Saudi Arabia,33,18,15
2015,862,Venezuela (Bolivarian Republic of),Saudi Arabia,1618,1112,506
2015,36,Australia,Saudi Arabia,14480,8127,6353
2015,554,New Zealand,Saudi Arabia,1951,944,1007
2015,100,Bulgaria,Saudi Arabia,63,43,20
2015,203,Czechia,Saudi Arabia,208,161,47
2015,348,Hungary,Saudi Arabia,398,277,121
2015,616,Poland,Saudi Arabia,174,92,82
2015,642,Romania,Saudi Arabia,19,15,4
2015,643,Russian Federation,Saudi Arabia,219,155,64
2015,703,Slovakia,Saudi Arabia,39,35,4
2015,208,Denmark,Saudi Arabia,276,145,131
2015,233,Estonia,Saudi Arabia,5,4,1
2015,246,Finland,Saudi Arabia,406,203,203
2015,352,Iceland,Saudi Arabia,8,4,4
2015,372,Ireland,Saudi Arabia,429,215,214
2015,428,Latvia,Saudi Arabia,5,3,2
2015,578,Norway,Saudi Arabia,634,334,300
2015,752,Sweden,Saudi Arabia,3768,2036,1732
2015,826,United Kingdom,Saudi Arabia,26325,14912,11413
2015,300,Greece,Saudi Arabia,424,210,214
2015,380,Italy,Saudi Arabia,971,514,457
2015,470,Malta,Saudi Arabia,36,20,16
2015,705,Slovenia,Saudi Arabia,17,13,4
2015,724,Spain,Saudi Arabia,845,534,311
2015,40,Austria,Saudi Arabia,477,279,198
2015,56,Belgium,Saudi Arabia,485,276,209
2015,250,France,Saudi Arabia,2588,1341,1247
2015,276,Germany,Saudi Arabia,3157,1890,1267
2015,528,Netherlands,Saudi Arabia,1850,1032,818
2015,756,Switzerland,Saudi Arabia,1268,665,603
2015,124,Canada,Saudi Arabia,19956,10406,9550
2015,840,United States of America,Saudi Arabia,87863,38693,49170
2019,710,South Africa,Saudi Arabia,1079,555,524
2019,324,Guinea,Saudi Arabia,29,19,10
2019,466,Mali,Saudi Arabia,1637,716,921
2019,478,Mauritania,Saudi Arabia,316,194,122
2019,686,Senegal,Saudi Arabia,1477,720,757
2019,12,Algeria,Saudi Arabia,3907,2397,1510
2019,818,Egypt,Saudi Arabia,8130,5208,2922
2019,434,Libya,Saudi Arabia,37639,28772,8867
2019,48,Bahrain,Saudi Arabia,429,292,137
2019,196,Cyprus,Saudi Arabia,242,132,110
2019,368,Iraq,Saudi Arabia,690,510,180
2019,400,Jordan,Saudi Arabia,5252,3505,1747
2019,414,Kuwait,Saudi Arabia,2199,1352,847
2019,422,Lebanon,Saudi Arabia,1245,596,649
2019,512,Oman,Saudi Arabia,2060,1564,496
2019,634,Qatar,Saudi Arabia,914,738,176
2019,275,State of Palestine,Saudi Arabia,21626,10275,11351
2019,792,Turkey,Saudi Arabia,5971,2986,2985
2019,784,United Arab Emirates,Saudi Arabia,6483,4518,1965
2019,356,India,Saudi Arabia,4399,2307,2092
2019,144,Sri Lanka,Saudi Arabia,1417,750,667
2019,360,Indonesia,Saudi Arabia,2363,1400,963
2019,608,Philippines,Saudi Arabia,756,451,305
2019,764,Thailand,Saudi Arabia,1,1,0
2019,214,Dominican Republic,Saudi Arabia,17,14,3
2019,188,Costa Rica,Saudi Arabia,13,9,4
2019,320,Guatemala,Saudi Arabia,32,29,3
2019,484,Mexico,Saudi Arabia,115,86,29
2019,591,Panama,Saudi Arabia,52,36,16
2019,32,Argentina,Saudi Arabia,81,52,29
2019,68,Bolivia (Plurinational State of),Saudi Arabia,14,11,3
2019,76,Brazil,Saudi Arabia,440,320,120
2019,152,Chile,Saudi Arabia,68,37,31
2019,170,Colombia,Saudi Arabia,74,41,33
2019,218,Ecuador,Saudi Arabia,86,54,32
2019,604,Peru,Saudi Arabia,38,22,16
2019,862,Venezuela (Bolivarian Republic of),Saudi Arabia,1584,1087,497
2019,36,Australia,Saudi Arabia,15171,8425,6746
2019,554,New Zealand,Saudi Arabia,2005,970,1035
2019,100,Bulgaria,Saudi Arabia,106,75,31
2019,203,Czechia,Saudi Arabia,293,219,74
2019,348,Hungary,Saudi Arabia,435,283,152
2019,616,Poland,Saudi Arabia,184,101,83
2019,642,Romania,Saudi Arabia,123,92,31
2019,643,Russian Federation,Saudi Arabia,218,155,63
2019,703,Slovakia,Saudi Arabia,43,37,6
2019,208,Denmark,Saudi Arabia,440,227,213
2019,233,Estonia,Saudi Arabia,12,8,4
2019,246,Finland,Saudi Arabia,530,272,258
2019,352,Iceland,Saudi Arabia,13,8,5
2019,372,Ireland,Saudi Arabia,470,236,234
2019,428,Latvia,Saudi Arabia,5,3,2
2019,578,Norway,Saudi Arabia,900,482,418
2019,752,Sweden,Saudi Arabia,8557,4682,3875
2019,826,United Kingdom,Saudi Arabia,29894,16967,12927
2019,300,Greece,Saudi Arabia,414,213,201
2019,380,Italy,Saudi Arabia,1136,612,524
2019,470,Malta,Saudi Arabia,58,33,25
2019,705,Slovenia,Saudi Arabia,16,14,2
2019,724,Spain,Saudi Arabia,875,546,329
2019,40,Austria,Saudi Arabia,563,334,229
2019,56,Belgium,Saudi Arabia,748,426,322
2019,250,France,Saudi Arabia,2739,1417,1322
2019,276,Germany,Saudi Arabia,4457,2747,1710
2019,528,Netherlands,Saudi Arabia,2949,1647,1302
2019,756,Switzerland,Saudi Arabia,1407,743,664
2019,124,Canada,Saudi Arabia,21385,11152,10233
2019,840,United States of America,Saudi Arabia,94883,41214,53669
1990,800,Uganda,Senegal,58,46,12
1990,894,Zambia,Senegal,115,99,16
1990,178,Congo,Senegal,3468,2583,885
1990,266,Gabon,Senegal,9431,7506,1925
1990,516,Namibia,Senegal,45,27,18
1990,710,South Africa,Senegal,2683,2391,292
1990,854,Burkina Faso,Senegal,1983,1077,906
1990,132,Cabo Verde,Senegal,141,77,64
1990,384,Côte d'Ivoire,Senegal,23556,16461,7095
1990,270,Gambia,Senegal,72943,38674,34269
1990,288,Ghana,Senegal,53,33,20
1990,324,Guinea,Senegal,6770,4464,2306
1990,624,Guinea-Bissau,Senegal,5053,2072,2981
1990,430,Liberia,Senegal,243,158,85
1990,466,Mali,Senegal,12899,6487,6412
1990,478,Mauritania,Senegal,94138,50523,43615
1990,562,Niger,Senegal,732,471,261
1990,694,Sierra Leone,Senegal,737,489,248
1990,768,Togo,Senegal,483,259,224
1990,818,Egypt,Senegal,384,309,75
1990,434,Libya,Senegal,1096,884,212
1990,504,Morocco,Senegal,1233,652,581
1990,788,Tunisia,Senegal,325,162,163
1990,732,Western Sahara,Senegal,905,488,417
1990,196,Cyprus,Senegal,2,1,1
1990,792,Turkey,Senegal,16,11,5
1990,188,Costa Rica,Senegal,1,0,1
1990,484,Mexico,Senegal,23,23,0
1990,558,Nicaragua,Senegal,83,42,41
1990,68,Bolivia (Plurinational State of),Senegal,4,3,1
1990,152,Chile,Senegal,20,10,10
1990,862,Venezuela (Bolivarian Republic of),Senegal,13,6,7
1990,36,Australia,Senegal,149,79,70
1990,100,Bulgaria,Senegal,1,0,1
1990,203,Czechia,Senegal,8,7,1
1990,348,Hungary,Senegal,5,4,1
1990,616,Poland,Senegal,34,33,1
1990,643,Russian Federation,Senegal,108,53,55
1990,208,Denmark,Senegal,35,24,11
1990,246,Finland,Senegal,15,13,2
1990,352,Iceland,Senegal,3,2,1
1990,372,Ireland,Senegal,4,2,2
1990,578,Norway,Senegal,36,24,12
1990,752,Sweden,Senegal,180,108,72
1990,826,United Kingdom,Senegal,100,66,34
1990,300,Greece,Senegal,81,45,36
1990,380,Italy,Senegal,44973,42387,2586
1990,620,Portugal,Senegal,183,135,48
1990,724,Spain,Senegal,3334,2723,611
1990,40,Austria,Senegal,184,124,60
1990,56,Belgium,Senegal,1644,979,665
1990,250,France,Senegal,73801,43251,30550
1990,276,Germany,Senegal,1771,1683,88
1990,442,Luxembourg,Senegal,29,16,13
1990,528,Netherlands,Senegal,303,218,85
1990,756,Switzerland,Senegal,893,560,333
1990,124,Canada,Senegal,466,227,239
1990,840,United States of America,Senegal,2287,1576,711
1995,800,Uganda,Senegal,54,43,11
1995,894,Zambia,Senegal,138,119,19
1995,178,Congo,Senegal,4436,3300,1136
1995,266,Gabon,Senegal,12612,10036,2576
1995,516,Namibia,Senegal,43,26,17
1995,710,South Africa,Senegal,1674,1507,167
1995,854,Burkina Faso,Senegal,2466,1341,1125
1995,132,Cabo Verde,Senegal,384,216,168
1995,384,Côte d'Ivoire,Senegal,24586,17130,7456
1995,270,Gambia,Senegal,89990,46025,43965
1995,288,Ghana,Senegal,53,35,18
1995,324,Guinea,Senegal,7805,5436,2369
1995,624,Guinea-Bissau,Senegal,16635,7743,8892
1995,430,Liberia,Senegal,237,156,81
1995,466,Mali,Senegal,12540,6366,6174
1995,478,Mauritania,Senegal,36493,18499,17994
1995,562,Niger,Senegal,910,574,336
1995,694,Sierra Leone,Senegal,718,470,248
1995,768,Togo,Senegal,544,292,252
1995,818,Egypt,Senegal,334,268,66
1995,434,Libya,Senegal,952,780,172
1995,504,Morocco,Senegal,1132,591,541
1995,788,Tunisia,Senegal,323,162,161
1995,732,Western Sahara,Senegal,1006,549,457
1995,196,Cyprus,Senegal,3,1,2
1995,792,Turkey,Senegal,39,25,14
1995,188,Costa Rica,Senegal,1,0,1
1995,484,Mexico,Senegal,21,18,3
1995,558,Nicaragua,Senegal,66,33,33
1995,68,Bolivia (Plurinational State of),Senegal,2,1,1
1995,152,Chile,Senegal,13,9,4
1995,862,Venezuela (Bolivarian Republic of),Senegal,12,5,7
1995,36,Australia,Senegal,195,108,87
1995,100,Bulgaria,Senegal,3,1,2
1995,203,Czechia,Senegal,12,10,2
1995,348,Hungary,Senegal,11,8,3
1995,616,Poland,Senegal,29,29,0
1995,643,Russian Federation,Senegal,105,55,50
1995,208,Denmark,Senegal,58,36,22
1995,246,Finland,Senegal,25,22,3
1995,352,Iceland,Senegal,5,3,2
1995,372,Ireland,Senegal,12,6,6
1995,578,Norway,Senegal,44,29,15
1995,752,Sweden,Senegal,214,127,87
1995,826,United Kingdom,Senegal,396,226,170
1995,300,Greece,Senegal,63,36,27
1995,380,Italy,Senegal,47201,41818,5383
1995,620,Portugal,Senegal,396,292,104
1995,724,Spain,Senegal,4574,3705,869
1995,40,Austria,Senegal,208,141,67
1995,56,Belgium,Senegal,1633,970,663
1995,250,France,Senegal,76187,44118,32069
1995,276,Germany,Senegal,2171,1902,269
1995,442,Luxembourg,Senegal,27,15,12
1995,528,Netherlands,Senegal,445,317,128
1995,756,Switzerland,Senegal,1223,772,451
1995,124,Canada,Senegal,1119,541,578
1995,840,United States of America,Senegal,6496,4504,1992
2000,800,Uganda,Senegal,1,1,0
2000,894,Zambia,Senegal,166,143,23
2000,178,Congo,Senegal,6591,4897,1694
2000,266,Gabon,Senegal,15776,12576,3200
2000,516,Namibia,Senegal,41,24,17
2000,710,South Africa,Senegal,1157,1061,96
2000,854,Burkina Faso,Senegal,2965,1622,1343
2000,132,Cabo Verde,Senegal,627,356,271
2000,384,Côte d'Ivoire,Senegal,25619,17846,7773
2000,270,Gambia,Senegal,112746,56263,56483
2000,288,Ghana,Senegal,59,37,22
2000,324,Guinea,Senegal,8455,5836,2619
2000,624,Guinea-Bissau,Senegal,8119,3591,4528
2000,430,Liberia,Senegal,233,155,78
2000,466,Mali,Senegal,10719,5528,5191
2000,478,Mauritania,Senegal,37730,21035,16695
2000,562,Niger,Senegal,1096,682,414
2000,694,Sierra Leone,Senegal,700,452,248
2000,768,Togo,Senegal,612,329,283
2000,818,Egypt,Senegal,311,249,62
2000,434,Libya,Senegal,824,693,131
2000,504,Morocco,Senegal,1193,613,580
2000,788,Tunisia,Senegal,373,189,184
2000,732,Western Sahara,Senegal,1108,611,497
2000,196,Cyprus,Senegal,4,2,2
2000,792,Turkey,Senegal,63,39,24
2000,188,Costa Rica,Senegal,1,0,1
2000,484,Mexico,Senegal,20,12,8
2000,558,Nicaragua,Senegal,113,51,62
2000,152,Chile,Senegal,6,4,2
2000,862,Venezuela (Bolivarian Republic of),Senegal,12,5,7
2000,36,Australia,Senegal,240,142,98
2000,100,Bulgaria,Senegal,4,2,2
2000,203,Czechia,Senegal,15,12,3
2000,348,Hungary,Senegal,17,12,5
2000,616,Poland,Senegal,25,24,1
2000,643,Russian Federation,Senegal,100,56,44
2000,208,Denmark,Senegal,81,48,33
2000,246,Finland,Senegal,34,30,4
2000,352,Iceland,Senegal,6,4,2
2000,372,Ireland,Senegal,26,13,13
2000,578,Norway,Senegal,71,45,26
2000,752,Sweden,Senegal,230,136,94
2000,826,United Kingdom,Senegal,699,389,310
2000,300,Greece,Senegal,46,28,18
2000,380,Italy,Senegal,49429,41250,8179
2000,620,Portugal,Senegal,627,462,165
2000,705,Slovenia,Senegal,2,1,1
2000,724,Spain,Senegal,7783,6304,1479
2000,40,Austria,Senegal,232,159,73
2000,56,Belgium,Senegal,1576,936,640
2000,250,France,Senegal,78572,44985,33587
2000,276,Germany,Senegal,2571,2122,449
2000,442,Luxembourg,Senegal,26,14,12
2000,528,Netherlands,Senegal,604,427,177
2000,756,Switzerland,Senegal,1559,989,570
2000,124,Canada,Senegal,1798,867,931
2000,840,United States of America,Senegal,10801,7503,3298
2005,894,Zambia,Senegal,153,132,21
2005,120,Cameroon,Senegal,3172,2561,611
2005,178,Congo,Senegal,9227,5260,3967
2005,266,Gabon,Senegal,17203,13749,3454
2005,516,Namibia,Senegal,32,19,13
2005,710,South Africa,Senegal,1526,1391,135
2005,854,Burkina Faso,Senegal,3417,1867,1550
2005,132,Cabo Verde,Senegal,1025,553,472
2005,384,Côte d'Ivoire,Senegal,26820,18683,8137
2005,270,Gambia,Senegal,111877,55445,56432
2005,288,Ghana,Senegal,83,54,29
2005,324,Guinea,Senegal,5495,3330,2165
2005,624,Guinea-Bissau,Senegal,9265,4319,4946
2005,430,Liberia,Senegal,216,168,48
2005,466,Mali,Senegal,8533,4375,4158
2005,478,Mauritania,Senegal,38053,21852,16201
2005,562,Niger,Senegal,1115,694,421
2005,694,Sierra Leone,Senegal,609,453,156
2005,768,Togo,Senegal,689,371,318
2005,818,Egypt,Senegal,370,301,69
2005,434,Libya,Senegal,908,790,118
2005,504,Morocco,Senegal,1224,620,604
2005,788,Tunisia,Senegal,357,183,174
2005,732,Western Sahara,Senegal,1311,741,570
2005,196,Cyprus,Senegal,6,3,3
2005,792,Turkey,Senegal,64,39,25
2005,188,Costa Rica,Senegal,1,0,1
2005,484,Mexico,Senegal,24,15,9
2005,558,Nicaragua,Senegal,164,70,94
2005,68,Bolivia (Plurinational State of),Senegal,4,3,1
2005,152,Chile,Senegal,9,7,2
2005,862,Venezuela (Bolivarian Republic of),Senegal,12,5,7
2005,36,Australia,Senegal,280,176,104
2005,100,Bulgaria,Senegal,7,4,3
2005,203,Czechia,Senegal,34,32,2
2005,348,Hungary,Senegal,21,15,6
2005,616,Poland,Senegal,57,47,10
2005,643,Russian Federation,Senegal,86,53,33
2005,208,Denmark,Senegal,107,61,46
2005,246,Finland,Senegal,81,66,15
2005,352,Iceland,Senegal,10,6,4
2005,372,Ireland,Senegal,26,13,13
2005,578,Norway,Senegal,98,58,40
2005,752,Sweden,Senegal,328,183,145
2005,826,United Kingdom,Senegal,1249,703,546
2005,300,Greece,Senegal,350,313,37
2005,380,Italy,Senegal,67115,53440,13675
2005,620,Portugal,Senegal,1341,1048,293
2005,705,Slovenia,Senegal,1,1,0
2005,724,Spain,Senegal,26850,22332,4518
2005,40,Austria,Senegal,259,175,84
2005,56,Belgium,Senegal,2342,1427,915
2005,250,France,Senegal,99224,53444,45780
2005,276,Germany,Senegal,3012,2204,808
2005,442,Luxembourg,Senegal,22,13,9
2005,528,Netherlands,Senegal,857,571,286
2005,756,Switzerland,Senegal,1759,1081,678
2005,124,Canada,Senegal,3556,1900,1656
2005,840,United States of America,Senegal,20751,10395,10356
2010,894,Zambia,Senegal,142,107,35
2010,120,Cameroon,Senegal,2524,2060,464
2010,178,Congo,Senegal,9981,7740,2241
2010,266,Gabon,Senegal,19925,16001,3924
2010,516,Namibia,Senegal,30,18,12
2010,710,South Africa,Senegal,2389,2178,211
2010,854,Burkina Faso,Senegal,3857,2099,1758
2010,132,Cabo Verde,Senegal,1423,750,673
2010,384,Côte d'Ivoire,Senegal,28021,19517,8504
2010,270,Gambia,Senegal,114333,56539,57794
2010,288,Ghana,Senegal,61,38,23
2010,324,Guinea,Senegal,3571,2164,1407
2010,624,Guinea-Bissau,Senegal,10455,4914,5541
2010,430,Liberia,Senegal,342,236,106
2010,466,Mali,Senegal,16953,8461,8492
2010,478,Mauritania,Senegal,38381,22356,16025
2010,562,Niger,Senegal,1134,705,429
2010,694,Sierra Leone,Senegal,463,317,146
2010,768,Togo,Senegal,895,504,391
2010,818,Egypt,Senegal,399,322,77
2010,434,Libya,Senegal,994,866,128
2010,504,Morocco,Senegal,1370,691,679
2010,788,Tunisia,Senegal,317,163,154
2010,732,Western Sahara,Senegal,1514,870,644
2010,196,Cyprus,Senegal,9,5,4
2010,792,Turkey,Senegal,65,39,26
2010,188,Costa Rica,Senegal,1,0,1
2010,484,Mexico,Senegal,32,19,13
2010,558,Nicaragua,Senegal,175,76,99
2010,68,Bolivia (Plurinational State of),Senegal,7,6,1
2010,76,Brazil,Senegal,184,163,21
2010,152,Chile,Senegal,12,9,3
2010,862,Venezuela (Bolivarian Republic of),Senegal,13,5,8
2010,36,Australia,Senegal,370,233,137
2010,100,Bulgaria,Senegal,9,5,4
2010,203,Czechia,Senegal,51,50,1
2010,348,Hungary,Senegal,24,18,6
2010,616,Poland,Senegal,91,71,20
2010,642,Romania,Senegal,2,2,0
2010,643,Russian Federation,Senegal,71,49,22
2010,208,Denmark,Senegal,129,72,57
2010,233,Estonia,Senegal,2,1,1
2010,246,Finland,Senegal,143,110,33
2010,352,Iceland,Senegal,14,9,5
2010,372,Ireland,Senegal,22,10,12
2010,578,Norway,Senegal,177,111,66
2010,752,Sweden,Senegal,534,324,210
2010,826,United Kingdom,Senegal,1315,752,563
2010,300,Greece,Senegal,680,623,57
2010,380,Italy,Senegal,80612,63003,17609
2010,620,Portugal,Senegal,1833,1461,372
2010,705,Slovenia,Senegal,3,1,2
2010,724,Spain,Senegal,56349,47425,8924
2010,40,Austria,Senegal,286,191,95
2010,56,Belgium,Senegal,3228,1767,1461
2010,250,France,Senegal,110686,62309,48377
2010,276,Germany,Senegal,3371,2271,1100
2010,442,Luxembourg,Senegal,20,12,8
2010,528,Netherlands,Senegal,919,582,337
2010,756,Switzerland,Senegal,2060,1222,838
2010,124,Canada,Senegal,4985,2752,2233
2010,840,United States of America,Senegal,31599,15613,15986
2015,894,Zambia,Senegal,125,95,30
2015,120,Cameroon,Senegal,3224,2551,673
2015,178,Congo,Senegal,13265,10159,3106
2015,266,Gabon,Senegal,27861,23140,4721
2015,516,Namibia,Senegal,29,18,11
2015,710,South Africa,Senegal,4308,3909,399
2015,854,Burkina Faso,Senegal,4033,2195,1838
2015,132,Cabo Verde,Senegal,1478,777,701
2015,384,Côte d'Ivoire,Senegal,29222,20354,8868
2015,270,Gambia,Senegal,118452,58468,59984
2015,288,Ghana,Senegal,75,47,28
2015,324,Guinea,Senegal,2139,1296,843
2015,624,Guinea-Bissau,Senegal,11087,5158,5929
2015,430,Liberia,Senegal,392,270,122
2015,466,Mali,Senegal,21005,10484,10521
2015,478,Mauritania,Senegal,17630,10435,7195
2015,562,Niger,Senegal,1150,715,435
2015,694,Sierra Leone,Senegal,353,216,137
2015,768,Togo,Senegal,1008,568,440
2015,818,Egypt,Senegal,295,246,49
2015,434,Libya,Senegal,1120,974,146
2015,504,Morocco,Senegal,1785,897,888
2015,788,Tunisia,Senegal,409,211,198
2015,732,Western Sahara,Senegal,1745,1019,726
2015,196,Cyprus,Senegal,8,5,3
2015,792,Turkey,Senegal,65,39,26
2015,188,Costa Rica,Senegal,1,0,1
2015,484,Mexico,Senegal,33,20,13
2015,558,Nicaragua,Senegal,188,82,106
2015,68,Bolivia (Plurinational State of),Senegal,8,7,1
2015,76,Brazil,Senegal,222,197,25
2015,152,Chile,Senegal,18,14,4
2015,862,Venezuela (Bolivarian Republic of),Senegal,14,6,8
2015,36,Australia,Senegal,430,277,153
2015,100,Bulgaria,Senegal,12,8,4
2015,203,Czechia,Senegal,59,56,3
2015,348,Hungary,Senegal,36,27,9
2015,616,Poland,Senegal,87,69,18
2015,642,Romania,Senegal,16,4,12
2015,643,Russian Federation,Senegal,73,51,22
2015,208,Denmark,Senegal,162,97,65
2015,233,Estonia,Senegal,2,1,1
2015,246,Finland,Senegal,216,180,36
2015,352,Iceland,Senegal,21,12,9
2015,372,Ireland,Senegal,22,10,12
2015,578,Norway,Senegal,255,162,93
2015,752,Sweden,Senegal,807,519,288
2015,826,United Kingdom,Senegal,1681,940,741
2015,300,Greece,Senegal,638,583,55
2015,380,Italy,Senegal,88019,67496,20523
2015,620,Portugal,Senegal,2078,1636,442
2015,705,Slovenia,Senegal,5,4,1
2015,724,Spain,Senegal,49461,38720,10741
2015,40,Austria,Senegal,335,225,110
2015,56,Belgium,Senegal,5404,3087,2317
2015,250,France,Senegal,122616,67549,55067
2015,276,Germany,Senegal,3513,2364,1149
2015,442,Luxembourg,Senegal,30,18,12
2015,528,Netherlands,Senegal,1012,632,380
2015,756,Switzerland,Senegal,2712,1613,1099
2015,124,Canada,Senegal,7463,4192,3271
2015,840,United States of America,Senegal,42314,20798,21516
2019,894,Zambia,Senegal,161,123,38
2019,120,Cameroon,Senegal,3207,2538,669
2019,178,Congo,Senegal,13673,10470,3203
2019,266,Gabon,Senegal,30272,25139,5133
2019,516,Namibia,Senegal,30,19,11
2019,710,South Africa,Senegal,4828,4382,446
2019,854,Burkina Faso,Senegal,4158,2263,1895
2019,132,Cabo Verde,Senegal,1551,816,735
2019,384,Côte d'Ivoire,Senegal,30182,21023,9159
2019,270,Gambia,Senegal,132518,65408,67110
2019,288,Ghana,Senegal,84,53,31
2019,324,Guinea,Senegal,2041,1237,804
2019,624,Guinea-Bissau,Senegal,13632,6333,7299
2019,430,Liberia,Senegal,325,224,101
2019,466,Mali,Senegal,23389,11675,11714
2019,478,Mauritania,Senegal,18311,10845,7466
2019,562,Niger,Senegal,1243,773,470
2019,694,Sierra Leone,Senegal,316,183,133
2019,768,Togo,Senegal,1014,574,440
2019,818,Egypt,Senegal,420,342,78
2019,434,Libya,Senegal,1188,1034,154
2019,504,Morocco,Senegal,1903,957,946
2019,788,Tunisia,Senegal,415,214,201
2019,732,Western Sahara,Senegal,1814,1060,754
2019,196,Cyprus,Senegal,7,5,2
2019,792,Turkey,Senegal,87,53,34
2019,188,Costa Rica,Senegal,1,0,1
2019,484,Mexico,Senegal,34,21,13
2019,558,Nicaragua,Senegal,196,85,111
2019,68,Bolivia (Plurinational State of),Senegal,8,7,1
2019,76,Brazil,Senegal,250,222,28
2019,152,Chile,Senegal,24,19,5
2019,862,Venezuela (Bolivarian Republic of),Senegal,13,6,7
2019,36,Australia,Senegal,476,271,205
2019,100,Bulgaria,Senegal,16,12,4
2019,203,Czechia,Senegal,68,62,6
2019,348,Hungary,Senegal,43,30,13
2019,616,Poland,Senegal,92,74,18
2019,642,Romania,Senegal,84,59,25
2019,643,Russian Federation,Senegal,72,51,21
2019,208,Denmark,Senegal,198,113,85
2019,246,Finland,Senegal,271,229,42
2019,352,Iceland,Senegal,27,18,9
2019,372,Ireland,Senegal,24,11,13
2019,578,Norway,Senegal,311,195,116
2019,752,Sweden,Senegal,971,644,327
2019,826,United Kingdom,Senegal,1908,1069,839
2019,300,Greece,Senegal,623,572,51
2019,380,Italy,Senegal,103744,80037,23707
2019,620,Portugal,Senegal,2113,1665,448
2019,705,Slovenia,Senegal,3,2,1
2019,724,Spain,Senegal,51789,39297,12492
2019,40,Austria,Senegal,395,268,127
2019,56,Belgium,Senegal,6265,3518,2747
2019,250,France,Senegal,129790,71369,58421
2019,276,Germany,Senegal,5487,4056,1431
2019,442,Luxembourg,Senegal,660,362,298
2019,528,Netherlands,Senegal,1131,710,421
2019,756,Switzerland,Senegal,2934,1727,1207
2019,124,Canada,Senegal,7997,4492,3505
2019,840,United States of America,Senegal,45695,22211,23484
1990,710,South Africa,Serbia,1964,798,1166
1990,196,Cyprus,Serbia,630,303,327
1990,400,Jordan,Serbia,35,5,30
1990,214,Dominican Republic,Serbia,180,110,70
1990,484,Mexico,Serbia,5,2,3
1990,591,Panama,Serbia,27,20,7
1990,862,Venezuela (Bolivarian Republic of),Serbia,730,356,374
1990,36,Australia,Serbia,44312,23142,21170
1990,112,Belarus,Serbia,16,12,4
1990,100,Bulgaria,Serbia,562,267,295
1990,203,Czechia,Serbia,1181,693,488
1990,616,Poland,Serbia,4743,2273,2470
1990,642,Romania,Serbia,565,273,292
1990,703,Slovakia,Serbia,383,227,156
1990,208,Denmark,Serbia,5700,2993,2707
1990,352,Iceland,Serbia,312,173,139
1990,428,Latvia,Serbia,17,8,9
1990,826,United Kingdom,Serbia,1586,1073,513
1990,70,Bosnia and Herzegovina,Serbia,16974,8274,8700
1990,380,Italy,Serbia,17845,6203,11642
1990,470,Malta,Serbia,101,61,40
1990,807,North Macedonia,Serbia,17950,7482,10468
1990,620,Portugal,Serbia,46,41,5
1990,705,Slovenia,Serbia,24825,12689,12136
1990,40,Austria,Serbia,107506,52702,54804
1990,56,Belgium,Serbia,197,105,92
1990,250,France,Serbia,1898,1002,896
1990,276,Germany,Serbia,428334,238137,190197
1990,438,Liechtenstein,Serbia,379,379,0
1990,442,Luxembourg,Serbia,4602,2490,2112
1990,528,Netherlands,Serbia,14216,7481,6735
1990,756,Switzerland,Serbia,38963,21274,17689
1990,840,United States of America,Serbia,5763,2819,2944
1995,710,South Africa,Serbia,1550,730,820
1995,196,Cyprus,Serbia,891,410,481
1995,400,Jordan,Serbia,54,9,45
1995,214,Dominican Republic,Serbia,200,120,80
1995,484,Mexico,Serbia,13,5,8
1995,591,Panama,Serbia,29,22,7
1995,862,Venezuela (Bolivarian Republic of),Serbia,720,351,369
1995,36,Australia,Serbia,49660,25817,23843
1995,112,Belarus,Serbia,27,18,9
1995,100,Bulgaria,Serbia,895,417,478
1995,203,Czechia,Serbia,1772,1060,712
1995,348,Hungary,Serbia,8421,4114,4307
1995,616,Poland,Serbia,4056,1912,2144
1995,642,Romania,Serbia,1255,598,657
1995,703,Slovakia,Serbia,709,420,289
1995,208,Denmark,Serbia,5796,3043,2753
1995,352,Iceland,Serbia,463,261,202
1995,428,Latvia,Serbia,8,4,4
1995,826,United Kingdom,Serbia,3588,1843,1745
1995,70,Bosnia and Herzegovina,Serbia,21815,10606,11209
1995,300,Greece,Serbia,2508,1095,1413
1995,380,Italy,Serbia,48026,22646,25380
1995,470,Malta,Serbia,119,73,46
1995,807,North Macedonia,Serbia,16803,7004,9799
1995,620,Portugal,Serbia,99,88,11
1995,705,Slovenia,Serbia,24679,13366,11313
1995,40,Austria,Serbia,121286,60470,60816
1995,56,Belgium,Serbia,275,143,132
1995,250,France,Serbia,1960,1019,941
1995,276,Germany,Serbia,512812,278205,234607
1995,438,Liechtenstein,Serbia,461,461,0
1995,442,Luxembourg,Serbia,2288,1237,1051
1995,528,Netherlands,Serbia,31358,16109,15249
1995,756,Switzerland,Serbia,41386,23220,18166
1995,840,United States of America,Serbia,8130,4022,4108
2000,710,South Africa,Serbia,1600,848,752
2000,196,Cyprus,Serbia,1152,517,635
2000,400,Jordan,Serbia,72,13,59
2000,214,Dominican Republic,Serbia,220,131,89
2000,484,Mexico,Serbia,23,8,15
2000,591,Panama,Serbia,33,25,8
2000,862,Venezuela (Bolivarian Republic of),Serbia,711,347,364
2000,36,Australia,Serbia,52060,27056,25004
2000,112,Belarus,Serbia,37,24,13
2000,100,Bulgaria,Serbia,1227,566,661
2000,203,Czechia,Serbia,2363,1427,936
2000,348,Hungary,Serbia,16841,8228,8613
2000,616,Poland,Serbia,3470,1608,1862
2000,642,Romania,Serbia,1987,942,1045
2000,703,Slovakia,Serbia,1230,727,503
2000,208,Denmark,Serbia,5891,3092,2799
2000,234,Faroe Islands,Serbia,13,8,5
2000,352,Iceland,Serbia,614,350,264
2000,826,United Kingdom,Serbia,5651,2640,3011
2000,70,Bosnia and Herzegovina,Serbia,26662,12937,13725
2000,300,Greece,Serbia,5057,2183,2874
2000,380,Italy,Serbia,78207,39090,39117
2000,470,Malta,Serbia,302,186,116
2000,807,North Macedonia,Serbia,15656,6526,9130
2000,620,Portugal,Serbia,158,139,19
2000,705,Slovenia,Serbia,29945,16705,13240
2000,40,Austria,Serbia,135065,68237,66828
2000,56,Belgium,Serbia,346,179,167
2000,250,France,Serbia,2021,1036,985
2000,276,Germany,Serbia,597290,318273,279017
2000,438,Liechtenstein,Serbia,536,536,0
2000,528,Netherlands,Serbia,49504,25211,24293
2000,756,Switzerland,Serbia,82923,46577,36346
2000,840,United States of America,Serbia,10545,5253,5292
2005,710,South Africa,Serbia,2143,1085,1058
2005,196,Cyprus,Serbia,1686,751,935
2005,400,Jordan,Serbia,103,29,74
2005,214,Dominican Republic,Serbia,145,81,64
2005,484,Mexico,Serbia,38,16,22
2005,591,Panama,Serbia,26,21,5
2005,68,Bolivia (Plurinational State of),Serbia,9,7,2
2005,862,Venezuela (Bolivarian Republic of),Serbia,746,364,382
2005,36,Australia,Serbia,39290,20171,19119
2005,112,Belarus,Serbia,36,23,13
2005,100,Bulgaria,Serbia,1755,830,925
2005,203,Czechia,Serbia,1639,1031,608
2005,348,Hungary,Serbia,20802,10352,10450
2005,616,Poland,Serbia,2236,1123,1113
2005,642,Romania,Serbia,1973,968,1005
2005,703,Slovakia,Serbia,1380,825,555
2005,208,Denmark,Serbia,3736,1933,1803
2005,234,Faroe Islands,Serbia,35,20,15
2005,246,Finland,Serbia,43,23,20
2005,352,Iceland,Serbia,466,248,218
2005,428,Latvia,Serbia,3,3,0
2005,826,United Kingdom,Serbia,6567,3006,3561
2005,70,Bosnia and Herzegovina,Serbia,14345,6939,7406
2005,191,Croatia,Serbia,25928,11407,14521
2005,300,Greece,Serbia,4768,1870,2898
2005,380,Italy,Serbia,61890,30369,31521
2005,470,Malta,Serbia,472,291,181
2005,807,North Macedonia,Serbia,16097,6714,9383
2005,620,Portugal,Serbia,111,89,22
2005,705,Slovenia,Serbia,34154,19443,14711
2005,40,Austria,Serbia,150971,74489,76482
2005,56,Belgium,Serbia,11,5,6
2005,250,France,Serbia,17288,8900,8388
2005,276,Germany,Serbia,319713,171013,148700
2005,438,Liechtenstein,Serbia,335,303,32
2005,442,Luxembourg,Serbia,1929,1170,759
2005,528,Netherlands,Serbia,50508,25087,25421
2005,756,Switzerland,Serbia,112119,58217,53902
2005,124,Canada,Serbia,15576,7534,8042
2005,840,United States of America,Serbia,18657,9347,9310
2010,710,South Africa,Serbia,3356,1693,1663
2010,196,Cyprus,Serbia,2760,1248,1512
2010,400,Jordan,Serbia,131,41,90
2010,214,Dominican Republic,Serbia,69,31,38
2010,484,Mexico,Serbia,58,25,33
2010,591,Panama,Serbia,22,19,3
2010,68,Bolivia (Plurinational State of),Serbia,18,14,4
2010,76,Brazil,Serbia,429,151,278
2010,862,Venezuela (Bolivarian Republic of),Serbia,792,388,404
2010,36,Australia,Serbia,35170,17690,17480
2010,554,New Zealand,Serbia,555,269,286
2010,112,Belarus,Serbia,34,21,13
2010,100,Bulgaria,Serbia,2209,1058,1151
2010,203,Czechia,Serbia,774,573,201
2010,348,Hungary,Serbia,24763,12477,12286
2010,616,Poland,Serbia,1073,666,407
2010,642,Romania,Serbia,2177,1095,1082
2010,703,Slovakia,Serbia,1547,934,613
2010,208,Denmark,Serbia,1553,762,791
2010,233,Estonia,Serbia,13,9,4
2010,234,Faroe Islands,Serbia,35,26,9
2010,246,Finland,Serbia,89,45,44
2010,352,Iceland,Serbia,317,146,171
2010,428,Latvia,Serbia,6,6,0
2010,578,Norway,Serbia,2295,1143,1152
2010,752,Sweden,Serbia,5324,2777,2547
2010,826,United Kingdom,Serbia,6918,3244,3674
2010,70,Bosnia and Herzegovina,Serbia,10280,5027,5253
2010,191,Croatia,Serbia,51856,22814,29042
2010,300,Greece,Serbia,4659,1621,3038
2010,380,Italy,Serbia,46096,22011,24085
2010,470,Malta,Serbia,450,284,166
2010,499,Montenegro,Serbia,17455,7766,9689
2010,807,North Macedonia,Serbia,16538,6902,9636
2010,620,Portugal,Serbia,46,23,23
2010,705,Slovenia,Serbia,20890,12454,8436
2010,724,Spain,Serbia,3726,1900,1826
2010,40,Austria,Serbia,166876,80741,86135
2010,56,Belgium,Serbia,81,38,43
2010,250,France,Serbia,79539,38940,40599
2010,276,Germany,Serbia,86303,42893,43410
2010,438,Liechtenstein,Serbia,135,69,66
2010,442,Luxembourg,Serbia,3881,2354,1527
2010,528,Netherlands,Serbia,51863,25170,26693
2010,756,Switzerland,Serbia,109553,56207,53346
2010,124,Canada,Serbia,39030,18904,20126
2010,840,United States of America,Serbia,27554,13615,13939
2015,710,South Africa,Serbia,6052,2900,3152
2015,324,Guinea,Serbia,2,1,1
2015,196,Cyprus,Serbia,2651,1208,1443
2015,400,Jordan,Serbia,56,8,48
2015,214,Dominican Republic,Serbia,72,32,40
2015,484,Mexico,Serbia,61,26,35
2015,591,Panama,Serbia,27,23,4
2015,68,Bolivia (Plurinational State of),Serbia,21,16,5
2015,76,Brazil,Serbia,517,182,335
2015,862,Venezuela (Bolivarian Republic of),Serbia,830,400,430
2015,36,Australia,Serbia,33820,16902,16918
2015,554,New Zealand,Serbia,1103,534,569
2015,112,Belarus,Serbia,35,22,13
2015,100,Bulgaria,Serbia,2318,1143,1175
2015,203,Czechia,Serbia,1534,1020,514
2015,348,Hungary,Serbia,39691,21400,18291
2015,616,Poland,Serbia,1034,649,385
2015,642,Romania,Serbia,5783,4613,1170
2015,703,Slovakia,Serbia,1917,1229,688
2015,208,Denmark,Serbia,1823,905,918
2015,233,Estonia,Serbia,22,16,6
2015,234,Faroe Islands,Serbia,51,27,24
2015,246,Finland,Serbia,191,99,92
2015,352,Iceland,Serbia,307,145,162
2015,428,Latvia,Serbia,10,8,2
2015,578,Norway,Serbia,3926,1978,1948
2015,752,Sweden,Serbia,10092,5224,4868
2015,826,United Kingdom,Serbia,8847,4010,4837
2015,70,Bosnia and Herzegovina,Serbia,10222,4999,5223
2015,191,Croatia,Serbia,51185,21374,29811
2015,300,Greece,Serbia,4372,1400,2972
2015,380,Italy,Serbia,43435,20205,23230
2015,470,Malta,Serbia,764,501,263
2015,499,Montenegro,Serbia,9679,3964,5715
2015,807,North Macedonia,Serbia,17930,7452,10478
2015,620,Portugal,Serbia,51,23,28
2015,705,Slovenia,Serbia,27073,15849,11224
2015,724,Spain,Serbia,3900,1894,2006
2015,40,Austria,Serbia,195177,94987,100190
2015,56,Belgium,Serbia,343,169,174
2015,250,France,Serbia,88111,41898,46213
2015,276,Germany,Serbia,89923,44585,45338
2015,438,Liechtenstein,Serbia,141,65,76
2015,442,Luxembourg,Serbia,5920,3627,2293
2015,528,Netherlands,Serbia,26711,8837,17874
2015,756,Switzerland,Serbia,63340,30862,32478
2015,124,Canada,Serbia,33120,16217,16903
2015,840,United States of America,Serbia,38320,18837,19483
2019,710,South Africa,Serbia,6783,3254,3529
2019,324,Guinea,Serbia,1,1,0
2019,196,Cyprus,Serbia,2649,1222,1427
2019,400,Jordan,Serbia,60,9,51
2019,214,Dominican Republic,Serbia,74,33,41
2019,484,Mexico,Serbia,62,26,36
2019,591,Panama,Serbia,27,24,3
2019,68,Bolivia (Plurinational State of),Serbia,22,17,5
2019,76,Brazil,Serbia,582,205,377
2019,862,Venezuela (Bolivarian Republic of),Serbia,813,390,423
2019,36,Australia,Serbia,35019,17332,17687
2019,554,New Zealand,Serbia,1133,549,584
2019,112,Belarus,Serbia,34,22,12
2019,100,Bulgaria,Serbia,2879,1441,1438
2019,203,Czechia,Serbia,2038,1384,654
2019,348,Hungary,Serbia,41807,22729,19078
2019,616,Poland,Serbia,1095,703,392
2019,642,Romania,Serbia,2517,1479,1038
2019,703,Slovakia,Serbia,2190,1407,783
2019,208,Denmark,Serbia,3627,1873,1754
2019,233,Estonia,Serbia,31,19,12
2019,234,Faroe Islands,Serbia,57,33,24
2019,246,Finland,Serbia,295,138,157
2019,352,Iceland,Serbia,390,192,198
2019,428,Latvia,Serbia,12,11,1
2019,578,Norway,Serbia,5858,2894,2964
2019,752,Sweden,Serbia,15293,7812,7481
2019,826,United Kingdom,Serbia,10046,4567,5479
2019,70,Bosnia and Herzegovina,Serbia,9469,4623,4846
2019,191,Croatia,Serbia,47261,19654,27607
2019,300,Greece,Serbia,4269,1477,2792
2019,380,Italy,Serbia,45410,21119,24291
2019,470,Malta,Serbia,1232,811,421
2019,499,Montenegro,Serbia,8828,3566,5262
2019,807,North Macedonia,Serbia,17991,7478,10513
2019,620,Portugal,Serbia,178,69,109
2019,705,Slovenia,Serbia,24601,14336,10265
2019,724,Spain,Serbia,4041,1913,2128
2019,40,Austria,Serbia,230404,114167,116237
2019,56,Belgium,Serbia,411,199,212
2019,250,France,Serbia,93266,44238,49028
2019,276,Germany,Serbia,166432,86323,80109
2019,438,Liechtenstein,Serbia,161,74,87
2019,442,Luxembourg,Serbia,1728,793,935
2019,528,Netherlands,Serbia,30544,10346,20198
2019,756,Switzerland,Serbia,66177,32225,33952
2019,124,Canada,Serbia,35491,17378,18113
2019,840,United States of America,Serbia,41382,20117,21265
1990,480,Mauritius,Seychelles,43,12,31
1990,508,Mozambique,Seychelles,6212,3171,3041
1990,834,United Republic of Tanzania,Seychelles,214,129,85
1990,72,Botswana,Seychelles,45,45,0
1990,516,Namibia,Seychelles,84,32,52
1990,710,South Africa,Seychelles,28,15,13
1990,818,Egypt,Seychelles,15,9,6
1990,196,Cyprus,Seychelles,2,1,1
1990,36,Australia,Seychelles,2610,1288,1322
1990,208,Denmark,Seychelles,14,4,10
1990,372,Ireland,Seychelles,2,1,1
1990,752,Sweden,Seychelles,36,10,26
1990,826,United Kingdom,Seychelles,2896,1239,1657
1990,300,Greece,Seychelles,41,23,18
1990,380,Italy,Seychelles,181,63,118
1990,724,Spain,Seychelles,3,1,2
1990,40,Austria,Seychelles,24,10,14
1990,56,Belgium,Seychelles,56,21,35
1990,250,France,Seychelles,429,132,297
1990,528,Netherlands,Seychelles,39,16,23
1990,756,Switzerland,Seychelles,173,53,120
1990,124,Canada,Seychelles,22486,10946,11540
1995,480,Mauritius,Seychelles,39,14,25
1995,508,Mozambique,Seychelles,8545,4380,4165
1995,834,United Republic of Tanzania,Seychelles,286,172,114
1995,72,Botswana,Seychelles,67,48,19
1995,516,Namibia,Seychelles,80,31,49
1995,710,South Africa,Seychelles,133,59,74
1995,818,Egypt,Seychelles,14,9,5
1995,196,Cyprus,Seychelles,3,1,2
1995,144,Sri Lanka,Seychelles,2,2,0
1995,36,Australia,Seychelles,2797,1350,1447
1995,203,Czechia,Seychelles,1,1,0
1995,208,Denmark,Seychelles,18,6,12
1995,246,Finland,Seychelles,1,0,1
1995,372,Ireland,Seychelles,5,2,3
1995,752,Sweden,Seychelles,43,12,31
1995,826,United Kingdom,Seychelles,2828,1164,1664
1995,300,Greece,Seychelles,37,16,21
1995,380,Italy,Seychelles,520,107,413
1995,724,Spain,Seychelles,6,2,4
1995,40,Austria,Seychelles,27,11,16
1995,56,Belgium,Seychelles,56,21,35
1995,250,France,Seychelles,443,131,312
1995,528,Netherlands,Seychelles,57,23,34
1995,756,Switzerland,Seychelles,168,54,114
1995,124,Canada,Seychelles,11622,5655,5967
2000,480,Mauritius,Seychelles,58,18,40
2000,508,Mozambique,Seychelles,9939,4936,5003
2000,834,United Republic of Tanzania,Seychelles,305,184,121
2000,72,Botswana,Seychelles,95,55,40
2000,516,Namibia,Seychelles,75,28,47
2000,710,South Africa,Seychelles,280,118,162
2000,818,Egypt,Seychelles,15,10,5
2000,196,Cyprus,Seychelles,4,2,2
2000,144,Sri Lanka,Seychelles,5,4,1
2000,36,Australia,Seychelles,2790,1330,1460
2000,203,Czechia,Seychelles,1,1,0
2000,208,Denmark,Seychelles,21,8,13
2000,246,Finland,Seychelles,2,1,1
2000,372,Ireland,Seychelles,12,5,7
2000,752,Sweden,Seychelles,47,13,34
2000,826,United Kingdom,Seychelles,2808,1103,1705
2000,300,Greece,Seychelles,33,8,25
2000,380,Italy,Seychelles,859,152,707
2000,724,Spain,Seychelles,79,26,53
2000,40,Austria,Seychelles,30,13,17
2000,56,Belgium,Seychelles,51,16,35
2000,250,France,Seychelles,457,131,326
2000,528,Netherlands,Seychelles,78,29,49
2000,756,Switzerland,Seychelles,165,56,109
2000,124,Canada,Seychelles,1035,500,535
2005,480,Mauritius,Seychelles,80,25,55
2005,508,Mozambique,Seychelles,13443,6047,7396
2005,834,United Republic of Tanzania,Seychelles,345,208,137
2005,72,Botswana,Seychelles,147,84,63
2005,516,Namibia,Seychelles,59,22,37
2005,710,South Africa,Seychelles,368,145,223
2005,818,Egypt,Seychelles,18,12,6
2005,196,Cyprus,Seychelles,6,3,3
2005,144,Sri Lanka,Seychelles,12,6,6
2005,36,Australia,Seychelles,2890,1336,1554
2005,203,Czechia,Seychelles,1,1,0
2005,208,Denmark,Seychelles,20,6,14
2005,246,Finland,Seychelles,4,1,3
2005,372,Ireland,Seychelles,13,6,7
2005,752,Sweden,Seychelles,57,15,42
2005,826,United Kingdom,Seychelles,3008,1186,1822
2005,300,Greece,Seychelles,29,5,24
2005,380,Italy,Seychelles,919,182,737
2005,724,Spain,Seychelles,38,12,26
2005,40,Austria,Seychelles,34,14,20
2005,56,Belgium,Seychelles,66,20,46
2005,250,France,Seychelles,538,192,346
2005,528,Netherlands,Seychelles,78,29,49
2005,756,Switzerland,Seychelles,181,59,122
2005,124,Canada,Seychelles,936,442,494
2010,480,Mauritius,Seychelles,108,36,72
2010,508,Mozambique,Seychelles,15566,7002,8564
2010,834,United Republic of Tanzania,Seychelles,355,214,141
2010,72,Botswana,Seychelles,10,10,0
2010,516,Namibia,Seychelles,56,21,35
2010,710,South Africa,Seychelles,576,226,350
2010,818,Egypt,Seychelles,19,12,7
2010,196,Cyprus,Seychelles,9,5,4
2010,144,Sri Lanka,Seychelles,26,14,12
2010,76,Brazil,Seychelles,29,29,0
2010,36,Australia,Seychelles,2970,1360,1610
2010,203,Czechia,Seychelles,1,1,0
2010,208,Denmark,Seychelles,17,4,13
2010,246,Finland,Seychelles,7,0,7
2010,372,Ireland,Seychelles,11,4,7
2010,752,Sweden,Seychelles,63,17,46
2010,826,United Kingdom,Seychelles,3168,1289,1879
2010,300,Greece,Seychelles,26,3,23
2010,380,Italy,Seychelles,1025,220,805
2010,724,Spain,Seychelles,43,18,25
2010,40,Austria,Seychelles,37,15,22
2010,56,Belgium,Seychelles,87,32,55
2010,250,France,Seychelles,560,151,409
2010,528,Netherlands,Seychelles,85,31,54
2010,756,Switzerland,Seychelles,219,59,160
2010,124,Canada,Seychelles,905,419,486
2015,480,Mauritius,Seychelles,124,46,78
2015,508,Mozambique,Seychelles,16344,7352,8992
2015,834,United Republic of Tanzania,Seychelles,374,258,116
2015,72,Botswana,Seychelles,10,10,0
2015,516,Namibia,Seychelles,54,20,34
2015,710,South Africa,Seychelles,1038,375,663
2015,324,Guinea,Seychelles,3,2,1
2015,818,Egypt,Seychelles,14,10,4
2015,196,Cyprus,Seychelles,8,5,3
2015,144,Sri Lanka,Seychelles,25,13,12
2015,76,Brazil,Seychelles,35,35,0
2015,36,Australia,Seychelles,3030,1395,1635
2015,203,Czechia,Seychelles,3,1,2
2015,208,Denmark,Seychelles,19,6,13
2015,246,Finland,Seychelles,7,1,6
2015,372,Ireland,Seychelles,11,4,7
2015,752,Sweden,Seychelles,67,20,47
2015,826,United Kingdom,Seychelles,4051,1577,2474
2015,300,Greece,Seychelles,24,2,22
2015,380,Italy,Seychelles,931,191,740
2015,724,Spain,Seychelles,40,19,21
2015,40,Austria,Seychelles,44,19,25
2015,56,Belgium,Seychelles,76,29,47
2015,250,France,Seychelles,620,156,464
2015,528,Netherlands,Seychelles,84,28,56
2015,756,Switzerland,Seychelles,238,71,167
2015,124,Canada,Seychelles,1028,452,576
2019,480,Mauritius,Seychelles,125,47,78
2019,508,Mozambique,Seychelles,16997,7646,9351
2019,834,United Republic of Tanzania,Seychelles,335,221,114
2019,72,Botswana,Seychelles,10,10,0
2019,516,Namibia,Seychelles,57,22,35
2019,710,South Africa,Seychelles,1162,420,742
2019,324,Guinea,Seychelles,2,2,0
2019,818,Egypt,Seychelles,19,13,6
2019,196,Cyprus,Seychelles,7,5,2
2019,144,Sri Lanka,Seychelles,25,13,12
2019,76,Brazil,Seychelles,39,39,0
2019,36,Australia,Seychelles,3174,1445,1729
2019,203,Czechia,Seychelles,5,3,2
2019,208,Denmark,Seychelles,22,8,14
2019,246,Finland,Seychelles,8,1,7
2019,372,Ireland,Seychelles,12,5,7
2019,752,Sweden,Seychelles,80,23,57
2019,826,United Kingdom,Seychelles,4600,1798,2802
2019,300,Greece,Seychelles,23,3,20
2019,380,Italy,Seychelles,956,204,752
2019,724,Spain,Seychelles,41,19,22
2019,40,Austria,Seychelles,51,22,29
2019,56,Belgium,Seychelles,87,31,56
2019,250,France,Seychelles,656,164,492
2019,528,Netherlands,Seychelles,89,30,59
2019,756,Switzerland,Seychelles,238,74,164
2019,124,Canada,Seychelles,1101,484,617
1990,516,Namibia,Sierra Leone,242,111,131
1990,710,South Africa,Sierra Leone,384,259,125
1990,132,Cabo Verde,Sierra Leone,19,8,11
1990,384,Côte d'Ivoire,Sierra Leone,620,346,274
1990,270,Gambia,Sierra Leone,1435,812,623
1990,288,Ghana,Sierra Leone,119,62,57
1990,324,Guinea,Sierra Leone,15985,7429,8556
1990,624,Guinea-Bissau,Sierra Leone,87,59,28
1990,430,Liberia,Sierra Leone,7943,4538,3405
1990,466,Mali,Sierra Leone,1227,629,598
1990,566,Nigeria,Sierra Leone,1553,872,681
1990,686,Senegal,Sierra Leone,12313,5690,6623
1990,768,Togo,Sierra Leone,49,22,27
1990,818,Egypt,Sierra Leone,41,14,27
1990,434,Libya,Sierra Leone,117,41,76
1990,196,Cyprus,Sierra Leone,1,1,0
1990,152,Chile,Sierra Leone,1,1,0
1990,36,Australia,Sierra Leone,120,71,49
1990,203,Czechia,Sierra Leone,1,1,0
1990,348,Hungary,Sierra Leone,6,5,1
1990,208,Denmark,Sierra Leone,72,51,21
1990,246,Finland,Sierra Leone,21,19,2
1990,352,Iceland,Sierra Leone,5,3,2
1990,372,Ireland,Sierra Leone,38,23,15
1990,428,Latvia,Sierra Leone,2,2,0
1990,578,Norway,Sierra Leone,143,114,29
1990,752,Sweden,Sierra Leone,170,95,75
1990,826,United Kingdom,Sierra Leone,6161,2896,3265
1990,300,Greece,Sierra Leone,436,242,194
1990,380,Italy,Sierra Leone,91,32,59
1990,620,Portugal,Sierra Leone,12,12,0
1990,724,Spain,Sierra Leone,212,158,54
1990,40,Austria,Sierra Leone,147,112,35
1990,56,Belgium,Sierra Leone,1891,1230,661
1990,250,France,Sierra Leone,713,350,363
1990,276,Germany,Sierra Leone,1002,751,251
1990,528,Netherlands,Sierra Leone,634,505,129
1990,756,Switzerland,Sierra Leone,408,325,83
1990,124,Canada,Sierra Leone,216,105,111
1990,840,United States of America,Sierra Leone,7217,3972,3245
1995,516,Namibia,Sierra Leone,231,107,124
1995,710,South Africa,Sierra Leone,239,168,71
1995,132,Cabo Verde,Sierra Leone,26,11,15
1995,384,Côte d'Ivoire,Sierra Leone,693,384,309
1995,270,Gambia,Sierra Leone,6835,3717,3118
1995,288,Ghana,Sierra Leone,1180,666,514
1995,324,Guinea,Sierra Leone,273125,133832,139293
1995,624,Guinea-Bissau,Sierra Leone,524,265,259
1995,430,Liberia,Sierra Leone,124102,63943,60159
1995,466,Mali,Sierra Leone,1283,658,625
1995,566,Nigeria,Sierra Leone,1574,878,696
1995,686,Senegal,Sierra Leone,12876,5907,6969
1995,768,Togo,Sierra Leone,55,25,30
1995,818,Egypt,Sierra Leone,42,17,25
1995,434,Libya,Sierra Leone,144,72,72
1995,196,Cyprus,Sierra Leone,2,2,0
1995,152,Chile,Sierra Leone,1,1,0
1995,36,Australia,Sierra Leone,195,108,87
1995,203,Czechia,Sierra Leone,1,0,1
1995,348,Hungary,Sierra Leone,13,12,1
1995,208,Denmark,Sierra Leone,164,94,70
1995,246,Finland,Sierra Leone,29,25,4
1995,352,Iceland,Sierra Leone,8,5,3
1995,372,Ireland,Sierra Leone,105,61,44
1995,428,Latvia,Sierra Leone,2,2,0
1995,578,Norway,Sierra Leone,153,107,46
1995,752,Sweden,Sierra Leone,202,112,90
1995,826,United Kingdom,Sierra Leone,11228,5210,6018
1995,300,Greece,Sierra Leone,344,203,141
1995,380,Italy,Sierra Leone,455,210,245
1995,620,Portugal,Sierra Leone,26,25,1
1995,724,Spain,Sierra Leone,391,301,90
1995,40,Austria,Sierra Leone,166,127,39
1995,56,Belgium,Sierra Leone,1493,910,583
1995,250,France,Sierra Leone,736,355,381
1995,276,Germany,Sierra Leone,3113,2553,560
1995,528,Netherlands,Sierra Leone,933,739,194
1995,756,Switzerland,Sierra Leone,322,237,85
1995,124,Canada,Sierra Leone,606,293,313
1995,840,United States of America,Sierra Leone,14211,7900,6311
2000,516,Namibia,Sierra Leone,216,100,116
2000,710,South Africa,Sierra Leone,166,126,40
2000,132,Cabo Verde,Sierra Leone,32,14,18
2000,384,Côte d'Ivoire,Sierra Leone,722,400,322
2000,270,Gambia,Sierra Leone,2218,1191,1027
2000,288,Ghana,Sierra Leone,2385,1243,1142
2000,324,Guinea,Sierra Leone,365828,177427,188401
2000,624,Guinea-Bissau,Sierra Leone,960,471,489
2000,430,Liberia,Sierra Leone,71154,37641,33513
2000,466,Mali,Sierra Leone,1177,607,570
2000,566,Nigeria,Sierra Leone,1658,919,739
2000,686,Senegal,Sierra Leone,11638,6047,5591
2000,768,Togo,Sierra Leone,62,29,33
2000,818,Egypt,Sierra Leone,46,20,26
2000,434,Libya,Sierra Leone,175,106,69
2000,196,Cyprus,Sierra Leone,2,2,0
2000,152,Chile,Sierra Leone,1,1,0
2000,36,Australia,Sierra Leone,260,138,122
2000,203,Czechia,Sierra Leone,1,0,1
2000,348,Hungary,Sierra Leone,20,19,1
2000,208,Denmark,Sierra Leone,255,136,119
2000,246,Finland,Sierra Leone,36,30,6
2000,352,Iceland,Sierra Leone,10,6,4
2000,372,Ireland,Sierra Leone,229,136,93
2000,428,Latvia,Sierra Leone,3,3,0
2000,578,Norway,Sierra Leone,195,121,74
2000,752,Sweden,Sierra Leone,217,119,98
2000,826,United Kingdom,Sierra Leone,16485,7596,8889
2000,300,Greece,Sierra Leone,258,166,92
2000,380,Italy,Sierra Leone,818,388,430
2000,620,Portugal,Sierra Leone,43,39,4
2000,724,Spain,Sierra Leone,739,576,163
2000,40,Austria,Sierra Leone,185,143,42
2000,56,Belgium,Sierra Leone,1051,564,487
2000,250,France,Sierra Leone,759,360,399
2000,276,Germany,Sierra Leone,5223,4354,869
2000,528,Netherlands,Sierra Leone,1265,997,268
2000,756,Switzerland,Sierra Leone,238,149,89
2000,124,Canada,Sierra Leone,1010,488,522
2000,840,United States of America,Sierra Leone,21359,11925,9434
2005,516,Namibia,Sierra Leone,170,78,92
2005,710,South Africa,Sierra Leone,274,180,94
2005,132,Cabo Verde,Sierra Leone,23,10,13
2005,384,Côte d'Ivoire,Sierra Leone,755,418,337
2005,270,Gambia,Sierra Leone,2201,1174,1027
2005,288,Ghana,Sierra Leone,3354,1845,1509
2005,324,Guinea,Sierra Leone,27115,12202,14913
2005,624,Guinea-Bissau,Sierra Leone,863,431,432
2005,430,Liberia,Sierra Leone,26426,12158,14268
2005,466,Mali,Sierra Leone,4800,2401,2399
2005,566,Nigeria,Sierra Leone,3292,1918,1374
2005,686,Senegal,Sierra Leone,12523,6167,6356
2005,768,Togo,Sierra Leone,70,33,37
2005,818,Egypt,Sierra Leone,55,26,29
2005,434,Libya,Sierra Leone,192,131,61
2005,196,Cyprus,Sierra Leone,3,3,0
2005,68,Bolivia (Plurinational State of),Sierra Leone,1,1,0
2005,152,Chile,Sierra Leone,1,1,0
2005,36,Australia,Sierra Leone,1570,791,779
2005,100,Bulgaria,Sierra Leone,1,1,0
2005,203,Czechia,Sierra Leone,6,4,2
2005,348,Hungary,Sierra Leone,25,24,1
2005,208,Denmark,Sierra Leone,293,152,141
2005,246,Finland,Sierra Leone,74,57,17
2005,352,Iceland,Sierra Leone,12,7,5
2005,372,Ireland,Sierra Leone,229,141,88
2005,428,Latvia,Sierra Leone,2,2,0
2005,578,Norway,Sierra Leone,375,208,167
2005,752,Sweden,Sierra Leone,514,269,245
2005,826,United Kingdom,Sierra Leone,18732,8506,10226
2005,300,Greece,Sierra Leone,219,143,76
2005,380,Italy,Sierra Leone,1098,610,488
2005,620,Portugal,Sierra Leone,49,43,6
2005,724,Spain,Sierra Leone,1691,1041,650
2005,40,Austria,Sierra Leone,207,159,48
2005,56,Belgium,Sierra Leone,902,585,317
2005,250,France,Sierra Leone,975,563,412
2005,276,Germany,Sierra Leone,3821,3002,819
2005,528,Netherlands,Sierra Leone,5611,4328,1283
2005,756,Switzerland,Sierra Leone,261,160,101
2005,124,Canada,Sierra Leone,1674,852,822
2005,840,United States of America,Sierra Leone,27472,13761,13711
2010,516,Namibia,Sierra Leone,163,75,88
2010,710,South Africa,Sierra Leone,428,281,147
2010,132,Cabo Verde,Sierra Leone,14,6,8
2010,384,Côte d'Ivoire,Sierra Leone,788,436,352
2010,270,Gambia,Sierra Leone,2249,1197,1052
2010,288,Ghana,Sierra Leone,1939,965,974
2010,324,Guinea,Sierra Leone,13557,6101,7456
2010,624,Guinea-Bissau,Sierra Leone,766,391,375
2010,430,Liberia,Sierra Leone,12578,6843,5735
2010,466,Mali,Sierra Leone,1728,799,929
2010,566,Nigeria,Sierra Leone,3358,1956,1402
2010,686,Senegal,Sierra Leone,14007,6678,7329
2010,768,Togo,Sierra Leone,93,43,50
2010,818,Egypt,Sierra Leone,59,27,32
2010,434,Libya,Sierra Leone,211,145,66
2010,196,Cyprus,Sierra Leone,4,4,0
2010,68,Bolivia (Plurinational State of),Sierra Leone,2,2,0
2010,76,Brazil,Sierra Leone,6,6,0
2010,152,Chile,Sierra Leone,2,2,0
2010,36,Australia,Sierra Leone,3320,1682,1638
2010,100,Bulgaria,Sierra Leone,1,1,0
2010,203,Czechia,Sierra Leone,11,9,2
2010,348,Hungary,Sierra Leone,30,29,1
2010,208,Denmark,Sierra Leone,325,165,160
2010,246,Finland,Sierra Leone,133,103,30
2010,352,Iceland,Sierra Leone,13,8,5
2010,372,Ireland,Sierra Leone,192,113,79
2010,428,Latvia,Sierra Leone,1,1,0
2010,578,Norway,Sierra Leone,468,247,221
2010,752,Sweden,Sierra Leone,687,365,322
2010,826,United Kingdom,Sierra Leone,19733,9182,10551
2010,300,Greece,Sierra Leone,186,124,62
2010,380,Italy,Sierra Leone,1389,829,560
2010,620,Portugal,Sierra Leone,48,41,7
2010,705,Slovenia,Sierra Leone,7,7,0
2010,724,Spain,Sierra Leone,1204,824,380
2010,40,Austria,Sierra Leone,229,175,54
2010,56,Belgium,Sierra Leone,1245,814,431
2010,250,France,Sierra Leone,1221,565,656
2010,276,Germany,Sierra Leone,2634,1854,780
2010,528,Netherlands,Sierra Leone,4539,3207,1332
2010,756,Switzerland,Sierra Leone,315,184,131
2010,124,Canada,Sierra Leone,2395,1246,1149
2010,840,United States of America,Sierra Leone,34590,15339,19251
2015,516,Namibia,Sierra Leone,159,74,85
2015,710,South Africa,Sierra Leone,771,494,277
2015,132,Cabo Verde,Sierra Leone,15,7,8
2015,384,Côte d'Ivoire,Sierra Leone,821,454,367
2015,270,Gambia,Sierra Leone,2330,1238,1092
2015,288,Ghana,Sierra Leone,2386,1188,1198
2015,324,Guinea,Sierra Leone,8683,5068,3615
2015,624,Guinea-Bissau,Sierra Leone,812,411,401
2015,430,Liberia,Sierra Leone,14536,7848,6688
2015,466,Mali,Sierra Leone,2141,991,1150
2015,566,Nigeria,Sierra Leone,4073,2235,1838
2015,686,Senegal,Sierra Leone,14963,7130,7833
2015,768,Togo,Sierra Leone,105,49,56
2015,818,Egypt,Sierra Leone,43,23,20
2015,434,Libya,Sierra Leone,237,162,75
2015,196,Cyprus,Sierra Leone,3,3,0
2015,68,Bolivia (Plurinational State of),Sierra Leone,2,2,0
2015,76,Brazil,Sierra Leone,7,7,0
2015,152,Chile,Sierra Leone,3,3,0
2015,36,Australia,Sierra Leone,3990,2010,1980
2015,100,Bulgaria,Sierra Leone,1,1,0
2015,203,Czechia,Sierra Leone,16,14,2
2015,348,Hungary,Sierra Leone,33,32,1
2015,208,Denmark,Sierra Leone,367,182,185
2015,246,Finland,Sierra Leone,160,117,43
2015,352,Iceland,Sierra Leone,15,10,5
2015,372,Ireland,Sierra Leone,196,114,82
2015,428,Latvia,Sierra Leone,1,1,0
2015,578,Norway,Sierra Leone,519,267,252
2015,752,Sweden,Sierra Leone,837,447,390
2015,826,United Kingdom,Sierra Leone,25235,11342,13893
2015,300,Greece,Sierra Leone,174,114,60
2015,380,Italy,Sierra Leone,1372,823,549
2015,620,Portugal,Sierra Leone,53,44,9
2015,705,Slovenia,Sierra Leone,5,5,0
2015,724,Spain,Sierra Leone,1025,696,329
2015,40,Austria,Sierra Leone,267,203,64
2015,56,Belgium,Sierra Leone,1964,1288,676
2015,250,France,Sierra Leone,1352,606,746
2015,276,Germany,Sierra Leone,2744,1930,814
2015,528,Netherlands,Sierra Leone,4263,2844,1419
2015,756,Switzerland,Sierra Leone,355,226,129
2015,124,Canada,Sierra Leone,3021,1520,1501
2015,840,United States of America,Sierra Leone,41701,18375,23326
2019,516,Namibia,Sierra Leone,168,79,89
2019,710,South Africa,Sierra Leone,863,554,309
2019,132,Cabo Verde,Sierra Leone,15,7,8
2019,384,Côte d'Ivoire,Sierra Leone,847,468,379
2019,270,Gambia,Sierra Leone,2606,1385,1221
2019,288,Ghana,Sierra Leone,2685,1340,1345
2019,324,Guinea,Sierra Leone,8288,4838,3450
2019,624,Guinea-Bissau,Sierra Leone,879,445,434
2019,430,Liberia,Sierra Leone,18099,9772,8327
2019,466,Mali,Sierra Leone,2383,1103,1280
2019,566,Nigeria,Sierra Leone,4267,2342,1925
2019,686,Senegal,Sierra Leone,15463,7364,8099
2019,768,Togo,Sierra Leone,105,49,56
2019,818,Egypt,Sierra Leone,61,30,31
2019,434,Libya,Sierra Leone,251,172,79
2019,196,Cyprus,Sierra Leone,2,2,0
2019,68,Bolivia (Plurinational State of),Sierra Leone,2,2,0
2019,76,Brazil,Sierra Leone,7,7,0
2019,152,Chile,Sierra Leone,4,4,0
2019,36,Australia,Sierra Leone,4369,2178,2191
2019,100,Bulgaria,Sierra Leone,2,2,0
2019,203,Czechia,Sierra Leone,19,17,2
2019,348,Hungary,Sierra Leone,38,31,7
2019,208,Denmark,Sierra Leone,359,178,181
2019,246,Finland,Sierra Leone,182,133,49
2019,352,Iceland,Sierra Leone,15,10,5
2019,372,Ireland,Sierra Leone,215,126,89
2019,578,Norway,Sierra Leone,554,283,271
2019,752,Sweden,Sierra Leone,973,525,448
2019,826,United Kingdom,Sierra Leone,28656,12919,15737
2019,300,Greece,Sierra Leone,169,113,56
2019,380,Italy,Sierra Leone,1673,1083,590
2019,620,Portugal,Sierra Leone,53,44,9
2019,705,Slovenia,Sierra Leone,5,5,0
2019,724,Spain,Sierra Leone,1062,713,349
2019,40,Austria,Sierra Leone,315,241,74
2019,56,Belgium,Sierra Leone,2247,1469,778
2019,250,France,Sierra Leone,1431,640,791
2019,276,Germany,Sierra Leone,3010,2224,786
2019,528,Netherlands,Sierra Leone,4011,2642,1369
2019,756,Switzerland,Sierra Leone,356,218,138
2019,124,Canada,Sierra Leone,3237,1629,1608
2019,840,United States of America,Sierra Leone,45031,19571,25460
1990,710,South Africa,Singapore,427,177,250
1990,818,Egypt,Singapore,69,39,30
1990,434,Libya,Singapore,198,114,84
1990,196,Cyprus,Singapore,8,2,6
1990,792,Turkey,Singapore,48,19,29
1990,50,Bangladesh,Singapore,10556,5701,4855
1990,64,Bhutan,Singapore,8,4,4
1990,356,India,Singapore,9307,3962,5345
1990,462,Maldives,Singapore,42,23,19
1990,144,Sri Lanka,Singapore,8,5,3
1990,344,"China, Hong Kong SAR",Singapore,6619,3262,3357
1990,392,Japan,Singapore,1194,608,586
1990,96,Brunei Darussalam,Singapore,1499,829,670
1990,116,Cambodia,Singapore,57,37,20
1990,360,Indonesia,Singapore,4346,2858,1488
1990,458,Malaysia,Singapore,31269,14591,16678
1990,608,Philippines,Singapore,133,79,54
1990,764,Thailand,Singapore,809,603,206
1990,626,Timor-Leste,Singapore,57,31,26
1990,704,Viet Nam,Singapore,294,115,179
1990,188,Costa Rica,Singapore,17,10,7
1990,484,Mexico,Singapore,12,0,12
1990,591,Panama,Singapore,10,7,3
1990,32,Argentina,Singapore,4,0,4
1990,68,Bolivia (Plurinational State of),Singapore,6,4,2
1990,152,Chile,Singapore,24,14,10
1990,862,Venezuela (Bolivarian Republic of),Singapore,16,8,8
1990,36,Australia,Singapore,27151,12916,14235
1990,554,New Zealand,Singapore,3085,1312,1773
1990,598,Papua New Guinea,Singapore,71,50,21
1990,100,Bulgaria,Singapore,2,1,1
1990,203,Czechia,Singapore,3,1,2
1990,348,Hungary,Singapore,73,34,39
1990,643,Russian Federation,Singapore,60,29,31
1990,208,Denmark,Singapore,236,92,144
1990,246,Finland,Singapore,31,15,16
1990,352,Iceland,Singapore,6,2,4
1990,372,Ireland,Singapore,42,20,22
1990,428,Latvia,Singapore,2,1,1
1990,578,Norway,Singapore,268,111,157
1990,752,Sweden,Singapore,399,185,214
1990,826,United Kingdom,Singapore,33320,15854,17466
1990,300,Greece,Singapore,65,36,29
1990,380,Italy,Singapore,40,14,26
1990,470,Malta,Singapore,8,5,3
1990,620,Portugal,Singapore,7,3,4
1990,724,Spain,Singapore,35,12,23
1990,40,Austria,Singapore,158,61,97
1990,56,Belgium,Singapore,412,211,201
1990,250,France,Singapore,1348,592,756
1990,276,Germany,Singapore,725,339,386
1990,528,Netherlands,Singapore,2193,1083,1110
1990,756,Switzerland,Singapore,772,327,445
1990,124,Canada,Singapore,6030,2936,3094
1990,840,United States of America,Singapore,12889,5219,7670
1995,710,South Africa,Singapore,352,164,188
1995,818,Egypt,Singapore,84,47,37
1995,434,Libya,Singapore,342,217,125
1995,196,Cyprus,Singapore,12,3,9
1995,792,Turkey,Singapore,116,42,74
1995,50,Bangladesh,Singapore,9063,4895,4168
1995,64,Bhutan,Singapore,10,5,5
1995,356,India,Singapore,7240,3016,4224
1995,462,Maldives,Singapore,49,25,24
1995,144,Sri Lanka,Singapore,78,59,19
1995,344,"China, Hong Kong SAR",Singapore,7388,3616,3772
1995,392,Japan,Singapore,1575,756,819
1995,96,Brunei Darussalam,Singapore,1472,820,652
1995,116,Cambodia,Singapore,150,97,53
1995,360,Indonesia,Singapore,2875,1916,959
1995,458,Malaysia,Singapore,33418,16050,17368
1995,608,Philippines,Singapore,178,104,74
1995,764,Thailand,Singapore,730,546,184
1995,626,Timor-Leste,Singapore,62,33,29
1995,704,Viet Nam,Singapore,522,234,288
1995,188,Costa Rica,Singapore,9,6,3
1995,484,Mexico,Singapore,36,13,23
1995,591,Panama,Singapore,14,11,3
1995,32,Argentina,Singapore,4,0,4
1995,68,Bolivia (Plurinational State of),Singapore,6,3,3
1995,152,Chile,Singapore,41,29,12
1995,862,Venezuela (Bolivarian Republic of),Singapore,15,7,8
1995,36,Australia,Singapore,29812,14202,15610
1995,554,New Zealand,Singapore,3382,1433,1949
1995,598,Papua New Guinea,Singapore,72,48,24
1995,100,Bulgaria,Singapore,3,1,2
1995,203,Czechia,Singapore,5,2,3
1995,348,Hungary,Singapore,65,30,35
1995,643,Russian Federation,Singapore,61,31,30
1995,208,Denmark,Singapore,308,125,183
1995,246,Finland,Singapore,41,17,24
1995,352,Iceland,Singapore,9,3,6
1995,372,Ireland,Singapore,115,52,63
1995,428,Latvia,Singapore,2,1,1
1995,578,Norway,Singapore,314,135,179
1995,752,Sweden,Singapore,474,218,256
1995,826,United Kingdom,Singapore,35923,17079,18844
1995,300,Greece,Singapore,67,25,42
1995,380,Italy,Singapore,124,29,95
1995,470,Malta,Singapore,10,6,4
1995,620,Portugal,Singapore,15,6,9
1995,724,Spain,Singapore,53,18,35
1995,40,Austria,Singapore,179,71,108
1995,56,Belgium,Singapore,875,304,571
1995,250,France,Singapore,1392,598,794
1995,276,Germany,Singapore,894,348,546
1995,528,Netherlands,Singapore,2356,1142,1214
1995,756,Switzerland,Singapore,1004,453,551
1995,124,Canada,Singapore,7695,3725,3970
1995,840,United States of America,Singapore,17050,7007,10043
2000,710,South Africa,Singapore,382,192,190
2000,818,Egypt,Singapore,105,59,46
2000,434,Libya,Singapore,492,326,166
2000,196,Cyprus,Singapore,15,3,12
2000,792,Turkey,Singapore,185,65,120
2000,50,Bangladesh,Singapore,7569,4088,3481
2000,64,Bhutan,Singapore,11,5,6
2000,356,India,Singapore,5173,2071,3102
2000,462,Maldives,Singapore,54,30,24
2000,144,Sri Lanka,Singapore,150,95,55
2000,344,"China, Hong Kong SAR",Singapore,8156,3970,4186
2000,392,Japan,Singapore,1940,896,1044
2000,96,Brunei Darussalam,Singapore,1445,811,634
2000,116,Cambodia,Singapore,242,157,85
2000,360,Indonesia,Singapore,1405,975,430
2000,458,Malaysia,Singapore,44779,21837,22942
2000,608,Philippines,Singapore,231,179,52
2000,764,Thailand,Singapore,803,598,205
2000,626,Timor-Leste,Singapore,68,35,33
2000,704,Viet Nam,Singapore,1046,530,516
2000,188,Costa Rica,Singapore,6,5,1
2000,484,Mexico,Singapore,63,28,35
2000,591,Panama,Singapore,20,16,4
2000,32,Argentina,Singapore,4,0,4
2000,68,Bolivia (Plurinational State of),Singapore,6,3,3
2000,152,Chile,Singapore,59,41,18
2000,862,Venezuela (Bolivarian Republic of),Singapore,15,7,8
2000,36,Australia,Singapore,34240,16018,18222
2000,554,New Zealand,Singapore,3803,1850,1953
2000,598,Papua New Guinea,Singapore,53,35,18
2000,100,Bulgaria,Singapore,4,1,3
2000,203,Czechia,Singapore,7,3,4
2000,348,Hungary,Singapore,56,25,31
2000,643,Russian Federation,Singapore,60,31,29
2000,208,Denmark,Singapore,379,158,221
2000,246,Finland,Singapore,50,19,31
2000,352,Iceland,Singapore,11,3,8
2000,372,Ireland,Singapore,252,119,133
2000,428,Latvia,Singapore,3,1,2
2000,578,Norway,Singapore,365,145,220
2000,752,Sweden,Singapore,509,232,277
2000,826,United Kingdom,Singapore,39131,18542,20589
2000,300,Greece,Singapore,70,14,56
2000,380,Italy,Singapore,208,45,163
2000,470,Malta,Singapore,12,8,4
2000,620,Portugal,Singapore,25,9,16
2000,705,Slovenia,Singapore,1,1,0
2000,724,Spain,Singapore,640,251,389
2000,40,Austria,Singapore,199,81,118
2000,56,Belgium,Singapore,1313,393,920
2000,250,France,Singapore,1436,604,832
2000,276,Germany,Singapore,1062,356,706
2000,528,Netherlands,Singapore,2603,1237,1366
2000,756,Switzerland,Singapore,1241,583,658
2000,124,Canada,Singapore,9543,4604,4939
2000,840,United States of America,Singapore,21289,8844,12445
2005,710,South Africa,Singapore,503,242,261
2005,818,Egypt,Singapore,125,74,51
2005,434,Libya,Singapore,542,392,150
2005,196,Cyprus,Singapore,22,4,18
2005,792,Turkey,Singapore,190,64,126
2005,50,Bangladesh,Singapore,8316,4491,3825
2005,64,Bhutan,Singapore,14,7,7
2005,356,India,Singapore,4780,1907,2873
2005,462,Maldives,Singapore,55,32,23
2005,144,Sri Lanka,Singapore,296,122,174
2005,344,"China, Hong Kong SAR",Singapore,8905,4105,4800
2005,392,Japan,Singapore,2369,1079,1290
2005,96,Brunei Darussalam,Singapore,1477,833,644
2005,116,Cambodia,Singapore,189,124,65
2005,360,Indonesia,Singapore,10537,6247,4290
2005,458,Malaysia,Singapore,59989,30720,29269
2005,608,Philippines,Singapore,186,145,41
2005,764,Thailand,Singapore,713,515,198
2005,626,Timor-Leste,Singapore,73,39,34
2005,704,Viet Nam,Singapore,1220,642,578
2005,188,Costa Rica,Singapore,4,3,1
2005,484,Mexico,Singapore,51,22,29
2005,591,Panama,Singapore,28,19,9
2005,32,Argentina,Singapore,3,0,3
2005,68,Bolivia (Plurinational State of),Singapore,4,2,2
2005,152,Chile,Singapore,88,62,26
2005,862,Venezuela (Bolivarian Republic of),Singapore,15,7,8
2005,36,Australia,Singapore,43070,19890,23180
2005,554,New Zealand,Singapore,4644,2255,2389
2005,598,Papua New Guinea,Singapore,61,41,20
2005,100,Bulgaria,Singapore,6,2,4
2005,203,Czechia,Singapore,20,11,9
2005,348,Hungary,Singapore,70,32,38
2005,643,Russian Federation,Singapore,55,28,27
2005,208,Denmark,Singapore,530,226,304
2005,246,Finland,Singapore,103,38,65
2005,352,Iceland,Singapore,13,3,10
2005,372,Ireland,Singapore,252,127,125
2005,428,Latvia,Singapore,4,3,1
2005,578,Norway,Singapore,458,183,275
2005,752,Sweden,Singapore,492,204,288
2005,826,United Kingdom,Singapore,38195,17707,20488
2005,300,Greece,Singapore,77,17,60
2005,380,Italy,Singapore,388,119,269
2005,470,Malta,Singapore,15,8,7
2005,620,Portugal,Singapore,27,11,16
2005,724,Spain,Singapore,308,118,190
2005,40,Austria,Singapore,222,87,135
2005,56,Belgium,Singapore,468,167,301
2005,250,France,Singapore,2189,1012,1177
2005,276,Germany,Singapore,1743,674,1069
2005,528,Netherlands,Singapore,2902,1367,1535
2005,756,Switzerland,Singapore,1400,620,780
2005,124,Canada,Singapore,10381,4928,5453
2005,840,United States of America,Singapore,24653,10320,14333
2010,710,South Africa,Singapore,787,378,409
2010,466,Mali,Singapore,669,367,302
2010,818,Egypt,Singapore,135,78,57
2010,434,Libya,Singapore,594,431,163
2010,196,Cyprus,Singapore,36,7,29
2010,792,Turkey,Singapore,195,63,132
2010,50,Bangladesh,Singapore,9307,5026,4281
2010,64,Bhutan,Singapore,17,9,8
2010,356,India,Singapore,4386,1743,2643
2010,462,Maldives,Singapore,66,50,16
2010,144,Sri Lanka,Singapore,597,251,346
2010,344,"China, Hong Kong SAR",Singapore,9675,4250,5425
2010,392,Japan,Singapore,2512,1129,1383
2010,96,Brunei Darussalam,Singapore,1509,855,654
2010,116,Cambodia,Singapore,136,92,44
2010,360,Indonesia,Singapore,20346,11455,8891
2010,458,Malaysia,Singapore,71367,37696,33671
2010,608,Philippines,Singapore,807,623,184
2010,764,Thailand,Singapore,675,472,203
2010,626,Timor-Leste,Singapore,75,42,33
2010,704,Viet Nam,Singapore,1451,727,724
2010,188,Costa Rica,Singapore,8,7,1
2010,484,Mexico,Singapore,47,19,28
2010,591,Panama,Singapore,39,23,16
2010,32,Argentina,Singapore,2,0,2
2010,68,Bolivia (Plurinational State of),Singapore,1,1,0
2010,76,Brazil,Singapore,114,23,91
2010,152,Chile,Singapore,118,83,35
2010,862,Venezuela (Bolivarian Republic of),Singapore,17,8,9
2010,36,Australia,Singapore,53550,24160,29390
2010,554,New Zealand,Singapore,5152,2497,2655
2010,598,Papua New Guinea,Singapore,51,32,19
2010,100,Bulgaria,Singapore,7,2,5
2010,203,Czechia,Singapore,31,19,12
2010,348,Hungary,Singapore,83,38,45
2010,643,Russian Federation,Singapore,49,23,26
2010,208,Denmark,Singapore,669,291,378
2010,233,Estonia,Singapore,3,2,1
2010,246,Finland,Singapore,184,56,128
2010,352,Iceland,Singapore,14,3,11
2010,372,Ireland,Singapore,211,98,113
2010,428,Latvia,Singapore,5,4,1
2010,578,Norway,Singapore,595,245,350
2010,752,Sweden,Singapore,772,319,453
2010,826,United Kingdom,Singapore,40236,19096,21140
2010,300,Greece,Singapore,87,22,65
2010,380,Italy,Singapore,581,191,390
2010,470,Malta,Singapore,25,15,10
2010,620,Portugal,Singapore,25,11,14
2010,705,Slovenia,Singapore,8,1,7
2010,724,Spain,Singapore,421,160,261
2010,40,Austria,Singapore,245,93,152
2010,56,Belgium,Singapore,523,218,305
2010,250,France,Singapore,2144,874,1270
2010,276,Germany,Singapore,2308,944,1364
2010,528,Netherlands,Singapore,3138,1432,1706
2010,756,Switzerland,Singapore,1640,673,967
2010,124,Canada,Singapore,11000,5168,5832
2010,840,United States of America,Singapore,28863,11853,17010
2015,710,South Africa,Singapore,1419,644,775
2015,466,Mali,Singapore,828,454,374
2015,818,Egypt,Singapore,100,64,36
2015,434,Libya,Singapore,669,483,186
2015,196,Cyprus,Singapore,34,7,27
2015,792,Turkey,Singapore,197,60,137
2015,50,Bangladesh,Singapore,9583,5175,4408
2015,64,Bhutan,Singapore,18,9,9
2015,356,India,Singapore,4225,1677,2548
2015,462,Maldives,Singapore,77,68,9
2015,144,Sri Lanka,Singapore,608,250,358
2015,344,"China, Hong Kong SAR",Singapore,9879,4123,5756
2015,392,Japan,Singapore,2444,1090,1354
2015,96,Brunei Darussalam,Singapore,1541,877,664
2015,116,Cambodia,Singapore,123,84,39
2015,360,Indonesia,Singapore,22525,12896,9629
2015,458,Malaysia,Singapore,87031,46657,40374
2015,608,Philippines,Singapore,820,634,186
2015,764,Thailand,Singapore,729,509,220
2015,626,Timor-Leste,Singapore,81,49,32
2015,704,Viet Nam,Singapore,1751,869,882
2015,188,Costa Rica,Singapore,8,7,1
2015,484,Mexico,Singapore,49,20,29
2015,591,Panama,Singapore,46,26,20
2015,32,Argentina,Singapore,2,0,2
2015,68,Bolivia (Plurinational State of),Singapore,1,1,0
2015,76,Brazil,Singapore,137,27,110
2015,152,Chile,Singapore,178,125,53
2015,862,Venezuela (Bolivarian Republic of),Singapore,18,8,10
2015,36,Australia,Singapore,59480,28209,31271
2015,554,New Zealand,Singapore,5579,2698,2881
2015,598,Papua New Guinea,Singapore,51,33,18
2015,100,Bulgaria,Singapore,16,9,7
2015,203,Czechia,Singapore,53,31,22
2015,348,Hungary,Singapore,82,44,38
2015,643,Russian Federation,Singapore,50,24,26
2015,208,Denmark,Singapore,808,366,442
2015,233,Estonia,Singapore,9,3,6
2015,246,Finland,Singapore,249,94,155
2015,352,Iceland,Singapore,17,4,13
2015,372,Ireland,Singapore,216,99,117
2015,428,Latvia,Singapore,4,3,1
2015,578,Norway,Singapore,772,330,442
2015,752,Sweden,Singapore,738,280,458
2015,826,United Kingdom,Singapore,51455,23619,27836
2015,300,Greece,Singapore,81,18,63
2015,380,Italy,Singapore,553,182,371
2015,470,Malta,Singapore,42,27,15
2015,620,Portugal,Singapore,28,11,17
2015,705,Slovenia,Singapore,11,0,11
2015,724,Spain,Singapore,503,186,317
2015,40,Austria,Singapore,286,110,176
2015,56,Belgium,Singapore,588,244,344
2015,250,France,Singapore,2374,929,1445
2015,276,Germany,Singapore,2405,980,1425
2015,528,Netherlands,Singapore,3547,1628,1919
2015,756,Switzerland,Singapore,2007,855,1152
2015,124,Canada,Singapore,11742,5354,6388
2015,840,United States of America,Singapore,36132,14729,21403
2019,710,South Africa,Singapore,1590,724,866
2019,466,Mali,Singapore,921,505,416
2019,818,Egypt,Singapore,142,85,57
2019,434,Libya,Singapore,709,512,197
2019,196,Cyprus,Singapore,33,7,26
2019,792,Turkey,Singapore,266,83,183
2019,50,Bangladesh,Singapore,9709,2961,6748
2019,64,Bhutan,Singapore,18,9,9
2019,356,India,Singapore,4155,1650,2505
2019,462,Maldives,Singapore,82,73,9
2019,144,Sri Lanka,Singapore,612,252,360
2019,344,"China, Hong Kong SAR",Singapore,12799,5118,7681
2019,392,Japan,Singapore,2735,1220,1515
2019,96,Brunei Darussalam,Singapore,1659,944,715
2019,116,Cambodia,Singapore,130,89,41
2019,360,Indonesia,Singapore,23524,13468,10056
2019,458,Malaysia,Singapore,91002,49096,41906
2019,608,Philippines,Singapore,845,654,191
2019,764,Thailand,Singapore,760,531,229
2019,626,Timor-Leste,Singapore,80,49,31
2019,704,Viet Nam,Singapore,1830,908,922
2019,188,Costa Rica,Singapore,8,7,1
2019,484,Mexico,Singapore,50,21,29
2019,591,Panama,Singapore,48,29,19
2019,32,Argentina,Singapore,2,0,2
2019,68,Bolivia (Plurinational State of),Singapore,1,1,0
2019,76,Brazil,Singapore,154,31,123
2019,152,Chile,Singapore,237,163,74
2019,862,Venezuela (Bolivarian Republic of),Singapore,17,8,9
2019,36,Australia,Singapore,64739,29984,34755
2019,554,New Zealand,Singapore,5734,2773,2961
2019,598,Papua New Guinea,Singapore,51,33,18
2019,100,Bulgaria,Singapore,33,18,15
2019,203,Czechia,Singapore,84,45,39
2019,348,Hungary,Singapore,90,45,45
2019,643,Russian Federation,Singapore,49,24,25
2019,208,Denmark,Singapore,945,436,509
2019,233,Estonia,Singapore,13,5,8
2019,246,Finland,Singapore,303,115,188
2019,352,Iceland,Singapore,16,4,12
2019,372,Ireland,Singapore,237,109,128
2019,428,Latvia,Singapore,3,2,1
2019,578,Norway,Singapore,857,351,506
2019,752,Sweden,Singapore,985,409,576
2019,826,United Kingdom,Singapore,58432,26902,31530
2019,300,Greece,Singapore,79,20,59
2019,380,Italy,Singapore,621,209,412
2019,470,Malta,Singapore,67,43,24
2019,620,Portugal,Singapore,28,11,17
2019,705,Slovenia,Singapore,9,0,9
2019,724,Spain,Singapore,521,185,336
2019,40,Austria,Singapore,337,133,204
2019,56,Belgium,Singapore,660,285,375
2019,250,France,Singapore,2512,979,1533
2019,276,Germany,Singapore,2638,1030,1608
2019,528,Netherlands,Singapore,4126,1889,2237
2019,756,Switzerland,Singapore,2349,1010,1339
2019,124,Canada,Singapore,12582,5737,6845
2019,840,United States of America,Singapore,39018,15658,23360
1990,28,Antigua and Barbuda,Sint Maarten (Dutch part),8,4,4
1990,533,Aruba,Sint Maarten (Dutch part),125,66,59
1990,535,"Bonaire, Sint Eustatius and Saba",Sint Maarten (Dutch part),296,204,92
1990,662,Saint Lucia,Sint Maarten (Dutch part),33,21,12
1990,670,Saint Vincent and the Grenadines,Sint Maarten (Dutch part),87,32,55
1990,850,United States Virgin Islands,Sint Maarten (Dutch part),83,42,41
1990,68,Bolivia (Plurinational State of),Sint Maarten (Dutch part),32,17,15
1990,170,Colombia,Sint Maarten (Dutch part),22,10,12
1990,862,Venezuela (Bolivarian Republic of),Sint Maarten (Dutch part),226,107,119
1990,528,Netherlands,Sint Maarten (Dutch part),13798,6998,6800
1990,124,Canada,Sint Maarten (Dutch part),113,55,58
1995,28,Antigua and Barbuda,Sint Maarten (Dutch part),14,7,7
1995,533,Aruba,Sint Maarten (Dutch part),313,165,148
1995,535,"Bonaire, Sint Eustatius and Saba",Sint Maarten (Dutch part),289,199,90
1995,662,Saint Lucia,Sint Maarten (Dutch part),33,17,16
1995,670,Saint Vincent and the Grenadines,Sint Maarten (Dutch part),90,33,57
1995,850,United States Virgin Islands,Sint Maarten (Dutch part),93,47,46
1995,68,Bolivia (Plurinational State of),Sint Maarten (Dutch part),39,19,20
1995,170,Colombia,Sint Maarten (Dutch part),21,9,12
1995,862,Venezuela (Bolivarian Republic of),Sint Maarten (Dutch part),224,106,118
1995,528,Netherlands,Sint Maarten (Dutch part),15991,7959,8032
1995,124,Canada,Sint Maarten (Dutch part),108,52,56
2000,28,Antigua and Barbuda,Sint Maarten (Dutch part),19,10,9
2000,533,Aruba,Sint Maarten (Dutch part),500,264,236
2000,535,"Bonaire, Sint Eustatius and Saba",Sint Maarten (Dutch part),282,194,88
2000,662,Saint Lucia,Sint Maarten (Dutch part),62,32,30
2000,670,Saint Vincent and the Grenadines,Sint Maarten (Dutch part),98,39,59
2000,850,United States Virgin Islands,Sint Maarten (Dutch part),104,52,52
2000,68,Bolivia (Plurinational State of),Sint Maarten (Dutch part),79,40,39
2000,170,Colombia,Sint Maarten (Dutch part),20,9,11
2000,862,Venezuela (Bolivarian Republic of),Sint Maarten (Dutch part),218,103,115
2000,528,Netherlands,Sint Maarten (Dutch part),18735,9172,9563
2000,124,Canada,Sint Maarten (Dutch part),106,51,55
2005,28,Antigua and Barbuda,Sint Maarten (Dutch part),21,11,10
2005,533,Aruba,Sint Maarten (Dutch part),589,311,278
2005,535,"Bonaire, Sint Eustatius and Saba",Sint Maarten (Dutch part),300,207,93
2005,662,Saint Lucia,Sint Maarten (Dutch part),61,31,30
2005,670,Saint Vincent and the Grenadines,Sint Maarten (Dutch part),100,41,59
2005,850,United States Virgin Islands,Sint Maarten (Dutch part),101,51,50
2005,68,Bolivia (Plurinational State of),Sint Maarten (Dutch part),39,20,19
2005,170,Colombia,Sint Maarten (Dutch part),19,8,11
2005,862,Venezuela (Bolivarian Republic of),Sint Maarten (Dutch part),230,109,121
2005,528,Netherlands,Sint Maarten (Dutch part),22039,10771,11268
2005,124,Canada,Sint Maarten (Dutch part),105,49,56
2010,28,Antigua and Barbuda,Sint Maarten (Dutch part),22,12,10
2010,533,Aruba,Sint Maarten (Dutch part),666,352,314
2010,535,"Bonaire, Sint Eustatius and Saba",Sint Maarten (Dutch part),452,296,156
2010,531,Curaçao,Sint Maarten (Dutch part),460,198,262
2010,662,Saint Lucia,Sint Maarten (Dutch part),57,29,28
2010,670,Saint Vincent and the Grenadines,Sint Maarten (Dutch part),105,45,60
2010,850,United States Virgin Islands,Sint Maarten (Dutch part),99,51,48
2010,68,Bolivia (Plurinational State of),Sint Maarten (Dutch part),43,21,22
2010,170,Colombia,Sint Maarten (Dutch part),21,9,12
2010,862,Venezuela (Bolivarian Republic of),Sint Maarten (Dutch part),244,116,128
2010,528,Netherlands,Sint Maarten (Dutch part),21578,10621,10957
2010,124,Canada,Sint Maarten (Dutch part),1605,738,867
2015,28,Antigua and Barbuda,Sint Maarten (Dutch part),23,12,11
2015,533,Aruba,Sint Maarten (Dutch part),701,371,330
2015,535,"Bonaire, Sint Eustatius and Saba",Sint Maarten (Dutch part),514,337,177
2015,531,Curaçao,Sint Maarten (Dutch part),499,215,284
2015,662,Saint Lucia,Sint Maarten (Dutch part),54,28,26
2015,670,Saint Vincent and the Grenadines,Sint Maarten (Dutch part),112,52,60
2015,850,United States Virgin Islands,Sint Maarten (Dutch part),99,51,48
2015,68,Bolivia (Plurinational State of),Sint Maarten (Dutch part),48,25,23
2015,170,Colombia,Sint Maarten (Dutch part),23,10,13
2015,862,Venezuela (Bolivarian Republic of),Sint Maarten (Dutch part),256,120,136
2015,528,Netherlands,Sint Maarten (Dutch part),21893,10824,11069
2015,124,Canada,Sint Maarten (Dutch part),104,40,64
2019,28,Antigua and Barbuda,Sint Maarten (Dutch part),23,12,11
2019,533,Aruba,Sint Maarten (Dutch part),709,376,333
2019,535,"Bonaire, Sint Eustatius and Saba",Sint Maarten (Dutch part),612,402,210
2019,531,Curaçao,Sint Maarten (Dutch part),542,234,308
2019,662,Saint Lucia,Sint Maarten (Dutch part),52,27,25
2019,670,Saint Vincent and the Grenadines,Sint Maarten (Dutch part),112,52,60
2019,850,United States Virgin Islands,Sint Maarten (Dutch part),98,50,48
2019,68,Bolivia (Plurinational State of),Sint Maarten (Dutch part),52,27,25
2019,170,Colombia,Sint Maarten (Dutch part),23,10,13
2019,862,Venezuela (Bolivarian Republic of),Sint Maarten (Dutch part),250,116,134
2019,528,Netherlands,Sint Maarten (Dutch part),25034,12526,12508
2019,124,Canada,Sint Maarten (Dutch part),111,43,68
1990,710,South Africa,Slovakia,201,146,55
1990,818,Egypt,Slovakia,71,31,40
1990,196,Cyprus,Slovakia,34,14,20
1990,400,Jordan,Slovakia,12,4,8
1990,792,Turkey,Slovakia,76,38,38
1990,496,Mongolia,Slovakia,4,1,3
1990,188,Costa Rica,Slovakia,20,13,7
1990,484,Mexico,Slovakia,69,23,46
1990,591,Panama,Slovakia,5,4,1
1990,152,Chile,Slovakia,29,15,14
1990,218,Ecuador,Slovakia,17,8,9
1990,862,Venezuela (Bolivarian Republic of),Slovakia,21,7,14
1990,36,Australia,Slovakia,2697,1557,1140
1990,112,Belarus,Slovakia,25,11,14
1990,100,Bulgaria,Slovakia,63,12,51
1990,203,Czechia,Slovakia,70252,36842,33410
1990,348,Hungary,Slovakia,316,140,176
1990,616,Poland,Slovakia,2149,923,1226
1990,642,Romania,Slovakia,58,24,34
1990,643,Russian Federation,Slovakia,1020,501,519
1990,208,Denmark,Slovakia,105,40,65
1990,352,Iceland,Slovakia,1,0,1
1990,372,Ireland,Slovakia,412,203,209
1990,428,Latvia,Slovakia,21,8,13
1990,440,Lithuania,Slovakia,16,9,7
1990,578,Norway,Slovakia,6,3,3
1990,752,Sweden,Slovakia,190,67,123
1990,826,United Kingdom,Slovakia,1431,722,709
1990,70,Bosnia and Herzegovina,Slovakia,4681,2292,2389
1990,300,Greece,Slovakia,699,388,311
1990,380,Italy,Slovakia,223,77,146
1990,470,Malta,Slovakia,13,6,7
1990,807,North Macedonia,Slovakia,38,16,22
1990,620,Portugal,Slovakia,8,4,4
1990,688,Serbia,Slovakia,58,18,40
1990,705,Slovenia,Slovakia,35,18,17
1990,724,Spain,Slovakia,110,54,56
1990,40,Austria,Slovakia,14965,5341,9624
1990,56,Belgium,Slovakia,106,42,64
1990,250,France,Slovakia,2771,1182,1589
1990,276,Germany,Slovakia,16278,8721,7557
1990,438,Liechtenstein,Slovakia,18,7,11
1990,442,Luxembourg,Slovakia,69,30,39
1990,528,Netherlands,Slovakia,14,9,5
1990,756,Switzerland,Slovakia,3313,1351,1962
1990,124,Canada,Slovakia,10286,5008,5278
1995,710,South Africa,Slovakia,164,121,43
1995,818,Egypt,Slovakia,56,23,33
1995,196,Cyprus,Slovakia,48,18,30
1995,400,Jordan,Slovakia,20,6,14
1995,792,Turkey,Slovakia,184,88,96
1995,496,Mongolia,Slovakia,4,2,2
1995,188,Costa Rica,Slovakia,15,10,5
1995,484,Mexico,Slovakia,50,21,29
1995,591,Panama,Slovakia,5,4,1
1995,68,Bolivia (Plurinational State of),Slovakia,6,4,2
1995,152,Chile,Slovakia,40,20,20
1995,218,Ecuador,Slovakia,19,9,10
1995,862,Venezuela (Bolivarian Republic of),Slovakia,20,7,13
1995,36,Australia,Slovakia,4671,2564,2107
1995,112,Belarus,Slovakia,26,10,16
1995,100,Bulgaria,Slovakia,107,24,83
1995,203,Czechia,Slovakia,105379,56662,48717
1995,348,Hungary,Slovakia,7703,2732,4971
1995,616,Poland,Slovakia,1838,774,1064
1995,642,Romania,Slovakia,166,70,96
1995,643,Russian Federation,Slovakia,1046,524,522
1995,208,Denmark,Slovakia,113,43,70
1995,246,Finland,Slovakia,7,4,3
1995,352,Iceland,Slovakia,2,0,2
1995,372,Ireland,Slovakia,2234,1065,1169
1995,428,Latvia,Slovakia,19,8,11
1995,440,Lithuania,Slovakia,18,10,8
1995,578,Norway,Slovakia,18,6,12
1995,752,Sweden,Slovakia,226,79,147
1995,826,United Kingdom,Slovakia,3236,826,2410
1995,70,Bosnia and Herzegovina,Slovakia,5736,2828,2908
1995,191,Croatia,Slovakia,279,58,221
1995,300,Greece,Slovakia,548,252,296
1995,380,Italy,Slovakia,1748,312,1436
1995,470,Malta,Slovakia,16,7,9
1995,807,North Macedonia,Slovakia,35,15,20
1995,620,Portugal,Slovakia,18,8,10
1995,688,Serbia,Slovakia,371,109,262
1995,705,Slovenia,Slovakia,76,26,50
1995,724,Spain,Slovakia,212,101,111
1995,40,Austria,Slovakia,16884,6204,10680
1995,56,Belgium,Slovakia,106,42,64
1995,250,France,Slovakia,2861,1193,1668
1995,276,Germany,Slovakia,20363,11446,8917
1995,438,Liechtenstein,Slovakia,21,8,13
1995,442,Luxembourg,Slovakia,65,29,36
1995,528,Netherlands,Slovakia,19,11,8
1995,756,Switzerland,Slovakia,4523,1828,2695
1995,124,Canada,Slovakia,10329,5005,5324
2000,710,South Africa,Slovakia,177,131,46
2000,818,Egypt,Slovakia,46,18,28
2000,196,Cyprus,Slovakia,62,23,39
2000,400,Jordan,Slovakia,28,9,19
2000,792,Turkey,Slovakia,293,138,155
2000,496,Mongolia,Slovakia,5,2,3
2000,188,Costa Rica,Slovakia,17,11,6
2000,484,Mexico,Slovakia,34,19,15
2000,591,Panama,Slovakia,6,4,2
2000,68,Bolivia (Plurinational State of),Slovakia,11,7,4
2000,152,Chile,Slovakia,51,25,26
2000,218,Ecuador,Slovakia,21,10,11
2000,862,Venezuela (Bolivarian Republic of),Slovakia,20,7,13
2000,36,Australia,Slovakia,6360,3413,2947
2000,112,Belarus,Slovakia,27,9,18
2000,100,Bulgaria,Slovakia,151,36,115
2000,203,Czechia,Slovakia,140506,76483,64023
2000,348,Hungary,Slovakia,15089,5324,9765
2000,616,Poland,Slovakia,1572,648,924
2000,642,Romania,Slovakia,277,117,160
2000,643,Russian Federation,Slovakia,1036,530,506
2000,208,Denmark,Slovakia,121,46,75
2000,246,Finland,Slovakia,14,8,6
2000,352,Iceland,Slovakia,3,1,2
2000,372,Ireland,Slovakia,5284,2605,2679
2000,428,Latvia,Slovakia,17,7,10
2000,440,Lithuania,Slovakia,14,8,6
2000,578,Norway,Slovakia,141,55,86
2000,752,Sweden,Slovakia,243,84,159
2000,826,United Kingdom,Slovakia,5097,939,4158
2000,70,Bosnia and Herzegovina,Slovakia,6791,3365,3426
2000,191,Croatia,Slovakia,529,113,416
2000,300,Greece,Slovakia,407,116,291
2000,380,Italy,Slovakia,3273,548,2725
2000,470,Malta,Slovakia,40,17,23
2000,807,North Macedonia,Slovakia,33,14,19
2000,620,Portugal,Slovakia,29,12,17
2000,688,Serbia,Slovakia,505,141,364
2000,705,Slovenia,Slovakia,65,53,12
2000,724,Spain,Slovakia,406,194,212
2000,40,Austria,Slovakia,18802,7066,11736
2000,56,Belgium,Slovakia,103,42,61
2000,250,France,Slovakia,2950,1203,1747
2000,276,Germany,Slovakia,24447,14171,10276
2000,438,Liechtenstein,Slovakia,24,8,16
2000,442,Luxembourg,Slovakia,63,28,35
2000,528,Netherlands,Slovakia,27,14,13
2000,756,Switzerland,Slovakia,5750,2319,3431
2000,124,Canada,Slovakia,10617,5122,5495
2005,710,South Africa,Slovakia,233,170,63
2005,818,Egypt,Slovakia,55,24,31
2005,196,Cyprus,Slovakia,91,33,58
2005,400,Jordan,Slovakia,40,16,24
2005,792,Turkey,Slovakia,301,138,163
2005,496,Mongolia,Slovakia,3,2,1
2005,188,Costa Rica,Slovakia,11,7,4
2005,484,Mexico,Slovakia,64,24,40
2005,591,Panama,Slovakia,17,8,9
2005,68,Bolivia (Plurinational State of),Slovakia,14,10,4
2005,152,Chile,Slovakia,76,38,38
2005,218,Ecuador,Slovakia,24,11,13
2005,862,Venezuela (Bolivarian Republic of),Slovakia,20,7,13
2005,36,Australia,Slovakia,6060,3065,2995
2005,112,Belarus,Slovakia,26,9,17
2005,100,Bulgaria,Slovakia,219,58,161
2005,203,Czechia,Slovakia,109909,59441,50468
2005,348,Hungary,Slovakia,18638,6790,11848
2005,616,Poland,Slovakia,1435,609,826
2005,642,Romania,Slovakia,202,87,115
2005,643,Russian Federation,Slovakia,1431,745,686
2005,208,Denmark,Slovakia,504,259,245
2005,246,Finland,Slovakia,68,43,25
2005,352,Iceland,Slovakia,120,83,37
2005,372,Ireland,Slovakia,9193,5357,3836
2005,428,Latvia,Slovakia,36,19,17
2005,440,Lithuania,Slovakia,25,13,12
2005,578,Norway,Slovakia,490,249,241
2005,752,Sweden,Slovakia,536,197,339
2005,826,United Kingdom,Slovakia,31435,13712,17723
2005,70,Bosnia and Herzegovina,Slovakia,3961,1951,2010
2005,191,Croatia,Slovakia,585,130,455
2005,300,Greece,Slovakia,645,140,505
2005,380,Italy,Slovakia,7134,1691,5443
2005,470,Malta,Slovakia,64,26,38
2005,807,North Macedonia,Slovakia,33,14,19
2005,620,Portugal,Slovakia,60,17,43
2005,688,Serbia,Slovakia,499,135,364
2005,705,Slovenia,Slovakia,59,22,37
2005,724,Spain,Slovakia,3279,1496,1783
2005,40,Austria,Slovakia,21016,7585,13431
2005,56,Belgium,Slovakia,314,141,173
2005,250,France,Slovakia,3290,1208,2082
2005,276,Germany,Slovakia,30070,14128,15942
2005,438,Liechtenstein,Slovakia,26,7,19
2005,442,Luxembourg,Slovakia,262,116,146
2005,528,Netherlands,Slovakia,106,60,46
2005,756,Switzerland,Slovakia,8102,3104,4998
2005,124,Canada,Slovakia,11513,5545,5968
2010,710,South Africa,Slovakia,364,266,98
2010,818,Egypt,Slovakia,59,24,35
2010,196,Cyprus,Slovakia,149,56,93
2010,400,Jordan,Slovakia,52,23,29
2010,792,Turkey,Slovakia,310,139,171
2010,496,Mongolia,Slovakia,3,3,0
2010,188,Costa Rica,Slovakia,22,14,8
2010,484,Mexico,Slovakia,103,33,70
2010,591,Panama,Slovakia,30,12,18
2010,68,Bolivia (Plurinational State of),Slovakia,17,13,4
2010,76,Brazil,Slovakia,210,101,109
2010,152,Chile,Slovakia,102,52,50
2010,218,Ecuador,Slovakia,34,16,18
2010,862,Venezuela (Bolivarian Republic of),Slovakia,22,7,15
2010,36,Australia,Slovakia,5990,2803,3187
2010,112,Belarus,Slovakia,25,9,16
2010,100,Bulgaria,Slovakia,278,78,200
2010,203,Czechia,Slovakia,69630,39421,30209
2010,348,Hungary,Slovakia,22187,8257,13930
2010,616,Poland,Slovakia,1344,584,760
2010,642,Romania,Slovakia,158,71,87
2010,643,Russian Federation,Slovakia,1798,946,852
2010,208,Denmark,Slovakia,870,463,407
2010,233,Estonia,Slovakia,15,4,11
2010,246,Finland,Slovakia,141,90,51
2010,352,Iceland,Slovakia,235,164,71
2010,372,Ireland,Slovakia,11589,6741,4848
2010,428,Latvia,Slovakia,56,32,24
2010,440,Lithuania,Slovakia,34,16,18
2010,578,Norway,Slovakia,2048,1373,675
2010,752,Sweden,Slovakia,1213,551,662
2010,826,United Kingdom,Slovakia,33115,14828,18287
2010,70,Bosnia and Herzegovina,Slovakia,3409,1683,1726
2010,191,Croatia,Slovakia,640,147,493
2010,300,Greece,Slovakia,917,171,746
2010,380,Italy,Slovakia,11467,3145,8322
2010,470,Malta,Slovakia,83,25,58
2010,499,Montenegro,Slovakia,54,49,5
2010,807,North Macedonia,Slovakia,34,14,20
2010,620,Portugal,Slovakia,82,20,62
2010,688,Serbia,Slovakia,488,131,357
2010,705,Slovenia,Slovakia,432,179,253
2010,724,Spain,Slovakia,7312,3438,3874
2010,40,Austria,Slovakia,23230,8104,15126
2010,56,Belgium,Slovakia,697,359,338
2010,250,France,Slovakia,4181,1650,2531
2010,276,Germany,Slovakia,34672,14145,20527
2010,438,Liechtenstein,Slovakia,30,7,23
2010,442,Luxembourg,Slovakia,464,204,260
2010,528,Netherlands,Slovakia,219,133,86
2010,756,Switzerland,Slovakia,7597,2561,5036
2010,124,Canada,Slovakia,13145,6338,6807
2015,710,South Africa,Slovakia,655,471,184
2015,818,Egypt,Slovakia,43,21,22
2015,196,Cyprus,Slovakia,143,55,88
2015,400,Jordan,Slovakia,22,7,15
2015,792,Turkey,Slovakia,314,137,177
2015,496,Mongolia,Slovakia,3,3,0
2015,188,Costa Rica,Slovakia,22,14,8
2015,484,Mexico,Slovakia,109,35,74
2015,591,Panama,Slovakia,36,14,22
2015,68,Bolivia (Plurinational State of),Slovakia,20,15,5
2015,76,Brazil,Slovakia,253,122,131
2015,152,Chile,Slovakia,154,77,77
2015,218,Ecuador,Slovakia,49,23,26
2015,862,Venezuela (Bolivarian Republic of),Slovakia,24,8,16
2015,36,Australia,Slovakia,6720,3143,3577
2015,112,Belarus,Slovakia,27,9,18
2015,100,Bulgaria,Slovakia,341,96,245
2015,203,Czechia,Slovakia,89301,48510,40791
2015,348,Hungary,Slovakia,21085,8059,13026
2015,616,Poland,Slovakia,1295,577,718
2015,642,Romania,Slovakia,21,9,12
2015,643,Russian Federation,Slovakia,1832,959,873
2015,208,Denmark,Slovakia,1402,704,698
2015,233,Estonia,Slovakia,121,54,67
2015,246,Finland,Slovakia,232,118,114
2015,352,Iceland,Slovakia,243,154,89
2015,372,Ireland,Slovakia,11838,6824,5014
2015,428,Latvia,Slovakia,22,13,9
2015,440,Lithuania,Slovakia,38,18,20
2015,578,Norway,Slovakia,3857,2478,1379
2015,752,Sweden,Slovakia,1571,713,858
2015,826,United Kingdom,Slovakia,42349,18270,24079
2015,70,Bosnia and Herzegovina,Slovakia,3389,1673,1716
2015,191,Croatia,Slovakia,644,146,498
2015,300,Greece,Slovakia,860,130,730
2015,380,Italy,Slovakia,10643,2632,8011
2015,470,Malta,Slovakia,141,50,91
2015,499,Montenegro,Slovakia,56,51,5
2015,807,North Macedonia,Slovakia,36,15,21
2015,620,Portugal,Slovakia,92,17,75
2015,688,Serbia,Slovakia,476,127,349
2015,705,Slovenia,Slovakia,600,230,370
2015,724,Spain,Slovakia,7297,3085,4212
2015,40,Austria,Slovakia,27170,9577,17593
2015,56,Belgium,Slovakia,1307,674,633
2015,250,France,Slovakia,5437,2058,3379
2015,276,Germany,Slovakia,36126,14687,21439
2015,438,Liechtenstein,Slovakia,44,9,35
2015,442,Luxembourg,Slovakia,707,317,390
2015,528,Netherlands,Slovakia,505,280,225
2015,756,Switzerland,Slovakia,18587,8171,10416
2015,124,Canada,Slovakia,14316,6745,7571
2019,710,South Africa,Slovakia,733,528,205
2019,818,Egypt,Slovakia,61,26,35
2019,196,Cyprus,Slovakia,142,55,87
2019,400,Jordan,Slovakia,23,7,16
2019,792,Turkey,Slovakia,424,188,236
2019,496,Mongolia,Slovakia,3,3,0
2019,188,Costa Rica,Slovakia,22,14,8
2019,484,Mexico,Slovakia,112,36,76
2019,591,Panama,Slovakia,37,15,22
2019,68,Bolivia (Plurinational State of),Slovakia,21,16,5
2019,76,Brazil,Slovakia,284,137,147
2019,152,Chile,Slovakia,205,97,108
2019,218,Ecuador,Slovakia,48,23,25
2019,862,Venezuela (Bolivarian Republic of),Slovakia,23,8,15
2019,36,Australia,Slovakia,7236,3348,3888
2019,112,Belarus,Slovakia,26,9,17
2019,100,Bulgaria,Slovakia,413,123,290
2019,203,Czechia,Slovakia,98877,53577,45300
2019,348,Hungary,Slovakia,21018,8002,13016
2019,616,Poland,Slovakia,1371,640,731
2019,642,Romania,Slovakia,308,149,159
2019,643,Russian Federation,Slovakia,1831,959,872
2019,208,Denmark,Slovakia,2978,1553,1425
2019,233,Estonia,Slovakia,140,74,66
2019,246,Finland,Slovakia,366,179,187
2019,352,Iceland,Slovakia,389,267,122
2019,372,Ireland,Slovakia,12996,7509,5487
2019,428,Latvia,Slovakia,22,14,8
2019,440,Lithuania,Slovakia,51,24,27
2019,578,Norway,Slovakia,4242,2669,1573
2019,752,Sweden,Slovakia,1977,899,1078
2019,826,United Kingdom,Slovakia,48091,20816,27275
2019,70,Bosnia and Herzegovina,Slovakia,3139,1547,1592
2019,191,Croatia,Slovakia,594,133,461
2019,300,Greece,Slovakia,839,154,685
2019,380,Italy,Slovakia,11201,2724,8477
2019,470,Malta,Slovakia,227,82,145
2019,499,Montenegro,Slovakia,56,52,4
2019,807,North Macedonia,Slovakia,36,15,21
2019,620,Portugal,Slovakia,93,17,76
2019,688,Serbia,Slovakia,483,129,354
2019,705,Slovenia,Slovakia,549,183,366
2019,724,Spain,Slovakia,7560,3092,4468
2019,40,Austria,Slovakia,32073,11663,20410
2019,56,Belgium,Slovakia,1558,795,763
2019,250,France,Slovakia,5755,2171,3584
2019,276,Germany,Slovakia,50687,23736,26951
2019,438,Liechtenstein,Slovakia,51,11,40
2019,442,Luxembourg,Slovakia,876,347,529
2019,528,Netherlands,Slovakia,1058,546,512
2019,756,Switzerland,Slovakia,21153,9585,11568
2019,124,Canada,Slovakia,15341,7228,8113
1990,140,Central African Republic,Slovenia,15,8,7
1990,196,Cyprus,Slovenia,4,2,2
1990,792,Turkey,Slovenia,35,18,17
1990,484,Mexico,Slovenia,39,23,16
1990,32,Argentina,Slovenia,1783,830,953
1990,152,Chile,Slovenia,23,14,9
1990,170,Colombia,Slovenia,26,14,12
1990,604,Peru,Slovenia,16,9,7
1990,862,Venezuela (Bolivarian Republic of),Slovenia,91,50,41
1990,36,Australia,Slovenia,7227,3914,3313
1990,100,Bulgaria,Slovenia,8,4,4
1990,203,Czechia,Slovenia,64,34,30
1990,348,Hungary,Slovenia,96,53,43
1990,616,Poland,Slovenia,183,78,105
1990,643,Russian Federation,Slovenia,138,68,70
1990,703,Slovakia,Slovenia,15,8,7
1990,208,Denmark,Slovenia,56,24,32
1990,352,Iceland,Slovenia,8,5,3
1990,372,Ireland,Slovenia,11,5,6
1990,428,Latvia,Slovenia,2,0,2
1990,752,Sweden,Slovenia,536,292,244
1990,826,United Kingdom,Slovenia,334,207,127
1990,70,Bosnia and Herzegovina,Slovenia,2796,1077,1719
1990,191,Croatia,Slovenia,29943,10682,19261
1990,300,Greece,Slovenia,104,57,47
1990,380,Italy,Slovenia,1268,441,827
1990,470,Malta,Slovenia,6,4,2
1990,807,North Macedonia,Slovenia,258,108,150
1990,620,Portugal,Slovenia,8,4,4
1990,688,Serbia,Slovenia,1343,625,718
1990,724,Spain,Slovenia,49,23,26
1990,40,Austria,Slovenia,12724,4904,7820
1990,56,Belgium,Slovenia,23,13,10
1990,250,France,Slovenia,3354,1540,1814
1990,276,Germany,Slovenia,12999,7361,5638
1990,438,Liechtenstein,Slovenia,53,20,33
1990,442,Luxembourg,Slovenia,54,28,26
1990,528,Netherlands,Slovenia,7,5,2
1990,756,Switzerland,Slovenia,3460,1417,2043
1990,124,Canada,Slovenia,8990,4377,4613
1990,840,United States of America,Slovenia,3347,1638,1709
1995,140,Central African Republic,Slovenia,42,23,19
1995,196,Cyprus,Slovenia,6,3,3
1995,792,Turkey,Slovenia,85,41,44
1995,484,Mexico,Slovenia,43,25,18
1995,32,Argentina,Slovenia,1741,821,920
1995,68,Bolivia (Plurinational State of),Slovenia,4,2,2
1995,152,Chile,Slovenia,31,18,13
1995,170,Colombia,Slovenia,26,14,12
1995,604,Peru,Slovenia,17,9,8
1995,862,Venezuela (Bolivarian Republic of),Slovenia,89,49,40
1995,36,Australia,Slovenia,8185,4356,3829
1995,100,Bulgaria,Slovenia,14,7,7
1995,203,Czechia,Slovenia,96,52,44
1995,348,Hungary,Slovenia,189,97,92
1995,616,Poland,Slovenia,156,65,91
1995,643,Russian Federation,Slovenia,127,71,56
1995,703,Slovakia,Slovenia,95,63,32
1995,208,Denmark,Slovenia,60,25,35
1995,246,Finland,Slovenia,2,1,1
1995,352,Iceland,Slovenia,10,6,4
1995,372,Ireland,Slovenia,38,17,21
1995,428,Latvia,Slovenia,3,1,2
1995,578,Norway,Slovenia,10,5,5
1995,752,Sweden,Slovenia,636,345,291
1995,826,United Kingdom,Slovenia,756,323,433
1995,70,Bosnia and Herzegovina,Slovenia,3080,1186,1894
1995,191,Croatia,Slovenia,26764,9299,17465
1995,300,Greece,Slovenia,105,44,61
1995,380,Italy,Slovenia,3048,1041,2007
1995,470,Malta,Slovenia,8,5,3
1995,807,North Macedonia,Slovenia,241,101,140
1995,620,Portugal,Slovenia,18,8,10
1995,688,Serbia,Slovenia,8530,3871,4659
1995,724,Spain,Slovenia,109,46,63
1995,40,Austria,Slovenia,14355,5677,8678
1995,56,Belgium,Slovenia,23,13,10
1995,250,France,Slovenia,3463,1559,1904
1995,276,Germany,Slovenia,19580,10179,9401
1995,438,Liechtenstein,Slovenia,63,22,41
1995,442,Luxembourg,Slovenia,51,27,24
1995,528,Netherlands,Slovenia,15,9,6
1995,756,Switzerland,Slovenia,3005,1292,1713
1995,124,Canada,Slovenia,9028,4374,4654
1995,840,United States of America,Slovenia,4721,2336,2385
2000,140,Central African Republic,Slovenia,66,37,29
2000,196,Cyprus,Slovenia,7,3,4
2000,792,Turkey,Slovenia,136,64,72
2000,484,Mexico,Slovenia,49,28,21
2000,32,Argentina,Slovenia,1699,812,887
2000,68,Bolivia (Plurinational State of),Slovenia,8,5,3
2000,152,Chile,Slovenia,40,23,17
2000,170,Colombia,Slovenia,25,14,11
2000,604,Peru,Slovenia,21,11,10
2000,862,Venezuela (Bolivarian Republic of),Slovenia,88,48,40
2000,36,Australia,Slovenia,8640,4540,4100
2000,100,Bulgaria,Slovenia,19,10,9
2000,203,Czechia,Slovenia,128,70,58
2000,348,Hungary,Slovenia,282,142,140
2000,616,Poland,Slovenia,134,55,79
2000,643,Russian Federation,Slovenia,113,72,41
2000,703,Slovakia,Slovenia,203,135,68
2000,208,Denmark,Slovenia,64,27,37
2000,246,Finland,Slovenia,4,3,1
2000,352,Iceland,Slovenia,11,7,4
2000,372,Ireland,Slovenia,87,41,46
2000,428,Latvia,Slovenia,4,1,3
2000,578,Norway,Slovenia,59,25,34
2000,752,Sweden,Slovenia,683,368,315
2000,826,United Kingdom,Slovenia,1192,444,748
2000,70,Bosnia and Herzegovina,Slovenia,3363,1294,2069
2000,191,Croatia,Slovenia,20724,7151,13573
2000,300,Greece,Slovenia,107,29,78
2000,380,Italy,Slovenia,4828,1642,3186
2000,470,Malta,Slovenia,19,11,8
2000,807,North Macedonia,Slovenia,225,94,131
2000,620,Portugal,Slovenia,30,13,17
2000,688,Serbia,Slovenia,11597,5129,6468
2000,724,Spain,Slovenia,217,91,126
2000,40,Austria,Slovenia,15986,6451,9535
2000,56,Belgium,Slovenia,22,12,10
2000,250,France,Slovenia,3571,1577,1994
2000,276,Germany,Slovenia,26160,12997,13163
2000,438,Liechtenstein,Slovenia,73,23,50
2000,442,Luxembourg,Slovenia,49,25,24
2000,528,Netherlands,Slovenia,26,13,13
2000,756,Switzerland,Slovenia,2561,1176,1385
2000,124,Canada,Slovenia,9280,4476,4804
2000,840,United States of America,Slovenia,6124,3053,3071
2005,140,Central African Republic,Slovenia,50,28,22
2005,196,Cyprus,Slovenia,10,4,6
2005,792,Turkey,Slovenia,140,65,75
2005,484,Mexico,Slovenia,47,24,23
2005,32,Argentina,Slovenia,1253,609,644
2005,68,Bolivia (Plurinational State of),Slovenia,8,5,3
2005,152,Chile,Slovenia,60,35,25
2005,170,Colombia,Slovenia,24,14,10
2005,604,Peru,Slovenia,25,13,12
2005,862,Venezuela (Bolivarian Republic of),Slovenia,92,51,41
2005,36,Australia,Slovenia,8760,4502,4258
2005,100,Bulgaria,Slovenia,27,14,13
2005,203,Czechia,Slovenia,182,113,69
2005,348,Hungary,Slovenia,348,178,170
2005,616,Poland,Slovenia,143,76,67
2005,643,Russian Federation,Slovenia,230,151,79
2005,703,Slovakia,Slovenia,228,152,76
2005,208,Denmark,Slovenia,152,71,81
2005,246,Finland,Slovenia,16,10,6
2005,352,Iceland,Slovenia,21,13,8
2005,372,Ireland,Slovenia,160,86,74
2005,428,Latvia,Slovenia,7,3,4
2005,578,Norway,Slovenia,110,53,57
2005,752,Sweden,Slovenia,821,421,400
2005,826,United Kingdom,Slovenia,1555,601,954
2005,70,Bosnia and Herzegovina,Slovenia,2072,800,1272
2005,191,Croatia,Slovenia,20094,7147,12947
2005,300,Greece,Slovenia,120,30,90
2005,380,Italy,Slovenia,4763,1776,2987
2005,470,Malta,Slovenia,32,18,14
2005,807,North Macedonia,Slovenia,231,97,134
2005,620,Portugal,Slovenia,43,17,26
2005,688,Serbia,Slovenia,11448,5096,6352
2005,724,Spain,Slovenia,451,218,233
2005,40,Austria,Slovenia,15649,6574,9075
2005,56,Belgium,Slovenia,48,21,27
2005,250,France,Slovenia,2853,1202,1651
2005,276,Germany,Slovenia,29475,14098,15377
2005,438,Liechtenstein,Slovenia,92,25,67
2005,442,Luxembourg,Slovenia,181,91,90
2005,528,Netherlands,Slovenia,36,21,15
2005,756,Switzerland,Slovenia,2918,1269,1649
2005,124,Canada,Slovenia,8496,4044,4452
2005,840,United States of America,Slovenia,6149,3083,3066
2010,140,Central African Republic,Slovenia,49,27,22
2010,196,Cyprus,Slovenia,16,7,9
2010,792,Turkey,Slovenia,144,65,79
2010,484,Mexico,Slovenia,51,23,28
2010,32,Argentina,Slovenia,807,406,401
2010,68,Bolivia (Plurinational State of),Slovenia,8,5,3
2010,76,Brazil,Slovenia,175,96,79
2010,152,Chile,Slovenia,80,47,33
2010,170,Colombia,Slovenia,27,16,11
2010,604,Peru,Slovenia,27,15,12
2010,862,Venezuela (Bolivarian Republic of),Slovenia,98,54,44
2010,36,Australia,Slovenia,8380,4215,4165
2010,100,Bulgaria,Slovenia,34,18,16
2010,203,Czechia,Slovenia,220,148,72
2010,348,Hungary,Slovenia,414,214,200
2010,616,Poland,Slovenia,158,99,59
2010,643,Russian Federation,Slovenia,344,227,117
2010,703,Slovakia,Slovenia,255,171,84
2010,208,Denmark,Slovenia,234,113,121
2010,233,Estonia,Slovenia,8,6,2
2010,246,Finland,Slovenia,33,19,14
2010,352,Iceland,Slovenia,29,17,12
2010,372,Ireland,Slovenia,206,106,100
2010,428,Latvia,Slovenia,11,6,5
2010,578,Norway,Slovenia,188,90,98
2010,752,Sweden,Slovenia,983,517,466
2010,826,United Kingdom,Slovenia,1638,654,984
2010,70,Bosnia and Herzegovina,Slovenia,1973,782,1191
2010,191,Croatia,Slovenia,19463,7142,12321
2010,300,Greece,Slovenia,138,32,106
2010,380,Italy,Slovenia,4614,1896,2718
2010,470,Malta,Slovenia,17,9,8
2010,499,Montenegro,Slovenia,1438,501,937
2010,807,North Macedonia,Slovenia,237,99,138
2010,620,Portugal,Slovenia,50,19,31
2010,688,Serbia,Slovenia,11183,4871,6312
2010,724,Spain,Slovenia,1011,508,503
2010,40,Austria,Slovenia,15311,6697,8614
2010,56,Belgium,Slovenia,101,51,50
2010,250,France,Slovenia,2434,1043,1391
2010,276,Germany,Slovenia,32149,14977,17172
2010,438,Liechtenstein,Slovenia,113,28,85
2010,442,Luxembourg,Slovenia,317,159,158
2010,528,Netherlands,Slovenia,73,41,32
2010,756,Switzerland,Slovenia,3384,1351,2033
2010,124,Canada,Slovenia,8305,3906,4399
2010,840,United States of America,Slovenia,6363,3147,3216
2015,140,Central African Republic,Slovenia,43,24,19
2015,324,Guinea,Slovenia,28,17,11
2015,196,Cyprus,Slovenia,15,7,8
2015,792,Turkey,Slovenia,146,64,82
2015,484,Mexico,Slovenia,54,25,29
2015,32,Argentina,Slovenia,810,407,403
2015,68,Bolivia (Plurinational State of),Slovenia,9,6,3
2015,76,Brazil,Slovenia,211,116,95
2015,152,Chile,Slovenia,121,71,50
2015,170,Colombia,Slovenia,30,18,12
2015,604,Peru,Slovenia,29,17,12
2015,862,Venezuela (Bolivarian Republic of),Slovenia,103,56,47
2015,36,Australia,Slovenia,8060,4080,3980
2015,100,Bulgaria,Slovenia,94,51,43
2015,203,Czechia,Slovenia,337,225,112
2015,348,Hungary,Slovenia,412,214,198
2015,616,Poland,Slovenia,152,97,55
2015,643,Russian Federation,Slovenia,350,231,119
2015,703,Slovakia,Slovenia,311,216,95
2015,208,Denmark,Slovenia,351,174,177
2015,233,Estonia,Slovenia,31,17,14
2015,246,Finland,Slovenia,64,33,31
2015,352,Iceland,Slovenia,32,18,14
2015,372,Ireland,Slovenia,210,107,103
2015,428,Latvia,Slovenia,6,3,3
2015,578,Norway,Slovenia,382,193,189
2015,752,Sweden,Slovenia,1252,621,631
2015,826,United Kingdom,Slovenia,2094,799,1295
2015,70,Bosnia and Herzegovina,Slovenia,1961,777,1184
2015,191,Croatia,Slovenia,19587,7152,12435
2015,300,Greece,Slovenia,129,26,103
2015,380,Italy,Slovenia,4576,1827,2749
2015,470,Malta,Slovenia,29,17,12
2015,499,Montenegro,Slovenia,1617,569,1048
2015,807,North Macedonia,Slovenia,256,107,149
2015,620,Portugal,Slovenia,55,18,37
2015,688,Serbia,Slovenia,10930,4744,6186
2015,724,Spain,Slovenia,1312,610,702
2015,40,Austria,Slovenia,17908,7888,10020
2015,56,Belgium,Slovenia,154,70,84
2015,250,France,Slovenia,2570,1137,1433
2015,276,Germany,Slovenia,33498,15564,17934
2015,438,Liechtenstein,Slovenia,109,27,82
2015,442,Luxembourg,Slovenia,483,246,237
2015,528,Netherlands,Slovenia,152,75,77
2015,756,Switzerland,Slovenia,5654,2780,2874
2015,124,Canada,Slovenia,8164,3735,4429
2015,840,United States of America,Slovenia,9666,4757,4909
2019,140,Central African Republic,Slovenia,47,26,21
2019,324,Guinea,Slovenia,26,16,10
2019,196,Cyprus,Slovenia,14,7,7
2019,792,Turkey,Slovenia,197,88,109
2019,484,Mexico,Slovenia,55,26,29
2019,32,Argentina,Slovenia,824,414,410
2019,68,Bolivia (Plurinational State of),Slovenia,9,6,3
2019,76,Brazil,Slovenia,237,131,106
2019,152,Chile,Slovenia,161,91,70
2019,170,Colombia,Slovenia,30,18,12
2019,604,Peru,Slovenia,34,21,13
2019,862,Venezuela (Bolivarian Republic of),Slovenia,100,54,46
2019,36,Australia,Slovenia,8305,4109,4196
2019,100,Bulgaria,Slovenia,122,72,50
2019,203,Czechia,Slovenia,379,248,131
2019,348,Hungary,Slovenia,426,218,208
2019,616,Poland,Slovenia,160,104,56
2019,643,Russian Federation,Slovenia,349,231,118
2019,703,Slovakia,Slovenia,349,241,108
2019,208,Denmark,Slovenia,466,239,227
2019,233,Estonia,Slovenia,31,15,16
2019,246,Finland,Slovenia,104,51,53
2019,352,Iceland,Slovenia,45,19,26
2019,372,Ireland,Slovenia,230,118,112
2019,428,Latvia,Slovenia,7,4,3
2019,578,Norway,Slovenia,448,229,219
2019,752,Sweden,Slovenia,1464,736,728
2019,826,United Kingdom,Slovenia,2377,911,1466
2019,70,Bosnia and Herzegovina,Slovenia,1816,718,1098
2019,191,Croatia,Slovenia,18085,6570,11515
2019,300,Greece,Slovenia,125,29,96
2019,380,Italy,Slovenia,4768,1890,2878
2019,470,Malta,Slovenia,46,27,19
2019,499,Montenegro,Slovenia,1622,576,1046
2019,807,North Macedonia,Slovenia,256,107,149
2019,620,Portugal,Slovenia,55,18,37
2019,688,Serbia,Slovenia,11104,4825,6279
2019,724,Spain,Slovenia,1359,615,744
2019,40,Austria,Slovenia,21140,9516,11624
2019,56,Belgium,Slovenia,205,95,110
2019,250,France,Slovenia,2720,1200,1520
2019,276,Germany,Slovenia,36746,19011,17735
2019,438,Liechtenstein,Slovenia,108,28,80
2019,442,Luxembourg,Slovenia,621,271,350
2019,528,Netherlands,Slovenia,404,175,229
2019,756,Switzerland,Slovenia,6444,3147,3297
2019,124,Canada,Slovenia,8748,4002,4746
2019,840,United States of America,Slovenia,10437,5079,5358
1990,36,Australia,Solomon Islands,1052,493,559
1990,242,Fiji,Solomon Islands,646,346,300
1990,598,Papua New Guinea,Solomon Islands,324,189,135
1990,548,Vanuatu,Solomon Islands,83,39,44
1990,520,Nauru,Solomon Islands,39,28,11
1990,882,Samoa,Solomon Islands,5,2,3
1990,208,Denmark,Solomon Islands,2,2,0
1990,826,United Kingdom,Solomon Islands,42,25,17
1990,300,Greece,Solomon Islands,6,3,3
1990,380,Italy,Solomon Islands,1,0,1
1990,40,Austria,Solomon Islands,8,4,4
1990,250,France,Solomon Islands,4,3,1
1995,36,Australia,Solomon Islands,1263,582,681
1995,242,Fiji,Solomon Islands,636,337,299
1995,598,Papua New Guinea,Solomon Islands,331,202,129
1995,548,Vanuatu,Solomon Islands,65,35,30
1995,520,Nauru,Solomon Islands,36,25,11
1995,882,Samoa,Solomon Islands,10,3,7
1995,208,Denmark,Solomon Islands,2,2,0
1995,372,Ireland,Solomon Islands,1,1,0
1995,826,United Kingdom,Solomon Islands,170,81,89
1995,300,Greece,Solomon Islands,12,5,7
1995,380,Italy,Solomon Islands,3,1,2
1995,40,Austria,Solomon Islands,9,4,5
1995,250,France,Solomon Islands,4,3,1
2000,36,Australia,Solomon Islands,1400,634,766
2000,242,Fiji,Solomon Islands,634,336,298
2000,598,Papua New Guinea,Solomon Islands,247,162,85
2000,548,Vanuatu,Solomon Islands,51,26,25
2000,520,Nauru,Solomon Islands,33,22,11
2000,882,Samoa,Solomon Islands,16,5,11
2000,208,Denmark,Solomon Islands,2,2,0
2000,372,Ireland,Solomon Islands,3,2,1
2000,752,Sweden,Solomon Islands,2,0,2
2000,826,United Kingdom,Solomon Islands,302,138,164
2000,300,Greece,Solomon Islands,19,8,11
2000,380,Italy,Solomon Islands,5,3,2
2000,40,Austria,Solomon Islands,10,5,5
2000,250,France,Solomon Islands,4,3,1
2005,68,Bolivia (Plurinational State of),Solomon Islands,1,0,1
2005,36,Australia,Solomon Islands,1640,720,920
2005,242,Fiji,Solomon Islands,636,336,300
2005,598,Papua New Guinea,Solomon Islands,257,175,82
2005,548,Vanuatu,Solomon Islands,75,38,37
2005,520,Nauru,Solomon Islands,31,21,10
2005,882,Samoa,Solomon Islands,14,4,10
2005,208,Denmark,Solomon Islands,3,3,0
2005,246,Finland,Solomon Islands,2,1,1
2005,352,Iceland,Solomon Islands,1,0,1
2005,372,Ireland,Solomon Islands,3,2,1
2005,752,Sweden,Solomon Islands,4,2,2
2005,826,United Kingdom,Solomon Islands,301,141,160
2005,300,Greece,Solomon Islands,10,4,6
2005,380,Italy,Solomon Islands,5,2,3
2005,40,Austria,Solomon Islands,11,5,6
2005,250,France,Solomon Islands,6,2,4
2010,68,Bolivia (Plurinational State of),Solomon Islands,1,0,1
2010,36,Australia,Solomon Islands,1930,864,1066
2010,242,Fiji,Solomon Islands,683,365,318
2010,598,Papua New Guinea,Solomon Islands,218,151,67
2010,548,Vanuatu,Solomon Islands,113,57,56
2010,520,Nauru,Solomon Islands,41,27,14
2010,882,Samoa,Solomon Islands,13,4,9
2010,208,Denmark,Solomon Islands,2,2,0
2010,246,Finland,Solomon Islands,5,3,2
2010,352,Iceland,Solomon Islands,1,0,1
2010,372,Ireland,Solomon Islands,2,1,1
2010,752,Sweden,Solomon Islands,4,3,1
2010,826,United Kingdom,Solomon Islands,317,152,165
2010,380,Italy,Solomon Islands,3,0,3
2010,40,Austria,Solomon Islands,12,6,6
2010,250,France,Solomon Islands,3,2,1
2015,324,Guinea,Solomon Islands,12,8,4
2015,68,Bolivia (Plurinational State of),Solomon Islands,1,0,1
2015,36,Australia,Solomon Islands,2300,1055,1245
2015,242,Fiji,Solomon Islands,703,379,324
2015,598,Papua New Guinea,Solomon Islands,221,155,66
2015,548,Vanuatu,Solomon Islands,119,60,59
2015,520,Nauru,Solomon Islands,64,43,21
2015,882,Samoa,Solomon Islands,10,4,6
2015,208,Denmark,Solomon Islands,2,2,0
2015,246,Finland,Solomon Islands,6,3,3
2015,352,Iceland,Solomon Islands,1,0,1
2015,372,Ireland,Solomon Islands,2,1,1
2015,752,Sweden,Solomon Islands,4,3,1
2015,826,United Kingdom,Solomon Islands,405,188,217
2015,380,Italy,Solomon Islands,3,0,3
2015,40,Austria,Solomon Islands,14,7,7
2015,250,France,Solomon Islands,3,2,1
2019,324,Guinea,Solomon Islands,11,8,3
2019,68,Bolivia (Plurinational State of),Solomon Islands,1,0,1
2019,36,Australia,Solomon Islands,2581,1158,1423
2019,242,Fiji,Solomon Islands,717,387,330
2019,598,Papua New Guinea,Solomon Islands,222,156,66
2019,548,Vanuatu,Solomon Islands,121,61,60
2019,520,Nauru,Solomon Islands,71,48,23
2019,882,Samoa,Solomon Islands,9,4,5
2019,208,Denmark,Solomon Islands,4,4,0
2019,246,Finland,Solomon Islands,5,1,4
2019,352,Iceland,Solomon Islands,1,0,1
2019,372,Ireland,Solomon Islands,2,1,1
2019,752,Sweden,Solomon Islands,5,4,1
2019,826,United Kingdom,Solomon Islands,459,214,245
2019,380,Italy,Solomon Islands,6,2,4
2019,40,Austria,Solomon Islands,16,8,8
2019,250,France,Solomon Islands,3,2,1
1990,262,Djibouti,Somalia,101216,54118,47098
1990,232,Eritrea,Somalia,1438,741,697
1990,231,Ethiopia,Somalia,616940,324269,292671
1990,404,Kenya,Somalia,7875,4382,3493
1990,454,Malawi,Somalia,211,78,133
1990,690,Seychelles,Somalia,11,9,2
1990,800,Uganda,Somalia,378,261,117
1990,834,United Republic of Tanzania,Somalia,467,281,186
1990,748,Eswatini,Somalia,2,2,0
1990,516,Namibia,Somalia,138,96,42
1990,710,South Africa,Somalia,3233,1692,1541
1990,12,Algeria,Somalia,926,453,473
1990,818,Egypt,Somalia,1372,642,730
1990,434,Libya,Somalia,3917,1845,2072
1990,48,Bahrain,Somalia,340,243,97
1990,196,Cyprus,Somalia,3,2,1
1990,368,Iraq,Somalia,204,145,59
1990,400,Jordan,Somalia,24,15,9
1990,414,Kuwait,Somalia,2111,1279,832
1990,634,Qatar,Somalia,109,68,41
1990,760,Syrian Arab Republic,Somalia,200,102,98
1990,792,Turkey,Somalia,114,76,38
1990,784,United Arab Emirates,Somalia,2578,1835,743
1990,887,Yemen,Somalia,36771,21042,15729
1990,458,Malaysia,Somalia,51,32,19
1990,764,Thailand,Somalia,2,1,1
1990,188,Costa Rica,Somalia,1,0,1
1990,558,Nicaragua,Somalia,17,5,12
1990,32,Argentina,Somalia,4,4,0
1990,152,Chile,Somalia,12,4,8
1990,36,Australia,Somalia,361,243,118
1990,554,New Zealand,Somalia,415,198,217
1990,100,Bulgaria,Somalia,1,1,0
1990,203,Czechia,Somalia,1,1,0
1990,348,Hungary,Somalia,5,4,1
1990,643,Russian Federation,Somalia,129,63,66
1990,208,Denmark,Somalia,584,386,198
1990,246,Finland,Somalia,54,41,13
1990,372,Ireland,Somalia,102,55,47
1990,578,Norway,Somalia,1286,926,360
1990,752,Sweden,Somalia,10279,5473,4806
1990,826,United Kingdom,Somalia,6078,3570,2508
1990,300,Greece,Somalia,44,24,20
1990,380,Italy,Somalia,11363,3625,7738
1990,470,Malta,Somalia,7,5,2
1990,724,Spain,Somalia,18,12,6
1990,40,Austria,Somalia,670,406,264
1990,56,Belgium,Somalia,2103,1368,735
1990,250,France,Somalia,1485,742,743
1990,276,Germany,Somalia,5957,4858,1099
1990,528,Netherlands,Somalia,1859,1070,789
1990,756,Switzerland,Somalia,2647,1368,1279
1990,124,Canada,Somalia,19517,9501,10016
1990,840,United States of America,Somalia,2437,1193,1244
1995,262,Djibouti,Somalia,82625,44204,38421
1995,232,Eritrea,Somalia,1607,869,738
1995,231,Ethiopia,Somalia,459615,231129,228486
1995,404,Kenya,Somalia,172164,91248,80916
1995,454,Malawi,Somalia,61,35,26
1995,690,Seychelles,Somalia,13,10,3
1995,800,Uganda,Somalia,1007,571,436
1995,834,United Republic of Tanzania,Somalia,4247,2149,2098
1995,748,Eswatini,Somalia,128,75,53
1995,516,Namibia,Somalia,131,92,39
1995,710,South Africa,Somalia,2874,1568,1306
1995,12,Algeria,Somalia,6248,3511,2737
1995,818,Egypt,Somalia,6209,3363,2846
1995,434,Libya,Somalia,40088,26153,13935
1995,729,Sudan,Somalia,122,61,61
1995,48,Bahrain,Somalia,374,264,110
1995,196,Cyprus,Somalia,4,2,2
1995,368,Iraq,Somalia,377,241,136
1995,400,Jordan,Somalia,58,34,24
1995,414,Kuwait,Somalia,1691,1078,613
1995,634,Qatar,Somalia,184,127,57
1995,760,Syrian Arab Republic,Somalia,345,175,170
1995,792,Turkey,Somalia,14,14,0
1995,784,United Arab Emirates,Somalia,3304,2367,937
1995,887,Yemen,Somalia,61684,35648,26036
1995,458,Malaysia,Somalia,121,72,49
1995,764,Thailand,Somalia,9,5,4
1995,188,Costa Rica,Somalia,1,0,1
1995,558,Nicaragua,Somalia,14,4,10
1995,32,Argentina,Somalia,4,4,0
1995,152,Chile,Somalia,11,5,6
1995,36,Australia,Somalia,2113,1118,995
1995,554,New Zealand,Somalia,504,244,260
1995,100,Bulgaria,Somalia,2,2,0
1995,203,Czechia,Somalia,2,1,1
1995,348,Hungary,Somalia,139,109,30
1995,643,Russian Federation,Somalia,121,66,55
1995,208,Denmark,Somalia,6085,3273,2812
1995,246,Finland,Somalia,1772,1009,763
1995,352,Iceland,Somalia,1,0,1
1995,372,Ireland,Somalia,282,146,136
1995,578,Norway,Somalia,3293,2004,1289
1995,752,Sweden,Somalia,12198,6451,5747
1995,826,United Kingdom,Somalia,23882,11330,12552
1995,300,Greece,Somalia,55,31,24
1995,380,Italy,Somalia,9103,2957,6146
1995,470,Malta,Somalia,9,6,3
1995,724,Spain,Somalia,28,19,9
1995,40,Austria,Somalia,756,463,293
1995,56,Belgium,Somalia,1661,1013,648
1995,250,France,Somalia,1533,753,780
1995,276,Germany,Somalia,6853,4572,2281
1995,528,Netherlands,Somalia,11388,6401,4987
1995,756,Switzerland,Somalia,2901,1656,1245
1995,124,Canada,Somalia,19599,9496,10103
1995,840,United States of America,Somalia,19353,9625,9728
2000,262,Djibouti,Somalia,83230,44574,38656
2000,232,Eritrea,Somalia,1775,997,778
2000,231,Ethiopia,Somalia,389419,182322,207097
2000,404,Kenya,Somalia,159197,82223,76974
2000,454,Malawi,Somalia,59,33,26
2000,690,Seychelles,Somalia,15,11,4
2000,800,Uganda,Somalia,1384,700,684
2000,834,United Republic of Tanzania,Somalia,3655,1916,1739
2000,748,Eswatini,Somalia,116,60,56
2000,516,Namibia,Somalia,123,85,38
2000,710,South Africa,Somalia,6302,3332,2970
2000,12,Algeria,Somalia,11570,6569,5001
2000,818,Egypt,Somalia,11540,6353,5187
2000,434,Libya,Somalia,76918,51219,25699
2000,729,Sudan,Somalia,43,19,24
2000,48,Bahrain,Somalia,410,284,126
2000,196,Cyprus,Somalia,5,3,2
2000,368,Iraq,Somalia,357,196,161
2000,400,Jordan,Somalia,92,54,38
2000,414,Kuwait,Somalia,1929,1303,626
2000,634,Qatar,Somalia,233,167,66
2000,760,Syrian Arab Republic,Somalia,443,224,219
2000,792,Turkey,Somalia,34,28,6
2000,784,United Arab Emirates,Somalia,4221,3023,1198
2000,887,Yemen,Somalia,69757,39943,29814
2000,458,Malaysia,Somalia,233,136,97
2000,764,Thailand,Somalia,19,10,9
2000,188,Costa Rica,Somalia,1,0,1
2000,558,Nicaragua,Somalia,23,5,18
2000,32,Argentina,Somalia,4,4,0
2000,152,Chile,Somalia,11,4,7
2000,36,Australia,Somalia,3750,1936,1814
2000,554,New Zealand,Somalia,1724,839,885
2000,100,Bulgaria,Somalia,2,2,0
2000,203,Czechia,Somalia,3,2,1
2000,348,Hungary,Somalia,272,213,59
2000,643,Russian Federation,Somalia,109,67,42
2000,208,Denmark,Somalia,11586,6160,5426
2000,246,Finland,Somalia,3490,1977,1513
2000,352,Iceland,Somalia,1,0,1
2000,372,Ireland,Somalia,618,328,290
2000,578,Norway,Somalia,6445,3603,2842
2000,752,Sweden,Somalia,13082,6878,6204
2000,826,United Kingdom,Somalia,42089,19249,22840
2000,300,Greece,Somalia,66,37,29
2000,380,Italy,Somalia,6842,2288,4554
2000,470,Malta,Somalia,10,7,3
2000,705,Slovenia,Somalia,1,1,0
2000,724,Spain,Somalia,349,249,100
2000,40,Austria,Somalia,841,519,322
2000,56,Belgium,Somalia,1169,627,542
2000,250,France,Somalia,1581,764,817
2000,276,Germany,Somalia,7749,4287,3462
2000,528,Netherlands,Somalia,21261,11911,9350
2000,756,Switzerland,Somalia,3167,1954,1213
2000,124,Canada,Somalia,20146,9718,10428
2000,840,United States of America,Somalia,36668,18281,18387
2005,262,Djibouti,Somalia,76262,43138,33124
2005,232,Eritrea,Somalia,2096,1121,975
2005,231,Ethiopia,Somalia,327545,161785,165760
2005,404,Kenya,Somalia,208156,109595,98561
2005,454,Malawi,Somalia,57,32,25
2005,690,Seychelles,Somalia,36,24,12
2005,800,Uganda,Somalia,2387,1200,1187
2005,834,United Republic of Tanzania,Somalia,3424,2279,1145
2005,748,Eswatini,Somalia,156,77,79
2005,516,Namibia,Somalia,97,67,30
2005,710,South Africa,Somalia,10324,4777,5547
2005,12,Algeria,Somalia,9132,5185,3947
2005,818,Egypt,Somalia,17739,10465,7274
2005,434,Libya,Somalia,84755,61493,23262
2005,729,Sudan,Somalia,38,16,22
2005,48,Bahrain,Somalia,512,349,163
2005,196,Cyprus,Somalia,7,4,3
2005,368,Iraq,Somalia,409,276,133
2005,400,Jordan,Somalia,132,84,48
2005,414,Kuwait,Somalia,2083,1375,708
2005,634,Qatar,Somalia,655,486,169
2005,760,Syrian Arab Republic,Somalia,1126,576,550
2005,792,Turkey,Somalia,89,59,30
2005,784,United Arab Emirates,Somalia,4165,2885,1280
2005,887,Yemen,Somalia,92022,56367,35655
2005,458,Malaysia,Somalia,588,355,233
2005,764,Thailand,Somalia,68,34,34
2005,188,Costa Rica,Somalia,1,0,1
2005,558,Nicaragua,Somalia,34,6,28
2005,32,Argentina,Somalia,3,3,0
2005,68,Bolivia (Plurinational State of),Somalia,2,0,2
2005,152,Chile,Somalia,16,6,10
2005,36,Australia,Somalia,4500,2222,2278
2005,554,New Zealand,Somalia,1775,862,913
2005,100,Bulgaria,Somalia,3,3,0
2005,203,Czechia,Somalia,20,11,9
2005,348,Hungary,Somalia,336,264,72
2005,643,Russian Federation,Somalia,83,59,24
2005,208,Denmark,Somalia,11017,5845,5172
2005,246,Finland,Somalia,5970,3233,2737
2005,352,Iceland,Somalia,1,0,1
2005,372,Ireland,Somalia,620,347,273
2005,428,Latvia,Somalia,2,2,0
2005,578,Norway,Somalia,12766,7020,5746
2005,752,Sweden,Somalia,16045,8236,7809
2005,826,United Kingdom,Somalia,67595,29710,37885
2005,300,Greece,Somalia,412,310,102
2005,380,Italy,Somalia,9198,4566,4632
2005,470,Malta,Somalia,14,9,5
2005,724,Spain,Somalia,168,119,49
2005,40,Austria,Somalia,940,571,369
2005,56,Belgium,Somalia,1318,702,616
2005,250,France,Somalia,1464,696,768
2005,276,Germany,Somalia,6784,3931,2853
2005,528,Netherlands,Somalia,15080,8248,6832
2005,756,Switzerland,Somalia,3648,2183,1465
2005,124,Canada,Somalia,20528,9400,11128
2005,840,United States of America,Somalia,76917,38559,38358
2010,262,Djibouti,Somalia,84118,44897,39221
2010,232,Eritrea,Somalia,2415,1246,1169
2010,231,Ethiopia,Somalia,349609,182516,167093
2010,404,Kenya,Somalia,392063,201694,190369
2010,454,Malawi,Somalia,56,31,25
2010,690,Seychelles,Somalia,58,37,21
2010,800,Uganda,Somalia,17425,8930,8495
2010,834,United Republic of Tanzania,Somalia,2273,1208,1065
2010,748,Eswatini,Somalia,146,69,77
2010,516,Namibia,Somalia,93,65,28
2010,710,South Africa,Somalia,16172,7451,8721
2010,12,Algeria,Somalia,10035,5509,4526
2010,818,Egypt,Somalia,19145,10996,8149
2010,434,Libya,Somalia,92720,67567,25153
2010,729,Sudan,Somalia,86,41,45
2010,48,Bahrain,Somalia,727,490,237
2010,196,Cyprus,Somalia,11,7,4
2010,368,Iraq,Somalia,413,287,126
2010,400,Jordan,Somalia,170,112,58
2010,414,Kuwait,Somalia,2758,1798,960
2010,634,Qatar,Somalia,1609,1290,319
2010,760,Syrian Arab Republic,Somalia,2762,1409,1353
2010,792,Turkey,Somalia,955,550,405
2010,784,United Arab Emirates,Somalia,8173,5725,2448
2010,887,Yemen,Somalia,194353,106606,87747
2010,458,Malaysia,Somalia,1026,576,450
2010,764,Thailand,Somalia,122,61,61
2010,188,Costa Rica,Somalia,1,0,1
2010,558,Nicaragua,Somalia,36,7,29
2010,32,Argentina,Somalia,2,2,0
2010,68,Bolivia (Plurinational State of),Somalia,3,0,3
2010,152,Chile,Somalia,22,9,13
2010,36,Australia,Somalia,6190,2998,3192
2010,554,New Zealand,Somalia,1472,714,758
2010,100,Bulgaria,Somalia,3,3,0
2010,203,Czechia,Somalia,35,20,15
2010,348,Hungary,Somalia,400,315,85
2010,643,Russian Federation,Somalia,57,50,7
2010,208,Denmark,Somalia,10263,5436,4827
2010,233,Estonia,Somalia,2,0,2
2010,246,Finland,Somalia,9243,4535,4708
2010,352,Iceland,Somalia,1,0,1
2010,372,Ireland,Somalia,520,274,246
2010,428,Latvia,Somalia,5,4,1
2010,578,Norway,Somalia,18002,9593,8409
2010,752,Sweden,Somalia,37846,19014,18832
2010,826,United Kingdom,Somalia,111360,42620,68740
2010,300,Greece,Somalia,788,608,180
2010,380,Italy,Somalia,12634,7177,5457
2010,470,Malta,Somalia,3723,1893,1830
2010,705,Slovenia,Somalia,1,1,0
2010,724,Spain,Somalia,307,192,115
2010,40,Austria,Somalia,1039,623,416
2010,56,Belgium,Somalia,1659,866,793
2010,250,France,Somalia,1768,835,933
2010,276,Germany,Somalia,5953,3591,2362
2010,528,Netherlands,Somalia,19863,11152,8711
2010,756,Switzerland,Somalia,4185,2404,1781
2010,124,Canada,Somalia,22255,9726,12529
2010,840,United States of America,Somalia,120575,59618,60957
2015,262,Djibouti,Somalia,93042,49768,43274
2015,232,Eritrea,Somalia,2457,1281,1176
2015,231,Ethiopia,Somalia,442910,225826,217084
2015,404,Kenya,Somalia,488470,250295,238175
2015,454,Malawi,Somalia,54,31,23
2015,690,Seychelles,Somalia,64,42,22
2015,800,Uganda,Somalia,35224,17511,17713
2015,834,United Republic of Tanzania,Somalia,2967,1552,1415
2015,748,Eswatini,Somalia,181,96,85
2015,516,Namibia,Somalia,91,64,27
2015,710,South Africa,Somalia,29171,12639,16532
2015,324,Guinea,Somalia,6,4,2
2015,12,Algeria,Somalia,11076,6076,5000
2015,818,Egypt,Somalia,14195,8936,5259
2015,434,Libya,Somalia,104539,75791,28748
2015,729,Sudan,Somalia,130,64,66
2015,48,Bahrain,Somalia,519,348,171
2015,196,Cyprus,Somalia,10,7,3
2015,368,Iraq,Somalia,414,307,107
2015,400,Jordan,Somalia,738,406,332
2015,414,Kuwait,Somalia,3168,1914,1254
2015,634,Qatar,Somalia,1243,1013,230
2015,760,Syrian Arab Republic,Somalia,1084,568,516
2015,792,Turkey,Somalia,2176,1245,931
2015,784,United Arab Emirates,Somalia,8930,6150,2780
2015,887,Yemen,Somalia,275683,145260,130423
2015,458,Malaysia,Somalia,1510,873,637
2015,764,Thailand,Somalia,131,65,66
2015,188,Costa Rica,Somalia,1,0,1
2015,558,Nicaragua,Somalia,38,7,31
2015,32,Argentina,Somalia,2,2,0
2015,68,Bolivia (Plurinational State of),Somalia,3,0,3
2015,152,Chile,Somalia,33,14,19
2015,36,Australia,Somalia,8650,4239,4411
2015,554,New Zealand,Somalia,1147,555,592
2015,100,Bulgaria,Somalia,18,10,8
2015,203,Czechia,Somalia,28,15,13
2015,348,Hungary,Somalia,603,497,106
2015,643,Russian Federation,Somalia,59,51,8
2015,208,Denmark,Somalia,11116,5960,5156
2015,233,Estonia,Somalia,2,2,0
2015,246,Finland,Somalia,12497,6211,6286
2015,352,Iceland,Somalia,2,1,1
2015,372,Ireland,Somalia,531,277,254
2015,428,Latvia,Somalia,5,4,1
2015,578,Norway,Somalia,27311,14541,12770
2015,752,Sweden,Somalia,60623,30294,30329
2015,826,United Kingdom,Somalia,142412,51897,90515
2015,300,Greece,Somalia,739,563,176
2015,380,Italy,Somalia,12018,7316,4702
2015,470,Malta,Somalia,1882,957,925
2015,705,Slovenia,Somalia,35,23,12
2015,724,Spain,Somalia,272,168,104
2015,40,Austria,Somalia,1215,730,485
2015,56,Belgium,Somalia,3319,1763,1556
2015,250,France,Somalia,3281,1600,1681
2015,276,Germany,Somalia,6203,3736,2467
2015,528,Netherlands,Somalia,27115,14351,12764
2015,756,Switzerland,Somalia,6852,4038,2814
2015,124,Canada,Somalia,27067,11989,15078
2015,840,United States of America,Somalia,93003,45745,47258
2019,262,Djibouti,Somalia,95518,51093,44425
2019,232,Eritrea,Somalia,2481,1294,1187
2019,231,Ethiopia,Somalia,477774,243602,234172
2019,404,Kenya,Somalia,452919,232240,220679
2019,454,Malawi,Somalia,71,40,31
2019,690,Seychelles,Somalia,64,42,22
2019,800,Uganda,Somalia,37207,18036,19171
2019,834,United Republic of Tanzania,Somalia,2660,1384,1276
2019,748,Eswatini,Somalia,301,158,143
2019,516,Namibia,Somalia,96,68,28
2019,710,South Africa,Somalia,32696,14184,18512
2019,324,Guinea,Somalia,5,4,1
2019,12,Algeria,Somalia,11520,6320,5200
2019,818,Egypt,Somalia,20232,11851,8381
2019,434,Libya,Somalia,110919,80417,30502
2019,729,Sudan,Somalia,160,78,82
2019,48,Bahrain,Somalia,546,367,179
2019,196,Cyprus,Somalia,9,7,2
2019,368,Iraq,Somalia,424,315,109
2019,400,Jordan,Somalia,793,436,357
2019,414,Kuwait,Somalia,3354,2027,1327
2019,634,Qatar,Somalia,1267,1016,251
2019,760,Syrian Arab Republic,Somalia,1079,567,512
2019,792,Turkey,Somalia,2942,1696,1246
2019,784,United Arab Emirates,Somalia,9591,6605,2986
2019,887,Yemen,Somalia,279856,147467,132389
2019,458,Malaysia,Somalia,1578,917,661
2019,764,Thailand,Somalia,136,68,68
2019,188,Costa Rica,Somalia,1,0,1
2019,558,Nicaragua,Somalia,39,7,32
2019,32,Argentina,Somalia,2,2,0
2019,68,Bolivia (Plurinational State of),Somalia,3,0,3
2019,152,Chile,Somalia,44,18,26
2019,36,Australia,Somalia,9976,4835,5141
2019,554,New Zealand,Somalia,1178,570,608
2019,100,Bulgaria,Somalia,26,13,13
2019,203,Czechia,Somalia,27,15,12
2019,348,Hungary,Somalia,681,565,116
2019,643,Russian Federation,Somalia,58,51,7
2019,208,Denmark,Somalia,12228,6402,5826
2019,233,Estonia,Somalia,4,4,0
2019,246,Finland,Somalia,14921,7489,7432
2019,352,Iceland,Somalia,11,7,4
2019,372,Ireland,Somalia,582,304,278
2019,428,Latvia,Somalia,4,4,0
2019,578,Norway,Somalia,31160,16382,14778
2019,752,Sweden,Somalia,66818,32970,33848
2019,826,United Kingdom,Somalia,161723,59194,102529
2019,300,Greece,Somalia,529,259,270
2019,380,Italy,Somalia,12585,7730,4855
2019,470,Malta,Somalia,3037,1555,1482
2019,705,Slovenia,Somalia,27,20,7
2019,724,Spain,Somalia,281,171,110
2019,40,Austria,Somalia,1434,872,562
2019,56,Belgium,Somalia,6253,3523,2730
2019,250,France,Somalia,3472,1689,1783
2019,276,Germany,Somalia,29661,19529,10132
2019,528,Netherlands,Somalia,27991,14386,13605
2019,756,Switzerland,Somalia,7705,4574,3131
2019,124,Canada,Somalia,29005,12848,16157
2019,840,United States of America,Somalia,100433,48851,51582
1990,232,Eritrea,South Africa,97,60,37
1990,404,Kenya,South Africa,197,110,87
1990,454,Malawi,South Africa,1276,395,881
1990,480,Mauritius,South Africa,184,72,112
1990,508,Mozambique,South Africa,7397,4066,3331
1990,690,Seychelles,South Africa,83,35,48
1990,834,United Republic of Tanzania,South Africa,409,248,161
1990,894,Zambia,South Africa,6328,3240,3088
1990,716,Zimbabwe,South Africa,11426,6508,4918
1990,24,Angola,South Africa,2437,1283,1154
1990,140,Central African Republic,South Africa,81,52,29
1990,266,Gabon,South Africa,4,4,0
1990,72,Botswana,South Africa,5780,3791,1989
1990,748,Eswatini,South Africa,20848,9903,10945
1990,426,Lesotho,South Africa,2777,1277,1500
1990,516,Namibia,South Africa,12536,6211,6325
1990,654,Saint Helena,South Africa,32,19,13
1990,694,Sierra Leone,South Africa,239,51,188
1990,818,Egypt,South Africa,190,110,80
1990,434,Libya,South Africa,543,315,228
1990,196,Cyprus,South Africa,1235,585,650
1990,376,Israel,South Africa,8519,4083,4436
1990,400,Jordan,South Africa,24,11,13
1990,792,Turkey,South Africa,71,39,32
1990,144,Sri Lanka,South Africa,3,2,1
1990,608,Philippines,South Africa,186,102,84
1990,28,Antigua and Barbuda,South Africa,19,9,10
1990,44,Bahamas,South Africa,21,12,9
1990,136,Cayman Islands,South Africa,11,6,5
1990,214,Dominican Republic,South Africa,242,144,98
1990,662,Saint Lucia,South Africa,4,2,2
1990,188,Costa Rica,South Africa,47,21,26
1990,484,Mexico,South Africa,87,42,45
1990,591,Panama,South Africa,12,6,6
1990,32,Argentina,South Africa,278,126,152
1990,68,Bolivia (Plurinational State of),South Africa,11,2,9
1990,152,Chile,South Africa,134,73,61
1990,170,Colombia,South Africa,49,30,19
1990,218,Ecuador,South Africa,41,29,12
1990,604,Peru,South Africa,71,45,26
1990,862,Venezuela (Bolivarian Republic of),South Africa,70,34,36
1990,36,Australia,South Africa,58684,29023,29661
1990,554,New Zealand,South Africa,5555,2612,2943
1990,100,Bulgaria,South Africa,9,3,6
1990,203,Czechia,South Africa,38,20,18
1990,348,Hungary,South Africa,44,25,19
1990,616,Poland,South Africa,376,197,179
1990,643,Russian Federation,South Africa,246,121,125
1990,703,Slovakia,South Africa,6,4,2
1990,208,Denmark,South Africa,604,300,304
1990,234,Faroe Islands,South Africa,1,1,0
1990,246,Finland,South Africa,115,51,64
1990,352,Iceland,South Africa,65,23,42
1990,372,Ireland,South Africa,621,306,315
1990,833,Isle of Man,South Africa,303,145,158
1990,428,Latvia,South Africa,2,1,1
1990,578,Norway,South Africa,629,309,320
1990,752,Sweden,South Africa,798,454,344
1990,826,United Kingdom,South Africa,66921,30985,35936
1990,300,Greece,South Africa,1755,900,855
1990,380,Italy,South Africa,409,142,267
1990,470,Malta,South Africa,45,20,25
1990,620,Portugal,South Africa,6464,3138,3326
1990,688,Serbia,South Africa,3,1,2
1990,705,Slovenia,South Africa,5,3,2
1990,724,Spain,South Africa,740,351,389
1990,40,Austria,South Africa,1538,679,859
1990,56,Belgium,South Africa,2761,1212,1549
1990,250,France,South Africa,2397,1016,1381
1990,276,Germany,South Africa,4059,1792,2267
1990,442,Luxembourg,South Africa,45,22,23
1990,528,Netherlands,South Africa,6568,3155,3413
1990,756,Switzerland,South Africa,4029,1851,2178
1990,60,Bermuda,South Africa,33,20,13
1990,124,Canada,South Africa,23729,11552,12177
1990,840,United States of America,South Africa,34707,16657,18050
1995,232,Eritrea,South Africa,143,88,55
1995,404,Kenya,South Africa,185,101,84
1995,454,Malawi,South Africa,9179,4136,5043
1995,480,Mauritius,South Africa,192,83,109
1995,508,Mozambique,South Africa,10175,5613,4562
1995,690,Seychelles,South Africa,224,165,59
1995,834,United Republic of Tanzania,South Africa,547,332,215
1995,894,Zambia,South Africa,2660,1368,1292
1995,716,Zimbabwe,South Africa,15313,8736,6577
1995,24,Angola,South Africa,2832,1435,1397
1995,140,Central African Republic,South Africa,84,59,25
1995,266,Gabon,South Africa,5,5,0
1995,72,Botswana,South Africa,9329,6090,3239
1995,748,Eswatini,South Africa,9097,4221,4876
1995,426,Lesotho,South Africa,2528,1225,1303
1995,516,Namibia,South Africa,11988,5978,6010
1995,654,Saint Helena,South Africa,21,12,9
1995,694,Sierra Leone,South Africa,233,45,188
1995,818,Egypt,South Africa,170,97,73
1995,434,Libya,South Africa,505,306,199
1995,196,Cyprus,South Africa,1747,791,956
1995,376,Israel,South Africa,9581,4501,5080
1995,400,Jordan,South Africa,48,30,18
1995,792,Turkey,South Africa,172,91,81
1995,144,Sri Lanka,South Africa,33,25,8
1995,410,Republic of Korea,South Africa,190,83,107
1995,608,Philippines,South Africa,250,135,115
1995,28,Antigua and Barbuda,South Africa,28,13,15
1995,44,Bahamas,South Africa,54,34,20
1995,136,Cayman Islands,South Africa,22,11,11
1995,214,Dominican Republic,South Africa,269,157,112
1995,662,Saint Lucia,South Africa,5,3,2
1995,188,Costa Rica,South Africa,37,17,20
1995,484,Mexico,South Africa,96,44,52
1995,591,Panama,South Africa,17,9,8
1995,32,Argentina,South Africa,271,124,147
1995,68,Bolivia (Plurinational State of),South Africa,6,1,5
1995,152,Chile,South Africa,189,102,87
1995,170,Colombia,South Africa,48,29,19
1995,218,Ecuador,South Africa,46,32,14
1995,604,Peru,South Africa,72,45,27
1995,862,Venezuela (Bolivarian Republic of),South Africa,67,35,32
1995,36,Australia,South Africa,61139,30023,31116
1995,554,New Zealand,South Africa,11026,5363,5663
1995,100,Bulgaria,South Africa,35,15,20
1995,203,Czechia,South Africa,57,31,26
1995,348,Hungary,South Africa,137,72,65
1995,616,Poland,South Africa,321,166,155
1995,643,Russian Federation,South Africa,241,126,115
1995,703,Slovakia,South Africa,33,23,10
1995,208,Denmark,South Africa,794,398,396
1995,234,Faroe Islands,South Africa,2,0,2
1995,246,Finland,South Africa,145,74,71
1995,352,Iceland,South Africa,64,23,41
1995,372,Ireland,South Africa,2196,1047,1149
1995,833,Isle of Man,South Africa,345,164,181
1995,428,Latvia,South Africa,2,1,1
1995,578,Norway,South Africa,641,310,331
1995,752,Sweden,South Africa,947,535,412
1995,826,United Kingdom,South Africa,100971,47600,53371
1995,300,Greece,South Africa,3596,1649,1947
1995,380,Italy,South Africa,824,273,551
1995,470,Malta,South Africa,53,24,29
1995,620,Portugal,South Africa,8622,4126,4496
1995,688,Serbia,South Africa,39,11,28
1995,705,Slovenia,South Africa,9,4,5
1995,724,Spain,South Africa,914,453,461
1995,40,Austria,South Africa,1736,783,953
1995,56,Belgium,South Africa,2744,1203,1541
1995,250,France,South Africa,2475,1025,1450
1995,276,Germany,South Africa,4560,1873,2687
1995,442,Luxembourg,South Africa,42,21,21
1995,528,Netherlands,South Africa,8417,3952,4465
1995,756,Switzerland,South Africa,4606,2254,2352
1995,60,Bermuda,South Africa,62,40,22
1995,124,Canada,South Africa,29983,14514,15469
1995,840,United States of America,South Africa,49789,24170,25619
2000,232,Eritrea,South Africa,189,116,73
2000,404,Kenya,South Africa,101,50,51
2000,454,Malawi,South Africa,8837,3968,4869
2000,480,Mauritius,South Africa,307,120,187
2000,508,Mozambique,South Africa,11835,6356,5479
2000,690,Seychelles,South Africa,366,296,70
2000,834,United Republic of Tanzania,South Africa,582,353,229
2000,894,Zambia,South Africa,1535,790,745
2000,716,Zimbabwe,South Africa,17024,9709,7315
2000,24,Angola,South Africa,3226,1586,1640
2000,140,Central African Republic,South Africa,80,62,18
2000,266,Gabon,South Africa,7,7,0
2000,72,Botswana,South Africa,13860,9030,4830
2000,748,Eswatini,South Africa,12272,5886,6386
2000,426,Lesotho,South Africa,2441,1256,1185
2000,516,Namibia,South Africa,11132,5576,5556
2000,654,Saint Helena,South Africa,20,11,9
2000,694,Sierra Leone,South Africa,227,39,188
2000,818,Egypt,South Africa,164,92,72
2000,434,Libya,South Africa,476,307,169
2000,196,Cyprus,South Africa,2258,996,1262
2000,376,Israel,South Africa,10107,4722,5385
2000,400,Jordan,South Africa,72,49,23
2000,792,Turkey,South Africa,275,143,132
2000,144,Sri Lanka,South Africa,64,40,24
2000,410,Republic of Korea,South Africa,442,200,242
2000,608,Philippines,South Africa,852,432,420
2000,28,Antigua and Barbuda,South Africa,37,17,20
2000,44,Bahamas,South Africa,88,58,30
2000,136,Cayman Islands,South Africa,40,21,19
2000,214,Dominican Republic,South Africa,296,171,125
2000,662,Saint Lucia,South Africa,8,5,3
2000,188,Costa Rica,South Africa,44,20,24
2000,484,Mexico,South Africa,110,48,62
2000,591,Panama,South Africa,24,13,11
2000,32,Argentina,South Africa,264,122,142
2000,152,Chile,South Africa,244,130,114
2000,170,Colombia,South Africa,47,29,18
2000,218,Ecuador,South Africa,51,36,15
2000,604,Peru,South Africa,85,53,32
2000,862,Venezuela (Bolivarian Republic of),South Africa,65,36,29
2000,36,Australia,South Africa,80650,39836,40814
2000,554,New Zealand,South Africa,25359,12326,13033
2000,100,Bulgaria,South Africa,61,28,33
2000,203,Czechia,South Africa,76,42,34
2000,348,Hungary,South Africa,230,120,110
2000,616,Poland,South Africa,275,140,135
2000,643,Russian Federation,South Africa,229,127,102
2000,703,Slovakia,South Africa,70,47,23
2000,208,Denmark,South Africa,984,496,488
2000,234,Faroe Islands,South Africa,1,0,1
2000,246,Finland,South Africa,175,97,78
2000,352,Iceland,South Africa,63,23,40
2000,372,Ireland,South Africa,4979,2457,2522
2000,833,Isle of Man,South Africa,387,184,203
2000,428,Latvia,South Africa,3,2,1
2000,578,Norway,South Africa,744,371,373
2000,752,Sweden,South Africa,1016,571,445
2000,826,United Kingdom,South Africa,136720,64877,71843
2000,300,Greece,South Africa,5497,2390,3107
2000,380,Italy,South Africa,1238,404,834
2000,470,Malta,South Africa,67,32,35
2000,620,Portugal,South Africa,11131,5298,5833
2000,688,Serbia,South Africa,90,34,56
2000,705,Slovenia,South Africa,27,9,18
2000,724,Spain,South Africa,1483,762,721
2000,40,Austria,South Africa,1933,886,1047
2000,56,Belgium,South Africa,2646,1160,1486
2000,250,France,South Africa,2552,1033,1519
2000,276,Germany,South Africa,5060,1954,3106
2000,438,Liechtenstein,South Africa,1,1,0
2000,442,Luxembourg,South Africa,41,21,20
2000,528,Netherlands,South Africa,10553,4871,5682
2000,756,Switzerland,South Africa,5200,2671,2529
2000,60,Bermuda,South Africa,90,60,30
2000,124,Canada,South Africa,36949,17824,19125
2000,840,United States of America,South Africa,65171,31874,33297
2005,232,Eritrea,South Africa,154,91,63
2005,404,Kenya,South Africa,98,50,48
2005,454,Malawi,South Africa,8421,3767,4654
2005,480,Mauritius,South Africa,412,166,246
2005,508,Mozambique,South Africa,16007,7908,8099
2005,690,Seychelles,South Africa,297,215,82
2005,834,United Republic of Tanzania,South Africa,659,400,259
2005,894,Zambia,South Africa,2170,1117,1053
2005,716,Zimbabwe,South Africa,19010,10842,8168
2005,24,Angola,South Africa,4172,1996,2176
2005,140,Central African Republic,South Africa,61,47,14
2005,266,Gabon,South Africa,7,7,0
2005,72,Botswana,South Africa,9390,6023,3367
2005,748,Eswatini,South Africa,12415,5647,6768
2005,426,Lesotho,South Africa,2492,1282,1210
2005,516,Namibia,South Africa,8802,4382,4420
2005,654,Saint Helena,South Africa,29,14,15
2005,694,Sierra Leone,South Africa,112,78,34
2005,818,Egypt,South Africa,195,115,80
2005,434,Libya,South Africa,524,372,152
2005,196,Cyprus,South Africa,3305,1446,1859
2005,376,Israel,South Africa,10671,4957,5714
2005,400,Jordan,South Africa,103,74,29
2005,792,Turkey,South Africa,283,144,139
2005,144,Sri Lanka,South Africa,127,51,76
2005,410,Republic of Korea,South Africa,830,375,455
2005,608,Philippines,South Africa,689,355,334
2005,28,Antigua and Barbuda,South Africa,40,18,22
2005,44,Bahamas,South Africa,92,54,38
2005,136,Cayman Islands,South Africa,36,18,18
2005,214,Dominican Republic,South Africa,154,88,66
2005,662,Saint Lucia,South Africa,7,5,2
2005,188,Costa Rica,South Africa,29,12,17
2005,484,Mexico,South Africa,143,74,69
2005,591,Panama,South Africa,30,15,15
2005,32,Argentina,South Africa,195,92,103
2005,68,Bolivia (Plurinational State of),South Africa,8,4,4
2005,152,Chile,South Africa,366,198,168
2005,170,Colombia,South Africa,45,28,17
2005,218,Ecuador,South Africa,60,43,17
2005,604,Peru,South Africa,100,62,38
2005,862,Venezuela (Bolivarian Republic of),South Africa,67,36,31
2005,36,Australia,South Africa,114150,56789,57361
2005,554,New Zealand,South Africa,39855,19345,20510
2005,100,Bulgaria,South Africa,96,45,51
2005,203,Czechia,South Africa,187,108,79
2005,348,Hungary,South Africa,284,151,133
2005,616,Poland,South Africa,329,178,151
2005,643,Russian Federation,South Africa,234,129,105
2005,703,Slovakia,South Africa,79,53,26
2005,208,Denmark,South Africa,1312,679,633
2005,234,Faroe Islands,South Africa,6,1,5
2005,246,Finland,South Africa,413,247,166
2005,352,Iceland,South Africa,65,23,42
2005,372,Ireland,South Africa,7504,3856,3648
2005,833,Isle of Man,South Africa,485,220,265
2005,428,Latvia,South Africa,8,6,2
2005,578,Norway,South Africa,841,415,426
2005,752,Sweden,South Africa,1567,894,673
2005,826,United Kingdom,South Africa,159229,75990,83239
2005,191,Croatia,South Africa,101,47,54
2005,300,Greece,South Africa,6279,2734,3545
2005,380,Italy,South Africa,3447,1423,2024
2005,470,Malta,South Africa,80,37,43
2005,620,Portugal,South Africa,11373,5409,5964
2005,688,Serbia,South Africa,148,68,80
2005,705,Slovenia,South Africa,28,10,18
2005,724,Spain,South Africa,1880,966,914
2005,40,Austria,South Africa,2161,962,1199
2005,56,Belgium,South Africa,3116,1431,1685
2005,250,France,South Africa,4182,1953,2229
2005,276,Germany,South Africa,10414,4773,5641
2005,438,Liechtenstein,South Africa,15,7,8
2005,442,Luxembourg,South Africa,35,19,16
2005,528,Netherlands,South Africa,12263,5691,6572
2005,756,Switzerland,South Africa,5792,2838,2954
2005,60,Bermuda,South Africa,174,108,66
2005,124,Canada,South Africa,38430,18800,19630
2005,840,United States of America,South Africa,73064,35941,37123
2010,232,Eritrea,South Africa,120,67,53
2010,404,Kenya,South Africa,110,53,57
2010,454,Malawi,South Africa,8272,3693,4579
2010,480,Mauritius,South Africa,541,233,308
2010,508,Mozambique,South Africa,18535,9157,9378
2010,690,Seychelles,South Africa,228,133,95
2010,834,United Republic of Tanzania,South Africa,678,412,266
2010,894,Zambia,South Africa,3072,1563,1509
2010,716,Zimbabwe,South Africa,18910,10787,8123
2010,24,Angola,South Africa,5118,2407,2711
2010,140,Central African Republic,South Africa,60,46,14
2010,266,Gabon,South Africa,8,8,0
2010,72,Botswana,South Africa,4920,2660,2260
2010,748,Eswatini,South Africa,12260,4684,7576
2010,426,Lesotho,South Africa,2544,1308,1236
2010,516,Namibia,South Africa,8481,4231,4250
2010,466,Mali,South Africa,453,302,151
2010,654,Saint Helena,South Africa,44,22,22
2010,694,Sierra Leone,South Africa,97,64,33
2010,818,Egypt,South Africa,210,120,90
2010,434,Libya,South Africa,574,409,165
2010,196,Cyprus,South Africa,5412,2406,3006
2010,376,Israel,South Africa,11365,5241,6124
2010,400,Jordan,South Africa,131,95,36
2010,792,Turkey,South Africa,291,145,146
2010,144,Sri Lanka,South Africa,257,106,151
2010,410,Republic of Korea,South Africa,1549,672,877
2010,608,Philippines,South Africa,800,396,404
2010,28,Antigua and Barbuda,South Africa,42,19,23
2010,44,Bahamas,South Africa,96,51,45
2010,136,Cayman Islands,South Africa,36,18,18
2010,214,Dominican Republic,South Africa,10,3,7
2010,662,Saint Lucia,South Africa,6,4,2
2010,188,Costa Rica,South Africa,57,25,32
2010,484,Mexico,South Africa,193,109,84
2010,591,Panama,South Africa,39,19,20
2010,32,Argentina,South Africa,126,62,64
2010,68,Bolivia (Plurinational State of),South Africa,15,8,7
2010,76,Brazil,South Africa,1573,1121,452
2010,152,Chile,South Africa,488,266,222
2010,170,Colombia,South Africa,50,32,18
2010,218,Ecuador,South Africa,84,60,24
2010,604,Peru,South Africa,111,69,42
2010,862,Venezuela (Bolivarian Republic of),South Africa,69,34,35
2010,36,Australia,South Africa,155950,77819,78131
2010,554,New Zealand,South Africa,48514,23503,25011
2010,100,Bulgaria,South Africa,127,61,66
2010,203,Czechia,South Africa,279,166,113
2010,348,Hungary,South Africa,338,182,156
2010,616,Poland,South Africa,395,222,173
2010,643,Russian Federation,South Africa,236,130,106
2010,703,Slovakia,South Africa,88,59,29
2010,208,Denmark,South Africa,1610,848,762
2010,233,Estonia,South Africa,23,14,9
2010,234,Faroe Islands,South Africa,14,8,6
2010,246,Finland,South Africa,733,432,301
2010,352,Iceland,South Africa,67,25,42
2010,372,Ireland,South Africa,8794,4159,4635
2010,833,Isle of Man,South Africa,577,252,325
2010,428,Latvia,South Africa,13,9,4
2010,578,Norway,South Africa,1169,623,546
2010,752,Sweden,South Africa,2023,1146,877
2010,826,United Kingdom,South Africa,220812,111804,109008
2010,191,Croatia,South Africa,202,94,108
2010,300,Greece,South Africa,7346,3205,4141
2010,380,Italy,South Africa,5726,2438,3288
2010,470,Malta,South Africa,142,72,70
2010,620,Portugal,South Africa,9728,4635,5093
2010,688,Serbia,South Africa,145,66,79
2010,705,Slovenia,South Africa,35,18,17
2010,724,Spain,South Africa,2437,1292,1145
2010,40,Austria,South Africa,2388,1038,1350
2010,56,Belgium,South Africa,3371,1601,1770
2010,250,France,South Africa,4864,1905,2959
2010,276,Germany,South Africa,14860,7169,7691
2010,438,Liechtenstein,South Africa,30,13,17
2010,442,Luxembourg,South Africa,30,17,13
2010,528,Netherlands,South Africa,12910,5987,6923
2010,756,Switzerland,South Africa,6870,3158,3712
2010,60,Bermuda,South Africa,258,156,102
2010,124,Canada,South Africa,40555,20132,20423
2010,840,United States of America,South Africa,83406,40446,42960
2015,232,Eritrea,South Africa,122,69,53
2015,404,Kenya,South Africa,112,54,58
2015,454,Malawi,South Africa,8174,3645,4529
2015,480,Mauritius,South Africa,622,285,337
2015,508,Mozambique,South Africa,19461,9615,9846
2015,690,Seychelles,South Africa,255,155,100
2015,834,United Republic of Tanzania,South Africa,712,433,279
2015,894,Zambia,South Africa,2706,1372,1334
2015,716,Zimbabwe,South Africa,19013,10714,8299
2015,24,Angola,South Africa,6064,2818,3246
2015,140,Central African Republic,South Africa,52,40,12
2015,266,Gabon,South Africa,12,12,0
2015,72,Botswana,South Africa,5370,2902,2468
2015,748,Eswatini,South Africa,12511,4921,7590
2015,426,Lesotho,South Africa,2610,1342,1268
2015,516,Namibia,South Africa,8300,4152,4148
2015,324,Guinea,South Africa,1251,762,489
2015,466,Mali,South Africa,561,374,187
2015,654,Saint Helena,South Africa,66,42,24
2015,694,Sierra Leone,South Africa,85,52,33
2015,818,Egypt,South Africa,155,97,58
2015,434,Libya,South Africa,647,459,188
2015,196,Cyprus,South Africa,5199,2331,2868
2015,376,Israel,South Africa,11721,5374,6347
2015,400,Jordan,South Africa,56,37,19
2015,792,Turkey,South Africa,295,144,151
2015,144,Sri Lanka,South Africa,261,105,156
2015,410,Republic of Korea,South Africa,1924,809,1115
2015,608,Philippines,South Africa,813,404,409
2015,28,Antigua and Barbuda,South Africa,45,21,24
2015,44,Bahamas,South Africa,104,55,49
2015,136,Cayman Islands,South Africa,38,20,18
2015,214,Dominican Republic,South Africa,10,3,7
2015,662,Saint Lucia,South Africa,5,4,1
2015,188,Costa Rica,South Africa,57,25,32
2015,484,Mexico,South Africa,204,115,89
2015,591,Panama,South Africa,46,23,23
2015,32,Argentina,South Africa,126,62,64
2015,68,Bolivia (Plurinational State of),South Africa,17,9,8
2015,76,Brazil,South Africa,1894,1350,544
2015,152,Chile,South Africa,739,396,343
2015,170,Colombia,South Africa,55,36,19
2015,218,Ecuador,South Africa,122,87,35
2015,604,Peru,South Africa,118,74,44
2015,862,Venezuela (Bolivarian Republic of),South Africa,71,35,36
2015,36,Australia,South Africa,177390,89230,88160
2015,554,New Zealand,South Africa,56396,27272,29124
2015,100,Bulgaria,South Africa,214,109,105
2015,203,Czechia,South Africa,338,204,134
2015,348,Hungary,South Africa,355,200,155
2015,616,Poland,South Africa,380,217,163
2015,643,Russian Federation,South Africa,240,131,109
2015,703,Slovakia,South Africa,112,79,33
2015,208,Denmark,South Africa,1951,1054,897
2015,233,Estonia,South Africa,31,21,10
2015,234,Faroe Islands,South Africa,20,11,9
2015,246,Finland,South Africa,1040,614,426
2015,352,Iceland,South Africa,81,31,50
2015,372,Ireland,South Africa,8983,4190,4793
2015,833,Isle of Man,South Africa,807,398,409
2015,428,Latvia,South Africa,13,9,4
2015,578,Norway,South Africa,1466,791,675
2015,752,Sweden,South Africa,2515,1439,1076
2015,826,United Kingdom,South Africa,204540,94618,109922
2015,191,Croatia,South Africa,203,94,109
2015,300,Greece,South Africa,6894,2842,4052
2015,380,Italy,South Africa,5692,2405,3287
2015,470,Malta,South Africa,241,131,110
2015,620,Portugal,South Africa,11028,4958,6070
2015,688,Serbia,South Africa,141,64,77
2015,705,Slovenia,South Africa,47,20,27
2015,724,Spain,South Africa,2829,1494,1335
2015,40,Austria,South Africa,2792,1222,1570
2015,56,Belgium,South Africa,3596,1691,1905
2015,250,France,South Africa,5388,2020,3368
2015,276,Germany,South Africa,15483,7450,8033
2015,438,Liechtenstein,South Africa,34,12,22
2015,442,Luxembourg,South Africa,45,26,19
2015,528,Netherlands,South Africa,13470,6242,7228
2015,756,Switzerland,South Africa,7675,3533,4142
2015,60,Bermuda,South Africa,262,159,103
2015,124,Canada,South Africa,44386,22059,22327
2015,840,United States of America,South Africa,101037,48729,52308
2019,232,Eritrea,South Africa,123,70,53
2019,404,Kenya,South Africa,103,50,53
2019,454,Malawi,South Africa,8292,3698,4594
2019,480,Mauritius,South Africa,627,287,340
2019,508,Mozambique,South Africa,20239,10000,10239
2019,690,Seychelles,South Africa,257,156,101
2019,834,United Republic of Tanzania,South Africa,638,387,251
2019,894,Zambia,South Africa,3487,1772,1715
2019,716,Zimbabwe,South Africa,19524,11094,8430
2019,24,Angola,South Africa,6421,3173,3248
2019,140,Central African Republic,South Africa,57,44,13
2019,266,Gabon,South Africa,13,13,0
2019,72,Botswana,South Africa,5751,3109,2642
2019,748,Eswatini,South Africa,12494,4903,7591
2019,426,Lesotho,South Africa,2751,1415,1336
2019,516,Namibia,South Africa,8785,4395,4390
2019,324,Guinea,South Africa,1194,728,466
2019,466,Mali,South Africa,624,416,208
2019,654,Saint Helena,South Africa,76,51,25
2019,694,Sierra Leone,South Africa,80,48,32
2019,818,Egypt,South Africa,220,128,92
2019,434,Libya,South Africa,686,487,199
2019,196,Cyprus,South Africa,5196,2359,2837
2019,376,Israel,South Africa,11398,5226,6172
2019,400,Jordan,South Africa,60,40,20
2019,792,Turkey,South Africa,398,196,202
2019,144,Sri Lanka,South Africa,263,106,157
2019,410,Republic of Korea,South Africa,1958,823,1135
2019,608,Philippines,South Africa,838,417,421
2019,28,Antigua and Barbuda,South Africa,46,22,24
2019,44,Bahamas,South Africa,110,58,52
2019,136,Cayman Islands,South Africa,41,21,20
2019,214,Dominican Republic,South Africa,10,3,7
2019,662,Saint Lucia,South Africa,4,4,0
2019,188,Costa Rica,South Africa,57,25,32
2019,484,Mexico,South Africa,210,119,91
2019,591,Panama,South Africa,48,25,23
2019,32,Argentina,South Africa,128,63,65
2019,68,Bolivia (Plurinational State of),South Africa,18,10,8
2019,76,Brazil,South Africa,2133,1521,612
2019,152,Chile,South Africa,987,504,483
2019,170,Colombia,South Africa,56,37,19
2019,218,Ecuador,South Africa,120,86,34
2019,604,Peru,South Africa,139,87,52
2019,862,Venezuela (Bolivarian Republic of),South Africa,69,34,35
2019,36,Australia,South Africa,196142,98368,97774
2019,554,New Zealand,South Africa,57969,28033,29936
2019,100,Bulgaria,South Africa,284,145,139
2019,203,Czechia,South Africa,399,243,156
2019,348,Hungary,South Africa,396,224,172
2019,616,Poland,South Africa,402,237,165
2019,643,Russian Federation,South Africa,239,131,108
2019,703,Slovakia,South Africa,129,93,36
2019,208,Denmark,South Africa,2351,1254,1097
2019,233,Estonia,South Africa,39,30,9
2019,234,Faroe Islands,South Africa,22,13,9
2019,246,Finland,South Africa,1221,722,499
2019,352,Iceland,South Africa,95,43,52
2019,372,Ireland,South Africa,9862,4616,5246
2019,833,Isle of Man,South Africa,818,403,415
2019,428,Latvia,South Africa,21,13,8
2019,578,Norway,South Africa,1687,911,776
2019,752,Sweden,South Africa,3431,1920,1511
2019,826,United Kingdom,South Africa,232276,107764,124512
2019,191,Croatia,South Africa,187,87,100
2019,300,Greece,South Africa,6732,2925,3807
2019,380,Italy,South Africa,5868,2574,3294
2019,470,Malta,South Africa,388,212,176
2019,620,Portugal,South Africa,11215,5056,6159
2019,688,Serbia,South Africa,143,65,78
2019,705,Slovenia,South Africa,56,28,28
2019,724,Spain,South Africa,2931,1515,1416
2019,40,Austria,South Africa,3295,1474,1821
2019,56,Belgium,South Africa,3948,1877,2071
2019,250,France,South Africa,5703,2130,3573
2019,276,Germany,South Africa,16984,8262,8722
2019,438,Liechtenstein,South Africa,32,14,18
2019,442,Luxembourg,South Africa,620,332,288
2019,528,Netherlands,South Africa,15715,7431,8284
2019,756,Switzerland,South Africa,8182,3805,4377
2019,60,Bermuda,South Africa,264,160,104
2019,124,Canada,South Africa,47564,23639,23925
2019,840,United States of America,South Africa,109110,52015,57095
1990,232,Eritrea,South Sudan,933,494,439
1990,231,Ethiopia,South Sudan,384266,201974,182292
1990,404,Kenya,South Sudan,5801,3332,2469
1990,180,Democratic Republic of the Congo,South Sudan,113409,54593,58816
1990,434,Libya,South Sudan,4753,2605,2148
1990,48,Bahrain,South Sudan,522,326,196
1990,368,Iraq,South Sudan,360,311,49
1990,400,Jordan,South Sudan,233,181,52
1990,422,Lebanon,South Sudan,106,82,24
1990,634,Qatar,South Sudan,608,444,164
1990,784,United Arab Emirates,South Sudan,3951,2452,1499
1990,428,Latvia,South Sudan,1,0,1
1995,232,Eritrea,South Sudan,1109,612,497
1995,231,Ethiopia,South Sudan,235512,129959,105553
1995,404,Kenya,South Sudan,53996,28584,25412
1995,180,Democratic Republic of the Congo,South Sudan,137306,68135,69171
1995,434,Libya,South Sudan,3005,1698,1307
1995,48,Bahrain,South Sudan,586,368,218
1995,368,Iraq,South Sudan,268,222,46
1995,400,Jordan,South Sudan,285,199,86
1995,422,Lebanon,South Sudan,129,87,42
1995,634,Qatar,South Sudan,660,493,167
1995,784,United Arab Emirates,South Sudan,5187,3344,1843
1995,428,Latvia,South Sudan,1,0,1
2000,232,Eritrea,South Sudan,1284,730,554
2000,231,Ethiopia,South Sudan,131405,82820,48585
2000,404,Kenya,South Sudan,81156,41894,39262
2000,180,Democratic Republic of the Congo,South Sudan,118742,58238,60504
2000,434,Libya,South Sudan,1307,850,457
2000,48,Bahrain,South Sudan,652,407,245
2000,368,Iraq,South Sudan,254,200,54
2000,400,Jordan,South Sudan,336,217,119
2000,422,Lebanon,South Sudan,152,93,59
2000,634,Qatar,South Sudan,615,469,146
2000,784,United Arab Emirates,South Sudan,6723,4407,2316
2000,428,Latvia,South Sudan,2,1,1
2005,232,Eritrea,South Sudan,1375,841,534
2005,231,Ethiopia,South Sudan,110527,63903,46624
2005,404,Kenya,South Sudan,62546,33359,29187
2005,180,Democratic Republic of the Congo,South Sudan,57555,28229,29326
2005,434,Libya,South Sudan,1440,1027,413
2005,48,Bahrain,South Sudan,829,524,305
2005,368,Iraq,South Sudan,291,246,45
2005,400,Jordan,South Sudan,485,334,151
2005,422,Lebanon,South Sudan,119,74,45
2005,634,Qatar,South Sudan,1155,834,321
2005,784,United Arab Emirates,South Sudan,6751,4363,2388
2005,428,Latvia,South Sudan,2,2,0
2010,232,Eritrea,South Sudan,1465,951,514
2010,231,Ethiopia,South Sudan,112021,61950,50071
2010,404,Kenya,South Sudan,53218,27160,26058
2010,180,Democratic Republic of the Congo,South Sudan,4472,2209,2263
2010,434,Libya,South Sudan,1576,1129,447
2010,729,Sudan,South Sudan,212948,104784,108164
2010,48,Bahrain,South Sudan,1190,757,433
2010,368,Iraq,South Sudan,294,251,43
2010,400,Jordan,South Sudan,624,441,183
2010,422,Lebanon,South Sudan,86,56,30
2010,634,Qatar,South Sudan,2632,2047,585
2010,784,United Arab Emirates,South Sudan,13368,8882,4486
2010,428,Latvia,South Sudan,2,2,0
2015,232,Eritrea,South Sudan,1490,973,517
2015,231,Ethiopia,South Sudan,395202,209303,185899
2015,404,Kenya,South Sudan,95765,47883,47882
2015,800,Uganda,South Sudan,262321,131537,130784
2015,180,Democratic Republic of the Congo,South Sudan,8749,2359,6390
2015,710,South Africa,South Sudan,94,48,46
2015,324,Guinea,South Sudan,3,2,1
2015,818,Egypt,South Sudan,6238,3618,2620
2015,434,Libya,South Sudan,1776,1266,510
2015,729,Sudan,South Sudan,255959,126321,129638
2015,48,Bahrain,South Sudan,849,536,313
2015,368,Iraq,South Sudan,295,259,36
2015,400,Jordan,South Sudan,268,172,96
2015,414,Kuwait,South Sudan,1726,960,766
2015,422,Lebanon,South Sudan,72,35,37
2015,512,Oman,South Sudan,317,214,103
2015,634,Qatar,South Sudan,2033,1611,422
2015,784,United Arab Emirates,South Sudan,14607,9512,5095
2015,887,Yemen,South Sudan,541,282,259
2015,36,Australia,South Sudan,7480,4171,3309
2015,578,Norway,South Sudan,65,37,28
2015,752,Sweden,South Sudan,21,13,8
2015,756,Switzerland,South Sudan,40,30,10
2015,124,Canada,South Sudan,5506,2976,2530
2019,232,Eritrea,South Sudan,1504,982,522
2019,231,Ethiopia,South Sudan,476311,245779,230532
2019,404,Kenya,South Sudan,88793,44430,44363
2019,800,Uganda,South Sudan,1100096,534915,565181
2019,180,Democratic Republic of the Congo,South Sudan,92018,42330,49688
2019,710,South Africa,South Sudan,106,55,51
2019,324,Guinea,South Sudan,2,2,0
2019,818,Egypt,South Sudan,13336,7073,6263
2019,434,Libya,South Sudan,1884,1343,541
2019,729,Sudan,South Sudan,773512,381744,391768
2019,48,Bahrain,South Sudan,893,564,329
2019,368,Iraq,South Sudan,302,266,36
2019,400,Jordan,South Sudan,288,185,103
2019,414,Kuwait,South Sudan,1827,1016,811
2019,422,Lebanon,South Sudan,68,34,34
2019,512,Oman,South Sudan,390,263,127
2019,634,Qatar,South Sudan,2073,1612,461
2019,784,United Arab Emirates,South Sudan,15688,10215,5473
2019,887,Yemen,South Sudan,549,286,263
2019,36,Australia,South Sudan,9342,5015,4327
2019,578,Norway,South Sudan,188,114,74
2019,752,Sweden,South Sudan,108,42,66
2019,756,Switzerland,South Sudan,40,32,8
2019,124,Canada,South Sudan,5900,3189,2711
1990,480,Mauritius,Spain,15,10,5
1990,690,Seychelles,Spain,11,7,4
1990,800,Uganda,Spain,59,23,36
1990,226,Equatorial Guinea,Spain,324,189,135
1990,516,Namibia,Spain,508,298,210
1990,710,South Africa,Spain,488,216,272
1990,132,Cabo Verde,Spain,30,14,16
1990,324,Guinea,Spain,59,27,32
1990,430,Liberia,Spain,286,157,129
1990,478,Mauritania,Spain,77,38,39
1990,818,Egypt,Spain,449,241,208
1990,434,Libya,Spain,1282,691,591
1990,504,Morocco,Spain,2802,1482,1320
1990,196,Cyprus,Spain,39,12,27
1990,376,Israel,Spain,3129,1368,1761
1990,400,Jordan,Spain,282,108,174
1990,792,Turkey,Spain,292,147,145
1990,344,"China, Hong Kong SAR",Spain,269,144,125
1990,392,Japan,Spain,856,436,420
1990,608,Philippines,Spain,257,124,133
1990,28,Antigua and Barbuda,Spain,5,2,3
1990,44,Bahamas,Spain,32,21,11
1990,535,"Bonaire, Sint Eustatius and Saba",Spain,15,8,7
1990,136,Cayman Islands,Spain,8,4,4
1990,192,Cuba,Spain,10703,5394,5309
1990,214,Dominican Republic,Spain,7354,4743,2611
1990,332,Haiti,Spain,1297,824,473
1990,630,Puerto Rico,Spain,4542,2151,2391
1990,188,Costa Rica,Spain,1829,1038,791
1990,222,El Salvador,Spain,855,498,357
1990,320,Guatemala,Spain,944,406,538
1990,340,Honduras,Spain,371,217,154
1990,484,Mexico,Spain,24620,13473,11147
1990,558,Nicaragua,Spain,557,317,240
1990,591,Panama,Spain,2506,1579,927
1990,32,Argentina,Spain,229535,101638,127897
1990,68,Bolivia (Plurinational State of),Spain,1644,822,822
1990,76,Brazil,Spain,59188,32204,26984
1990,152,Chile,Spain,9710,5190,4520
1990,170,Colombia,Spain,5631,3108,2523
1990,218,Ecuador,Spain,2013,1048,965
1990,600,Paraguay,Spain,1114,639,475
1990,604,Peru,Spain,3165,1683,1482
1990,858,Uruguay,Spain,34478,16611,17867
1990,862,Venezuela (Bolivarian Republic of),Spain,109078,59040,50038
1990,36,Australia,Spain,15097,8181,6916
1990,540,New Caledonia,Spain,94,51,43
1990,258,French Polynesia,Spain,72,55,17
1990,112,Belarus,Spain,31,19,12
1990,100,Bulgaria,Spain,18,10,8
1990,203,Czechia,Spain,42,25,17
1990,348,Hungary,Spain,54,24,30
1990,616,Poland,Spain,1577,862,715
1990,642,Romania,Spain,106,42,64
1990,643,Russian Federation,Spain,840,412,428
1990,703,Slovakia,Spain,10,5,5
1990,208,Denmark,Spain,1525,821,704
1990,246,Finland,Spain,502,321,181
1990,352,Iceland,Spain,105,63,42
1990,372,Ireland,Spain,499,246,253
1990,428,Latvia,Spain,18,8,10
1990,440,Lithuania,Spain,1450,835,615
1990,578,Norway,Spain,1321,811,510
1990,752,Sweden,Spain,3990,2373,1617
1990,826,United Kingdom,Spain,37827,16147,21680
1990,20,Andorra,Spain,27103,14498,12605
1990,292,Gibraltar,Spain,2392,665,1727
1990,300,Greece,Spain,2586,1113,1473
1990,380,Italy,Spain,26557,3629,22928
1990,470,Malta,Spain,11,5,6
1990,620,Portugal,Spain,11027,4327,6700
1990,688,Serbia,Spain,19,11,8
1990,705,Slovenia,Spain,128,64,64
1990,40,Austria,Spain,2271,1042,1229
1990,56,Belgium,Spain,41437,20332,21105
1990,250,France,Spain,433748,198881,234867
1990,276,Germany,Spain,142457,82288,60169
1990,438,Liechtenstein,Spain,191,105,86
1990,442,Luxembourg,Spain,1911,981,930
1990,528,Netherlands,Spain,17357,9176,8181
1990,756,Switzerland,Spain,54716,28761,25955
1990,60,Bermuda,Spain,94,65,29
1990,124,Canada,Spain,10713,5216,5497
1990,840,United States of America,Spain,76415,22953,53462
1995,480,Mauritius,Spain,7,5,2
1995,690,Seychelles,Spain,10,5,5
1995,800,Uganda,Spain,55,20,35
1995,226,Equatorial Guinea,Spain,429,249,180
1995,516,Namibia,Spain,485,286,199
1995,710,South Africa,Spain,478,240,238
1995,132,Cabo Verde,Spain,40,20,20
1995,324,Guinea,Spain,68,36,32
1995,430,Liberia,Spain,279,151,128
1995,478,Mauritania,Spain,82,45,37
1995,818,Egypt,Spain,362,189,173
1995,434,Libya,Spain,900,480,420
1995,504,Morocco,Spain,2571,1341,1230
1995,196,Cyprus,Spain,55,15,40
1995,376,Israel,Spain,3065,1320,1745
1995,400,Jordan,Spain,326,128,198
1995,792,Turkey,Spain,707,341,366
1995,144,Sri Lanka,Spain,3,3,0
1995,344,"China, Hong Kong SAR",Spain,300,159,141
1995,392,Japan,Spain,1146,550,596
1995,608,Philippines,Spain,345,163,182
1995,28,Antigua and Barbuda,Spain,8,4,4
1995,44,Bahamas,Spain,40,28,12
1995,535,"Bonaire, Sint Eustatius and Saba",Spain,30,15,15
1995,136,Cayman Islands,Spain,16,7,9
1995,192,Cuba,Spain,8112,3922,4190
1995,214,Dominican Republic,Spain,8168,5198,2970
1995,332,Haiti,Spain,1232,783,449
1995,630,Puerto Rico,Spain,4168,1976,2192
1995,188,Costa Rica,Spain,1392,798,594
1995,222,El Salvador,Spain,664,384,280
1995,320,Guatemala,Spain,889,438,451
1995,340,Honduras,Spain,381,217,164
1995,484,Mexico,Spain,22491,12178,10313
1995,558,Nicaragua,Spain,442,250,192
1995,591,Panama,Spain,2432,1525,907
1995,32,Argentina,Spain,179945,79509,100436
1995,68,Bolivia (Plurinational State of),Spain,1651,822,829
1995,76,Brazil,Spain,51448,27897,23551
1995,152,Chile,Spain,9183,4771,4412
1995,170,Colombia,Spain,5620,3068,2552
1995,218,Ecuador,Spain,2556,1313,1243
1995,600,Paraguay,Spain,1057,611,446
1995,604,Peru,Spain,3168,1666,1502
1995,858,Uruguay,Spain,29447,13758,15689
1995,862,Venezuela (Bolivarian Republic of),Spain,92458,49441,43017
1995,36,Australia,Spain,15025,8114,6911
1995,540,New Caledonia,Spain,109,59,50
1995,258,French Polynesia,Spain,79,60,19
1995,112,Belarus,Spain,34,18,16
1995,100,Bulgaria,Spain,346,185,161
1995,203,Czechia,Spain,63,38,25
1995,348,Hungary,Spain,437,218,219
1995,616,Poland,Spain,1348,728,620
1995,642,Romania,Spain,158,79,79
1995,643,Russian Federation,Spain,850,432,418
1995,703,Slovakia,Spain,240,122,118
1995,208,Denmark,Spain,2136,1121,1015
1995,246,Finland,Spain,579,370,209
1995,352,Iceland,Spain,130,79,51
1995,372,Ireland,Spain,1765,842,923
1995,428,Latvia,Spain,17,9,8
1995,440,Lithuania,Spain,935,538,397
1995,578,Norway,Spain,1403,826,577
1995,752,Sweden,Spain,4736,2802,1934
1995,826,United Kingdom,Spain,44874,18838,26036
1995,20,Andorra,Spain,26972,14286,12686
1995,191,Croatia,Spain,31,9,22
1995,292,Gibraltar,Spain,2235,641,1594
1995,300,Greece,Spain,1760,695,1065
1995,380,Italy,Spain,23051,3449,19602
1995,470,Malta,Spain,14,6,8
1995,620,Portugal,Spain,12207,4834,7373
1995,688,Serbia,Spain,122,69,53
1995,705,Slovenia,Spain,278,113,165
1995,40,Austria,Spain,2562,1198,1364
1995,56,Belgium,Spain,38946,19953,18993
1995,250,France,Spain,447770,201230,246540
1995,276,Germany,Spain,133808,72506,61302
1995,438,Liechtenstein,Spain,391,205,186
1995,442,Luxembourg,Spain,2142,1061,1081
1995,528,Netherlands,Spain,17326,9023,8303
1995,756,Switzerland,Spain,47536,25323,22213
1995,60,Bermuda,Spain,102,73,29
1995,124,Canada,Spain,10509,5093,5416
1995,840,United States of America,Spain,80702,23859,56843
2000,480,Mauritius,Spain,3,2,1
2000,690,Seychelles,Spain,10,3,7
2000,800,Uganda,Spain,55,18,37
2000,226,Equatorial Guinea,Spain,534,309,225
2000,516,Namibia,Spain,452,267,185
2000,710,South Africa,Spain,613,327,286
2000,132,Cabo Verde,Spain,50,26,24
2000,324,Guinea,Spain,73,38,35
2000,430,Liberia,Spain,275,145,130
2000,478,Mauritania,Spain,84,50,34
2000,818,Egypt,Spain,303,151,152
2000,434,Libya,Spain,534,287,247
2000,504,Morocco,Spain,2708,1391,1317
2000,196,Cyprus,Spain,71,19,52
2000,268,Georgia,Spain,20,10,10
2000,376,Israel,Spain,2829,1217,1612
2000,400,Jordan,Spain,370,150,220
2000,792,Turkey,Spain,1126,536,590
2000,144,Sri Lanka,Spain,8,5,3
2000,344,"China, Hong Kong SAR",Spain,331,175,156
2000,392,Japan,Spain,1338,618,720
2000,608,Philippines,Spain,83,35,48
2000,28,Antigua and Barbuda,Spain,10,5,5
2000,44,Bahamas,Spain,49,36,13
2000,535,"Bonaire, Sint Eustatius and Saba",Spain,46,23,23
2000,136,Cayman Islands,Spain,29,12,17
2000,192,Cuba,Spain,5521,2450,3071
2000,214,Dominican Republic,Spain,8982,5653,3329
2000,332,Haiti,Spain,1170,744,426
2000,630,Puerto Rico,Spain,3806,1807,1999
2000,188,Costa Rica,Spain,1650,932,718
2000,222,El Salvador,Spain,473,271,202
2000,320,Guatemala,Spain,833,469,364
2000,340,Honduras,Spain,391,218,173
2000,484,Mexico,Spain,21334,11468,9866
2000,558,Nicaragua,Spain,415,234,181
2000,591,Panama,Spain,2512,1561,951
2000,32,Argentina,Spain,130356,57382,72974
2000,68,Bolivia (Plurinational State of),Spain,1641,814,827
2000,76,Brazil,Spain,43708,23590,20118
2000,152,Chile,Spain,8648,4470,4178
2000,170,Colombia,Spain,5608,3027,2581
2000,218,Ecuador,Spain,3099,1579,1520
2000,600,Paraguay,Spain,998,578,420
2000,604,Peru,Spain,3702,1945,1757
2000,858,Uruguay,Spain,24303,11133,13170
2000,862,Venezuela (Bolivarian Republic of),Spain,77650,40970,36680
2000,36,Australia,Spain,14170,7448,6722
2000,540,New Caledonia,Spain,124,66,58
2000,258,French Polynesia,Spain,85,64,21
2000,112,Belarus,Spain,37,18,19
2000,100,Bulgaria,Spain,674,360,314
2000,203,Czechia,Spain,84,52,32
2000,348,Hungary,Spain,819,411,408
2000,616,Poland,Spain,1153,614,539
2000,642,Romania,Spain,213,116,97
2000,643,Russian Federation,Spain,831,437,394
2000,703,Slovakia,Spain,537,273,264
2000,208,Denmark,Spain,2747,1421,1326
2000,246,Finland,Spain,655,419,236
2000,352,Iceland,Spain,154,95,59
2000,372,Ireland,Spain,4000,1974,2026
2000,428,Latvia,Spain,17,11,6
2000,440,Lithuania,Spain,732,421,311
2000,578,Norway,Spain,1610,910,700
2000,752,Sweden,Spain,5079,2991,2088
2000,826,United Kingdom,Spain,52676,21778,30898
2000,20,Andorra,Spain,26841,14066,12775
2000,191,Croatia,Spain,59,17,42
2000,292,Gibraltar,Spain,2077,616,1461
2000,300,Greece,Spain,963,270,693
2000,380,Italy,Spain,19545,3269,16276
2000,470,Malta,Spain,35,15,20
2000,620,Portugal,Spain,13884,5566,8318
2000,688,Serbia,Spain,167,93,74
2000,705,Slovenia,Spain,30,10,20
2000,40,Austria,Spain,2853,1354,1499
2000,56,Belgium,Spain,34629,17035,17594
2000,250,France,Spain,461791,203579,258212
2000,276,Germany,Spain,125158,62724,62434
2000,438,Liechtenstein,Spain,585,299,286
2000,442,Luxembourg,Spain,2397,1154,1243
2000,528,Netherlands,Spain,17910,9168,8742
2000,756,Switzerland,Spain,40529,22041,18488
2000,60,Bermuda,Spain,109,80,29
2000,124,Canada,Spain,10554,5091,5463
2000,840,United States of America,Spain,84962,24814,60148
2005,480,Mauritius,Spain,13,9,4
2005,690,Seychelles,Spain,16,4,12
2005,800,Uganda,Spain,53,17,36
2005,226,Equatorial Guinea,Spain,779,458,321
2005,516,Namibia,Spain,357,210,147
2005,710,South Africa,Spain,805,413,392
2005,132,Cabo Verde,Spain,94,45,49
2005,324,Guinea,Spain,511,302,209
2005,430,Liberia,Spain,124,82,42
2005,478,Mauritania,Spain,84,52,32
2005,818,Egypt,Spain,361,191,170
2005,434,Libya,Spain,588,365,223
2005,504,Morocco,Spain,2777,1407,1370
2005,196,Cyprus,Spain,104,27,77
2005,268,Georgia,Spain,18,9,9
2005,376,Israel,Spain,2317,1005,1312
2005,400,Jordan,Spain,534,255,279
2005,792,Turkey,Spain,1160,539,621
2005,144,Sri Lanka,Spain,17,7,10
2005,344,"China, Hong Kong SAR",Spain,362,184,178
2005,392,Japan,Spain,1799,819,980
2005,608,Philippines,Spain,67,29,38
2005,28,Antigua and Barbuda,Spain,11,5,6
2005,44,Bahamas,Spain,76,59,17
2005,535,"Bonaire, Sint Eustatius and Saba",Spain,49,25,24
2005,136,Cayman Islands,Spain,27,11,16
2005,192,Cuba,Spain,3698,1642,2056
2005,214,Dominican Republic,Spain,7864,4884,2980
2005,332,Haiti,Spain,1111,707,404
2005,630,Puerto Rico,Spain,3281,1556,1725
2005,188,Costa Rica,Spain,1081,605,476
2005,222,El Salvador,Spain,493,281,212
2005,320,Guatemala,Spain,991,593,398
2005,340,Honduras,Spain,383,215,168
2005,484,Mexico,Spain,19878,10577,9301
2005,558,Nicaragua,Spain,400,224,176
2005,591,Panama,Spain,2766,1715,1051
2005,32,Argentina,Spain,107663,46867,60796
2005,68,Bolivia (Plurinational State of),Spain,6059,3190,2869
2005,76,Brazil,Spain,37357,20296,17061
2005,152,Chile,Spain,9969,5218,4751
2005,170,Colombia,Spain,5428,2931,2497
2005,218,Ecuador,Spain,3658,1902,1756
2005,600,Paraguay,Spain,950,550,400
2005,604,Peru,Spain,4349,2309,2040
2005,858,Uruguay,Spain,16957,7768,9189
2005,862,Venezuela (Bolivarian Republic of),Spain,75453,40372,35081
2005,36,Australia,Spain,14320,7399,6921
2005,540,New Caledonia,Spain,132,71,61
2005,258,French Polynesia,Spain,88,67,21
2005,112,Belarus,Spain,36,18,18
2005,100,Bulgaria,Spain,1109,605,504
2005,203,Czechia,Spain,306,205,101
2005,348,Hungary,Spain,1012,517,495
2005,616,Poland,Spain,3029,1564,1465
2005,642,Romania,Spain,3504,1836,1668
2005,643,Russian Federation,Spain,1110,593,517
2005,703,Slovakia,Spain,603,312,291
2005,208,Denmark,Spain,3645,1887,1758
2005,246,Finland,Spain,1191,742,449
2005,352,Iceland,Spain,224,132,92
2005,372,Ireland,Spain,6314,2713,3601
2005,428,Latvia,Spain,107,68,39
2005,440,Lithuania,Spain,745,439,306
2005,578,Norway,Spain,1841,1022,819
2005,752,Sweden,Spain,5606,3225,2381
2005,826,United Kingdom,Spain,64301,27726,36575
2005,20,Andorra,Spain,28450,15018,13432
2005,191,Croatia,Spain,123,48,75
2005,292,Gibraltar,Spain,2010,660,1350
2005,300,Greece,Spain,1085,337,748
2005,380,Italy,Spain,25685,6351,19334
2005,470,Malta,Spain,56,24,32
2005,620,Portugal,Spain,15191,6369,8822
2005,688,Serbia,Spain,165,91,74
2005,705,Slovenia,Spain,43,19,24
2005,40,Austria,Spain,3189,1473,1716
2005,56,Belgium,Spain,34140,17107,17033
2005,250,France,Spain,306067,134888,171179
2005,276,Germany,Spain,101503,50266,51237
2005,438,Liechtenstein,Spain,429,226,203
2005,442,Luxembourg,Spain,2495,1201,1294
2005,528,Netherlands,Spain,18379,9058,9321
2005,756,Switzerland,Spain,46561,24422,22139
2005,60,Bermuda,Spain,119,78,41
2005,124,Canada,Spain,9876,4961,4915
2005,840,United States of America,Spain,86286,25537,60749
2010,480,Mauritius,Spain,24,15,9
2010,690,Seychelles,Spain,22,5,17
2010,800,Uganda,Spain,53,17,36
2010,226,Equatorial Guinea,Spain,1023,607,416
2010,516,Namibia,Spain,344,203,141
2010,710,South Africa,Spain,1260,645,615
2010,132,Cabo Verde,Spain,138,65,73
2010,324,Guinea,Spain,1022,603,419
2010,430,Liberia,Spain,57,27,30
2010,478,Mauritania,Spain,84,53,31
2010,818,Egypt,Spain,390,200,190
2010,434,Libya,Spain,644,402,242
2010,504,Morocco,Spain,3108,1567,1541
2010,196,Cyprus,Spain,170,46,124
2010,268,Georgia,Spain,18,9,9
2010,376,Israel,Spain,1833,802,1031
2010,400,Jordan,Spain,687,349,338
2010,792,Turkey,Spain,1195,541,654
2010,144,Sri Lanka,Spain,36,16,20
2010,344,"China, Hong Kong SAR",Spain,393,192,201
2010,392,Japan,Spain,1907,857,1050
2010,608,Philippines,Spain,1284,515,769
2010,28,Antigua and Barbuda,Spain,11,5,6
2010,44,Bahamas,Spain,102,81,21
2010,535,"Bonaire, Sint Eustatius and Saba",Spain,15,8,7
2010,136,Cayman Islands,Spain,28,12,16
2010,192,Cuba,Spain,2057,908,1149
2010,531,Curaçao,Spain,19,7,12
2010,214,Dominican Republic,Spain,6691,4082,2609
2010,332,Haiti,Spain,1166,742,424
2010,630,Puerto Rico,Spain,2344,1099,1245
2010,188,Costa Rica,Spain,2130,1194,936
2010,222,El Salvador,Spain,512,291,221
2010,320,Guatemala,Spain,1148,717,431
2010,340,Honduras,Spain,374,212,162
2010,484,Mexico,Spain,20727,10928,9799
2010,558,Nicaragua,Spain,427,241,186
2010,591,Panama,Spain,3152,1966,1186
2010,32,Argentina,Spain,84969,36351,48618
2010,68,Bolivia (Plurinational State of),Spain,10463,5558,4905
2010,76,Brazil,Spain,30469,16690,13779
2010,152,Chile,Spain,11286,5965,5321
2010,170,Colombia,Spain,6188,3379,2809
2010,218,Ecuador,Spain,5138,2608,2530
2010,600,Paraguay,Spain,905,524,381
2010,604,Peru,Spain,5483,3012,2471
2010,858,Uruguay,Spain,15718,7124,8594
2010,862,Venezuela (Bolivarian Republic of),Spain,74051,40173,33878
2010,36,Australia,Spain,14890,7552,7338
2010,540,New Caledonia,Spain,140,75,65
2010,258,French Polynesia,Spain,85,65,20
2010,112,Belarus,Spain,34,17,17
2010,100,Bulgaria,Spain,1497,823,674
2010,203,Czechia,Spain,498,343,155
2010,348,Hungary,Spain,1205,623,582
2010,616,Poland,Spain,5000,2553,2447
2010,642,Romania,Spain,7333,3815,3518
2010,643,Russian Federation,Spain,1368,737,631
2010,703,Slovakia,Spain,676,354,322
2010,208,Denmark,Spain,4462,2313,2149
2010,233,Estonia,Spain,164,104,60
2010,246,Finland,Spain,2007,1179,828
2010,352,Iceland,Spain,293,169,124
2010,372,Ireland,Spain,7588,2548,5040
2010,428,Latvia,Spain,196,123,73
2010,440,Lithuania,Spain,658,383,275
2010,578,Norway,Spain,2684,1476,1208
2010,752,Sweden,Spain,6763,3867,2896
2010,826,United Kingdom,Spain,67738,29999,37739
2010,20,Andorra,Spain,25929,13692,12237
2010,191,Croatia,Spain,187,80,107
2010,292,Gibraltar,Spain,1942,703,1239
2010,300,Greece,Spain,1255,421,834
2010,380,Italy,Spain,33117,9637,23480
2010,470,Malta,Spain,123,62,61
2010,620,Portugal,Spain,13976,6133,7843
2010,688,Serbia,Spain,162,89,73
2010,705,Slovenia,Spain,106,58,48
2010,40,Austria,Spain,3524,1592,1932
2010,56,Belgium,Spain,36993,16792,20201
2010,250,France,Spain,285868,122435,163433
2010,276,Germany,Spain,81357,39151,42206
2010,438,Liechtenstein,Spain,274,152,122
2010,442,Luxembourg,Spain,2621,1261,1360
2010,528,Netherlands,Spain,19544,9409,10135
2010,756,Switzerland,Spain,53545,26410,27135
2010,60,Bermuda,Spain,129,76,53
2010,124,Canada,Spain,9060,4760,4300
2010,840,United States of America,Spain,90296,25850,64446
2015,480,Mauritius,Spain,27,18,9
2015,690,Seychelles,Spain,24,6,18
2015,800,Uganda,Spain,53,17,36
2015,226,Equatorial Guinea,Spain,1279,765,514
2015,516,Namibia,Spain,336,199,137
2015,710,South Africa,Spain,2271,1107,1164
2015,132,Cabo Verde,Spain,143,67,76
2015,324,Guinea,Spain,1187,700,487
2015,430,Liberia,Spain,65,31,34
2015,478,Mauritania,Spain,84,54,30
2015,818,Egypt,Spain,289,167,122
2015,434,Libya,Spain,726,450,276
2015,504,Morocco,Spain,4051,2034,2017
2015,196,Cyprus,Spain,163,45,118
2015,268,Georgia,Spain,18,9,9
2015,376,Israel,Spain,1890,822,1068
2015,400,Jordan,Spain,295,117,178
2015,792,Turkey,Spain,1213,535,678
2015,144,Sri Lanka,Spain,35,15,20
2015,344,"China, Hong Kong SAR",Spain,401,188,213
2015,392,Japan,Spain,2495,1113,1382
2015,608,Philippines,Spain,1305,526,779
2015,28,Antigua and Barbuda,Spain,12,6,6
2015,44,Bahamas,Spain,111,88,23
2015,535,"Bonaire, Sint Eustatius and Saba",Spain,17,10,7
2015,136,Cayman Islands,Spain,29,13,16
2015,192,Cuba,Spain,1645,717,928
2015,531,Curaçao,Spain,20,7,13
2015,214,Dominican Republic,Spain,6967,4349,2618
2015,332,Haiti,Spain,1224,779,445
2015,630,Puerto Rico,Spain,1816,847,969
2015,188,Costa Rica,Spain,2163,1207,956
2015,222,El Salvador,Spain,534,304,230
2015,320,Guatemala,Spain,1320,831,489
2015,340,Honduras,Spain,525,299,226
2015,484,Mexico,Spain,22880,12738,10142
2015,558,Nicaragua,Spain,460,261,199
2015,591,Panama,Spain,3702,2305,1397
2015,32,Argentina,Spain,98050,41914,56136
2015,68,Bolivia (Plurinational State of),Spain,12181,6470,5711
2015,76,Brazil,Spain,36691,19998,16693
2015,152,Chile,Spain,17097,8862,8235
2015,170,Colombia,Spain,6928,3814,3114
2015,218,Ecuador,Spain,7473,3767,3706
2015,600,Paraguay,Spain,883,511,372
2015,604,Peru,Spain,6648,3667,2981
2015,858,Uruguay,Spain,16232,7353,8879
2015,862,Venezuela (Bolivarian Republic of),Spain,74582,39979,34603
2015,36,Australia,Spain,17730,9059,8671
2015,540,New Caledonia,Spain,107,52,55
2015,258,French Polynesia,Spain,80,61,19
2015,112,Belarus,Spain,35,16,19
2015,100,Bulgaria,Spain,5240,2776,2464
2015,203,Czechia,Spain,962,681,281
2015,348,Hungary,Spain,1912,1016,896
2015,616,Poland,Spain,4820,2506,2314
2015,642,Romania,Spain,29937,15458,14479
2015,643,Russian Federation,Spain,1394,747,647
2015,703,Slovakia,Spain,885,497,388
2015,208,Denmark,Spain,6133,3170,2963
2015,233,Estonia,Spain,393,231,162
2015,246,Finland,Spain,3318,1911,1407
2015,352,Iceland,Spain,540,320,220
2015,372,Ireland,Spain,7751,2539,5212
2015,428,Latvia,Spain,148,96,52
2015,440,Lithuania,Spain,630,364,266
2015,578,Norway,Spain,6308,3417,2891
2015,752,Sweden,Spain,10199,5695,4504
2015,826,United Kingdom,Spain,86626,36933,49693
2015,20,Andorra,Spain,20577,10143,10434
2015,191,Croatia,Spain,188,80,108
2015,292,Gibraltar,Spain,2072,767,1305
2015,300,Greece,Spain,1177,361,816
2015,380,Italy,Spain,31013,9183,21830
2015,470,Malta,Spain,209,112,97
2015,620,Portugal,Spain,15843,6495,9348
2015,688,Serbia,Spain,158,87,71
2015,705,Slovenia,Spain,463,196,267
2015,40,Austria,Spain,4122,1875,2247
2015,56,Belgium,Spain,46030,21377,24653
2015,250,France,Spain,286484,127234,159250
2015,276,Germany,Spain,84770,40689,44081
2015,438,Liechtenstein,Spain,275,150,125
2015,442,Luxembourg,Spain,3998,1956,2042
2015,528,Netherlands,Spain,24734,11974,12760
2015,756,Switzerland,Spain,69181,35181,34000
2015,60,Bermuda,Spain,130,77,53
2015,124,Canada,Spain,10634,5519,5115
2015,840,United States of America,Spain,111685,31566,80119
2019,480,Mauritius,Spain,27,18,9
2019,690,Seychelles,Spain,24,6,18
2019,800,Uganda,Spain,53,17,36
2019,226,Equatorial Guinea,Spain,1406,841,565
2019,516,Namibia,Spain,355,210,145
2019,710,South Africa,Spain,2545,1242,1303
2019,132,Cabo Verde,Spain,150,71,79
2019,324,Guinea,Spain,1133,669,464
2019,430,Liberia,Spain,53,25,28
2019,478,Mauritania,Spain,87,56,31
2019,818,Egypt,Spain,411,217,194
2019,434,Libya,Spain,770,478,292
2019,504,Morocco,Spain,4320,2170,2150
2019,196,Cyprus,Spain,162,46,116
2019,268,Georgia,Spain,18,9,9
2019,376,Israel,Spain,1837,799,1038
2019,400,Jordan,Spain,317,126,191
2019,792,Turkey,Spain,1640,733,907
2019,144,Sri Lanka,Spain,35,15,20
2019,344,"China, Hong Kong SAR",Spain,519,235,284
2019,392,Japan,Spain,2883,1287,1596
2019,608,Philippines,Spain,1346,543,803
2019,28,Antigua and Barbuda,Spain,12,6,6
2019,44,Bahamas,Spain,117,93,24
2019,535,"Bonaire, Sint Eustatius and Saba",Spain,20,12,8
2019,136,Cayman Islands,Spain,32,15,17
2019,192,Cuba,Spain,1513,656,857
2019,531,Curaçao,Spain,21,7,14
2019,214,Dominican Republic,Spain,7199,4494,2705
2019,332,Haiti,Spain,1272,810,462
2019,630,Puerto Rico,Spain,2811,1306,1505
2019,188,Costa Rica,Spain,2194,1231,963
2019,222,El Salvador,Spain,541,308,233
2019,320,Guatemala,Spain,1354,853,501
2019,340,Honduras,Spain,533,304,229
2019,484,Mexico,Spain,23589,13133,10456
2019,558,Nicaragua,Spain,481,273,208
2019,591,Panama,Spain,3941,2454,1487
2019,32,Argentina,Spain,99769,42555,57214
2019,68,Bolivia (Plurinational State of),Spain,13299,7064,6235
2019,76,Brazil,Spain,41321,22522,18799
2019,152,Chile,Spain,22842,11227,11615
2019,170,Colombia,Spain,7086,3901,3185
2019,218,Ecuador,Spain,7357,3707,3650
2019,600,Paraguay,Spain,905,524,381
2019,604,Peru,Spain,7723,4404,3319
2019,858,Uruguay,Spain,16784,7630,9154
2019,862,Venezuela (Bolivarian Republic of),Spain,73054,39008,34046
2019,36,Australia,Spain,19594,9887,9707
2019,540,New Caledonia,Spain,112,54,58
2019,258,French Polynesia,Spain,83,64,19
2019,112,Belarus,Spain,34,16,18
2019,100,Bulgaria,Spain,7098,3754,3344
2019,203,Czechia,Spain,1147,815,332
2019,348,Hungary,Spain,2240,1162,1078
2019,616,Poland,Spain,5104,2748,2356
2019,642,Romania,Spain,46238,24052,22186
2019,643,Russian Federation,Spain,1393,747,646
2019,703,Slovakia,Spain,1111,634,477
2019,208,Denmark,Spain,7937,4117,3820
2019,233,Estonia,Spain,486,286,200
2019,246,Finland,Spain,3898,2257,1641
2019,352,Iceland,Spain,768,454,314
2019,372,Ireland,Spain,8509,2805,5704
2019,428,Latvia,Spain,160,103,57
2019,440,Lithuania,Spain,648,365,283
2019,578,Norway,Spain,7455,4074,3381
2019,752,Sweden,Spain,13235,7341,5894
2019,826,United Kingdom,Spain,98372,42083,56289
2019,20,Andorra,Spain,21958,10906,11052
2019,191,Croatia,Spain,173,73,100
2019,292,Gibraltar,Spain,2092,775,1317
2019,300,Greece,Spain,1149,383,766
2019,380,Italy,Spain,34345,10918,23427
2019,470,Malta,Spain,337,182,155
2019,620,Portugal,Spain,16112,6626,9486
2019,688,Serbia,Spain,160,88,72
2019,705,Slovenia,Spain,182,98,84
2019,40,Austria,Spain,4865,2259,2606
2019,56,Belgium,Spain,49889,23490,26399
2019,250,France,Spain,303245,134293,168952
2019,276,Germany,Spain,155083,80275,74808
2019,438,Liechtenstein,Spain,286,153,133
2019,442,Luxembourg,Spain,5650,2851,2799
2019,528,Netherlands,Spain,29337,14370,14967
2019,756,Switzerland,Spain,70467,35782,34685
2019,60,Bermuda,Spain,131,78,53
2019,124,Canada,Spain,11395,5914,5481
2019,840,United States of America,Spain,120608,33157,87451
1990,480,Mauritius,Sri Lanka,9,2,7
1990,690,Seychelles,Sri Lanka,316,179,137
1990,72,Botswana,Sri Lanka,398,211,187
1990,710,South Africa,Sri Lanka,963,399,564
1990,288,Ghana,Sri Lanka,15,8,7
1990,818,Egypt,Sri Lanka,249,151,98
1990,434,Libya,Sri Lanka,710,432,278
1990,48,Bahrain,Sri Lanka,5863,1544,4319
1990,196,Cyprus,Sri Lanka,2457,558,1899
1990,400,Jordan,Sri Lanka,11062,131,10931
1990,414,Kuwait,Sri Lanka,36364,3636,32728
1990,422,Lebanon,Sri Lanka,5054,60,4994
1990,512,Oman,Sri Lanka,13996,4573,9423
1990,634,Qatar,Sri Lanka,932,600,332
1990,682,Saudi Arabia,Sri Lanka,200579,133422,67157
1990,792,Turkey,Sri Lanka,18,17,1
1990,784,United Arab Emirates,Sri Lanka,44420,11333,33087
1990,64,Bhutan,Sri Lanka,15,8,7
1990,356,India,Sri Lanka,281720,143161,138559
1990,462,Maldives,Sri Lanka,4289,2359,1930
1990,524,Nepal,Sri Lanka,78,44,34
1990,586,Pakistan,Sri Lanka,889,464,425
1990,156,China,Sri Lanka,3026,820,2206
1990,344,"China, Hong Kong SAR",Sri Lanka,524,208,316
1990,408,Dem. People's Republic of Korea,Sri Lanka,120,24,96
1990,392,Japan,Sri Lanka,1206,614,592
1990,410,Republic of Korea,Sri Lanka,60,46,14
1990,96,Brunei Darussalam,Sri Lanka,676,251,425
1990,116,Cambodia,Sri Lanka,22,16,6
1990,458,Malaysia,Sri Lanka,1194,777,417
1990,608,Philippines,Sri Lanka,43,28,15
1990,702,Singapore,Sri Lanka,5788,2649,3139
1990,764,Thailand,Sri Lanka,3781,2029,1752
1990,704,Viet Nam,Sri Lanka,46,24,22
1990,44,Bahamas,Sri Lanka,24,13,11
1990,188,Costa Rica,Sri Lanka,1,1,0
1990,32,Argentina,Sri Lanka,6,6,0
1990,152,Chile,Sri Lanka,6,1,5
1990,36,Australia,Sri Lanka,46660,23966,22694
1990,554,New Zealand,Sri Lanka,2298,1205,1093
1990,598,Papua New Guinea,Sri Lanka,118,73,45
1990,100,Bulgaria,Sri Lanka,2,2,0
1990,203,Czechia,Sri Lanka,8,6,2
1990,348,Hungary,Sri Lanka,47,28,19
1990,616,Poland,Sri Lanka,35,24,11
1990,642,Romania,Sri Lanka,1,1,0
1990,643,Russian Federation,Sri Lanka,1020,501,519
1990,208,Denmark,Sri Lanka,5014,2923,2091
1990,246,Finland,Sri Lanka,159,73,86
1990,352,Iceland,Sri Lanka,83,26,57
1990,372,Ireland,Sri Lanka,46,27,19
1990,428,Latvia,Sri Lanka,31,13,18
1990,578,Norway,Sri Lanka,4707,3273,1434
1990,752,Sweden,Sri Lanka,4599,2040,2559
1990,826,United Kingdom,Sri Lanka,38424,20798,17626
1990,300,Greece,Sri Lanka,1344,744,600
1990,380,Italy,Sri Lanka,19974,11738,8236
1990,470,Malta,Sri Lanka,9,5,4
1990,620,Portugal,Sri Lanka,3,2,1
1990,724,Spain,Sri Lanka,45,24,21
1990,40,Austria,Sri Lanka,540,294,246
1990,56,Belgium,Sri Lanka,238,110,128
1990,250,France,Sri Lanka,33041,18074,14967
1990,276,Germany,Sri Lanka,38618,28423,10195
1990,528,Netherlands,Sri Lanka,4699,2660,2039
1990,756,Switzerland,Sri Lanka,18837,11383,7454
1990,124,Canada,Sri Lanka,24410,11884,12526
1990,840,United States of America,Sri Lanka,14022,7906,6116
1995,480,Mauritius,Sri Lanka,19,5,14
1995,690,Seychelles,Sri Lanka,391,246,145
1995,72,Botswana,Sri Lanka,480,252,228
1995,710,South Africa,Sri Lanka,600,277,323
1995,288,Ghana,Sri Lanka,15,9,6
1995,818,Egypt,Sri Lanka,199,117,82
1995,434,Libya,Sri Lanka,486,284,202
1995,48,Bahrain,Sri Lanka,5119,1791,3328
1995,196,Cyprus,Sri Lanka,3474,680,2794
1995,400,Jordan,Sri Lanka,13104,755,12349
1995,414,Kuwait,Sri Lanka,23883,5147,18736
1995,422,Lebanon,Sri Lanka,5965,45,5920
1995,512,Oman,Sri Lanka,14591,4929,9662
1995,634,Qatar,Sri Lanka,1033,701,332
1995,682,Saudi Arabia,Sri Lanka,205566,137099,68467
1995,792,Turkey,Sri Lanka,21,18,3
1995,784,United Arab Emirates,Sri Lanka,43576,16689,26887
1995,64,Bhutan,Sri Lanka,18,10,8
1995,356,India,Sri Lanka,235785,119180,116605
1995,462,Maldives,Sri Lanka,6212,3104,3108
1995,524,Nepal,Sri Lanka,98,10,88
1995,586,Pakistan,Sri Lanka,413,219,194
1995,156,China,Sri Lanka,3470,1038,2432
1995,344,"China, Hong Kong SAR",Sri Lanka,585,230,355
1995,408,Dem. People's Republic of Korea,Sri Lanka,126,28,98
1995,392,Japan,Sri Lanka,2832,1359,1473
1995,410,Republic of Korea,Sri Lanka,1258,936,322
1995,96,Brunei Darussalam,Sri Lanka,916,346,570
1995,116,Cambodia,Sri Lanka,58,42,16
1995,458,Malaysia,Sri Lanka,1366,891,475
1995,608,Philippines,Sri Lanka,57,37,20
1995,702,Singapore,Sri Lanka,5078,2334,2744
1995,764,Thailand,Sri Lanka,6348,3306,3042
1995,704,Viet Nam,Sri Lanka,114,62,52
1995,44,Bahamas,Sri Lanka,16,8,8
1995,188,Costa Rica,Sri Lanka,1,1,0
1995,32,Argentina,Sri Lanka,6,6,0
1995,68,Bolivia (Plurinational State of),Sri Lanka,3,2,1
1995,152,Chile,Sri Lanka,6,4,2
1995,36,Australia,Sri Lanka,52524,26666,25858
1995,554,New Zealand,Sri Lanka,3913,1990,1923
1995,598,Papua New Guinea,Sri Lanka,120,81,39
1995,100,Bulgaria,Sri Lanka,4,3,1
1995,203,Czechia,Sri Lanka,12,9,3
1995,348,Hungary,Sri Lanka,42,25,17
1995,616,Poland,Sri Lanka,30,21,9
1995,643,Russian Federation,Sri Lanka,941,525,416
1995,208,Denmark,Sri Lanka,6510,3490,3020
1995,246,Finland,Sri Lanka,232,122,110
1995,352,Iceland,Sri Lanka,93,30,63
1995,372,Ireland,Sri Lanka,127,73,54
1995,428,Latvia,Sri Lanka,21,12,9
1995,578,Norway,Sri Lanka,6122,3773,2349
1995,752,Sweden,Sri Lanka,5458,2398,3060
1995,826,United Kingdom,Sri Lanka,51624,28679,22945
1995,300,Greece,Sri Lanka,1069,511,558
1995,380,Italy,Sri Lanka,30976,16657,14319
1995,470,Malta,Sri Lanka,11,6,5
1995,620,Portugal,Sri Lanka,7,5,2
1995,724,Spain,Sri Lanka,69,38,31
1995,40,Austria,Sri Lanka,610,337,273
1995,56,Belgium,Sri Lanka,238,110,128
1995,250,France,Sri Lanka,34109,18398,15711
1995,276,Germany,Sri Lanka,43756,28020,15736
1995,528,Netherlands,Sri Lanka,6813,3790,3023
1995,756,Switzerland,Sri Lanka,20205,11874,8331
1995,124,Canada,Sri Lanka,56926,27513,29413
1995,840,United States of America,Sri Lanka,19905,11315,8590
2000,480,Mauritius,Sri Lanka,42,9,33
2000,690,Seychelles,Sri Lanka,467,314,153
2000,72,Botswana,Sri Lanka,613,321,292
2000,710,South Africa,Sri Lanka,415,225,190
2000,288,Ghana,Sri Lanka,17,9,8
2000,818,Egypt,Sri Lanka,164,91,73
2000,434,Libya,Sri Lanka,270,144,126
2000,48,Bahrain,Sri Lanka,4391,2002,2389
2000,196,Cyprus,Sri Lanka,4491,803,3688
2000,400,Jordan,Sri Lanka,15147,1435,13712
2000,414,Kuwait,Sri Lanka,20680,8871,11809
2000,422,Lebanon,Sri Lanka,6876,31,6845
2000,512,Oman,Sri Lanka,11085,4952,6133
2000,634,Qatar,Sri Lanka,980,698,282
2000,682,Saudi Arabia,Sri Lanka,211212,141163,70049
2000,792,Turkey,Sri Lanka,36,30,6
2000,784,United Arab Emirates,Sri Lanka,45340,22765,22575
2000,64,Bhutan,Sri Lanka,21,12,9
2000,356,India,Sri Lanka,189850,95199,94651
2000,462,Maldives,Sri Lanka,7720,4251,3469
2000,524,Nepal,Sri Lanka,87,20,67
2000,586,Pakistan,Sri Lanka,569,308,261
2000,156,China,Sri Lanka,3915,1256,2659
2000,344,"China, Hong Kong SAR",Sri Lanka,646,252,394
2000,408,Dem. People's Republic of Korea,Sri Lanka,132,33,99
2000,392,Japan,Sri Lanka,5655,2613,3042
2000,410,Republic of Korea,Sri Lanka,2858,2145,713
2000,96,Brunei Darussalam,Sri Lanka,1156,442,714
2000,116,Cambodia,Sri Lanka,93,67,26
2000,458,Malaysia,Sri Lanka,1927,1254,673
2000,608,Philippines,Sri Lanka,151,122,29
2000,702,Singapore,Sri Lanka,4860,2196,2664
2000,764,Thailand,Sri Lanka,10226,5191,5035
2000,704,Viet Nam,Sri Lanka,278,159,119
2000,44,Bahamas,Sri Lanka,9,5,4
2000,188,Costa Rica,Sri Lanka,1,1,0
2000,32,Argentina,Sri Lanka,6,6,0
2000,68,Bolivia (Plurinational State of),Sri Lanka,5,3,2
2000,152,Chile,Sri Lanka,7,4,3
2000,36,Australia,Sri Lanka,58210,29578,28632
2000,554,New Zealand,Sri Lanka,6001,2917,3084
2000,598,Papua New Guinea,Sri Lanka,89,68,21
2000,100,Bulgaria,Sri Lanka,5,4,1
2000,203,Czechia,Sri Lanka,15,11,4
2000,348,Hungary,Sri Lanka,36,21,15
2000,616,Poland,Sri Lanka,26,18,8
2000,642,Romania,Sri Lanka,1,1,0
2000,643,Russian Federation,Sri Lanka,829,530,299
2000,208,Denmark,Sri Lanka,8005,4057,3948
2000,246,Finland,Sri Lanka,304,170,134
2000,352,Iceland,Sri Lanka,102,34,68
2000,372,Ireland,Sri Lanka,278,163,115
2000,428,Latvia,Sri Lanka,12,11,1
2000,578,Norway,Sri Lanka,7295,3966,3329
2000,752,Sweden,Sri Lanka,5854,2550,3304
2000,826,United Kingdom,Sri Lanka,65693,36983,28710
2000,300,Greece,Sri Lanka,811,275,536
2000,380,Italy,Sri Lanka,41977,21576,20401
2000,470,Malta,Sri Lanka,13,8,5
2000,620,Portugal,Sri Lanka,12,7,5
2000,705,Slovenia,Sri Lanka,7,5,2
2000,724,Spain,Sri Lanka,838,492,346
2000,40,Austria,Sri Lanka,679,379,300
2000,56,Belgium,Sri Lanka,230,106,124
2000,250,France,Sri Lanka,35177,18722,16455
2000,276,Germany,Sri Lanka,48894,27617,21277
2000,528,Netherlands,Sri Lanka,9156,5039,4117
2000,756,Switzerland,Sri Lanka,21648,12433,9215
2000,124,Canada,Sri Lanka,90795,43801,46994
2000,840,United States of America,Sri Lanka,25904,14805,11099
2005,480,Mauritius,Sri Lanka,496,103,393
2005,690,Seychelles,Sri Lanka,500,343,157
2005,72,Botswana,Sri Lanka,1029,533,496
2005,710,South Africa,Sri Lanka,545,283,262
2005,288,Ghana,Sri Lanka,24,13,11
2005,818,Egypt,Sri Lanka,195,113,82
2005,434,Libya,Sri Lanka,297,184,113
2005,48,Bahrain,Sri Lanka,6038,3073,2965
2005,196,Cyprus,Sri Lanka,6573,1141,5432
2005,400,Jordan,Sri Lanka,21878,4476,17402
2005,414,Kuwait,Sri Lanka,20373,9505,10868
2005,422,Lebanon,Sri Lanka,5382,242,5140
2005,512,Oman,Sri Lanka,9913,4482,5431
2005,634,Qatar,Sri Lanka,12231,7940,4291
2005,682,Saudi Arabia,Sri Lanka,260909,179368,81541
2005,792,Turkey,Sri Lanka,37,31,6
2005,784,United Arab Emirates,Sri Lanka,49194,26058,23136
2005,64,Bhutan,Sri Lanka,26,14,12
2005,356,India,Sri Lanka,175411,87758,87653
2005,462,Maldives,Sri Lanka,6929,3996,2933
2005,524,Nepal,Sri Lanka,76,14,62
2005,586,Pakistan,Sri Lanka,384,210,174
2005,156,China,Sri Lanka,4319,1695,2624
2005,344,"China, Hong Kong SAR",Sri Lanka,705,254,451
2005,408,Dem. People's Republic of Korea,Sri Lanka,136,39,97
2005,392,Japan,Sri Lanka,8580,3909,4671
2005,410,Republic of Korea,Sri Lanka,7941,7389,552
2005,96,Brunei Darussalam,Sri Lanka,1182,456,726
2005,116,Cambodia,Sri Lanka,73,53,20
2005,458,Malaysia,Sri Lanka,4186,2807,1379
2005,608,Philippines,Sri Lanka,122,99,23
2005,702,Singapore,Sri Lanka,6850,3025,3825
2005,764,Thailand,Sri Lanka,8375,4199,4176
2005,704,Viet Nam,Sri Lanka,151,91,60
2005,44,Bahamas,Sri Lanka,23,13,10
2005,188,Costa Rica,Sri Lanka,1,1,0
2005,32,Argentina,Sri Lanka,4,4,0
2005,68,Bolivia (Plurinational State of),Sri Lanka,4,3,1
2005,152,Chile,Sri Lanka,10,6,4
2005,36,Australia,Sri Lanka,70620,36037,34583
2005,554,New Zealand,Sri Lanka,6940,3369,3571
2005,598,Papua New Guinea,Sri Lanka,93,73,20
2005,100,Bulgaria,Sri Lanka,7,5,2
2005,203,Czechia,Sri Lanka,58,41,17
2005,348,Hungary,Sri Lanka,44,26,18
2005,616,Poland,Sri Lanka,56,30,26
2005,643,Russian Federation,Sri Lanka,709,432,277
2005,208,Denmark,Sri Lanka,8033,4019,4014
2005,246,Finland,Sri Lanka,514,290,224
2005,352,Iceland,Sri Lanka,134,48,86
2005,372,Ireland,Sri Lanka,278,169,109
2005,428,Latvia,Sri Lanka,26,19,7
2005,578,Norway,Sri Lanka,8235,4285,3950
2005,752,Sweden,Sri Lanka,6228,2698,3530
2005,826,United Kingdom,Sri Lanka,90900,49356,41544
2005,300,Greece,Sri Lanka,860,313,547
2005,380,Italy,Sri Lanka,63528,35011,28517
2005,470,Malta,Sri Lanka,17,9,8
2005,620,Portugal,Sri Lanka,19,12,7
2005,705,Slovenia,Sri Lanka,6,6,0
2005,724,Spain,Sri Lanka,403,234,169
2005,40,Austria,Sri Lanka,759,416,343
2005,56,Belgium,Sri Lanka,489,255,234
2005,250,France,Sri Lanka,34159,17759,16400
2005,276,Germany,Sri Lanka,42932,23715,19217
2005,528,Netherlands,Sri Lanka,10249,5307,4942
2005,756,Switzerland,Sri Lanka,28476,15329,13147
2005,124,Canada,Sri Lanka,107923,53033,54890
2005,840,United States of America,Sri Lanka,33489,16775,16714
2010,480,Mauritius,Sri Lanka,979,223,756
2010,690,Seychelles,Sri Lanka,534,372,162
2010,72,Botswana,Sri Lanka,850,440,410
2010,710,South Africa,Sri Lanka,853,442,411
2010,288,Ghana,Sri Lanka,17,9,8
2010,818,Egypt,Sri Lanka,210,118,92
2010,434,Libya,Sri Lanka,326,203,123
2010,48,Bahrain,Sri Lanka,9019,4832,4187
2010,196,Cyprus,Sri Lanka,10763,1979,8784
2010,400,Jordan,Sri Lanka,28134,7018,21116
2010,414,Kuwait,Sri Lanka,25148,12643,12505
2010,422,Lebanon,Sri Lanka,3887,452,3435
2010,512,Oman,Sri Lanka,10342,4982,5360
2010,634,Qatar,Sri Lanka,33403,23938,9465
2010,682,Saudi Arabia,Sri Lanka,338283,238095,100188
2010,792,Turkey,Sri Lanka,67,49,18
2010,784,United Arab Emirates,Sri Lanka,101145,57848,43297
2010,64,Bhutan,Sri Lanka,31,16,15
2010,356,India,Sri Lanka,160971,80316,80655
2010,462,Maldives,Sri Lanka,6850,4912,1938
2010,524,Nepal,Sri Lanka,41,17,24
2010,586,Pakistan,Sri Lanka,663,346,317
2010,156,China,Sri Lanka,4723,2133,2590
2010,344,"China, Hong Kong SAR",Sri Lanka,766,256,510
2010,408,Dem. People's Republic of Korea,Sri Lanka,139,45,94
2010,392,Japan,Sri Lanka,9097,4092,5005
2010,410,Republic of Korea,Sri Lanka,16165,15520,645
2010,96,Brunei Darussalam,Sri Lanka,1208,470,738
2010,116,Cambodia,Sri Lanka,52,38,14
2010,458,Malaysia,Sri Lanka,5960,4072,1888
2010,608,Philippines,Sri Lanka,170,137,33
2010,702,Singapore,Sri Lanka,9222,4016,5206
2010,764,Thailand,Sri Lanka,7126,3596,3530
2010,704,Viet Nam,Sri Lanka,101,60,41
2010,44,Bahamas,Sri Lanka,36,20,16
2010,188,Costa Rica,Sri Lanka,1,1,0
2010,32,Argentina,Sri Lanka,2,2,0
2010,68,Bolivia (Plurinational State of),Sri Lanka,2,2,0
2010,152,Chile,Sri Lanka,14,9,5
2010,36,Australia,Sri Lanka,96480,49849,46631
2010,554,New Zealand,Sri Lanka,8516,4126,4390
2010,598,Papua New Guinea,Sri Lanka,78,62,16
2010,520,Nauru,Sri Lanka,216,161,55
2010,100,Bulgaria,Sri Lanka,9,6,3
2010,203,Czechia,Sri Lanka,96,69,27
2010,348,Hungary,Sri Lanka,52,31,21
2010,616,Poland,Sri Lanka,89,43,46
2010,643,Russian Federation,Sri Lanka,576,325,251
2010,208,Denmark,Sri Lanka,7918,3913,4005
2010,233,Estonia,Sri Lanka,9,7,2
2010,246,Finland,Sri Lanka,843,439,404
2010,352,Iceland,Sri Lanka,165,62,103
2010,372,Ireland,Sri Lanka,233,135,98
2010,428,Latvia,Sri Lanka,40,27,13
2010,578,Norway,Sri Lanka,8751,4591,4160
2010,752,Sweden,Sri Lanka,6722,2948,3774
2010,826,United Kingdom,Sri Lanka,109679,59441,50238
2010,300,Greece,Sri Lanka,944,364,580
2010,380,Italy,Sri Lanka,83767,47685,36082
2010,470,Malta,Sri Lanka,14,9,5
2010,620,Portugal,Sri Lanka,23,14,9
2010,705,Slovenia,Sri Lanka,10,6,4
2010,724,Spain,Sri Lanka,565,351,214
2010,40,Austria,Sri Lanka,839,453,386
2010,56,Belgium,Sri Lanka,1196,616,580
2010,250,France,Sri Lanka,44946,23301,21645
2010,276,Germany,Sri Lanka,37795,20236,17559
2010,528,Netherlands,Sri Lanka,9987,5177,4810
2010,756,Switzerland,Sri Lanka,28600,15075,13525
2010,124,Canada,Sri Lanka,132130,65896,66234
2010,840,United States of America,Sri Lanka,42299,20899,21400
2015,480,Mauritius,Sri Lanka,1126,299,827
2015,690,Seychelles,Sri Lanka,598,427,171
2015,72,Botswana,Sri Lanka,927,480,447
2015,710,South Africa,Sri Lanka,1538,760,778
2015,288,Ghana,Sri Lanka,20,11,9
2015,324,Guinea,Sri Lanka,2,2,0
2015,818,Egypt,Sri Lanka,155,96,59
2015,434,Libya,Sri Lanka,367,227,140
2015,48,Bahrain,Sri Lanka,9841,5204,4637
2015,196,Cyprus,Sri Lanka,10340,1957,8383
2015,400,Jordan,Sri Lanka,12110,975,11135
2015,414,Kuwait,Sri Lanka,36556,15875,20681
2015,422,Lebanon,Sri Lanka,3272,1566,1706
2015,512,Oman,Sri Lanka,23519,13165,10354
2015,634,Qatar,Sri Lanka,54731,40243,14488
2015,682,Saudi Arabia,Sri Lanka,423765,292548,131217
2015,792,Turkey,Sri Lanka,52,40,12
2015,784,United Arab Emirates,Sri Lanka,110523,61346,49177
2015,64,Bhutan,Sri Lanka,33,18,15
2015,356,India,Sri Lanka,155088,77286,77802
2015,462,Maldives,Sri Lanka,6772,5828,944
2015,524,Nepal,Sri Lanka,46,20,26
2015,586,Pakistan,Sri Lanka,578,286,292
2015,156,China,Sri Lanka,5435,2591,2844
2015,344,"China, Hong Kong SAR",Sri Lanka,782,241,541
2015,408,Dem. People's Republic of Korea,Sri Lanka,153,50,103
2015,392,Japan,Sri Lanka,13152,5868,7284
2015,410,Republic of Korea,Sri Lanka,20085,19265,820
2015,96,Brunei Darussalam,Sri Lanka,1234,484,750
2015,116,Cambodia,Sri Lanka,47,35,12
2015,458,Malaysia,Sri Lanka,7260,4985,2275
2015,608,Philippines,Sri Lanka,172,139,33
2015,702,Singapore,Sri Lanka,10730,4664,6066
2015,764,Thailand,Sri Lanka,7705,3875,3830
2015,704,Viet Nam,Sri Lanka,79,47,32
2015,44,Bahamas,Sri Lanka,39,22,17
2015,188,Costa Rica,Sri Lanka,1,1,0
2015,32,Argentina,Sri Lanka,2,2,0
2015,68,Bolivia (Plurinational State of),Sri Lanka,2,2,0
2015,152,Chile,Sri Lanka,21,14,7
2015,36,Australia,Sri Lanka,119700,62147,57553
2015,554,New Zealand,Sri Lanka,9956,4815,5141
2015,598,Papua New Guinea,Sri Lanka,79,64,15
2015,520,Nauru,Sri Lanka,39,30,9
2015,100,Bulgaria,Sri Lanka,13,11,2
2015,203,Czechia,Sri Lanka,135,107,28
2015,348,Hungary,Sri Lanka,65,41,24
2015,616,Poland,Sri Lanka,85,42,43
2015,642,Romania,Sri Lanka,4,2,2
2015,643,Russian Federation,Sri Lanka,588,330,258
2015,208,Denmark,Sri Lanka,8594,4291,4303
2015,233,Estonia,Sri Lanka,21,18,3
2015,246,Finland,Sri Lanka,1173,616,557
2015,352,Iceland,Sri Lanka,164,64,100
2015,372,Ireland,Sri Lanka,238,137,101
2015,428,Latvia,Sri Lanka,28,18,10
2015,578,Norway,Sri Lanka,9289,4822,4467
2015,752,Sweden,Sri Lanka,7025,3090,3935
2015,826,United Kingdom,Sri Lanka,142069,75691,66378
2015,300,Greece,Sri Lanka,886,319,567
2015,380,Italy,Sri Lanka,85313,47606,37707
2015,470,Malta,Sri Lanka,23,15,8
2015,620,Portugal,Sri Lanka,26,15,11
2015,705,Slovenia,Sri Lanka,17,10,7
2015,724,Spain,Sri Lanka,628,389,239
2015,40,Austria,Sri Lanka,981,533,448
2015,56,Belgium,Sri Lanka,1901,977,924
2015,250,France,Sri Lanka,49790,25153,24637
2015,276,Germany,Sri Lanka,39380,21041,18339
2015,528,Netherlands,Sri Lanka,10461,5337,5124
2015,756,Switzerland,Sri Lanka,32930,17620,15310
2015,124,Canada,Sri Lanka,131185,64397,66788
2015,840,United States of America,Sri Lanka,52908,26004,26904
2019,480,Mauritius,Sri Lanka,1136,302,834
2019,690,Seychelles,Sri Lanka,604,432,172
2019,72,Botswana,Sri Lanka,992,514,478
2019,710,South Africa,Sri Lanka,1723,853,870
2019,288,Ghana,Sri Lanka,22,12,10
2019,324,Guinea,Sri Lanka,1,1,0
2019,818,Egypt,Sri Lanka,220,126,94
2019,434,Libya,Sri Lanka,389,241,148
2019,48,Bahrain,Sri Lanka,10358,5478,4880
2019,196,Cyprus,Sri Lanka,10334,2041,8293
2019,400,Jordan,Sri Lanka,13023,1049,11974
2019,414,Kuwait,Sri Lanka,38707,16809,21898
2019,422,Lebanon,Sri Lanka,3090,1479,1611
2019,512,Oman,Sri Lanka,28967,16215,12752
2019,634,Qatar,Sri Lanka,155825,111630,44195
2019,682,Saudi Arabia,Sri Lanka,516256,352876,163380
2019,792,Turkey,Sri Lanka,70,54,16
2019,784,United Arab Emirates,Sri Lanka,118708,65880,52828
2019,64,Bhutan,Sri Lanka,34,19,15
2019,356,India,Sri Lanka,152536,76015,76521
2019,462,Maldives,Sri Lanka,7296,6280,1016
2019,524,Nepal,Sri Lanka,44,19,25
2019,586,Pakistan,Sri Lanka,537,266,271
2019,156,China,Sri Lanka,5728,2731,2997
2019,344,"China, Hong Kong SAR",Sri Lanka,1013,292,721
2019,408,Dem. People's Republic of Korea,Sri Lanka,155,51,104
2019,392,Japan,Sri Lanka,18190,8116,10074
2019,410,Republic of Korea,Sri Lanka,20446,19611,835
2019,96,Brunei Darussalam,Sri Lanka,1328,521,807
2019,116,Cambodia,Sri Lanka,49,37,12
2019,458,Malaysia,Sri Lanka,7591,5230,2361
2019,608,Philippines,Sri Lanka,177,143,34
2019,702,Singapore,Sri Lanka,9093,3946,5147
2019,764,Thailand,Sri Lanka,8033,4040,3993
2019,704,Viet Nam,Sri Lanka,82,49,33
2019,44,Bahamas,Sri Lanka,41,23,18
2019,188,Costa Rica,Sri Lanka,1,1,0
2019,32,Argentina,Sri Lanka,2,2,0
2019,68,Bolivia (Plurinational State of),Sri Lanka,2,2,0
2019,152,Chile,Sri Lanka,28,19,9
2019,36,Australia,Sri Lanka,136979,72711,64268
2019,554,New Zealand,Sri Lanka,10233,4949,5284
2019,598,Papua New Guinea,Sri Lanka,79,64,15
2019,520,Nauru,Sri Lanka,129,97,32
2019,100,Bulgaria,Sri Lanka,18,15,3
2019,203,Czechia,Sri Lanka,174,130,44
2019,348,Hungary,Sri Lanka,73,46,27
2019,616,Poland,Sri Lanka,90,47,43
2019,642,Romania,Sri Lanka,251,177,74
2019,643,Russian Federation,Sri Lanka,587,330,257
2019,208,Denmark,Sri Lanka,8412,4149,4263
2019,233,Estonia,Sri Lanka,30,24,6
2019,246,Finland,Sri Lanka,1388,724,664
2019,352,Iceland,Sri Lanka,183,74,109
2019,372,Ireland,Sri Lanka,261,151,110
2019,428,Latvia,Sri Lanka,33,24,9
2019,578,Norway,Sri Lanka,10154,5233,4921
2019,752,Sweden,Sri Lanka,7313,3217,4096
2019,826,United Kingdom,Sri Lanka,161334,86146,75188
2019,300,Greece,Sri Lanka,865,333,532
2019,380,Italy,Sri Lanka,94745,52444,42301
2019,470,Malta,Sri Lanka,37,25,12
2019,620,Portugal,Sri Lanka,77,51,26
2019,705,Slovenia,Sri Lanka,17,8,9
2019,724,Spain,Sri Lanka,650,397,253
2019,40,Austria,Sri Lanka,1158,639,519
2019,56,Belgium,Sri Lanka,2256,1153,1103
2019,250,France,Sri Lanka,52703,26566,26137
2019,276,Germany,Sri Lanka,43198,23025,20173
2019,528,Netherlands,Sri Lanka,11017,5612,5405
2019,756,Switzerland,Sri Lanka,35481,19049,16432
2019,124,Canada,Sri Lanka,140579,69009,71570
2019,840,United States of America,Sri Lanka,57135,27769,29366
1990,710,South Africa,State of Palestine,97,6,91
1990,478,Mauritania,State of Palestine,135,60,75
1990,12,Algeria,State of Palestine,36004,19020,16984
1990,818,Egypt,State of Palestine,53328,27145,26183
1990,434,Libya,State of Palestine,152266,77914,74352
1990,788,Tunisia,State of Palestine,589,293,296
1990,48,Bahrain,State of Palestine,1531,1095,436
1990,196,Cyprus,State of Palestine,90,54,36
1990,368,Iraq,State of Palestine,14347,9515,4832
1990,400,Jordan,State of Palestine,851880,403331,448549
1990,414,Kuwait,State of Palestine,9497,5750,3747
1990,422,Lebanon,State of Palestine,389171,184258,204913
1990,634,Qatar,State of Palestine,7574,4875,2699
1990,760,Syrian Arab Republic,State of Palestine,244707,125212,119495
1990,792,Turkey,State of Palestine,768,480,288
1990,784,United Arab Emirates,State of Palestine,11602,8260,3342
1990,887,Yemen,State of Palestine,2562,1422,1140
1990,214,Dominican Republic,State of Palestine,188,93,95
1990,222,El Salvador,State of Palestine,75,26,49
1990,320,Guatemala,State of Palestine,30,13,17
1990,340,Honduras,State of Palestine,116,64,52
1990,484,Mexico,State of Palestine,2,0,2
1990,591,Panama,State of Palestine,56,41,15
1990,152,Chile,State of Palestine,390,214,176
1990,218,Ecuador,State of Palestine,33,16,17
1990,862,Venezuela (Bolivarian Republic of),State of Palestine,425,275,150
1990,36,Australia,State of Palestine,2753,1618,1135
1990,100,Bulgaria,State of Palestine,3,3,0
1990,203,Czechia,State of Palestine,19,17,2
1990,348,Hungary,State of Palestine,93,76,17
1990,642,Romania,State of Palestine,7,4,3
1990,643,Russian Federation,State of Palestine,1808,887,921
1990,703,Slovakia,State of Palestine,6,5,1
1990,804,Ukraine,State of Palestine,1828,1708,120
1990,208,Denmark,State of Palestine,54,44,10
1990,372,Ireland,State of Palestine,13,9,4
1990,752,Sweden,State of Palestine,799,497,302
1990,300,Greece,State of Palestine,389,216,173
1990,380,Italy,State of Palestine,55,19,36
1990,470,Malta,State of Palestine,12,10,2
1990,688,Serbia,State of Palestine,9,9,0
1990,40,Austria,State of Palestine,152,108,44
1990,56,Belgium,State of Palestine,8,6,2
1990,250,France,State of Palestine,850,514,336
1990,756,Switzerland,State of Palestine,275,194,81
1990,124,Canada,State of Palestine,5397,2627,2770
1990,840,United States of America,State of Palestine,21070,10307,10763
1995,710,South Africa,State of Palestine,60,8,52
1995,478,Mauritania,State of Palestine,144,72,72
1995,12,Algeria,State of Palestine,33836,18261,15575
1995,818,Egypt,State of Palestine,52935,27402,25533
1995,434,Libya,State of Palestine,179924,106089,73835
1995,788,Tunisia,State of Palestine,627,316,311
1995,48,Bahrain,State of Palestine,1684,1185,499
1995,196,Cyprus,State of Palestine,128,75,53
1995,368,Iraq,State of Palestine,73847,42738,31109
1995,400,Jordan,State of Palestine,1140038,540174,599864
1995,414,Kuwait,State of Palestine,7610,4849,2761
1995,422,Lebanon,State of Palestine,428088,202684,225404
1995,634,Qatar,State of Palestine,8393,5686,2707
1995,760,Syrian Arab Republic,State of Palestine,289464,145829,143635
1995,792,Turkey,State of Palestine,432,361,71
1995,784,United Arab Emirates,State of Palestine,14868,10650,4218
1995,887,Yemen,State of Palestine,3353,1880,1473
1995,764,Thailand,State of Palestine,1,1,0
1995,214,Dominican Republic,State of Palestine,209,101,108
1995,222,El Salvador,State of Palestine,58,20,38
1995,320,Guatemala,State of Palestine,30,13,17
1995,340,Honduras,State of Palestine,115,62,53
1995,484,Mexico,State of Palestine,6,3,3
1995,591,Panama,State of Palestine,80,59,21
1995,152,Chile,State of Palestine,539,291,248
1995,218,Ecuador,State of Palestine,37,18,19
1995,862,Venezuela (Bolivarian Republic of),State of Palestine,419,271,148
1995,36,Australia,State of Palestine,3005,1732,1273
1995,100,Bulgaria,State of Palestine,2,2,0
1995,203,Czechia,State of Palestine,28,25,3
1995,348,Hungary,State of Palestine,83,67,16
1995,642,Romania,State of Palestine,12,8,4
1995,643,Russian Federation,State of Palestine,1556,929,627
1995,703,Slovakia,State of Palestine,13,12,1
1995,804,Ukraine,State of Palestine,1768,1656,112
1995,208,Denmark,State of Palestine,27,22,5
1995,372,Ireland,State of Palestine,36,25,11
1995,752,Sweden,State of Palestine,949,587,362
1995,300,Greece,State of Palestine,387,252,135
1995,380,Italy,State of Palestine,214,129,85
1995,470,Malta,State of Palestine,15,12,3
1995,688,Serbia,State of Palestine,58,55,3
1995,40,Austria,State of Palestine,172,123,49
1995,56,Belgium,State of Palestine,8,6,2
1995,250,France,State of Palestine,877,524,353
1995,756,Switzerland,State of Palestine,196,137,59
1995,124,Canada,State of Palestine,5420,2626,2794
1995,840,United States of America,State of Palestine,23377,11543,11834
2000,710,South Africa,State of Palestine,41,11,30
2000,478,Mauritania,State of Palestine,148,82,66
2000,12,Algeria,State of Palestine,31667,17501,14166
2000,818,Egypt,State of Palestine,66745,34840,31905
2000,434,Libya,State of Palestine,210540,137755,72785
2000,788,Tunisia,State of Palestine,732,376,356
2000,48,Bahrain,State of Palestine,1843,1273,570
2000,196,Cyprus,State of Palestine,165,95,70
2000,368,Iraq,State of Palestine,94124,64522,29602
2000,400,Jordan,State of Palestine,1428251,676212,752039
2000,414,Kuwait,State of Palestine,8681,5863,2818
2000,422,Lebanon,State of Palestine,467005,221110,245895
2000,634,Qatar,State of Palestine,7961,5664,2297
2000,760,Syrian Arab Republic,State of Palestine,385199,196452,188747
2000,792,Turkey,State of Palestine,748,606,142
2000,784,United Arab Emirates,State of Palestine,18995,13608,5387
2000,887,Yemen,State of Palestine,2794,1503,1291
2000,764,Thailand,State of Palestine,3,1,2
2000,214,Dominican Republic,State of Palestine,230,109,121
2000,222,El Salvador,State of Palestine,41,14,27
2000,320,Guatemala,State of Palestine,29,12,17
2000,340,Honduras,State of Palestine,114,60,54
2000,484,Mexico,State of Palestine,11,5,6
2000,591,Panama,State of Palestine,111,82,29
2000,152,Chile,State of Palestine,689,369,320
2000,218,Ecuador,State of Palestine,41,20,21
2000,862,Venezuela (Bolivarian Republic of),State of Palestine,410,265,145
2000,36,Australia,State of Palestine,3060,1743,1317
2000,100,Bulgaria,State of Palestine,1,1,0
2000,203,Czechia,State of Palestine,37,33,4
2000,348,Hungary,State of Palestine,72,58,14
2000,642,Romania,State of Palestine,19,13,6
2000,643,Russian Federation,State of Palestine,1248,937,311
2000,703,Slovakia,State of Palestine,24,21,3
2000,804,Ukraine,State of Palestine,1731,1624,107
2000,372,Ireland,State of Palestine,79,55,24
2000,578,Norway,State of Palestine,49,32,17
2000,752,Sweden,State of Palestine,1018,627,391
2000,300,Greece,State of Palestine,392,291,101
2000,380,Italy,State of Palestine,373,239,134
2000,470,Malta,State of Palestine,19,16,3
2000,688,Serbia,State of Palestine,80,75,5
2000,40,Austria,State of Palestine,191,137,54
2000,56,Belgium,State of Palestine,8,6,2
2000,250,France,State of Palestine,904,534,370
2000,756,Switzerland,State of Palestine,119,80,39
2000,124,Canada,State of Palestine,5572,2689,2883
2000,840,United States of America,State of Palestine,25706,12806,12900
2005,710,South Africa,State of Palestine,53,11,42
2005,478,Mauritania,State of Palestine,149,85,64
2005,12,Algeria,State of Palestine,24996,13815,11181
2005,818,Egypt,State of Palestine,117556,69005,48551
2005,434,Libya,State of Palestine,231990,166106,65884
2005,788,Tunisia,State of Palestine,662,342,320
2005,48,Bahrain,State of Palestine,2795,1899,896
2005,196,Cyprus,State of Palestine,241,138,103
2005,368,Iraq,State of Palestine,29507,20228,9279
2005,400,Jordan,State of Palestine,1611803,774698,837105
2005,414,Kuwait,State of Palestine,9376,6184,3192
2005,422,Lebanon,State of Palestine,498778,240311,258467
2005,634,Qatar,State of Palestine,5408,3764,1644
2005,760,Syrian Arab Republic,State of Palestine,441091,225145,215946
2005,792,Turkey,State of Palestine,721,595,126
2005,784,United Arab Emirates,State of Palestine,22830,15788,7042
2005,887,Yemen,State of Palestine,3392,1835,1557
2005,764,Thailand,State of Palestine,8,4,4
2005,214,Dominican Republic,State of Palestine,124,60,64
2005,222,El Salvador,State of Palestine,43,15,28
2005,320,Guatemala,State of Palestine,35,13,22
2005,340,Honduras,State of Palestine,112,59,53
2005,484,Mexico,State of Palestine,18,9,9
2005,591,Panama,State of Palestine,124,89,35
2005,68,Bolivia (Plurinational State of),State of Palestine,6,4,2
2005,152,Chile,State of Palestine,1034,562,472
2005,218,Ecuador,State of Palestine,48,24,24
2005,862,Venezuela (Bolivarian Republic of),State of Palestine,431,279,152
2005,36,Australia,State of Palestine,3260,1840,1420
2005,100,Bulgaria,State of Palestine,1,1,0
2005,203,Czechia,State of Palestine,75,66,9
2005,348,Hungary,State of Palestine,89,72,17
2005,642,Romania,State of Palestine,22,16,6
2005,643,Russian Federation,State of Palestine,911,736,175
2005,703,Slovakia,State of Palestine,27,23,4
2005,804,Ukraine,State of Palestine,1581,1484,97
2005,246,Finland,State of Palestine,15,11,4
2005,372,Ireland,State of Palestine,79,56,23
2005,578,Norway,State of Palestine,685,462,223
2005,752,Sweden,State of Palestine,2145,1351,794
2005,191,Croatia,State of Palestine,22,20,2
2005,300,Greece,State of Palestine,708,615,93
2005,380,Italy,State of Palestine,382,262,120
2005,470,Malta,State of Palestine,23,18,5
2005,688,Serbia,State of Palestine,79,74,5
2005,40,Austria,State of Palestine,214,152,62
2005,56,Belgium,State of Palestine,90,59,31
2005,250,France,State of Palestine,865,546,319
2005,756,Switzerland,State of Palestine,136,90,46
2005,124,Canada,State of Palestine,6362,3353,3009
2005,840,United States of America,State of Palestine,28004,14030,13974
2010,710,South Africa,State of Palestine,82,17,65
2010,478,Mauritania,State of Palestine,160,93,67
2010,12,Algeria,State of Palestine,27470,14649,12821
2010,818,Egypt,State of Palestine,126871,72477,54394
2010,434,Libya,State of Palestine,253786,182543,71243
2010,788,Tunisia,State of Palestine,414,215,199
2010,48,Bahrain,State of Palestine,4364,2945,1419
2010,196,Cyprus,State of Palestine,394,228,166
2010,368,Iraq,State of Palestine,12956,9125,3831
2010,400,Jordan,State of Palestine,1760396,837066,923330
2010,414,Kuwait,State of Palestine,12410,8087,4323
2010,422,Lebanon,State of Palestine,530550,259511,271039
2010,634,Qatar,State of Palestine,7243,5805,1438
2010,760,Syrian Arab Republic,State of Palestine,496983,252651,244332
2010,792,Turkey,State of Palestine,793,640,153
2010,784,United Arab Emirates,State of Palestine,48946,34277,14669
2010,887,Yemen,State of Palestine,3792,1990,1802
2010,764,Thailand,State of Palestine,14,7,7
2010,214,Dominican Republic,State of Palestine,18,11,7
2010,222,El Salvador,State of Palestine,44,15,29
2010,320,Guatemala,State of Palestine,40,13,27
2010,340,Honduras,State of Palestine,110,59,51
2010,484,Mexico,State of Palestine,28,13,15
2010,591,Panama,State of Palestine,143,99,44
2010,68,Bolivia (Plurinational State of),State of Palestine,11,8,3
2010,152,Chile,State of Palestine,1379,754,625
2010,218,Ecuador,State of Palestine,67,33,34
2010,862,Venezuela (Bolivarian Republic of),State of Palestine,459,298,161
2010,36,Australia,State of Palestine,3070,1741,1329
2010,203,Czechia,State of Palestine,105,93,12
2010,348,Hungary,State of Palestine,105,85,20
2010,642,Romania,State of Palestine,27,18,9
2010,643,Russian Federation,State of Palestine,556,519,37
2010,703,Slovakia,State of Palestine,30,26,4
2010,804,Ukraine,State of Palestine,1508,1416,92
2010,233,Estonia,State of Palestine,1,1,0
2010,246,Finland,State of Palestine,32,24,8
2010,372,Ireland,State of Palestine,66,45,21
2010,428,Latvia,State of Palestine,1,1,0
2010,578,Norway,State of Palestine,2668,1747,921
2010,752,Sweden,State of Palestine,3444,2084,1360
2010,191,Croatia,State of Palestine,43,40,3
2010,300,Greece,State of Palestine,1064,977,87
2010,380,Italy,State of Palestine,372,270,102
2010,470,Malta,State of Palestine,53,27,26
2010,688,Serbia,State of Palestine,78,73,5
2010,705,Slovenia,State of Palestine,6,5,1
2010,40,Austria,State of Palestine,237,167,70
2010,56,Belgium,State of Palestine,224,140,84
2010,250,France,State of Palestine,932,541,391
2010,756,Switzerland,State of Palestine,158,100,58
2010,124,Canada,State of Palestine,7395,4150,3245
2010,840,United States of America,State of Palestine,31222,15428,15794
2015,710,South Africa,State of Palestine,146,24,122
2015,478,Mauritania,State of Palestine,161,95,66
2015,12,Algeria,State of Palestine,30319,16155,14164
2015,818,Egypt,State of Palestine,94070,58962,35108
2015,434,Libya,State of Palestine,286136,204708,81428
2015,788,Tunisia,State of Palestine,554,290,264
2015,48,Bahrain,State of Palestine,4671,3130,1541
2015,196,Cyprus,State of Palestine,2394,1229,1165
2015,368,Iraq,State of Palestine,12051,6749,5302
2015,400,Jordan,State of Palestine,1969731,982945,986786
2015,414,Kuwait,State of Palestine,14253,8605,5648
2015,422,Lebanon,State of Palestine,515853,246916,268937
2015,634,Qatar,State of Palestine,5595,4558,1037
2015,760,Syrian Arab Republic,State of Palestine,598128,304071,294057
2015,792,Turkey,State of Palestine,740,609,131
2015,784,United Arab Emirates,State of Palestine,53484,36823,16661
2015,887,Yemen,State of Palestine,3757,1926,1831
2015,764,Thailand,State of Palestine,15,8,7
2015,214,Dominican Republic,State of Palestine,18,11,7
2015,222,El Salvador,State of Palestine,46,16,30
2015,320,Guatemala,State of Palestine,46,15,31
2015,340,Honduras,State of Palestine,154,83,71
2015,484,Mexico,State of Palestine,29,13,16
2015,591,Panama,State of Palestine,167,115,52
2015,68,Bolivia (Plurinational State of),State of Palestine,13,10,3
2015,152,Chile,State of Palestine,2089,1122,967
2015,218,Ecuador,State of Palestine,97,48,49
2015,862,Venezuela (Bolivarian Republic of),State of Palestine,481,310,171
2015,36,Australia,State of Palestine,3190,1814,1376
2015,100,Bulgaria,State of Palestine,42,27,15
2015,203,Czechia,State of Palestine,100,81,19
2015,348,Hungary,State of Palestine,74,52,22
2015,642,Romania,State of Palestine,72,60,12
2015,643,Russian Federation,State of Palestine,566,528,38
2015,703,Slovakia,State of Palestine,44,38,6
2015,804,Ukraine,State of Palestine,1513,1421,92
2015,233,Estonia,State of Palestine,7,7,0
2015,246,Finland,State of Palestine,62,41,21
2015,372,Ireland,State of Palestine,67,45,22
2015,428,Latvia,State of Palestine,2,2,0
2015,578,Norway,State of Palestine,3342,2018,1324
2015,752,Sweden,State of Palestine,5759,3389,2370
2015,191,Croatia,State of Palestine,43,40,3
2015,300,Greece,State of Palestine,998,913,85
2015,380,Italy,State of Palestine,5027,2581,2446
2015,470,Malta,State of Palestine,56,29,27
2015,688,Serbia,State of Palestine,76,72,4
2015,705,Slovenia,State of Palestine,2,2,0
2015,40,Austria,State of Palestine,277,196,81
2015,56,Belgium,State of Palestine,660,476,184
2015,250,France,State of Palestine,1032,587,445
2015,756,Switzerland,State of Palestine,195,122,73
2015,124,Canada,State of Palestine,8159,4540,3619
2015,840,United States of America,State of Palestine,40177,19750,20427
2019,710,South Africa,State of Palestine,163,28,135
2019,478,Mauritania,State of Palestine,167,99,68
2019,12,Algeria,State of Palestine,31534,16803,14731
2019,818,Egypt,State of Palestine,134080,78130,55950
2019,434,Libya,State of Palestine,303601,218931,84670
2019,788,Tunisia,State of Palestine,563,295,268
2019,48,Bahrain,State of Palestine,4916,3294,1622
2019,196,Cyprus,State of Palestine,2392,1240,1152
2019,368,Iraq,State of Palestine,12342,6912,5430
2019,400,Jordan,State of Palestine,2118267,1057069,1061198
2019,414,Kuwait,State of Palestine,15091,9111,5980
2019,422,Lebanon,State of Palestine,487270,233235,254035
2019,634,Qatar,State of Palestine,5706,4573,1133
2019,760,Syrian Arab Republic,State of Palestine,595847,303847,292000
2019,792,Turkey,State of Palestine,1000,825,175
2019,784,United Arab Emirates,State of Palestine,57445,39548,17897
2019,887,Yemen,State of Palestine,3813,1955,1858
2019,764,Thailand,State of Palestine,15,8,7
2019,214,Dominican Republic,State of Palestine,18,11,7
2019,222,El Salvador,State of Palestine,46,16,30
2019,320,Guatemala,State of Palestine,47,16,31
2019,340,Honduras,State of Palestine,156,84,72
2019,484,Mexico,State of Palestine,29,13,16
2019,591,Panama,State of Palestine,176,123,53
2019,68,Bolivia (Plurinational State of),State of Palestine,14,11,3
2019,152,Chile,State of Palestine,2791,1428,1363
2019,218,Ecuador,State of Palestine,95,47,48
2019,862,Venezuela (Bolivarian Republic of),State of Palestine,471,303,168
2019,36,Australia,State of Palestine,3364,1898,1466
2019,100,Bulgaria,State of Palestine,71,45,26
2019,203,Czechia,State of Palestine,115,89,26
2019,348,Hungary,State of Palestine,112,84,28
2019,642,Romania,State of Palestine,230,181,49
2019,643,Russian Federation,State of Palestine,565,528,37
2019,703,Slovakia,State of Palestine,50,44,6
2019,804,Ukraine,State of Palestine,1528,1436,92
2019,233,Estonia,State of Palestine,8,8,0
2019,246,Finland,State of Palestine,76,45,31
2019,372,Ireland,State of Palestine,73,49,24
2019,428,Latvia,State of Palestine,2,2,0
2019,578,Norway,State of Palestine,3698,2215,1483
2019,752,Sweden,State of Palestine,9396,5780,3616
2019,191,Croatia,State of Palestine,39,37,2
2019,300,Greece,State of Palestine,1228,600,628
2019,380,Italy,State of Palestine,597,450,147
2019,470,Malta,State of Palestine,90,47,43
2019,688,Serbia,State of Palestine,77,73,4
2019,705,Slovenia,State of Palestine,3,3,0
2019,40,Austria,State of Palestine,326,233,93
2019,56,Belgium,State of Palestine,1216,796,420
2019,250,France,State of Palestine,1092,620,472
2019,756,Switzerland,State of Palestine,229,139,90
2019,124,Canada,State of Palestine,8743,4865,3878
2019,840,United States of America,State of Palestine,43387,21091,22296
1990,232,Eritrea,Sudan,131,69,62
1990,231,Ethiopia,Sudan,53857,28308,25549
1990,404,Kenya,Sudan,814,467,347
1990,800,Uganda,Sudan,124116,61466,62650
1990,140,Central African Republic,Sudan,22094,11480,10614
1990,148,Chad,Sudan,9529,5144,4385
1990,180,Democratic Republic of the Congo,Sudan,15895,7651,8244
1990,516,Namibia,Sudan,294,130,164
1990,710,South Africa,Sudan,2619,1225,1394
1990,288,Ghana,Sudan,18,14,4
1990,562,Niger,Sudan,337,152,185
1990,12,Algeria,Sudan,9127,5143,3984
1990,818,Egypt,Sudan,15184,8284,6900
1990,434,Libya,Sudan,38599,21153,17446
1990,48,Bahrain,Sudan,4235,2646,1589
1990,196,Cyprus,Sudan,129,66,63
1990,368,Iraq,Sudan,2924,2522,402
1990,400,Jordan,Sudan,1891,1468,423
1990,414,Kuwait,Sudan,29503,14174,15329
1990,422,Lebanon,Sudan,864,671,193
1990,512,Oman,Sudan,4910,2847,2063
1990,634,Qatar,Sudan,3178,2318,860
1990,682,Saudi Arabia,Sudan,178769,118914,59855
1990,792,Turkey,Sudan,63,50,13
1990,784,United Arab Emirates,Sudan,32088,19917,12171
1990,887,Yemen,Sudan,18648,10342,8306
1990,608,Philippines,Sudan,17,15,2
1990,188,Costa Rica,Sudan,1,1,0
1990,32,Argentina,Sudan,18,18,0
1990,152,Chile,Sudan,5,3,2
1990,36,Australia,Sudan,1218,638,580
1990,100,Bulgaria,Sudan,12,11,1
1990,203,Czechia,Sudan,16,12,4
1990,348,Hungary,Sudan,72,63,9
1990,616,Poland,Sudan,88,73,15
1990,643,Russian Federation,Sudan,588,289,299
1990,208,Denmark,Sudan,74,58,16
1990,372,Ireland,Sudan,113,73,40
1990,428,Latvia,Sudan,1,1,0
1990,578,Norway,Sudan,68,48,20
1990,752,Sweden,Sudan,557,314,243
1990,826,United Kingdom,Sudan,1489,984,505
1990,300,Greece,Sudan,1141,959,182
1990,380,Italy,Sudan,47,17,30
1990,470,Malta,Sudan,8,7,1
1990,724,Spain,Sudan,36,26,10
1990,40,Austria,Sudan,350,258,92
1990,56,Belgium,Sudan,175,101,74
1990,250,France,Sudan,1132,712,420
1990,528,Netherlands,Sudan,1725,1306,419
1990,756,Switzerland,Sudan,426,271,155
1990,124,Canada,Sudan,1324,644,680
1990,840,United States of America,Sudan,4423,2606,1817
1995,232,Eritrea,Sudan,155,85,70
1995,231,Ethiopia,Sudan,33008,18214,14794
1995,404,Kenya,Sudan,41215,21845,19370
1995,800,Uganda,Sudan,268735,133162,135573
1995,140,Central African Republic,Sudan,27015,14332,12683
1995,148,Chad,Sudan,19071,10278,8793
1995,180,Democratic Republic of the Congo,Sudan,15271,7553,7718
1995,516,Namibia,Sudan,281,126,155
1995,710,South Africa,Sudan,1633,834,799
1995,288,Ghana,Sudan,18,15,3
1995,562,Niger,Sudan,418,180,238
1995,694,Sierra Leone,Sudan,3,2,1
1995,12,Algeria,Sudan,5362,3009,2353
1995,818,Egypt,Sudan,11817,6442,5375
1995,434,Libya,Sudan,24407,13791,10616
1995,48,Bahrain,Sudan,4760,2984,1776
1995,196,Cyprus,Sudan,183,90,93
1995,368,Iraq,Sudan,3447,2856,591
1995,400,Jordan,Sudan,2309,1612,697
1995,414,Kuwait,Sudan,24089,12991,11098
1995,422,Lebanon,Sudan,1051,713,338
1995,512,Oman,Sudan,8625,5124,3501
1995,634,Qatar,Sudan,3452,2573,879
1995,682,Saudi Arabia,Sudan,183214,122191,61023
1995,760,Syrian Arab Republic,Sudan,48,24,24
1995,792,Turkey,Sudan,132,100,32
1995,784,United Arab Emirates,Sudan,42130,27155,14975
1995,887,Yemen,Sudan,19777,11574,8203
1995,608,Philippines,Sudan,22,20,2
1995,188,Costa Rica,Sudan,1,1,0
1995,32,Argentina,Sudan,18,18,0
1995,152,Chile,Sudan,4,1,3
1995,36,Australia,Sudan,2734,1438,1296
1995,100,Bulgaria,Sudan,17,15,2
1995,203,Czechia,Sudan,25,19,6
1995,348,Hungary,Sudan,95,77,18
1995,616,Poland,Sudan,75,63,12
1995,643,Russian Federation,Sudan,483,303,180
1995,208,Denmark,Sudan,140,102,38
1995,372,Ireland,Sudan,314,198,116
1995,428,Latvia,Sudan,1,1,0
1995,578,Norway,Sudan,138,99,39
1995,752,Sweden,Sudan,662,372,290
1995,826,United Kingdom,Sudan,5854,3323,2531
1995,300,Greece,Sudan,1262,839,423
1995,380,Italy,Sudan,430,281,149
1995,470,Malta,Sudan,10,8,2
1995,724,Spain,Sudan,55,39,16
1995,40,Austria,Sudan,395,293,102
1995,56,Belgium,Sudan,175,101,74
1995,250,France,Sudan,1169,728,441
1995,528,Netherlands,Sudan,2540,1910,630
1995,756,Switzerland,Sudan,554,345,209
1995,124,Canada,Sudan,4312,2082,2230
1995,840,United States of America,Sudan,12268,7296,4972
2000,232,Eritrea,Sudan,180,102,78
2000,231,Ethiopia,Sudan,18417,11608,6809
2000,404,Kenya,Sudan,56360,28061,28299
2000,800,Uganda,Sudan,341554,171428,170126
2000,140,Central African Republic,Sudan,29587,15931,13656
2000,148,Chad,Sudan,28613,15412,13201
2000,180,Democratic Republic of the Congo,Sudan,16643,8163,8480
2000,516,Namibia,Sudan,262,117,145
2000,710,South Africa,Sudan,1205,703,502
2000,288,Ghana,Sudan,20,16,4
2000,562,Niger,Sudan,504,211,293
2000,694,Sierra Leone,Sudan,1,1,0
2000,12,Algeria,Sudan,1597,875,722
2000,818,Egypt,Sudan,9388,5112,4276
2000,434,Libya,Sudan,10616,6906,3710
2000,48,Bahrain,Sudan,5299,3308,1991
2000,196,Cyprus,Sudan,236,114,122
2000,368,Iraq,Sudan,3267,2569,698
2000,400,Jordan,Sudan,2727,1761,966
2000,414,Kuwait,Sudan,28031,16978,11053
2000,422,Lebanon,Sudan,1238,755,483
2000,512,Oman,Sudan,9917,6342,3575
2000,634,Qatar,Sudan,3213,2450,763
2000,682,Saudi Arabia,Sudan,188246,125814,62432
2000,760,Syrian Arab Republic,Sudan,91,46,45
2000,792,Turkey,Sudan,212,160,52
2000,784,United Arab Emirates,Sudan,54597,35785,18812
2000,887,Yemen,Sudan,20102,10796,9306
2000,608,Philippines,Sudan,23,20,3
2000,764,Thailand,Sudan,1,0,1
2000,188,Costa Rica,Sudan,1,1,0
2000,32,Argentina,Sudan,18,18,0
2000,152,Chile,Sudan,4,0,4
2000,36,Australia,Sudan,4090,2171,1919
2000,100,Bulgaria,Sudan,21,18,3
2000,203,Czechia,Sudan,33,25,8
2000,348,Hungary,Sudan,117,90,27
2000,616,Poland,Sudan,64,53,11
2000,643,Russian Federation,Sudan,361,305,56
2000,208,Denmark,Sudan,206,146,60
2000,372,Ireland,Sudan,687,440,247
2000,428,Latvia,Sudan,2,2,0
2000,578,Norway,Sudan,341,225,116
2000,752,Sweden,Sudan,710,396,314
2000,826,United Kingdom,Sudan,10319,5711,4608
2000,300,Greece,Sudan,1404,726,678
2000,380,Italy,Sudan,813,545,268
2000,470,Malta,Sudan,12,10,2
2000,705,Slovenia,Sudan,14,9,5
2000,724,Spain,Sudan,665,485,180
2000,40,Austria,Sudan,440,328,112
2000,56,Belgium,Sudan,168,95,73
2000,250,France,Sudan,1205,743,462
2000,528,Netherlands,Sudan,3441,2576,865
2000,756,Switzerland,Sudan,686,421,265
2000,124,Canada,Sudan,7403,3571,3832
2000,840,United States of America,Sudan,20292,12103,8189
2005,232,Eritrea,Sudan,192,117,75
2005,231,Ethiopia,Sudan,15491,8957,6534
2005,404,Kenya,Sudan,76711,42192,34519
2005,800,Uganda,Sudan,337681,167986,169695
2005,140,Central African Republic,Sudan,22623,12194,10429
2005,148,Chad,Sudan,247525,112293,135232
2005,180,Democratic Republic of the Congo,Sudan,16643,8163,8480
2005,516,Namibia,Sudan,207,92,115
2005,710,South Africa,Sudan,1676,901,775
2005,288,Ghana,Sudan,28,23,5
2005,562,Niger,Sudan,513,215,298
2005,694,Sierra Leone,Sudan,5,3,2
2005,12,Algeria,Sudan,1260,691,569
2005,818,Egypt,Sudan,24677,14906,9771
2005,434,Libya,Sudan,11697,8338,3359
2005,48,Bahrain,Sudan,6869,4337,2532
2005,196,Cyprus,Sudan,346,166,180
2005,368,Iraq,Sudan,3745,3170,575
2005,400,Jordan,Sudan,3939,2713,1226
2005,414,Kuwait,Sudan,30751,18635,12116
2005,422,Lebanon,Sudan,969,606,363
2005,512,Oman,Sudan,7816,4856,2960
2005,634,Qatar,Sudan,9065,6549,2516
2005,682,Saudi Arabia,Sudan,232539,159864,72675
2005,760,Syrian Arab Republic,Sudan,221,113,108
2005,792,Turkey,Sudan,224,167,57
2005,784,United Arab Emirates,Sudan,55931,36147,19784
2005,887,Yemen,Sudan,21394,11347,10047
2005,608,Philippines,Sudan,18,16,2
2005,188,Costa Rica,Sudan,1,1,0
2005,32,Argentina,Sudan,13,13,0
2005,68,Bolivia (Plurinational State of),Sudan,1,1,0
2005,152,Chile,Sudan,6,1,5
2005,36,Australia,Sudan,18590,10358,8232
2005,100,Bulgaria,Sudan,29,24,5
2005,203,Czechia,Sudan,49,40,9
2005,348,Hungary,Sudan,145,112,33
2005,616,Poland,Sudan,89,73,16
2005,643,Russian Federation,Sudan,310,270,40
2005,208,Denmark,Sudan,440,276,164
2005,372,Ireland,Sudan,688,456,232
2005,428,Latvia,Sudan,1,1,0
2005,578,Norway,Sudan,665,394,271
2005,752,Sweden,Sudan,1041,602,439
2005,826,United Kingdom,Sudan,13407,7613,5794
2005,191,Croatia,Sudan,33,24,9
2005,300,Greece,Sudan,1650,933,717
2005,380,Italy,Sudan,1864,1407,457
2005,470,Malta,Sudan,16,12,4
2005,705,Slovenia,Sudan,14,9,5
2005,724,Spain,Sudan,320,232,88
2005,40,Austria,Sudan,492,363,129
2005,56,Belgium,Sudan,342,210,132
2005,250,France,Sudan,2075,1357,718
2005,528,Netherlands,Sudan,5811,4068,1743
2005,756,Switzerland,Sudan,812,479,333
2005,124,Canada,Sudan,10205,5262,4943
2005,840,United States of America,Sudan,30514,15285,15229
2010,232,Eritrea,Sudan,205,133,72
2010,231,Ethiopia,Sudan,37102,18963,18139
2010,404,Kenya,Sudan,26998,13275,13723
2010,800,Uganda,Sudan,145366,71323,74043
2010,140,Central African Republic,Sudan,22388,12075,10313
2010,148,Chad,Sudan,293127,131316,161811
2010,180,Democratic Republic of the Congo,Sudan,626,309,317
2010,516,Namibia,Sudan,199,89,110
2010,710,South Africa,Sudan,2625,1408,1217
2010,288,Ghana,Sudan,21,16,5
2010,466,Mali,Sudan,497,292,205
2010,562,Niger,Sudan,522,219,303
2010,694,Sierra Leone,Sudan,11,6,5
2010,12,Algeria,Sudan,1384,732,652
2010,818,Egypt,Sudan,46632,27047,19585
2010,434,Libya,Sudan,12797,9164,3633
2010,48,Bahrain,Sudan,9955,6329,3626
2010,196,Cyprus,Sudan,566,275,291
2010,368,Iraq,Sudan,3782,3236,546
2010,400,Jordan,Sudan,5066,3579,1487
2010,414,Kuwait,Sudan,41140,25088,16052
2010,422,Lebanon,Sudan,700,458,242
2010,512,Oman,Sudan,6978,4288,2690
2010,634,Qatar,Sudan,22272,17319,4953
2010,682,Saudi Arabia,Sudan,301500,212206,89294
2010,760,Syrian Arab Republic,Sudan,539,275,264
2010,792,Turkey,Sudan,353,243,110
2010,784,United Arab Emirates,Sudan,111835,74302,37533
2010,887,Yemen,Sudan,23170,12032,11138
2010,608,Philippines,Sudan,61,53,8
2010,764,Thailand,Sudan,1,1,0
2010,188,Costa Rica,Sudan,1,1,0
2010,32,Argentina,Sudan,8,8,0
2010,68,Bolivia (Plurinational State of),Sudan,2,2,0
2010,152,Chile,Sudan,8,1,7
2010,36,Australia,Sudan,25440,13558,11882
2010,100,Bulgaria,Sudan,35,29,6
2010,203,Czechia,Sudan,60,51,9
2010,348,Hungary,Sudan,173,135,38
2010,616,Poland,Sudan,117,94,23
2010,643,Russian Federation,Sudan,254,229,25
2010,208,Denmark,Sudan,661,398,263
2010,233,Estonia,Sudan,4,3,1
2010,246,Finland,Sudan,1040,532,508
2010,372,Ireland,Sudan,576,367,209
2010,428,Latvia,Sudan,1,1,0
2010,578,Norway,Sudan,1069,619,450
2010,752,Sweden,Sudan,1766,980,786
2010,826,United Kingdom,Sudan,14123,8145,5978
2010,191,Croatia,Sudan,66,49,17
2010,300,Greece,Sudan,1972,1187,785
2010,380,Italy,Sudan,3094,2440,654
2010,470,Malta,Sudan,366,187,179
2010,705,Slovenia,Sudan,13,10,3
2010,724,Spain,Sudan,396,285,111
2010,40,Austria,Sudan,543,398,145
2010,56,Belgium,Sudan,645,430,215
2010,250,France,Sudan,3012,1831,1181
2010,528,Netherlands,Sudan,4448,2955,1493
2010,756,Switzerland,Sudan,907,518,389
2010,124,Canada,Sudan,13755,7355,6400
2010,840,United States of America,Sudan,41940,18599,23341
2015,232,Eritrea,Sudan,208,136,72
2015,231,Ethiopia,Sudan,39539,20012,19527
2015,404,Kenya,Sudan,10266,5133,5133
2015,728,South Sudan,Sudan,562391,277127,285264
2015,800,Uganda,Sudan,66853,30213,36640
2015,140,Central African Republic,Sudan,19546,10480,9066
2015,148,Chad,Sudan,323465,147430,176035
2015,180,Democratic Republic of the Congo,Sudan,5621,691,4930
2015,516,Namibia,Sudan,194,87,107
2015,710,South Africa,Sudan,4640,2380,2260
2015,288,Ghana,Sudan,25,19,6
2015,324,Guinea,Sudan,7,5,2
2015,466,Mali,Sudan,615,362,253
2015,562,Niger,Sudan,529,221,308
2015,694,Sierra Leone,Sudan,15,8,7
2015,12,Algeria,Sudan,1527,807,720
2015,818,Egypt,Sudan,41589,24122,17467
2015,434,Libya,Sudan,14428,10276,4152
2015,48,Bahrain,Sudan,7522,4741,2781
2015,196,Cyprus,Sudan,543,266,277
2015,368,Iraq,Sudan,3792,3329,463
2015,400,Jordan,Sudan,5180,2849,2331
2015,414,Kuwait,Sudan,45525,25316,20209
2015,422,Lebanon,Sudan,589,282,307
2015,512,Oman,Sudan,15552,10459,5093
2015,634,Qatar,Sudan,18583,14723,3860
2015,682,Saudi Arabia,Sudan,385241,266864,118377
2015,760,Syrian Arab Republic,Sudan,211,111,100
2015,792,Turkey,Sudan,400,267,133
2015,784,United Arab Emirates,Sudan,122204,79574,42630
2015,887,Yemen,Sudan,26541,13831,12710
2015,608,Philippines,Sudan,62,54,8
2015,764,Thailand,Sudan,1,1,0
2015,188,Costa Rica,Sudan,1,1,0
2015,32,Argentina,Sudan,8,8,0
2015,68,Bolivia (Plurinational State of),Sudan,2,2,0
2015,152,Chile,Sudan,12,2,10
2015,36,Australia,Sudan,19730,10142,9588
2015,100,Bulgaria,Sudan,46,38,8
2015,203,Czechia,Sudan,58,48,10
2015,348,Hungary,Sudan,178,142,36
2015,616,Poland,Sudan,112,91,21
2015,643,Russian Federation,Sudan,258,233,25
2015,208,Denmark,Sudan,742,443,299
2015,233,Estonia,Sudan,12,11,1
2015,246,Finland,Sudan,1127,582,545
2015,372,Ireland,Sudan,588,372,216
2015,428,Latvia,Sudan,3,2,1
2015,578,Norway,Sudan,3300,1982,1318
2015,752,Sweden,Sudan,3763,2071,1692
2015,826,United Kingdom,Sudan,18061,10190,7871
2015,191,Croatia,Sudan,66,49,17
2015,300,Greece,Sudan,1850,1082,768
2015,380,Italy,Sudan,2861,2203,658
2015,470,Malta,Sudan,186,95,91
2015,705,Slovenia,Sudan,16,12,4
2015,724,Spain,Sudan,389,271,118
2015,40,Austria,Sudan,635,466,169
2015,56,Belgium,Sudan,1047,689,358
2015,250,France,Sudan,8008,3905,4103
2015,528,Netherlands,Sudan,4422,2854,1568
2015,756,Switzerland,Sudan,1443,776,667
2015,124,Canada,Sudan,10753,5543,5210
2015,840,United States of America,Sudan,45327,19973,25354
2019,232,Eritrea,Sudan,210,138,72
2019,231,Ethiopia,Sudan,42651,20587,22064
2019,404,Kenya,Sudan,9518,4763,4755
2019,728,South Sudan,Sudan,576668,284016,292652
2019,800,Uganda,Sudan,67395,30286,37109
2019,140,Central African Republic,Sudan,21726,11654,10072
2019,148,Chad,Sudan,354817,161575,193242
2019,180,Democratic Republic of the Congo,Sudan,5432,584,4848
2019,516,Namibia,Sudan,205,92,113
2019,710,South Africa,Sudan,5199,2669,2530
2019,288,Ghana,Sudan,28,22,6
2019,324,Guinea,Sudan,6,5,1
2019,466,Mali,Sudan,684,403,281
2019,562,Niger,Sudan,572,239,333
2019,694,Sierra Leone,Sudan,8,5,3
2019,12,Algeria,Sudan,1588,840,748
2019,818,Egypt,Sudan,59277,31441,27836
2019,434,Libya,Sudan,15308,10903,4405
2019,48,Bahrain,Sudan,7917,4990,2927
2019,196,Cyprus,Sudan,542,268,274
2019,368,Iraq,Sudan,3883,3409,474
2019,400,Jordan,Sudan,5570,3064,2506
2019,414,Kuwait,Sudan,48204,26806,21398
2019,422,Lebanon,Sudan,556,267,289
2019,512,Oman,Sudan,19155,12883,6272
2019,634,Qatar,Sudan,23954,18623,5331
2019,682,Saudi Arabia,Sudan,469324,321932,147392
2019,760,Syrian Arab Republic,Sudan,210,111,99
2019,792,Turkey,Sudan,540,362,178
2019,784,United Arab Emirates,Sudan,131254,85459,45795
2019,887,Yemen,Sudan,26942,14041,12901
2019,608,Philippines,Sudan,63,55,8
2019,764,Thailand,Sudan,1,1,0
2019,188,Costa Rica,Sudan,1,1,0
2019,32,Argentina,Sudan,8,8,0
2019,68,Bolivia (Plurinational State of),Sudan,2,2,0
2019,152,Chile,Sudan,16,2,14
2019,36,Australia,Sudan,20620,10658,9962
2019,100,Bulgaria,Sudan,51,42,9
2019,203,Czechia,Sudan,62,49,13
2019,348,Hungary,Sudan,208,163,45
2019,616,Poland,Sudan,118,97,21
2019,643,Russian Federation,Sudan,257,233,24
2019,208,Denmark,Sudan,863,504,359
2019,233,Estonia,Sudan,21,21,0
2019,246,Finland,Sudan,1489,772,717
2019,372,Ireland,Sudan,645,409,236
2019,428,Latvia,Sudan,3,3,0
2019,578,Norway,Sudan,4636,2923,1713
2019,752,Sweden,Sudan,7491,4267,3224
2019,826,United Kingdom,Sudan,20510,11595,8915
2019,191,Croatia,Sudan,60,45,15
2019,300,Greece,Sudan,1806,1085,721
2019,380,Italy,Sudan,2994,2288,706
2019,470,Malta,Sudan,300,155,145
2019,705,Slovenia,Sudan,12,10,2
2019,724,Spain,Sudan,403,278,125
2019,40,Austria,Sudan,749,553,196
2019,56,Belgium,Sudan,1247,833,414
2019,250,France,Sudan,8476,4124,4352
2019,528,Netherlands,Sudan,5420,3520,1900
2019,756,Switzerland,Sudan,2438,1392,1046
2019,124,Canada,Sudan,11523,5940,5583
2019,840,United States of America,Sudan,48947,21273,27674
1990,196,Cyprus,Suriname,1,0,1
1990,608,Philippines,Suriname,28,15,13
1990,28,Antigua and Barbuda,Suriname,9,4,5
1990,533,Aruba,Suriname,721,379,342
1990,535,"Bonaire, Sint Eustatius and Saba",Suriname,2005,942,1063
1990,212,Dominica,Suriname,7,4,3
1990,214,Dominican Republic,Suriname,103,37,66
1990,312,Guadeloupe,Suriname,3,2,1
1990,662,Saint Lucia,Suriname,18,7,11
1990,188,Costa Rica,Suriname,13,7,6
1990,32,Argentina,Suriname,11,1,10
1990,68,Bolivia (Plurinational State of),Suriname,1,1,0
1990,76,Brazil,Suriname,120,51,69
1990,152,Chile,Suriname,8,2,6
1990,254,French Guiana,Suriname,15289,8160,7129
1990,328,Guyana,Suriname,1047,525,522
1990,862,Venezuela (Bolivarian Republic of),Suriname,106,49,57
1990,36,Australia,Suriname,68,31,37
1990,208,Denmark,Suriname,20,12,8
1990,372,Ireland,Suriname,2,1,1
1990,578,Norway,Suriname,10,6,4
1990,752,Sweden,Suriname,16,8,8
1990,826,United Kingdom,Suriname,36,21,15
1990,300,Greece,Suriname,2,2,0
1990,380,Italy,Suriname,12,4,8
1990,724,Spain,Suriname,11,3,8
1990,40,Austria,Suriname,11,6,5
1990,56,Belgium,Suriname,274,81,193
1990,250,France,Suriname,267,117,150
1990,528,Netherlands,Suriname,156211,75404,80807
1990,756,Switzerland,Suriname,67,20,47
1990,124,Canada,Suriname,513,249,264
1990,840,United States of America,Suriname,2860,1403,1457
1995,196,Cyprus,Suriname,2,0,2
1995,608,Philippines,Suriname,37,20,17
1995,28,Antigua and Barbuda,Suriname,23,10,13
1995,533,Aruba,Suriname,997,498,499
1995,535,"Bonaire, Sint Eustatius and Saba",Suriname,2167,982,1185
1995,212,Dominica,Suriname,9,5,4
1995,214,Dominican Republic,Suriname,115,40,75
1995,312,Guadeloupe,Suriname,14,5,9
1995,662,Saint Lucia,Suriname,24,10,14
1995,188,Costa Rica,Suriname,11,6,5
1995,32,Argentina,Suriname,11,1,10
1995,68,Bolivia (Plurinational State of),Suriname,1,1,0
1995,76,Brazil,Suriname,177,104,73
1995,152,Chile,Suriname,5,1,4
1995,254,French Guiana,Suriname,15381,7905,7476
1995,328,Guyana,Suriname,1681,832,849
1995,862,Venezuela (Bolivarian Republic of),Suriname,80,38,42
1995,36,Australia,Suriname,76,32,44
1995,203,Czechia,Suriname,1,1,0
1995,208,Denmark,Suriname,23,13,10
1995,246,Finland,Suriname,2,1,1
1995,372,Ireland,Suriname,6,2,4
1995,578,Norway,Suriname,9,4,5
1995,752,Sweden,Suriname,19,9,10
1995,826,United Kingdom,Suriname,144,64,80
1995,300,Greece,Suriname,2,2,0
1995,380,Italy,Suriname,17,5,12
1995,724,Spain,Suriname,18,6,12
1995,40,Austria,Suriname,13,7,6
1995,56,Belgium,Suriname,274,81,193
1995,250,France,Suriname,276,118,158
1995,528,Netherlands,Suriname,167083,79029,88054
1995,756,Switzerland,Suriname,71,27,44
1995,124,Canada,Suriname,664,321,343
1995,840,United States of America,Suriname,4274,2120,2154
2000,196,Cyprus,Suriname,2,0,2
2000,608,Philippines,Suriname,131,66,65
2000,28,Antigua and Barbuda,Suriname,37,17,20
2000,533,Aruba,Suriname,1273,618,655
2000,535,"Bonaire, Sint Eustatius and Saba",Suriname,2305,1018,1287
2000,212,Dominica,Suriname,11,6,5
2000,214,Dominican Republic,Suriname,126,42,84
2000,312,Guadeloupe,Suriname,24,8,16
2000,662,Saint Lucia,Suriname,33,14,19
2000,188,Costa Rica,Suriname,15,8,7
2000,32,Argentina,Suriname,11,1,10
2000,68,Bolivia (Plurinational State of),Suriname,1,1,0
2000,76,Brazil,Suriname,233,156,77
2000,152,Chile,Suriname,2,0,2
2000,254,French Guiana,Suriname,15472,7650,7822
2000,328,Guyana,Suriname,2314,1138,1176
2000,862,Venezuela (Bolivarian Republic of),Suriname,61,29,32
2000,36,Australia,Suriname,90,45,45
2000,203,Czechia,Suriname,1,1,0
2000,208,Denmark,Suriname,26,15,11
2000,246,Finland,Suriname,3,2,1
2000,372,Ireland,Suriname,14,5,9
2000,578,Norway,Suriname,17,7,10
2000,752,Sweden,Suriname,21,10,11
2000,826,United Kingdom,Suriname,255,108,147
2000,300,Greece,Suriname,2,1,1
2000,380,Italy,Suriname,21,6,15
2000,724,Spain,Suriname,222,89,133
2000,40,Austria,Suriname,14,8,6
2000,56,Belgium,Suriname,265,81,184
2000,250,France,Suriname,284,119,165
2000,528,Netherlands,Suriname,183613,85195,98418
2000,756,Switzerland,Suriname,76,34,42
2000,124,Canada,Suriname,831,401,430
2000,840,United States of America,Suriname,5720,2857,2863
2005,196,Cyprus,Suriname,3,0,3
2005,608,Philippines,Suriname,106,55,51
2005,28,Antigua and Barbuda,Suriname,40,18,22
2005,533,Aruba,Suriname,1285,614,671
2005,52,Barbados,Suriname,33,8,25
2005,535,"Bonaire, Sint Eustatius and Saba",Suriname,2456,1085,1371
2005,212,Dominica,Suriname,13,8,5
2005,214,Dominican Republic,Suriname,76,29,47
2005,312,Guadeloupe,Suriname,30,12,18
2005,662,Saint Lucia,Suriname,29,13,16
2005,534,Sint Maarten (Dutch part),Suriname,250,115,135
2005,188,Costa Rica,Suriname,10,5,5
2005,32,Argentina,Suriname,8,0,8
2005,68,Bolivia (Plurinational State of),Suriname,1,1,0
2005,76,Brazil,Suriname,253,157,96
2005,152,Chile,Suriname,3,1,2
2005,254,French Guiana,Suriname,20487,9793,10694
2005,328,Guyana,Suriname,3117,1549,1568
2005,862,Venezuela (Bolivarian Republic of),Suriname,54,26,28
2005,36,Australia,Suriname,100,51,49
2005,100,Bulgaria,Suriname,1,1,0
2005,203,Czechia,Suriname,4,3,1
2005,208,Denmark,Suriname,28,15,13
2005,246,Finland,Suriname,3,2,1
2005,372,Ireland,Suriname,14,5,9
2005,578,Norway,Suriname,21,9,12
2005,752,Sweden,Suriname,27,12,15
2005,826,United Kingdom,Suriname,326,129,197
2005,300,Greece,Suriname,6,2,4
2005,380,Italy,Suriname,36,12,24
2005,724,Spain,Suriname,107,42,65
2005,40,Austria,Suriname,16,9,7
2005,56,Belgium,Suriname,454,171,283
2005,250,France,Suriname,22274,10785,11489
2005,528,Netherlands,Suriname,189945,86761,103184
2005,756,Switzerland,Suriname,83,34,49
2005,124,Canada,Suriname,835,406,429
2005,840,United States of America,Suriname,9938,4993,4945
2010,196,Cyprus,Suriname,4,0,4
2010,608,Philippines,Suriname,123,60,63
2010,28,Antigua and Barbuda,Suriname,42,19,23
2010,533,Aruba,Suriname,1271,597,674
2010,52,Barbados,Suriname,45,11,34
2010,535,"Bonaire, Sint Eustatius and Saba",Suriname,366,141,225
2010,531,Curaçao,Suriname,1722,746,976
2010,212,Dominica,Suriname,16,10,6
2010,214,Dominican Republic,Suriname,26,16,10
2010,312,Guadeloupe,Suriname,36,17,19
2010,662,Saint Lucia,Suriname,23,10,13
2010,534,Sint Maarten (Dutch part),Suriname,500,229,271
2010,188,Costa Rica,Suriname,20,11,9
2010,32,Argentina,Suriname,5,0,5
2010,76,Brazil,Suriname,270,157,113
2010,152,Chile,Suriname,4,1,3
2010,254,French Guiana,Suriname,25501,11935,13566
2010,328,Guyana,Suriname,3920,1960,1960
2010,862,Venezuela (Bolivarian Republic of),Suriname,48,23,25
2010,36,Australia,Suriname,120,52,68
2010,100,Bulgaria,Suriname,1,1,0
2010,203,Czechia,Suriname,7,5,2
2010,208,Denmark,Suriname,28,15,13
2010,233,Estonia,Suriname,1,1,0
2010,246,Finland,Suriname,2,2,0
2010,372,Ireland,Suriname,12,4,8
2010,578,Norway,Suriname,39,16,23
2010,752,Sweden,Suriname,32,12,20
2010,826,United Kingdom,Suriname,343,140,203
2010,300,Greece,Suriname,9,2,7
2010,380,Italy,Suriname,47,15,32
2010,724,Spain,Suriname,196,75,121
2010,40,Austria,Suriname,17,9,8
2010,56,Belgium,Suriname,1111,471,640
2010,250,France,Suriname,22896,9295,13601
2010,528,Netherlands,Suriname,187312,84284,103028
2010,756,Switzerland,Suriname,101,38,63
2010,124,Canada,Suriname,865,426,439
2010,840,United States of America,Suriname,14573,6487,8086
2015,196,Cyprus,Suriname,3,0,3
2015,608,Philippines,Suriname,125,62,63
2015,28,Antigua and Barbuda,Suriname,45,21,24
2015,533,Aruba,Suriname,1337,628,709
2015,52,Barbados,Suriname,47,12,35
2015,535,"Bonaire, Sint Eustatius and Saba",Suriname,416,160,256
2015,531,Curaçao,Suriname,1871,813,1058
2015,212,Dominica,Suriname,19,12,7
2015,214,Dominican Republic,Suriname,27,17,10
2015,312,Guadeloupe,Suriname,37,17,20
2015,662,Saint Lucia,Suriname,22,10,12
2015,534,Sint Maarten (Dutch part),Suriname,521,238,283
2015,188,Costa Rica,Suriname,20,11,9
2015,32,Argentina,Suriname,5,0,5
2015,76,Brazil,Suriname,325,189,136
2015,152,Chile,Suriname,6,2,4
2015,254,French Guiana,Suriname,30785,14211,16574
2015,328,Guyana,Suriname,4595,2297,2298
2015,862,Venezuela (Bolivarian Republic of),Suriname,46,23,23
2015,36,Australia,Suriname,170,71,99
2015,100,Bulgaria,Suriname,1,1,0
2015,203,Czechia,Suriname,7,3,4
2015,208,Denmark,Suriname,31,16,15
2015,233,Estonia,Suriname,2,1,1
2015,246,Finland,Suriname,1,1,0
2015,372,Ireland,Suriname,12,4,8
2015,578,Norway,Suriname,41,17,24
2015,752,Sweden,Suriname,44,22,22
2015,826,United Kingdom,Suriname,438,171,267
2015,300,Greece,Suriname,8,2,6
2015,380,Italy,Suriname,41,13,28
2015,724,Spain,Suriname,218,89,129
2015,40,Austria,Suriname,20,11,9
2015,56,Belgium,Suriname,3017,1375,1642
2015,250,France,Suriname,25364,9882,15482
2015,528,Netherlands,Suriname,196783,88712,108071
2015,756,Switzerland,Suriname,130,43,87
2015,124,Canada,Suriname,1043,561,482
2015,840,United States of America,Suriname,14794,6544,8250
2019,196,Cyprus,Suriname,2,0,2
2019,608,Philippines,Suriname,128,64,64
2019,28,Antigua and Barbuda,Suriname,46,22,24
2019,533,Aruba,Suriname,1352,635,717
2019,52,Barbados,Suriname,47,12,35
2019,535,"Bonaire, Sint Eustatius and Saba",Suriname,495,191,304
2019,531,Curaçao,Suriname,2033,883,1150
2019,212,Dominica,Suriname,19,12,7
2019,214,Dominican Republic,Suriname,27,17,10
2019,312,Guadeloupe,Suriname,37,17,20
2019,662,Saint Lucia,Suriname,21,10,11
2019,534,Sint Maarten (Dutch part),Suriname,539,247,292
2019,188,Costa Rica,Suriname,20,11,9
2019,32,Argentina,Suriname,5,0,5
2019,76,Brazil,Suriname,366,213,153
2019,152,Chile,Suriname,8,3,5
2019,254,French Guiana,Suriname,34060,15720,18340
2019,328,Guyana,Suriname,4689,2345,2344
2019,862,Venezuela (Bolivarian Republic of),Suriname,45,23,22
2019,36,Australia,Suriname,179,70,109
2019,100,Bulgaria,Suriname,2,2,0
2019,203,Czechia,Suriname,7,3,4
2019,208,Denmark,Suriname,33,17,16
2019,233,Estonia,Suriname,1,1,0
2019,246,Finland,Suriname,2,2,0
2019,352,Iceland,Suriname,1,0,1
2019,372,Ireland,Suriname,13,5,8
2019,578,Norway,Suriname,41,17,24
2019,752,Sweden,Suriname,65,32,33
2019,826,United Kingdom,Suriname,497,195,302
2019,300,Greece,Suriname,7,2,5
2019,380,Italy,Suriname,61,20,41
2019,724,Spain,Suriname,225,89,136
2019,40,Austria,Suriname,23,13,10
2019,56,Belgium,Suriname,3909,1780,2129
2019,250,France,Suriname,26847,10422,16425
2019,528,Netherlands,Suriname,191481,85197,106284
2019,756,Switzerland,Suriname,143,47,96
2019,124,Canada,Suriname,1117,601,516
2019,840,United States of America,Suriname,15975,6966,9009
1990,800,Uganda,Sweden,29,29,0
1990,140,Central African Republic,Sweden,10,5,5
1990,72,Botswana,Sweden,129,80,49
1990,516,Namibia,Sweden,149,68,81
1990,710,South Africa,Sweden,116,66,50
1990,430,Liberia,Sweden,1120,588,532
1990,818,Egypt,Sweden,358,204,154
1990,434,Libya,Sweden,1021,585,436
1990,196,Cyprus,Sweden,227,84,143
1990,376,Israel,Sweden,1178,488,690
1990,400,Jordan,Sweden,82,39,43
1990,792,Turkey,Sweden,1291,638,653
1990,64,Bhutan,Sweden,11,6,5
1990,462,Maldives,Sweden,11,6,5
1990,144,Sri Lanka,Sweden,29,18,11
1990,392,Japan,Sweden,586,299,287
1990,608,Philippines,Sweden,99,71,28
1990,764,Thailand,Sweden,249,179,70
1990,44,Bahamas,Sweden,11,4,7
1990,214,Dominican Republic,Sweden,369,85,284
1990,188,Costa Rica,Sweden,97,59,38
1990,222,El Salvador,Sweden,33,17,16
1990,320,Guatemala,Sweden,27,8,19
1990,340,Honduras,Sweden,23,12,11
1990,484,Mexico,Sweden,324,162,162
1990,558,Nicaragua,Sweden,55,23,32
1990,591,Panama,Sweden,27,18,9
1990,32,Argentina,Sweden,566,321,245
1990,68,Bolivia (Plurinational State of),Sweden,200,90,110
1990,76,Brazil,Sweden,457,331,126
1990,152,Chile,Sweden,731,367,364
1990,170,Colombia,Sweden,175,82,93
1990,218,Ecuador,Sweden,117,62,55
1990,604,Peru,Sweden,175,94,81
1990,862,Venezuela (Bolivarian Republic of),Sweden,231,119,112
1990,36,Australia,Sweden,5694,3019,2675
1990,554,New Zealand,Sweden,522,285,237
1990,112,Belarus,Sweden,190,122,68
1990,100,Bulgaria,Sweden,15,9,6
1990,203,Czechia,Sweden,52,34,18
1990,348,Hungary,Sweden,262,116,146
1990,616,Poland,Sweden,998,527,471
1990,642,Romania,Sweden,177,71,106
1990,643,Russian Federation,Sweden,340,167,173
1990,703,Slovakia,Sweden,8,3,5
1990,208,Denmark,Sweden,15641,6260,9381
1990,233,Estonia,Sweden,90,51,39
1990,234,Faroe Islands,Sweden,56,33,23
1990,246,Finland,Sweden,26043,12932,13111
1990,352,Iceland,Sweden,1012,463,549
1990,372,Ireland,Sweden,145,71,74
1990,428,Latvia,Sweden,128,89,39
1990,440,Lithuania,Sweden,478,314,164
1990,578,Norway,Sweden,20429,9183,11246
1990,826,United Kingdom,Sweden,10818,3652,7166
1990,20,Andorra,Sweden,54,29,25
1990,191,Croatia,Sweden,279,101,178
1990,300,Greece,Sweden,3364,1202,2162
1990,380,Italy,Sweden,5968,1213,4755
1990,470,Malta,Sweden,28,15,13
1990,620,Portugal,Sweden,216,98,118
1990,688,Serbia,Sweden,146,77,69
1990,705,Slovenia,Sweden,248,134,114
1990,724,Spain,Sweden,5755,2382,3373
1990,40,Austria,Sweden,1956,814,1142
1990,56,Belgium,Sweden,1593,845,748
1990,250,France,Sweden,10606,3496,7110
1990,276,Germany,Sweden,13195,5443,7752
1990,438,Liechtenstein,Sweden,22,11,11
1990,442,Luxembourg,Sweden,456,224,232
1990,528,Netherlands,Sweden,2144,930,1214
1990,756,Switzerland,Sweden,6101,2621,3480
1990,124,Canada,Sweden,7489,3645,3844
1990,304,Greenland,Sweden,141,119,22
1990,840,United States of America,Sweden,53676,21747,31929
1995,800,Uganda,Sweden,27,27,0
1995,140,Central African Republic,Sweden,15,8,7
1995,72,Botswana,Sweden,124,76,48
1995,516,Namibia,Sweden,142,66,76
1995,710,South Africa,Sweden,95,55,40
1995,430,Liberia,Sweden,1094,563,531
1995,818,Egypt,Sweden,297,166,131
1995,434,Libya,Sweden,779,452,327
1995,196,Cyprus,Sweden,321,110,211
1995,376,Israel,Sweden,1149,466,683
1995,400,Jordan,Sweden,96,43,53
1995,792,Turkey,Sweden,3124,1476,1648
1995,64,Bhutan,Sweden,13,8,5
1995,462,Maldives,Sweden,24,12,12
1995,144,Sri Lanka,Sweden,39,26,13
1995,392,Japan,Sweden,860,413,447
1995,608,Philippines,Sweden,133,95,38
1995,764,Thailand,Sweden,416,295,121
1995,44,Bahamas,Sweden,21,8,13
1995,214,Dominican Republic,Sweden,410,87,323
1995,188,Costa Rica,Sweden,80,47,33
1995,222,El Salvador,Sweden,29,16,13
1995,320,Guatemala,Sweden,29,13,16
1995,340,Honduras,Sweden,23,12,11
1995,484,Mexico,Sweden,466,221,245
1995,558,Nicaragua,Sweden,44,18,26
1995,591,Panama,Sweden,37,25,12
1995,32,Argentina,Sweden,497,266,231
1995,68,Bolivia (Plurinational State of),Sweden,177,83,94
1995,76,Brazil,Sweden,587,390,197
1995,152,Chile,Sweden,980,489,491
1995,170,Colombia,Sweden,168,81,87
1995,218,Ecuador,Sweden,131,69,62
1995,604,Peru,Sweden,176,93,83
1995,862,Venezuela (Bolivarian Republic of),Sweden,180,97,83
1995,36,Australia,Sweden,6612,3413,3199
1995,554,New Zealand,Sweden,644,339,305
1995,112,Belarus,Sweden,271,152,119
1995,100,Bulgaria,Sweden,37,22,15
1995,203,Czechia,Sweden,78,52,26
1995,348,Hungary,Sweden,653,309,344
1995,616,Poland,Sweden,853,445,408
1995,642,Romania,Sweden,134,62,72
1995,643,Russian Federation,Sweden,338,176,162
1995,703,Slovakia,Sweden,76,41,35
1995,208,Denmark,Sweden,17707,7301,10406
1995,233,Estonia,Sweden,139,79,60
1995,234,Faroe Islands,Sweden,39,23,16
1995,246,Finland,Sweden,24814,12802,12012
1995,352,Iceland,Sweden,1280,600,680
1995,372,Ireland,Sweden,515,245,270
1995,428,Latvia,Sweden,167,113,54
1995,440,Lithuania,Sweden,308,202,106
1995,578,Norway,Sweden,23219,10416,12803
1995,826,United Kingdom,Sweden,16159,5543,10616
1995,20,Andorra,Sweden,52,28,24
1995,191,Croatia,Sweden,276,102,174
1995,300,Greece,Sweden,4336,1746,2590
1995,380,Italy,Sweden,5003,1118,3885
1995,470,Malta,Sweden,33,17,16
1995,620,Portugal,Sweden,466,211,255
1995,688,Serbia,Sweden,929,481,448
1995,705,Slovenia,Sweden,225,115,110
1995,724,Spain,Sweden,7207,3095,4112
1995,40,Austria,Sweden,2207,940,1267
1995,56,Belgium,Sweden,2712,1338,1374
1995,250,France,Sweden,10949,3486,7463
1995,276,Germany,Sweden,15721,6585,9136
1995,438,Liechtenstein,Sweden,23,11,12
1995,442,Luxembourg,Sweden,707,329,378
1995,528,Netherlands,Sweden,2770,1170,1600
1995,756,Switzerland,Sweden,6515,3036,3479
1995,124,Canada,Sweden,7391,3581,3810
1995,304,Greenland,Sweden,64,39,25
1995,840,United States of America,Sweden,52391,21475,30916
2000,800,Uganda,Sweden,26,26,0
2000,140,Central African Republic,Sweden,18,9,9
2000,72,Botswana,Sweden,133,82,51
2000,516,Namibia,Sweden,133,61,72
2000,710,South Africa,Sweden,102,60,42
2000,430,Liberia,Sweden,1075,539,536
2000,818,Egypt,Sweden,259,140,119
2000,434,Libya,Sweden,551,334,217
2000,196,Cyprus,Sweden,415,137,278
2000,376,Israel,Sweden,1056,426,630
2000,400,Jordan,Sweden,109,46,63
2000,792,Turkey,Sweden,4969,2317,2652
2000,64,Bhutan,Sweden,14,8,6
2000,462,Maldives,Sweden,36,19,17
2000,144,Sri Lanka,Sweden,51,34,17
2000,392,Japan,Sweden,1158,535,623
2000,608,Philippines,Sweden,121,82,39
2000,764,Thailand,Sweden,670,469,201
2000,44,Bahamas,Sweden,32,14,18
2000,214,Dominican Republic,Sweden,451,89,362
2000,188,Costa Rica,Sweden,104,58,46
2000,222,El Salvador,Sweden,25,15,10
2000,320,Guatemala,Sweden,30,17,13
2000,340,Honduras,Sweden,23,12,11
2000,484,Mexico,Sweden,629,290,339
2000,558,Nicaragua,Sweden,36,18,18
2000,591,Panama,Sweden,51,34,17
2000,32,Argentina,Sweden,428,211,217
2000,68,Bolivia (Plurinational State of),Sweden,152,75,77
2000,76,Brazil,Sweden,716,449,267
2000,152,Chile,Sweden,1229,609,620
2000,170,Colombia,Sweden,161,81,80
2000,218,Ecuador,Sweden,145,77,68
2000,604,Peru,Sweden,206,109,97
2000,862,Venezuela (Bolivarian Republic of),Sweden,140,78,62
2000,36,Australia,Sweden,7110,3605,3505
2000,554,New Zealand,Sweden,933,454,479
2000,112,Belarus,Sweden,352,183,169
2000,100,Bulgaria,Sweden,58,34,24
2000,203,Czechia,Sweden,104,70,34
2000,348,Hungary,Sweden,1043,502,541
2000,616,Poland,Sweden,729,375,354
2000,642,Romania,Sweden,89,51,38
2000,643,Russian Federation,Sweden,324,177,147
2000,703,Slovakia,Sweden,167,92,75
2000,208,Denmark,Sweden,19772,8341,11431
2000,233,Estonia,Sweden,188,108,80
2000,234,Faroe Islands,Sweden,59,33,26
2000,246,Finland,Sweden,23584,12672,10912
2000,352,Iceland,Sweden,1547,736,811
2000,372,Ireland,Sweden,1168,575,593
2000,428,Latvia,Sweden,206,137,69
2000,440,Lithuania,Sweden,241,158,83
2000,578,Norway,Sweden,33401,15658,17743
2000,826,United Kingdom,Sweden,21773,7501,14272
2000,20,Andorra,Sweden,49,26,23
2000,191,Croatia,Sweden,244,95,149
2000,300,Greece,Sweden,5380,2272,3108
2000,380,Italy,Sweden,4038,1023,3015
2000,470,Malta,Sweden,83,44,39
2000,620,Portugal,Sweden,736,333,403
2000,688,Serbia,Sweden,1264,642,622
2000,705,Slovenia,Sweden,399,196,203
2000,724,Spain,Sweden,11761,5252,6509
2000,40,Austria,Sweden,2457,1065,1392
2000,56,Belgium,Sweden,3752,1797,1955
2000,250,France,Sweden,11292,3476,7816
2000,276,Germany,Sweden,18246,7726,10520
2000,438,Liechtenstein,Sweden,24,11,13
2000,442,Luxembourg,Sweden,967,439,528
2000,528,Netherlands,Sweden,3492,1444,2048
2000,756,Switzerland,Sweden,6953,3472,3481
2000,124,Canada,Sweden,7468,3603,3865
2000,304,Greenland,Sweden,107,65,42
2000,840,United States of America,Sweden,50986,21190,29796
2005,800,Uganda,Sweden,25,25,0
2005,140,Central African Republic,Sweden,14,7,7
2005,72,Botswana,Sweden,254,155,99
2005,516,Namibia,Sweden,105,48,57
2005,710,South Africa,Sweden,133,74,59
2005,430,Liberia,Sweden,488,315,173
2005,818,Egypt,Sweden,308,175,133
2005,434,Libya,Sweden,607,411,196
2005,196,Cyprus,Sweden,607,197,410
2005,376,Israel,Sweden,856,345,511
2005,400,Jordan,Sweden,158,79,79
2005,792,Turkey,Sweden,5120,2326,2794
2005,64,Bhutan,Sweden,18,10,8
2005,462,Maldives,Sweden,26,15,11
2005,144,Sri Lanka,Sweden,76,46,30
2005,392,Japan,Sweden,1465,667,798
2005,608,Philippines,Sweden,97,66,31
2005,764,Thailand,Sweden,634,424,210
2005,44,Bahamas,Sweden,30,14,16
2005,214,Dominican Republic,Sweden,261,65,196
2005,188,Costa Rica,Sweden,68,37,31
2005,222,El Salvador,Sweden,30,19,11
2005,320,Guatemala,Sweden,36,23,13
2005,340,Honduras,Sweden,23,12,11
2005,484,Mexico,Sweden,493,243,250
2005,558,Nicaragua,Sweden,29,17,12
2005,591,Panama,Sweden,113,82,31
2005,32,Argentina,Sweden,316,158,158
2005,68,Bolivia (Plurinational State of),Sweden,202,101,101
2005,76,Brazil,Sweden,677,440,237
2005,152,Chile,Sweden,1844,929,915
2005,170,Colombia,Sweden,152,78,74
2005,218,Ecuador,Sweden,171,93,78
2005,604,Peru,Sweden,242,128,114
2005,862,Venezuela (Bolivarian Republic of),Sweden,127,69,58
2005,36,Australia,Sweden,8550,4083,4467
2005,554,New Zealand,Sweden,1124,546,578
2005,112,Belarus,Sweden,338,176,162
2005,100,Bulgaria,Sweden,89,53,36
2005,203,Czechia,Sweden,236,173,63
2005,348,Hungary,Sweden,1289,633,656
2005,616,Poland,Sweden,1025,575,450
2005,642,Romania,Sweden,118,65,53
2005,643,Russian Federation,Sweden,399,213,186
2005,703,Slovakia,Sweden,188,105,83
2005,208,Denmark,Sweden,20693,8746,11947
2005,233,Estonia,Sweden,321,208,113
2005,234,Faroe Islands,Sweden,58,33,25
2005,246,Finland,Sweden,28099,14827,13272
2005,352,Iceland,Sweden,1716,821,895
2005,372,Ireland,Sweden,1633,684,949
2005,428,Latvia,Sweden,331,223,108
2005,440,Lithuania,Sweden,293,178,115
2005,578,Norway,Sweden,33148,15891,17257
2005,826,United Kingdom,Sweden,25452,9274,16178
2005,20,Andorra,Sweden,55,29,26
2005,191,Croatia,Sweden,434,195,239
2005,300,Greece,Sweden,5459,2268,3191
2005,380,Italy,Sweden,5224,1562,3662
2005,470,Malta,Sweden,131,68,63
2005,620,Portugal,Sweden,787,358,429
2005,688,Serbia,Sweden,1247,626,621
2005,705,Slovenia,Sweden,387,189,198
2005,724,Spain,Sweden,14768,6636,8132
2005,40,Austria,Sweden,2747,1154,1593
2005,56,Belgium,Sweden,3688,1732,1956
2005,250,France,Sweden,9125,3132,5993
2005,276,Germany,Sweden,17149,7457,9692
2005,438,Liechtenstein,Sweden,23,10,13
2005,442,Luxembourg,Sweden,1152,523,629
2005,528,Netherlands,Sweden,3683,1483,2200
2005,756,Switzerland,Sweden,7741,3657,4084
2005,124,Canada,Sweden,7150,3326,3824
2005,304,Greenland,Sweden,82,53,29
2005,840,United States of America,Sweden,48928,20493,28435
2010,800,Uganda,Sweden,25,25,0
2010,140,Central African Republic,Sweden,14,7,7
2010,72,Botswana,Sweden,376,229,147
2010,516,Namibia,Sweden,101,47,54
2010,710,South Africa,Sweden,208,116,92
2010,430,Liberia,Sweden,225,101,124
2010,818,Egypt,Sweden,332,183,149
2010,434,Libya,Sweden,664,452,212
2010,196,Cyprus,Sweden,994,331,663
2010,376,Israel,Sweden,667,267,400
2010,400,Jordan,Sweden,203,107,96
2010,792,Turkey,Sweden,5276,2332,2944
2010,64,Bhutan,Sweden,22,12,10
2010,462,Maldives,Sweden,31,24,7
2010,144,Sri Lanka,Sweden,127,78,49
2010,392,Japan,Sweden,1553,698,855
2010,608,Philippines,Sweden,596,402,194
2010,764,Thailand,Sweden,645,415,230
2010,44,Bahamas,Sweden,27,13,14
2010,214,Dominican Republic,Sweden,70,41,29
2010,188,Costa Rica,Sweden,135,75,60
2010,222,El Salvador,Sweden,34,22,12
2010,320,Guatemala,Sweden,41,29,12
2010,340,Honduras,Sweden,22,12,10
2010,484,Mexico,Sweden,415,224,191
2010,558,Nicaragua,Sweden,31,19,12
2010,591,Panama,Sweden,181,133,48
2010,32,Argentina,Sweden,203,105,98
2010,68,Bolivia (Plurinational State of),Sweden,252,128,124
2010,76,Brazil,Sweden,629,425,204
2010,152,Chile,Sweden,2460,1249,1211
2010,170,Colombia,Sweden,170,91,79
2010,218,Ecuador,Sweden,240,127,113
2010,604,Peru,Sweden,270,142,128
2010,862,Venezuela (Bolivarian Republic of),Sweden,117,61,56
2010,36,Australia,Sweden,10050,4486,5564
2010,554,New Zealand,Sweden,1273,617,656
2010,112,Belarus,Sweden,324,169,155
2010,100,Bulgaria,Sweden,117,71,46
2010,203,Czechia,Sweden,345,261,84
2010,348,Hungary,Sweden,1534,763,771
2010,616,Poland,Sweden,1355,791,564
2010,642,Romania,Sweden,168,91,77
2010,643,Russian Federation,Sweden,467,245,222
2010,703,Slovakia,Sweden,211,119,92
2010,208,Denmark,Sweden,21232,8997,12235
2010,233,Estonia,Sweden,451,305,146
2010,234,Faroe Islands,Sweden,68,41,27
2010,246,Finland,Sweden,40255,19369,20886
2010,352,Iceland,Sweden,1881,904,977
2010,372,Ireland,Sweden,1829,560,1269
2010,428,Latvia,Sweden,449,302,147
2010,440,Lithuania,Sweden,307,168,139
2010,578,Norway,Sweden,41781,20867,20914
2010,826,United Kingdom,Sweden,26812,10120,16692
2010,20,Andorra,Sweden,53,28,25
2010,191,Croatia,Sweden,624,295,329
2010,300,Greece,Sweden,5762,2357,3405
2010,380,Italy,Sweden,6846,2219,4627
2010,470,Malta,Sweden,380,223,157
2010,499,Montenegro,Sweden,144,55,89
2010,620,Portugal,Sweden,709,325,384
2010,688,Serbia,Sweden,1219,611,608
2010,705,Slovenia,Sweden,389,194,195
2010,724,Spain,Sweden,18133,8101,10032
2010,40,Austria,Sweden,3036,1242,1794
2010,56,Belgium,Sweden,3873,1751,2122
2010,250,France,Sweden,9447,2761,6686
2010,276,Germany,Sweden,16172,7146,9026
2010,438,Liechtenstein,Sweden,24,9,15
2010,442,Luxembourg,Sweden,1350,612,738
2010,528,Netherlands,Sweden,4088,1686,2402
2010,756,Switzerland,Sweden,9187,4077,5110
2010,124,Canada,Sweden,6800,3053,3747
2010,304,Greenland,Sweden,90,60,30
2010,840,United States of America,Sweden,48320,19853,28467
2015,800,Uganda,Sweden,25,25,0
2015,140,Central African Republic,Sweden,12,6,6
2015,72,Botswana,Sweden,410,250,160
2015,516,Namibia,Sweden,98,46,52
2015,710,South Africa,Sweden,374,201,173
2015,324,Guinea,Sweden,3,3,0
2015,430,Liberia,Sweden,258,115,143
2015,818,Egypt,Sweden,246,150,96
2015,434,Libya,Sweden,748,506,242
2015,196,Cyprus,Sweden,955,323,632
2015,376,Israel,Sweden,688,273,415
2015,400,Jordan,Sweden,87,37,50
2015,792,Turkey,Sweden,5355,2299,3056
2015,64,Bhutan,Sweden,23,13,10
2015,462,Maldives,Sweden,36,32,4
2015,144,Sri Lanka,Sweden,129,79,50
2015,392,Japan,Sweden,1805,805,1000
2015,608,Philippines,Sweden,605,409,196
2015,764,Thailand,Sweden,697,448,249
2015,44,Bahamas,Sweden,29,14,15
2015,214,Dominican Republic,Sweden,73,43,30
2015,188,Costa Rica,Sweden,137,76,61
2015,222,El Salvador,Sweden,35,23,12
2015,320,Guatemala,Sweden,47,33,14
2015,340,Honduras,Sweden,31,18,13
2015,484,Mexico,Sweden,656,372,284
2015,558,Nicaragua,Sweden,33,21,12
2015,591,Panama,Sweden,212,155,57
2015,32,Argentina,Sweden,204,106,98
2015,68,Bolivia (Plurinational State of),Sweden,293,149,144
2015,76,Brazil,Sweden,757,511,246
2015,152,Chile,Sweden,3726,1853,1873
2015,170,Colombia,Sweden,190,103,87
2015,218,Ecuador,Sweden,349,184,165
2015,604,Peru,Sweden,287,155,132
2015,862,Venezuela (Bolivarian Republic of),Sweden,114,59,55
2015,36,Australia,Sweden,11480,4889,6591
2015,554,New Zealand,Sweden,1402,678,724
2015,112,Belarus,Sweden,340,177,163
2015,100,Bulgaria,Sweden,312,167,145
2015,203,Czechia,Sweden,464,325,139
2015,348,Hungary,Sweden,1604,853,751
2015,616,Poland,Sweden,1306,773,533
2015,642,Romania,Sweden,191,90,101
2015,643,Russian Federation,Sweden,475,247,228
2015,703,Slovakia,Sweden,270,159,111
2015,208,Denmark,Sweden,23531,10255,13276
2015,233,Estonia,Sweden,539,407,132
2015,234,Faroe Islands,Sweden,76,45,31
2015,246,Finland,Sweden,39644,19511,20133
2015,352,Iceland,Sweden,1920,949,971
2015,372,Ireland,Sweden,1868,556,1312
2015,428,Latvia,Sweden,324,193,131
2015,440,Lithuania,Sweden,312,174,138
2015,578,Norway,Sweden,49707,25210,24497
2015,826,United Kingdom,Sweden,34288,12309,21979
2015,20,Andorra,Sweden,49,49,0
2015,191,Croatia,Sweden,628,296,332
2015,300,Greece,Sweden,5408,2076,3332
2015,380,Italy,Sweden,6288,1988,4300
2015,470,Malta,Sweden,645,397,248
2015,499,Montenegro,Sweden,151,58,93
2015,620,Portugal,Sweden,803,345,458
2015,688,Serbia,Sweden,1191,596,595
2015,705,Slovenia,Sweden,332,177,155
2015,724,Spain,Sweden,19318,8736,10582
2015,40,Austria,Sweden,3551,1465,2086
2015,56,Belgium,Sweden,3342,1493,1849
2015,250,France,Sweden,9454,3287,6167
2015,276,Germany,Sweden,16851,7424,9427
2015,438,Liechtenstein,Sweden,25,9,16
2015,442,Luxembourg,Sweden,2059,951,1108
2015,528,Netherlands,Sweden,4447,1820,2627
2015,756,Switzerland,Sweden,9531,4162,5369
2015,124,Canada,Sweden,6589,2980,3609
2015,304,Greenland,Sweden,83,55,28
2015,840,United States of America,Sweden,52116,21256,30860
2019,800,Uganda,Sweden,25,25,0
2019,140,Central African Republic,Sweden,13,7,6
2019,72,Botswana,Sweden,439,268,171
2019,516,Namibia,Sweden,103,48,55
2019,710,South Africa,Sweden,418,225,193
2019,324,Guinea,Sweden,2,2,0
2019,430,Liberia,Sweden,214,96,118
2019,818,Egypt,Sweden,350,198,152
2019,434,Libya,Sweden,793,537,256
2019,196,Cyprus,Sweden,954,329,625
2019,376,Israel,Sweden,669,266,403
2019,400,Jordan,Sweden,93,40,53
2019,792,Turkey,Sweden,7240,3149,4091
2019,64,Bhutan,Sweden,23,13,10
2019,462,Maldives,Sweden,38,34,4
2019,144,Sri Lanka,Sweden,130,80,50
2019,392,Japan,Sweden,1881,839,1042
2019,608,Philippines,Sweden,624,422,202
2019,764,Thailand,Sweden,726,467,259
2019,44,Bahamas,Sweden,30,15,15
2019,214,Dominican Republic,Sweden,75,44,31
2019,188,Costa Rica,Sweden,139,78,61
2019,222,El Salvador,Sweden,35,23,12
2019,320,Guatemala,Sweden,48,34,14
2019,340,Honduras,Sweden,31,18,13
2019,484,Mexico,Sweden,676,384,292
2019,558,Nicaragua,Sweden,34,22,12
2019,591,Panama,Sweden,224,165,59
2019,32,Argentina,Sweden,207,108,99
2019,68,Bolivia (Plurinational State of),Sweden,319,162,157
2019,76,Brazil,Sweden,852,575,277
2019,152,Chile,Sweden,4978,2337,2641
2019,170,Colombia,Sweden,194,106,88
2019,218,Ecuador,Sweden,343,181,162
2019,604,Peru,Sweden,342,192,150
2019,862,Venezuela (Bolivarian Republic of),Sweden,111,57,54
2019,36,Australia,Sweden,12283,5148,7135
2019,554,New Zealand,Sweden,1441,697,744
2019,112,Belarus,Sweden,335,175,160
2019,100,Bulgaria,Sweden,451,233,218
2019,203,Czechia,Sweden,503,357,146
2019,348,Hungary,Sweden,1678,892,786
2019,616,Poland,Sweden,1383,841,542
2019,642,Romania,Sweden,683,367,316
2019,643,Russian Federation,Sweden,474,247,227
2019,703,Slovakia,Sweden,309,182,127
2019,208,Denmark,Sweden,25128,10950,14178
2019,233,Estonia,Sweden,600,466,134
2019,234,Faroe Islands,Sweden,85,51,34
2019,246,Finland,Sweden,43205,21339,21866
2019,352,Iceland,Sweden,2254,1133,1121
2019,372,Ireland,Sweden,2050,614,1436
2019,428,Latvia,Sweden,232,154,78
2019,440,Lithuania,Sweden,385,212,173
2019,578,Norway,Sweden,52421,26595,25826
2019,826,United Kingdom,Sweden,38937,14041,24896
2019,20,Andorra,Sweden,52,52,0
2019,191,Croatia,Sweden,579,272,307
2019,300,Greece,Sweden,5281,2151,3130
2019,380,Italy,Sweden,6264,2045,4219
2019,470,Malta,Sweden,1040,643,397
2019,499,Montenegro,Sweden,151,59,92
2019,620,Portugal,Sweden,816,352,464
2019,688,Serbia,Sweden,1209,606,603
2019,705,Slovenia,Sweden,320,170,150
2019,724,Spain,Sweden,19732,8848,10884
2019,40,Austria,Sweden,4191,1771,2420
2019,56,Belgium,Sweden,3406,1523,1883
2019,250,France,Sweden,10007,3465,6542
2019,276,Germany,Sweden,18484,8685,9799
2019,438,Liechtenstein,Sweden,31,13,18
2019,442,Luxembourg,Sweden,1674,865,809
2019,528,Netherlands,Sweden,5234,2232,3002
2019,756,Switzerland,Sweden,9671,4283,5388
2019,124,Canada,Sweden,7060,3193,3867
2019,304,Greenland,Sweden,81,54,27
2019,840,United States of America,Sweden,56279,22595,33684
1990,480,Mauritius,Switzerland,66,44,22
1990,140,Central African Republic,Switzerland,150,68,82
1990,516,Namibia,Switzerland,634,266,368
1990,710,South Africa,Switzerland,4268,1914,2354
1990,132,Cabo Verde,Switzerland,18,9,9
1990,288,Ghana,Switzerland,104,58,46
1990,430,Liberia,Switzerland,148,83,65
1990,818,Egypt,Switzerland,1775,936,839
1990,434,Libya,Switzerland,5069,2686,2383
1990,196,Cyprus,Switzerland,94,36,58
1990,376,Israel,Switzerland,2662,1137,1525
1990,400,Jordan,Switzerland,53,23,30
1990,792,Turkey,Switzerland,8109,4018,4091
1990,762,Tajikistan,Switzerland,81,36,45
1990,64,Bhutan,Switzerland,11,9,2
1990,462,Maldives,Switzerland,102,56,46
1990,144,Sri Lanka,Switzerland,6,4,2
1990,344,"China, Hong Kong SAR",Switzerland,487,350,137
1990,392,Japan,Switzerland,980,499,481
1990,496,Mongolia,Switzerland,4,2,2
1990,608,Philippines,Switzerland,250,171,79
1990,764,Thailand,Switzerland,370,306,64
1990,44,Bahamas,Switzerland,85,53,32
1990,136,Cayman Islands,Switzerland,24,19,5
1990,214,Dominican Republic,Switzerland,2140,1382,758
1990,312,Guadeloupe,Switzerland,89,43,46
1990,332,Haiti,Switzerland,377,240,137
1990,662,Saint Lucia,Switzerland,5,4,1
1990,188,Costa Rica,Switzerland,388,224,164
1990,222,El Salvador,Switzerland,87,54,33
1990,320,Guatemala,Switzerland,151,66,85
1990,340,Honduras,Switzerland,47,34,13
1990,484,Mexico,Switzerland,1195,710,485
1990,558,Nicaragua,Switzerland,95,65,30
1990,591,Panama,Switzerland,84,52,32
1990,32,Argentina,Switzerland,2175,1180,995
1990,68,Bolivia (Plurinational State of),Switzerland,325,186,139
1990,76,Brazil,Switzerland,2886,1596,1290
1990,152,Chile,Switzerland,696,374,322
1990,170,Colombia,Switzerland,663,413,250
1990,218,Ecuador,Switzerland,654,432,222
1990,604,Peru,Switzerland,485,262,223
1990,862,Venezuela (Bolivarian Republic of),Switzerland,854,521,333
1990,36,Australia,Switzerland,9905,5495,4410
1990,554,New Zealand,Switzerland,1505,821,684
1990,258,French Polynesia,Switzerland,107,94,13
1990,112,Belarus,Switzerland,22,13,9
1990,100,Bulgaria,Switzerland,15,7,8
1990,203,Czechia,Switzerland,95,56,39
1990,348,Hungary,Switzerland,145,64,81
1990,616,Poland,Switzerland,718,344,374
1990,642,Romania,Switzerland,106,52,54
1990,643,Russian Federation,Switzerland,407,200,207
1990,703,Slovakia,Switzerland,18,10,8
1990,208,Denmark,Switzerland,1388,673,715
1990,246,Finland,Switzerland,434,240,194
1990,352,Iceland,Switzerland,53,28,25
1990,372,Ireland,Switzerland,106,43,63
1990,428,Latvia,Switzerland,11,7,4
1990,440,Lithuania,Switzerland,23,14,9
1990,578,Norway,Switzerland,1151,539,612
1990,752,Sweden,Switzerland,1877,1024,853
1990,826,United Kingdom,Switzerland,12338,4214,8124
1990,20,Andorra,Switzerland,64,34,30
1990,191,Croatia,Switzerland,465,217,248
1990,300,Greece,Switzerland,2747,1448,1299
1990,380,Italy,Switzerland,43544,13618,29926
1990,470,Malta,Switzerland,17,10,7
1990,620,Portugal,Switzerland,3766,1902,1864
1990,688,Serbia,Switzerland,350,189,161
1990,705,Slovenia,Switzerland,798,402,396
1990,724,Spain,Switzerland,32884,16307,16577
1990,40,Austria,Switzerland,8704,4006,4698
1990,56,Belgium,Switzerland,5458,2977,2481
1990,250,France,Switzerland,60882,26559,34323
1990,276,Germany,Switzerland,33253,15052,18201
1990,438,Liechtenstein,Switzerland,4128,2169,1959
1990,442,Luxembourg,Switzerland,646,297,349
1990,528,Netherlands,Switzerland,4279,1858,2421
1990,60,Bermuda,Switzerland,117,76,41
1990,124,Canada,Switzerland,15674,7631,8043
1990,840,United States of America,Switzerland,39130,16263,22867
1995,480,Mauritius,Switzerland,30,21,9
1995,140,Central African Republic,Switzerland,193,90,103
1995,516,Namibia,Switzerland,606,257,349
1995,710,South Africa,Switzerland,2225,1030,1195
1995,132,Cabo Verde,Switzerland,24,13,11
1995,288,Ghana,Switzerland,104,62,42
1995,430,Liberia,Switzerland,144,79,65
1995,818,Egypt,Switzerland,1334,694,640
1995,434,Libya,Switzerland,2854,1483,1371
1995,196,Cyprus,Switzerland,133,47,86
1995,376,Israel,Switzerland,3030,1268,1762
1995,400,Jordan,Switzerland,148,72,76
1995,792,Turkey,Switzerland,8867,4312,4555
1995,762,Tajikistan,Switzerland,66,34,32
1995,64,Bhutan,Switzerland,13,10,3
1995,462,Maldives,Switzerland,100,50,50
1995,144,Sri Lanka,Switzerland,39,31,8
1995,344,"China, Hong Kong SAR",Switzerland,544,390,154
1995,392,Japan,Switzerland,955,458,497
1995,496,Mongolia,Switzerland,4,3,1
1995,608,Philippines,Switzerland,336,228,108
1995,764,Thailand,Switzerland,619,509,110
1995,44,Bahamas,Switzerland,120,70,50
1995,136,Cayman Islands,Switzerland,47,36,11
1995,214,Dominican Republic,Switzerland,2377,1514,863
1995,312,Guadeloupe,Switzerland,119,56,63
1995,332,Haiti,Switzerland,358,228,130
1995,662,Saint Lucia,Switzerland,5,3,2
1995,188,Costa Rica,Switzerland,360,207,153
1995,222,El Salvador,Switzerland,69,40,29
1995,320,Guatemala,Switzerland,124,62,62
1995,340,Honduras,Switzerland,47,33,14
1995,484,Mexico,Switzerland,1657,933,724
1995,558,Nicaragua,Switzerland,76,52,24
1995,591,Panama,Switzerland,121,77,44
1995,32,Argentina,Switzerland,1919,1009,910
1995,68,Bolivia (Plurinational State of),Switzerland,442,237,205
1995,76,Brazil,Switzerland,2919,1761,1158
1995,152,Chile,Switzerland,854,456,398
1995,170,Colombia,Switzerland,634,396,238
1995,218,Ecuador,Switzerland,734,485,249
1995,604,Peru,Switzerland,486,260,226
1995,862,Venezuela (Bolivarian Republic of),Switzerland,749,464,285
1995,36,Australia,Switzerland,10758,5923,4835
1995,554,New Zealand,Switzerland,1854,974,880
1995,258,French Polynesia,Switzerland,117,103,14
1995,112,Belarus,Switzerland,26,13,13
1995,100,Bulgaria,Switzerland,46,25,21
1995,203,Czechia,Switzerland,142,85,57
1995,348,Hungary,Switzerland,829,431,398
1995,616,Poland,Switzerland,613,289,324
1995,642,Romania,Switzerland,85,41,44
1995,643,Russian Federation,Switzerland,418,209,209
1995,703,Slovakia,Switzerland,186,101,85
1995,208,Denmark,Switzerland,1655,830,825
1995,246,Finland,Switzerland,476,275,201
1995,352,Iceland,Switzerland,63,33,30
1995,372,Ireland,Switzerland,294,112,182
1995,428,Latvia,Switzerland,17,11,6
1995,440,Lithuania,Switzerland,26,15,11
1995,578,Norway,Switzerland,1237,579,658
1995,752,Sweden,Switzerland,2227,1207,1020
1995,826,United Kingdom,Switzerland,13797,5044,8753
1995,20,Andorra,Switzerland,69,36,33
1995,191,Croatia,Switzerland,622,277,345
1995,300,Greece,Switzerland,3115,1461,1654
1995,380,Italy,Switzerland,32837,10570,22267
1995,470,Malta,Switzerland,20,11,9
1995,620,Portugal,Switzerland,8128,4097,4031
1995,688,Serbia,Switzerland,2228,1182,1046
1995,705,Slovenia,Switzerland,744,378,366
1995,724,Spain,Switzerland,38443,19202,19241
1995,40,Austria,Switzerland,9820,4606,5214
1995,56,Belgium,Switzerland,5128,2712,2416
1995,250,France,Switzerland,62850,26821,36029
1995,276,Germany,Switzerland,34981,15208,19773
1995,438,Liechtenstein,Switzerland,4531,2306,2225
1995,442,Luxembourg,Switzerland,554,247,307
1995,528,Netherlands,Switzerland,4863,2059,2804
1995,60,Bermuda,Switzerland,118,71,47
1995,124,Canada,Switzerland,17934,8684,9250
1995,840,United States of America,Switzerland,41667,17528,24139
2000,480,Mauritius,Switzerland,13,9,4
2000,140,Central African Republic,Switzerland,220,104,116
2000,516,Namibia,Switzerland,564,240,324
2000,710,South Africa,Switzerland,826,398,428
2000,132,Cabo Verde,Switzerland,29,16,13
2000,288,Ghana,Switzerland,116,65,51
2000,430,Liberia,Switzerland,142,76,66
2000,818,Egypt,Switzerland,998,507,491
2000,434,Libya,Switzerland,686,335,351
2000,196,Cyprus,Switzerland,172,59,113
2000,268,Georgia,Switzerland,15,7,8
2000,376,Israel,Switzerland,3228,1346,1882
2000,400,Jordan,Switzerland,243,122,121
2000,792,Turkey,Switzerland,9659,4615,5044
2000,762,Tajikistan,Switzerland,57,31,26
2000,64,Bhutan,Switzerland,15,12,3
2000,462,Maldives,Switzerland,92,50,42
2000,144,Sri Lanka,Switzerland,73,51,22
2000,344,"China, Hong Kong SAR",Switzerland,600,429,171
2000,392,Japan,Switzerland,907,419,488
2000,496,Mongolia,Switzerland,5,3,2
2000,608,Philippines,Switzerland,369,240,129
2000,764,Thailand,Switzerland,997,814,183
2000,44,Bahamas,Switzerland,156,88,68
2000,136,Cayman Islands,Switzerland,82,63,19
2000,214,Dominican Republic,Switzerland,2614,1647,967
2000,312,Guadeloupe,Switzerland,148,69,79
2000,332,Haiti,Switzerland,340,217,123
2000,662,Saint Lucia,Switzerland,10,6,4
2000,188,Costa Rica,Switzerland,512,288,224
2000,222,El Salvador,Switzerland,51,26,25
2000,320,Guatemala,Switzerland,96,57,39
2000,340,Honduras,Switzerland,46,32,14
2000,484,Mexico,Switzerland,2192,1200,992
2000,558,Nicaragua,Switzerland,73,52,21
2000,591,Panama,Switzerland,166,106,60
2000,32,Argentina,Switzerland,1663,838,825
2000,68,Bolivia (Plurinational State of),Switzerland,555,286,269
2000,76,Brazil,Switzerland,2951,1925,1026
2000,152,Chile,Switzerland,1012,537,475
2000,170,Colombia,Switzerland,605,379,226
2000,218,Ecuador,Switzerland,814,538,276
2000,604,Peru,Switzerland,569,306,263
2000,862,Venezuela (Bolivarian Republic of),Switzerland,652,410,242
2000,36,Australia,Switzerland,12050,6480,5570
2000,554,New Zealand,Switzerland,2688,1308,1380
2000,258,French Polynesia,Switzerland,126,110,16
2000,112,Belarus,Switzerland,29,13,16
2000,100,Bulgaria,Switzerland,76,43,33
2000,203,Czechia,Switzerland,189,114,75
2000,348,Hungary,Switzerland,1512,797,715
2000,616,Poland,Switzerland,525,244,281
2000,642,Romania,Switzerland,63,29,34
2000,643,Russian Federation,Switzerland,415,211,204
2000,703,Slovakia,Switzerland,407,221,186
2000,208,Denmark,Switzerland,1922,988,934
2000,246,Finland,Switzerland,517,310,207
2000,352,Iceland,Switzerland,73,39,34
2000,372,Ireland,Switzerland,644,258,386
2000,428,Latvia,Switzerland,24,15,9
2000,440,Lithuania,Switzerland,20,12,8
2000,578,Norway,Switzerland,1501,720,781
2000,752,Sweden,Switzerland,2389,1288,1101
2000,826,United Kingdom,Switzerland,15488,5936,9552
2000,20,Andorra,Switzerland,74,39,35
2000,191,Croatia,Switzerland,712,312,400
2000,300,Greece,Switzerland,3535,1469,2066
2000,380,Italy,Switzerland,22130,7523,14607
2000,470,Malta,Switzerland,50,29,21
2000,620,Portugal,Switzerland,12821,6473,6348
2000,688,Serbia,Switzerland,3030,1578,1452
2000,705,Slovenia,Switzerland,1330,675,655
2000,724,Spain,Switzerland,58838,29903,28935
2000,40,Austria,Switzerland,10935,5206,5729
2000,56,Belgium,Switzerland,4649,2377,2272
2000,250,France,Switzerland,64818,27084,37734
2000,276,Germany,Switzerland,36709,15365,21344
2000,438,Liechtenstein,Switzerland,4823,2365,2458
2000,442,Luxembourg,Switzerland,468,200,268
2000,528,Netherlands,Switzerland,5618,2324,3294
2000,60,Bermuda,Switzerland,119,67,52
2000,124,Canada,Switzerland,20621,9947,10674
2000,840,United States of America,Switzerland,44200,18824,25376
2005,480,Mauritius,Switzerland,51,37,14
2005,140,Central African Republic,Switzerland,168,79,89
2005,516,Namibia,Switzerland,445,188,257
2005,710,South Africa,Switzerland,1086,497,589
2005,132,Cabo Verde,Switzerland,21,11,10
2005,288,Ghana,Switzerland,163,96,67
2005,430,Liberia,Switzerland,64,43,21
2005,818,Egypt,Switzerland,1188,640,548
2005,434,Libya,Switzerland,755,438,317
2005,196,Cyprus,Switzerland,251,84,167
2005,268,Georgia,Switzerland,14,7,7
2005,376,Israel,Switzerland,3461,1440,2021
2005,400,Jordan,Switzerland,350,197,153
2005,792,Turkey,Switzerland,9953,4638,5315
2005,762,Tajikistan,Switzerland,54,29,25
2005,64,Bhutan,Switzerland,19,15,4
2005,462,Maldives,Switzerland,84,49,35
2005,144,Sri Lanka,Switzerland,142,75,67
2005,344,"China, Hong Kong SAR",Switzerland,655,458,197
2005,392,Japan,Switzerland,1027,468,559
2005,496,Mongolia,Switzerland,10,5,5
2005,608,Philippines,Switzerland,298,196,102
2005,764,Thailand,Switzerland,901,720,181
2005,44,Bahamas,Switzerland,220,88,132
2005,136,Cayman Islands,Switzerland,75,57,18
2005,214,Dominican Republic,Switzerland,1808,1154,654
2005,312,Guadeloupe,Switzerland,182,84,98
2005,332,Haiti,Switzerland,322,206,116
2005,662,Saint Lucia,Switzerland,10,6,4
2005,188,Costa Rica,Switzerland,336,187,149
2005,222,El Salvador,Switzerland,54,25,29
2005,320,Guatemala,Switzerland,115,73,42
2005,340,Honduras,Switzerland,45,31,14
2005,484,Mexico,Switzerland,1725,947,778
2005,558,Nicaragua,Switzerland,73,53,20
2005,591,Panama,Switzerland,233,154,79
2005,32,Argentina,Switzerland,1227,628,599
2005,68,Bolivia (Plurinational State of),Switzerland,561,292,269
2005,76,Brazil,Switzerland,2976,1975,1001
2005,152,Chile,Switzerland,1518,817,701
2005,170,Colombia,Switzerland,570,359,211
2005,218,Ecuador,Switzerland,961,642,319
2005,604,Peru,Switzerland,668,361,307
2005,862,Venezuela (Bolivarian Republic of),Switzerland,647,402,245
2005,36,Australia,Switzerland,13060,6932,6128
2005,554,New Zealand,Switzerland,2880,1398,1482
2005,258,French Polynesia,Switzerland,131,115,16
2005,112,Belarus,Switzerland,28,12,16
2005,100,Bulgaria,Switzerland,119,70,49
2005,203,Czechia,Switzerland,332,224,108
2005,348,Hungary,Switzerland,1868,1001,867
2005,616,Poland,Switzerland,776,398,378
2005,642,Romania,Switzerland,73,35,38
2005,643,Russian Federation,Switzerland,497,252,245
2005,703,Slovakia,Switzerland,457,252,205
2005,208,Denmark,Switzerland,2218,1145,1073
2005,246,Finland,Switzerland,736,441,295
2005,352,Iceland,Switzerland,111,55,56
2005,372,Ireland,Switzerland,646,282,364
2005,428,Latvia,Switzerland,58,36,22
2005,440,Lithuania,Switzerland,37,27,10
2005,578,Norway,Switzerland,1555,748,807
2005,752,Sweden,Switzerland,2620,1402,1218
2005,826,United Kingdom,Switzerland,16618,6624,9994
2005,20,Andorra,Switzerland,86,45,41
2005,191,Croatia,Switzerland,1851,915,936
2005,300,Greece,Switzerland,3657,1521,2136
2005,380,Italy,Switzerland,110133,50147,59986
2005,470,Malta,Switzerland,80,45,35
2005,620,Portugal,Switzerland,14775,7488,7287
2005,688,Serbia,Switzerland,2989,1540,1449
2005,705,Slovenia,Switzerland,1405,709,696
2005,724,Spain,Switzerland,56682,28169,28513
2005,40,Austria,Switzerland,12223,5666,6557
2005,56,Belgium,Switzerland,4530,2272,2258
2005,250,France,Switzerland,84249,38020,46229
2005,276,Germany,Switzerland,53952,24315,29637
2005,438,Liechtenstein,Switzerland,8532,4302,4230
2005,442,Luxembourg,Switzerland,406,188,218
2005,528,Netherlands,Switzerland,5955,2493,3462
2005,60,Bermuda,Switzerland,122,67,55
2005,124,Canada,Switzerland,19811,9996,9815
2005,840,United States of America,Switzerland,42514,18242,24272
2010,480,Mauritius,Switzerland,92,66,26
2010,140,Central African Republic,Switzerland,166,78,88
2010,516,Namibia,Switzerland,428,181,247
2010,710,South Africa,Switzerland,1700,775,925
2010,132,Cabo Verde,Switzerland,13,6,7
2010,288,Ghana,Switzerland,121,68,53
2010,430,Liberia,Switzerland,30,15,15
2010,818,Egypt,Switzerland,1282,668,614
2010,434,Libya,Switzerland,827,484,343
2010,196,Cyprus,Switzerland,411,141,270
2010,268,Georgia,Switzerland,14,7,7
2010,376,Israel,Switzerland,3736,1548,2188
2010,400,Jordan,Switzerland,449,263,186
2010,792,Turkey,Switzerland,10256,4656,5600
2010,762,Tajikistan,Switzerland,53,29,24
2010,64,Bhutan,Switzerland,23,18,5
2010,462,Maldives,Switzerland,101,76,25
2010,144,Sri Lanka,Switzerland,284,151,133
2010,344,"China, Hong Kong SAR",Switzerland,711,488,223
2010,392,Japan,Switzerland,1089,490,599
2010,496,Mongolia,Switzerland,17,7,10
2010,608,Philippines,Switzerland,1017,651,366
2010,764,Thailand,Switzerland,870,680,190
2010,44,Bahamas,Switzerland,283,88,195
2010,136,Cayman Islands,Switzerland,75,57,18
2010,214,Dominican Republic,Switzerland,990,654,336
2010,312,Guadeloupe,Switzerland,215,98,117
2010,332,Haiti,Switzerland,338,217,121
2010,662,Saint Lucia,Switzerland,10,6,4
2010,188,Costa Rica,Switzerland,662,370,292
2010,222,El Salvador,Switzerland,57,24,33
2010,320,Guatemala,Switzerland,134,90,44
2010,340,Honduras,Switzerland,44,31,13
2010,484,Mexico,Switzerland,1460,807,653
2010,558,Nicaragua,Switzerland,78,57,21
2010,591,Panama,Switzerland,313,211,102
2010,32,Argentina,Switzerland,791,419,372
2010,68,Bolivia (Plurinational State of),Switzerland,566,298,268
2010,76,Brazil,Switzerland,2959,1996,963
2010,152,Chile,Switzerland,2025,1098,927
2010,170,Colombia,Switzerland,634,405,229
2010,218,Ecuador,Switzerland,1349,890,459
2010,604,Peru,Switzerland,748,403,345
2010,862,Venezuela (Bolivarian Republic of),Switzerland,649,398,251
2010,36,Australia,Switzerland,14030,7301,6729
2010,554,New Zealand,Switzerland,3057,1482,1575
2010,258,French Polynesia,Switzerland,127,112,15
2010,112,Belarus,Switzerland,27,11,16
2010,100,Bulgaria,Switzerland,156,93,63
2010,203,Czechia,Switzerland,444,318,126
2010,348,Hungary,Switzerland,2224,1205,1019
2010,616,Poland,Switzerland,1053,562,491
2010,642,Romania,Switzerland,99,47,52
2010,643,Russian Federation,Switzerland,569,287,282
2010,703,Slovakia,Switzerland,512,286,226
2010,208,Denmark,Switzerland,2468,1279,1189
2010,233,Estonia,Switzerland,42,33,9
2010,246,Finland,Switzerland,1141,642,499
2010,352,Iceland,Switzerland,147,70,77
2010,372,Ireland,Switzerland,541,212,329
2010,428,Latvia,Switzerland,91,56,35
2010,440,Lithuania,Switzerland,50,37,13
2010,578,Norway,Switzerland,1879,925,954
2010,752,Sweden,Switzerland,3061,1647,1414
2010,826,United Kingdom,Switzerland,17506,7194,10312
2010,20,Andorra,Switzerland,87,46,41
2010,191,Croatia,Switzerland,2990,1518,1472
2010,300,Greece,Switzerland,3931,1638,2293
2010,380,Italy,Switzerland,194518,89998,104520
2010,470,Malta,Switzerland,85,45,40
2010,499,Montenegro,Switzerland,202,30,172
2010,620,Portugal,Switzerland,14276,7276,7000
2010,688,Serbia,Switzerland,2922,1504,1418
2010,705,Slovenia,Switzerland,1386,706,680
2010,724,Spain,Switzerland,63693,31754,31939
2010,40,Austria,Switzerland,13511,6127,7384
2010,56,Belgium,Switzerland,4847,2178,2669
2010,250,France,Switzerland,89461,36212,53249
2010,276,Germany,Switzerland,68197,31844,36353
2010,438,Liechtenstein,Switzerland,12215,6210,6005
2010,442,Luxembourg,Switzerland,349,177,172
2010,528,Netherlands,Switzerland,6373,2710,3663
2010,60,Bermuda,Switzerland,124,67,57
2010,124,Canada,Switzerland,18750,9911,8839
2010,840,United States of America,Switzerland,42090,17729,24361
2015,480,Mauritius,Switzerland,105,77,28
2015,140,Central African Republic,Switzerland,145,68,77
2015,516,Namibia,Switzerland,418,177,241
2015,710,South Africa,Switzerland,3066,1313,1753
2015,132,Cabo Verde,Switzerland,13,6,7
2015,288,Ghana,Switzerland,148,83,65
2015,324,Guinea,Switzerland,17,11,6
2015,430,Liberia,Switzerland,34,17,17
2015,818,Egypt,Switzerland,950,554,396
2015,434,Libya,Switzerland,932,540,392
2015,196,Cyprus,Switzerland,394,137,257
2015,268,Georgia,Switzerland,14,7,7
2015,376,Israel,Switzerland,3853,1585,2268
2015,400,Jordan,Switzerland,193,96,97
2015,792,Turkey,Switzerland,10411,4598,5813
2015,762,Tajikistan,Switzerland,52,29,23
2015,64,Bhutan,Switzerland,24,19,5
2015,462,Maldives,Switzerland,118,103,15
2015,144,Sri Lanka,Switzerland,289,152,137
2015,344,"China, Hong Kong SAR",Switzerland,726,489,237
2015,392,Japan,Switzerland,1060,473,587
2015,496,Mongolia,Switzerland,21,6,15
2015,608,Philippines,Switzerland,1033,662,371
2015,764,Thailand,Switzerland,940,734,206
2015,44,Bahamas,Switzerland,307,94,213
2015,136,Cayman Islands,Switzerland,81,63,18
2015,214,Dominican Republic,Switzerland,1044,690,354
2015,312,Guadeloupe,Switzerland,223,100,123
2015,332,Haiti,Switzerland,354,227,127
2015,662,Saint Lucia,Switzerland,9,6,3
2015,188,Costa Rica,Switzerland,672,374,298
2015,222,El Salvador,Switzerland,59,25,34
2015,320,Guatemala,Switzerland,154,104,50
2015,340,Honduras,Switzerland,61,44,17
2015,484,Mexico,Switzerland,1549,850,699
2015,558,Nicaragua,Switzerland,84,62,22
2015,591,Panama,Switzerland,367,247,120
2015,32,Argentina,Switzerland,794,421,373
2015,68,Bolivia (Plurinational State of),Switzerland,659,347,312
2015,76,Brazil,Switzerland,3563,2403,1160
2015,152,Chile,Switzerland,3067,1633,1434
2015,170,Colombia,Switzerland,709,456,253
2015,218,Ecuador,Switzerland,1962,1290,672
2015,604,Peru,Switzerland,794,437,357
2015,862,Venezuela (Bolivarian Republic of),Switzerland,661,402,259
2015,36,Australia,Switzerland,14190,7388,6802
2015,554,New Zealand,Switzerland,3185,1541,1644
2015,258,French Polynesia,Switzerland,120,106,14
2015,112,Belarus,Switzerland,29,13,16
2015,100,Bulgaria,Switzerland,396,229,167
2015,203,Czechia,Switzerland,518,370,148
2015,348,Hungary,Switzerland,2648,1458,1190
2015,616,Poland,Switzerland,1015,551,464
2015,642,Romania,Switzerland,158,93,65
2015,643,Russian Federation,Switzerland,580,291,289
2015,703,Slovakia,Switzerland,677,393,284
2015,208,Denmark,Switzerland,2798,1471,1327
2015,233,Estonia,Switzerland,58,49,9
2015,246,Finland,Switzerland,1262,734,528
2015,352,Iceland,Switzerland,158,73,85
2015,372,Ireland,Switzerland,553,213,340
2015,428,Latvia,Switzerland,56,33,23
2015,440,Lithuania,Switzerland,61,37,24
2015,578,Norway,Switzerland,2250,1101,1149
2015,752,Sweden,Switzerland,3584,1922,1662
2015,826,United Kingdom,Switzerland,22387,8809,13578
2015,20,Andorra,Switzerland,80,80,0
2015,191,Croatia,Switzerland,3009,1523,1486
2015,300,Greece,Switzerland,3689,1446,2243
2015,380,Italy,Switzerland,194030,89900,104130
2015,470,Malta,Switzerland,143,80,63
2015,499,Montenegro,Switzerland,212,33,179
2015,620,Portugal,Switzerland,16183,7840,8343
2015,688,Serbia,Switzerland,2856,1467,1389
2015,705,Slovenia,Switzerland,980,516,464
2015,724,Spain,Switzerland,62286,30931,31355
2015,40,Austria,Switzerland,15802,7214,8588
2015,56,Belgium,Switzerland,5048,2284,2764
2015,250,France,Switzerland,99102,38489,60613
2015,276,Germany,Switzerland,71058,33090,37968
2015,438,Liechtenstein,Switzerland,12882,6596,6286
2015,442,Luxembourg,Switzerland,532,274,258
2015,528,Netherlands,Switzerland,6889,3011,3878
2015,60,Bermuda,Switzerland,125,67,58
2015,124,Canada,Switzerland,18923,9890,9033
2015,840,United States of America,Switzerland,43436,18168,25268
2019,480,Mauritius,Switzerland,105,77,28
2019,140,Central African Republic,Switzerland,161,76,85
2019,516,Namibia,Switzerland,442,187,255
2019,710,South Africa,Switzerland,3436,1474,1962
2019,132,Cabo Verde,Switzerland,13,6,7
2019,288,Ghana,Switzerland,166,94,72
2019,324,Guinea,Switzerland,16,11,5
2019,430,Liberia,Switzerland,28,14,14
2019,818,Egypt,Switzerland,1354,723,631
2019,434,Libya,Switzerland,988,573,415
2019,196,Cyprus,Switzerland,393,139,254
2019,268,Georgia,Switzerland,14,7,7
2019,376,Israel,Switzerland,3746,1541,2205
2019,400,Jordan,Switzerland,207,103,104
2019,792,Turkey,Switzerland,14077,6295,7782
2019,762,Tajikistan,Switzerland,51,29,22
2019,64,Bhutan,Switzerland,25,20,5
2019,462,Maldives,Switzerland,127,111,16
2019,144,Sri Lanka,Switzerland,291,153,138
2019,344,"China, Hong Kong SAR",Switzerland,940,624,316
2019,392,Japan,Switzerland,1186,530,656
2019,496,Mongolia,Switzerland,22,7,15
2019,608,Philippines,Switzerland,1065,683,382
2019,764,Thailand,Switzerland,980,766,214
2019,44,Bahamas,Switzerland,325,99,226
2019,136,Cayman Islands,Switzerland,89,69,20
2019,214,Dominican Republic,Switzerland,1078,713,365
2019,312,Guadeloupe,Switzerland,226,102,124
2019,332,Haiti,Switzerland,368,236,132
2019,662,Saint Lucia,Switzerland,8,6,2
2019,188,Costa Rica,Switzerland,681,381,300
2019,222,El Salvador,Switzerland,59,25,34
2019,320,Guatemala,Switzerland,158,107,51
2019,340,Honduras,Switzerland,61,44,17
2019,484,Mexico,Switzerland,1597,877,720
2019,558,Nicaragua,Switzerland,87,64,23
2019,591,Panama,Switzerland,389,263,126
2019,32,Argentina,Switzerland,807,427,380
2019,68,Bolivia (Plurinational State of),Switzerland,719,379,340
2019,76,Brazil,Switzerland,4012,2706,1306
2019,152,Chile,Switzerland,4097,2075,2022
2019,170,Colombia,Switzerland,725,467,258
2019,218,Ecuador,Switzerland,1931,1270,661
2019,604,Peru,Switzerland,945,538,407
2019,862,Venezuela (Bolivarian Republic of),Switzerland,647,393,254
2019,36,Australia,Switzerland,15087,7869,7218
2019,554,New Zealand,Switzerland,3273,1584,1689
2019,258,French Polynesia,Switzerland,124,110,14
2019,112,Belarus,Switzerland,28,13,15
2019,100,Bulgaria,Switzerland,551,313,238
2019,203,Czechia,Switzerland,594,408,186
2019,348,Hungary,Switzerland,3150,1701,1449
2019,616,Poland,Switzerland,1074,602,472
2019,642,Romania,Switzerland,594,371,223
2019,643,Russian Federation,Switzerland,579,291,288
2019,703,Slovakia,Switzerland,823,474,349
2019,208,Denmark,Switzerland,3031,1552,1479
2019,233,Estonia,Switzerland,81,57,24
2019,246,Finland,Switzerland,1458,861,597
2019,352,Iceland,Switzerland,185,89,96
2019,372,Ireland,Switzerland,607,235,372
2019,428,Latvia,Switzerland,71,44,27
2019,440,Lithuania,Switzerland,63,38,25
2019,578,Norway,Switzerland,2492,1221,1271
2019,752,Sweden,Switzerland,4164,2190,1974
2019,826,United Kingdom,Switzerland,25422,10042,15380
2019,20,Andorra,Switzerland,85,85,0
2019,191,Croatia,Switzerland,2778,1402,1376
2019,300,Greece,Switzerland,3602,1495,2107
2019,380,Italy,Switzerland,199233,93114,106119
2019,470,Malta,Switzerland,230,130,100
2019,499,Montenegro,Switzerland,212,34,178
2019,620,Portugal,Switzerland,16458,7992,8466
2019,688,Serbia,Switzerland,2901,1492,1409
2019,705,Slovenia,Switzerland,951,497,454
2019,724,Spain,Switzerland,63515,31135,32380
2019,40,Austria,Switzerland,18654,8691,9963
2019,56,Belgium,Switzerland,5419,2511,2908
2019,250,France,Switzerland,104900,40595,64305
2019,276,Germany,Switzerland,77948,36899,41049
2019,438,Liechtenstein,Switzerland,13931,7103,6828
2019,442,Luxembourg,Switzerland,1445,747,698
2019,528,Netherlands,Switzerland,7785,3510,4275
2019,60,Bermuda,Switzerland,126,68,58
2019,124,Canada,Switzerland,20278,10599,9679
2019,840,United States of America,Switzerland,46906,19325,27581
1990,266,Gabon,Syrian Arab Republic,9,5,4
1990,710,South Africa,Syrian Arab Republic,113,41,72
1990,288,Ghana,Syrian Arab Republic,37,20,17
1990,324,Guinea,Syrian Arab Republic,30,23,7
1990,478,Mauritania,Syrian Arab Republic,125,48,77
1990,12,Algeria,Syrian Arab Republic,3550,1966,1584
1990,818,Egypt,Syrian Arab Republic,5259,2818,2441
1990,434,Libya,Syrian Arab Republic,15014,8079,6935
1990,504,Morocco,Syrian Arab Republic,1399,740,659
1990,788,Tunisia,Syrian Arab Republic,375,187,188
1990,51,Armenia,Syrian Arab Republic,3225,1300,1925
1990,48,Bahrain,Syrian Arab Republic,1777,1271,506
1990,196,Cyprus,Syrian Arab Republic,810,622,188
1990,368,Iraq,Syrian Arab Republic,4778,2952,1826
1990,376,Israel,Syrian Arab Republic,10963,5212,5751
1990,400,Jordan,Syrian Arab Republic,51557,28760,22797
1990,414,Kuwait,Syrian Arab Republic,11021,6673,4348
1990,422,Lebanon,Syrian Arab Republic,23553,13138,10415
1990,634,Qatar,Syrian Arab Republic,526,384,142
1990,682,Saudi Arabia,Syrian Arab Republic,305838,172718,133120
1990,275,State of Palestine,Syrian Arab Republic,5224,2381,2843
1990,792,Turkey,Syrian Arab Republic,5247,2742,2505
1990,784,United Arab Emirates,Syrian Arab Republic,13462,9584,3878
1990,887,Yemen,Syrian Arab Republic,2238,1242,996
1990,360,Indonesia,Syrian Arab Republic,3465,1664,1801
1990,608,Philippines,Syrian Arab Republic,19,19,0
1990,28,Antigua and Barbuda,Syrian Arab Republic,142,68,74
1990,212,Dominica,Syrian Arab Republic,6,4,2
1990,214,Dominican Republic,Syrian Arab Republic,76,44,32
1990,312,Guadeloupe,Syrian Arab Republic,117,56,61
1990,474,Martinique,Syrian Arab Republic,68,33,35
1990,662,Saint Lucia,Syrian Arab Republic,12,9,3
1990,188,Costa Rica,Syrian Arab Republic,9,8,1
1990,320,Guatemala,Syrian Arab Republic,52,28,24
1990,484,Mexico,Syrian Arab Republic,510,348,162
1990,591,Panama,Syrian Arab Republic,83,53,30
1990,32,Argentina,Syrian Arab Republic,4931,2529,2402
1990,68,Bolivia (Plurinational State of),Syrian Arab Republic,23,11,12
1990,76,Brazil,Syrian Arab Republic,4434,2271,2163
1990,152,Chile,Syrian Arab Republic,358,195,163
1990,170,Colombia,Syrian Arab Republic,1238,778,460
1990,218,Ecuador,Syrian Arab Republic,22,16,6
1990,862,Venezuela (Bolivarian Republic of),Syrian Arab Republic,13833,8451,5382
1990,36,Australia,Syrian Arab Republic,5351,2743,2608
1990,112,Belarus,Syrian Arab Republic,40,40,0
1990,100,Bulgaria,Syrian Arab Republic,473,388,85
1990,203,Czechia,Syrian Arab Republic,108,94,14
1990,348,Hungary,Syrian Arab Republic,482,214,268
1990,616,Poland,Syrian Arab Republic,785,680,105
1990,642,Romania,Syrian Arab Republic,2087,1226,861
1990,643,Russian Federation,Syrian Arab Republic,5464,2681,2783
1990,703,Slovakia,Syrian Arab Republic,37,33,4
1990,804,Ukraine,Syrian Arab Republic,4494,4307,187
1990,208,Denmark,Syrian Arab Republic,538,282,256
1990,246,Finland,Syrian Arab Republic,49,38,11
1990,352,Iceland,Syrian Arab Republic,8,6,2
1990,372,Ireland,Syrian Arab Republic,22,15,7
1990,428,Latvia,Syrian Arab Republic,5,4,1
1990,578,Norway,Syrian Arab Republic,194,132,62
1990,752,Sweden,Syrian Arab Republic,11128,5572,5556
1990,826,United Kingdom,Syrian Arab Republic,2761,1647,1114
1990,300,Greece,Syrian Arab Republic,6547,5066,1481
1990,380,Italy,Syrian Arab Republic,527,183,344
1990,470,Malta,Syrian Arab Republic,101,81,20
1990,620,Portugal,Syrian Arab Republic,10,6,4
1990,688,Serbia,Syrian Arab Republic,14,12,2
1990,705,Slovenia,Syrian Arab Republic,1,1,0
1990,724,Spain,Syrian Arab Republic,1927,1463,464
1990,40,Austria,Syrian Arab Republic,1828,1146,682
1990,56,Belgium,Syrian Arab Republic,1712,1017,695
1990,250,France,Syrian Arab Republic,13644,8157,5487
1990,276,Germany,Syrian Arab Republic,15330,10588,4742
1990,528,Netherlands,Syrian Arab Republic,2035,1168,867
1990,756,Switzerland,Syrian Arab Republic,1309,792,517
1990,124,Canada,Syrian Arab Republic,10560,5141,5419
1990,840,United States of America,Syrian Arab Republic,36782,21141,15641
1995,266,Gabon,Syrian Arab Republic,12,7,5
1995,710,South Africa,Syrian Arab Republic,70,29,41
1995,288,Ghana,Syrian Arab Republic,37,22,15
1995,324,Guinea,Syrian Arab Republic,34,27,7
1995,478,Mauritania,Syrian Arab Republic,133,59,74
1995,12,Algeria,Syrian Arab Republic,3312,1822,1490
1995,818,Egypt,Syrian Arab Republic,5198,2783,2415
1995,434,Libya,Syrian Arab Republic,17576,10496,7080
1995,504,Morocco,Syrian Arab Republic,1284,670,614
1995,788,Tunisia,Syrian Arab Republic,377,190,187
1995,51,Armenia,Syrian Arab Republic,3422,1458,1964
1995,48,Bahrain,Syrian Arab Republic,1955,1376,579
1995,196,Cyprus,Syrian Arab Republic,1146,869,277
1995,368,Iraq,Syrian Arab Republic,5633,2941,2692
1995,376,Israel,Syrian Arab Republic,11277,5257,6020
1995,400,Jordan,Syrian Arab Republic,54585,30463,24122
1995,414,Kuwait,Syrian Arab Republic,8831,5627,3204
1995,422,Lebanon,Syrian Arab Republic,24856,13322,11534
1995,634,Qatar,Syrian Arab Republic,571,426,145
1995,682,Saudi Arabia,Syrian Arab Republic,313441,177724,135717
1995,275,State of Palestine,Syrian Arab Republic,5105,2313,2792
1995,792,Turkey,Syrian Arab Republic,5106,2557,2549
1995,784,United Arab Emirates,Syrian Arab Republic,17252,12357,4895
1995,887,Yemen,Syrian Arab Republic,2318,1287,1031
1995,144,Sri Lanka,Syrian Arab Republic,8,7,1
1995,360,Indonesia,Syrian Arab Republic,2292,1132,1160
1995,608,Philippines,Syrian Arab Republic,25,25,0
1995,28,Antigua and Barbuda,Syrian Arab Republic,171,82,89
1995,212,Dominica,Syrian Arab Republic,8,5,3
1995,214,Dominican Republic,Syrian Arab Republic,85,48,37
1995,312,Guadeloupe,Syrian Arab Republic,157,74,83
1995,474,Martinique,Syrian Arab Republic,102,47,55
1995,662,Saint Lucia,Syrian Arab Republic,16,13,3
1995,188,Costa Rica,Syrian Arab Republic,7,6,1
1995,320,Guatemala,Syrian Arab Republic,51,30,21
1995,484,Mexico,Syrian Arab Republic,480,300,180
1995,591,Panama,Syrian Arab Republic,119,77,42
1995,32,Argentina,Syrian Arab Republic,3607,1857,1750
1995,68,Bolivia (Plurinational State of),Syrian Arab Republic,12,6,6
1995,76,Brazil,Syrian Arab Republic,3864,2061,1803
1995,152,Chile,Syrian Arab Republic,329,188,141
1995,170,Colombia,Syrian Arab Republic,870,545,325
1995,218,Ecuador,Syrian Arab Republic,25,18,7
1995,862,Venezuela (Bolivarian Republic of),Syrian Arab Republic,13662,8347,5315
1995,36,Australia,Syrian Arab Republic,6538,3296,3242
1995,112,Belarus,Syrian Arab Republic,63,63,0
1995,100,Bulgaria,Syrian Arab Republic,606,496,110
1995,203,Czechia,Syrian Arab Republic,162,142,20
1995,348,Hungary,Syrian Arab Republic,664,424,240
1995,616,Poland,Syrian Arab Republic,671,580,91
1995,642,Romania,Syrian Arab Republic,4579,2689,1890
1995,643,Russian Federation,Syrian Arab Republic,4479,2806,1673
1995,703,Slovakia,Syrian Arab Republic,81,67,14
1995,804,Ukraine,Syrian Arab Republic,4347,4172,175
1995,208,Denmark,Syrian Arab Republic,921,423,498
1995,246,Finland,Syrian Arab Republic,105,70,35
1995,352,Iceland,Syrian Arab Republic,11,8,3
1995,372,Ireland,Syrian Arab Republic,61,41,20
1995,428,Latvia,Syrian Arab Republic,7,6,1
1995,578,Norway,Syrian Arab Republic,420,253,167
1995,752,Sweden,Syrian Arab Republic,13205,6562,6643
1995,826,United Kingdom,Syrian Arab Republic,3366,2009,1357
1995,300,Greece,Syrian Arab Republic,6220,4893,1327
1995,380,Italy,Syrian Arab Republic,1963,1099,864
1995,470,Malta,Syrian Arab Republic,119,95,24
1995,620,Portugal,Syrian Arab Republic,21,12,9
1995,688,Serbia,Syrian Arab Republic,94,76,18
1995,705,Slovenia,Syrian Arab Republic,1,1,0
1995,724,Spain,Syrian Arab Republic,2245,1688,557
1995,40,Austria,Syrian Arab Republic,2063,1306,757
1995,56,Belgium,Syrian Arab Republic,1702,1009,693
1995,250,France,Syrian Arab Republic,14085,8325,5760
1995,276,Germany,Syrian Arab Republic,20223,12480,7743
1995,528,Netherlands,Syrian Arab Republic,2996,1690,1306
1995,756,Switzerland,Syrian Arab Republic,1718,1070,648
1995,124,Canada,Syrian Arab Republic,13038,6311,6727
1995,840,United States of America,Syrian Arab Republic,46282,26795,19487
2000,266,Gabon,Syrian Arab Republic,15,8,7
2000,710,South Africa,Syrian Arab Republic,49,25,24
2000,288,Ghana,Syrian Arab Republic,41,22,19
2000,324,Guinea,Syrian Arab Republic,36,29,7
2000,478,Mauritania,Syrian Arab Republic,137,69,68
2000,12,Algeria,Syrian Arab Republic,3073,1677,1396
2000,818,Egypt,Syrian Arab Republic,5549,2968,2581
2000,434,Libya,Syrian Arab Republic,20428,13253,7175
2000,504,Morocco,Syrian Arab Republic,1353,695,658
2000,788,Tunisia,Syrian Arab Republic,437,223,214
2000,51,Armenia,Syrian Arab Republic,3743,1645,2098
2000,48,Bahrain,Syrian Arab Republic,2139,1478,661
2000,196,Cyprus,Syrian Arab Republic,1481,1116,365
2000,368,Iraq,Syrian Arab Republic,5338,2159,3179
2000,376,Israel,Syrian Arab Republic,10960,5073,5887
2000,400,Jordan,Syrian Arab Republic,57624,32278,25346
2000,414,Kuwait,Syrian Arab Republic,10073,6803,3270
2000,422,Lebanon,Syrian Arab Republic,26159,13507,12652
2000,634,Qatar,Syrian Arab Republic,531,405,126
2000,682,Saudi Arabia,Syrian Arab Republic,322050,183199,138851
2000,275,State of Palestine,Syrian Arab Republic,4986,2244,2742
2000,792,Turkey,Syrian Arab Republic,4995,2388,2607
2000,784,United Arab Emirates,Syrian Arab Republic,22036,15784,6252
2000,887,Yemen,Syrian Arab Republic,2411,1295,1116
2000,144,Sri Lanka,Syrian Arab Republic,17,12,5
2000,360,Indonesia,Syrian Arab Republic,1120,600,520
2000,608,Philippines,Syrian Arab Republic,26,25,1
2000,28,Antigua and Barbuda,Syrian Arab Republic,200,97,103
2000,212,Dominica,Syrian Arab Republic,10,6,4
2000,214,Dominican Republic,Syrian Arab Republic,93,52,41
2000,312,Guadeloupe,Syrian Arab Republic,196,91,105
2000,474,Martinique,Syrian Arab Republic,137,62,75
2000,662,Saint Lucia,Syrian Arab Republic,22,17,5
2000,188,Costa Rica,Syrian Arab Republic,8,7,1
2000,320,Guatemala,Syrian Arab Republic,49,31,18
2000,484,Mexico,Syrian Arab Republic,472,267,205
2000,591,Panama,Syrian Arab Republic,164,106,58
2000,32,Argentina,Syrian Arab Republic,2284,1187,1097
2000,76,Brazil,Syrian Arab Republic,3293,1851,1442
2000,152,Chile,Syrian Arab Republic,300,170,130
2000,170,Colombia,Syrian Arab Republic,502,313,189
2000,218,Ecuador,Syrian Arab Republic,27,19,8
2000,862,Venezuela (Bolivarian Republic of),Syrian Arab Republic,13367,8159,5208
2000,36,Australia,Syrian Arab Republic,7320,3666,3654
2000,112,Belarus,Syrian Arab Republic,86,86,0
2000,100,Bulgaria,Syrian Arab Republic,738,604,134
2000,203,Czechia,Syrian Arab Republic,215,189,26
2000,348,Hungary,Syrian Arab Republic,846,634,212
2000,616,Poland,Syrian Arab Republic,574,495,79
2000,642,Romania,Syrian Arab Republic,7217,4237,2980
2000,643,Russian Federation,Syrian Arab Republic,3332,2830,502
2000,703,Slovakia,Syrian Arab Republic,148,118,30
2000,804,Ukraine,Syrian Arab Republic,4255,4088,167
2000,208,Denmark,Syrian Arab Republic,1304,565,739
2000,246,Finland,Syrian Arab Republic,161,103,58
2000,352,Iceland,Syrian Arab Republic,14,11,3
2000,372,Ireland,Syrian Arab Republic,133,91,42
2000,428,Latvia,Syrian Arab Republic,10,9,1
2000,578,Norway,Syrian Arab Republic,582,333,249
2000,752,Sweden,Syrian Arab Republic,14162,6991,7171
2000,826,United Kingdom,Syrian Arab Republic,4028,2400,1628
2000,300,Greece,Syrian Arab Republic,5996,4777,1219
2000,380,Italy,Syrian Arab Republic,3399,2016,1383
2000,470,Malta,Syrian Arab Republic,151,122,29
2000,620,Portugal,Syrian Arab Republic,34,19,15
2000,688,Serbia,Syrian Arab Republic,129,104,25
2000,705,Slovenia,Syrian Arab Republic,27,23,4
2000,724,Spain,Syrian Arab Republic,3531,2656,875
2000,40,Austria,Syrian Arab Republic,2297,1465,832
2000,56,Belgium,Syrian Arab Republic,1643,975,668
2000,250,France,Syrian Arab Republic,14526,8494,6032
2000,276,Germany,Syrian Arab Republic,25116,14373,10743
2000,528,Netherlands,Syrian Arab Republic,4060,2267,1793
2000,756,Switzerland,Syrian Arab Republic,2134,1354,780
2000,124,Canada,Syrian Arab Republic,15827,7634,8193
2000,840,United States of America,Syrian Arab Republic,55946,32575,23371
2005,266,Gabon,Syrian Arab Republic,16,9,7
2005,710,South Africa,Syrian Arab Republic,64,31,33
2005,288,Ghana,Syrian Arab Republic,58,33,25
2005,324,Guinea,Syrian Arab Republic,20,19,1
2005,478,Mauritania,Syrian Arab Republic,138,73,65
2005,12,Algeria,Syrian Arab Republic,2425,1324,1101
2005,818,Egypt,Syrian Arab Republic,6606,3723,2883
2005,434,Libya,Syrian Arab Republic,22509,16015,6494
2005,504,Morocco,Syrian Arab Republic,1388,704,684
2005,788,Tunisia,Syrian Arab Republic,418,215,203
2005,51,Armenia,Syrian Arab Republic,2476,1134,1342
2005,48,Bahrain,Syrian Arab Republic,2743,1865,878
2005,196,Cyprus,Syrian Arab Republic,2168,1630,538
2005,368,Iraq,Syrian Arab Republic,6119,3498,2621
2005,376,Israel,Syrian Arab Republic,10017,4598,5419
2005,400,Jordan,Syrian Arab Republic,104791,64877,39914
2005,414,Kuwait,Syrian Arab Republic,10880,7176,3704
2005,422,Lebanon,Syrian Arab Republic,23419,12657,10762
2005,634,Qatar,Syrian Arab Republic,3279,2465,814
2005,682,Saudi Arabia,Syrian Arab Republic,397826,236194,161632
2005,275,State of Palestine,Syrian Arab Republic,4852,2204,2648
2005,792,Turkey,Syrian Arab Republic,5158,2406,2752
2005,784,United Arab Emirates,Syrian Arab Republic,22332,15463,6869
2005,887,Yemen,Syrian Arab Republic,2578,1362,1216
2005,144,Sri Lanka,Syrian Arab Republic,35,17,18
2005,360,Indonesia,Syrian Arab Republic,1533,901,632
2005,608,Philippines,Syrian Arab Republic,21,21,0
2005,28,Antigua and Barbuda,Syrian Arab Republic,215,104,111
2005,212,Dominica,Syrian Arab Republic,12,8,4
2005,214,Dominican Republic,Syrian Arab Republic,59,34,25
2005,312,Guadeloupe,Syrian Arab Republic,241,111,130
2005,474,Martinique,Syrian Arab Republic,143,63,80
2005,662,Saint Lucia,Syrian Arab Republic,86,67,19
2005,188,Costa Rica,Syrian Arab Republic,5,4,1
2005,320,Guatemala,Syrian Arab Republic,59,39,20
2005,484,Mexico,Syrian Arab Republic,313,186,127
2005,591,Panama,Syrian Arab Republic,190,117,73
2005,32,Argentina,Syrian Arab Republic,1703,889,814
2005,68,Bolivia (Plurinational State of),Syrian Arab Republic,1,0,1
2005,76,Brazil,Syrian Arab Republic,2688,1525,1163
2005,152,Chile,Syrian Arab Republic,450,259,191
2005,170,Colombia,Syrian Arab Republic,289,178,111
2005,218,Ecuador,Syrian Arab Republic,32,23,9
2005,862,Venezuela (Bolivarian Republic of),Syrian Arab Republic,14055,8587,5468
2005,36,Australia,Syrian Arab Republic,8260,4085,4175
2005,112,Belarus,Syrian Arab Republic,83,83,0
2005,100,Bulgaria,Syrian Arab Republic,989,814,175
2005,203,Czechia,Syrian Arab Republic,396,310,86
2005,348,Hungary,Syrian Arab Republic,1045,788,257
2005,616,Poland,Syrian Arab Republic,582,496,86
2005,642,Romania,Syrian Arab Republic,7254,4318,2936
2005,643,Russian Federation,Syrian Arab Republic,3301,2796,505
2005,703,Slovakia,Syrian Arab Republic,167,133,34
2005,804,Ukraine,Syrian Arab Republic,3887,3735,152
2005,208,Denmark,Syrian Arab Republic,1714,794,920
2005,246,Finland,Syrian Arab Republic,298,189,109
2005,352,Iceland,Syrian Arab Republic,17,12,5
2005,372,Ireland,Syrian Arab Republic,133,94,39
2005,428,Latvia,Syrian Arab Republic,15,15,0
2005,578,Norway,Syrian Arab Republic,978,543,435
2005,752,Sweden,Syrian Arab Republic,16772,8325,8447
2005,826,United Kingdom,Syrian Arab Republic,6191,3765,2426
2005,191,Croatia,Syrian Arab Republic,90,78,12
2005,300,Greece,Syrian Arab Republic,6597,5063,1534
2005,380,Italy,Syrian Arab Republic,4728,2978,1750
2005,470,Malta,Syrian Arab Republic,179,144,35
2005,620,Portugal,Syrian Arab Republic,31,18,13
2005,688,Serbia,Syrian Arab Republic,128,103,25
2005,705,Slovenia,Syrian Arab Republic,30,25,5
2005,724,Spain,Syrian Arab Republic,4433,3158,1275
2005,40,Austria,Syrian Arab Republic,2568,1616,952
2005,56,Belgium,Syrian Arab Republic,2865,1704,1161
2005,250,France,Syrian Arab Republic,15414,9010,6404
2005,276,Germany,Syrian Arab Republic,34895,20554,14341
2005,528,Netherlands,Syrian Arab Republic,6684,3748,2936
2005,756,Switzerland,Syrian Arab Republic,2613,1610,1003
2005,124,Canada,Syrian Arab Republic,18396,9223,9173
2005,840,United States of America,Syrian Arab Republic,57569,28837,28732
2010,266,Gabon,Syrian Arab Republic,18,10,8
2010,710,South Africa,Syrian Arab Republic,100,49,51
2010,288,Ghana,Syrian Arab Republic,43,23,20
2010,324,Guinea,Syrian Arab Republic,15,14,1
2010,478,Mauritania,Syrian Arab Republic,139,75,64
2010,12,Algeria,Syrian Arab Republic,2665,1403,1262
2010,818,Egypt,Syrian Arab Republic,7129,3899,3230
2010,434,Libya,Syrian Arab Republic,24624,17602,7022
2010,504,Morocco,Syrian Arab Republic,1553,783,770
2010,788,Tunisia,Syrian Arab Republic,829,427,402
2010,51,Armenia,Syrian Arab Republic,2062,982,1080
2010,48,Bahrain,Syrian Arab Republic,3954,2667,1287
2010,196,Cyprus,Syrian Arab Republic,3550,2680,870
2010,368,Iraq,Syrian Arab Republic,6180,3691,2489
2010,376,Israel,Syrian Arab Republic,9195,4168,5027
2010,400,Jordan,Syrian Arab Republic,149685,95148,54537
2010,414,Kuwait,Syrian Arab Republic,14401,9383,5018
2010,422,Lebanon,Syrian Arab Republic,20679,11807,8872
2010,634,Qatar,Syrian Arab Republic,8688,6963,1725
2010,682,Saudi Arabia,Syrian Arab Republic,515803,317211,198592
2010,275,State of Palestine,Syrian Arab Republic,4719,2164,2555
2010,792,Turkey,Syrian Arab Republic,5311,2414,2897
2010,784,United Arab Emirates,Syrian Arab Republic,44428,31056,13372
2010,887,Yemen,Syrian Arab Republic,2822,1467,1355
2010,144,Sri Lanka,Syrian Arab Republic,73,36,37
2010,360,Indonesia,Syrian Arab Republic,2045,1192,853
2010,608,Philippines,Syrian Arab Republic,61,58,3
2010,28,Antigua and Barbuda,Syrian Arab Republic,229,111,118
2010,212,Dominica,Syrian Arab Republic,14,10,4
2010,214,Dominican Republic,Syrian Arab Republic,24,15,9
2010,312,Guadeloupe,Syrian Arab Republic,285,130,155
2010,474,Martinique,Syrian Arab Republic,150,65,85
2010,662,Saint Lucia,Syrian Arab Republic,144,111,33
2010,188,Costa Rica,Syrian Arab Republic,11,10,1
2010,320,Guatemala,Syrian Arab Republic,68,46,22
2010,484,Mexico,Syrian Arab Republic,191,127,64
2010,591,Panama,Syrian Arab Republic,226,135,91
2010,32,Argentina,Syrian Arab Republic,1121,590,531
2010,68,Bolivia (Plurinational State of),Syrian Arab Republic,2,1,1
2010,76,Brazil,Syrian Arab Republic,2044,1175,869
2010,152,Chile,Syrian Arab Republic,600,347,253
2010,170,Colombia,Syrian Arab Republic,127,77,50
2010,218,Ecuador,Syrian Arab Republic,44,31,13
2010,862,Venezuela (Bolivarian Republic of),Syrian Arab Republic,14929,9136,5793
2010,36,Australia,Syrian Arab Republic,9330,4592,4738
2010,112,Belarus,Syrian Arab Republic,79,79,0
2010,100,Bulgaria,Syrian Arab Republic,1198,990,208
2010,203,Czechia,Syrian Arab Republic,540,407,133
2010,348,Hungary,Syrian Arab Republic,1244,942,302
2010,616,Poland,Syrian Arab Republic,610,513,97
2010,642,Romania,Syrian Arab Republic,4087,2598,1489
2010,643,Russian Federation,Syrian Arab Republic,3203,2704,499
2010,703,Slovakia,Syrian Arab Republic,187,150,37
2010,804,Ukraine,Syrian Arab Republic,3708,3564,144
2010,208,Denmark,Syrian Arab Republic,2086,1005,1081
2010,233,Estonia,Syrian Arab Republic,6,6,0
2010,246,Finland,Syrian Arab Republic,499,296,203
2010,352,Iceland,Syrian Arab Republic,19,13,6
2010,372,Ireland,Syrian Arab Republic,112,77,35
2010,428,Latvia,Syrian Arab Republic,20,20,0
2010,578,Norway,Syrian Arab Republic,1428,778,650
2010,752,Sweden,Syrian Arab Republic,20758,10544,10214
2010,826,United Kingdom,Syrian Arab Republic,6521,4018,2503
2010,191,Croatia,Syrian Arab Republic,179,156,23
2010,300,Greece,Syrian Arab Republic,7489,5566,1923
2010,380,Italy,Syrian Arab Republic,5827,3853,1974
2010,470,Malta,Syrian Arab Republic,215,183,32
2010,620,Portugal,Syrian Arab Republic,23,14,9
2010,688,Serbia,Syrian Arab Republic,126,101,25
2010,705,Slovenia,Syrian Arab Republic,35,26,9
2010,724,Spain,Syrian Arab Republic,4880,3483,1397
2010,40,Austria,Syrian Arab Republic,2838,1766,1072
2010,56,Belgium,Syrian Arab Republic,4409,2633,1776
2010,250,France,Syrian Arab Republic,15736,9056,6680
2010,276,Germany,Syrian Arab Republic,42959,25703,17256
2010,528,Netherlands,Syrian Arab Republic,6964,3818,3146
2010,756,Switzerland,Syrian Arab Republic,2820,1674,1146
2010,124,Canada,Syrian Arab Republic,22085,11400,10685
2010,840,United States of America,Syrian Arab Republic,61003,30138,30865
2015,266,Gabon,Syrian Arab Republic,26,16,10
2015,710,South Africa,Syrian Arab Republic,179,84,95
2015,288,Ghana,Syrian Arab Republic,52,28,24
2015,324,Guinea,Syrian Arab Republic,8,7,1
2015,478,Mauritania,Syrian Arab Republic,322,189,133
2015,12,Algeria,Syrian Arab Republic,2941,1547,1394
2015,818,Egypt,Syrian Arab Republic,90599,49643,40956
2015,434,Libya,Syrian Arab Republic,27762,19737,8025
2015,504,Morocco,Syrian Arab Republic,2024,1017,1007
2015,788,Tunisia,Syrian Arab Republic,1228,646,582
2015,51,Armenia,Syrian Arab Republic,17538,8353,9185
2015,48,Bahrain,Syrian Arab Republic,3044,2039,1005
2015,196,Cyprus,Syrian Arab Republic,7552,4029,3523
2015,368,Iraq,Syrian Arab Republic,252056,140172,111884
2015,376,Israel,Syrian Arab Republic,9483,4273,5210
2015,400,Jordan,Syrian Arab Republic,673705,336853,336852
2015,414,Kuwait,Syrian Arab Republic,21340,12880,8460
2015,422,Lebanon,Syrian Arab Republic,1230484,592918,637566
2015,634,Qatar,Syrian Arab Republic,7148,5823,1325
2015,682,Saudi Arabia,Syrian Arab Republic,659067,393766,265301
2015,275,State of Palestine,Syrian Arab Republic,4672,2137,2535
2015,792,Turkey,Syrian Arab Republic,2768494,1688782,1079712
2015,784,United Arab Emirates,Syrian Arab Republic,48547,33359,15188
2015,887,Yemen,Syrian Arab Republic,3943,2050,1893
2015,144,Sri Lanka,Syrian Arab Republic,73,35,38
2015,360,Indonesia,Syrian Arab Republic,2263,1340,923
2015,608,Philippines,Syrian Arab Republic,62,59,3
2015,28,Antigua and Barbuda,Syrian Arab Republic,244,118,126
2015,212,Dominica,Syrian Arab Republic,16,11,5
2015,214,Dominican Republic,Syrian Arab Republic,25,16,9
2015,312,Guadeloupe,Syrian Arab Republic,296,134,162
2015,474,Martinique,Syrian Arab Republic,155,67,88
2015,662,Saint Lucia,Syrian Arab Republic,137,106,31
2015,188,Costa Rica,Syrian Arab Republic,11,10,1
2015,320,Guatemala,Syrian Arab Republic,78,53,25
2015,484,Mexico,Syrian Arab Republic,202,134,68
2015,591,Panama,Syrian Arab Republic,265,158,107
2015,32,Argentina,Syrian Arab Republic,1125,592,533
2015,68,Bolivia (Plurinational State of),Syrian Arab Republic,2,1,1
2015,76,Brazil,Syrian Arab Republic,2461,1415,1046
2015,152,Chile,Syrian Arab Republic,908,517,391
2015,170,Colombia,Syrian Arab Republic,142,87,55
2015,218,Ecuador,Syrian Arab Republic,64,45,19
2015,862,Venezuela (Bolivarian Republic of),Syrian Arab Republic,15632,9480,6152
2015,36,Australia,Syrian Arab Republic,14170,6922,7248
2015,112,Belarus,Syrian Arab Republic,83,83,0
2015,100,Bulgaria,Syrian Arab Republic,8318,5433,2885
2015,203,Czechia,Syrian Arab Republic,922,634,288
2015,348,Hungary,Syrian Arab Republic,1642,1219,423
2015,616,Poland,Syrian Arab Republic,588,497,91
2015,642,Romania,Syrian Arab Republic,2576,2031,545
2015,643,Russian Federation,Syrian Arab Republic,3265,2754,511
2015,703,Slovakia,Syrian Arab Republic,237,191,46
2015,804,Ukraine,Syrian Arab Republic,3720,3576,144
2015,208,Denmark,Syrian Arab Republic,4498,2540,1958
2015,233,Estonia,Syrian Arab Republic,10,9,1
2015,246,Finland,Syrian Arab Republic,1714,991,723
2015,352,Iceland,Syrian Arab Republic,35,26,9
2015,372,Ireland,Syrian Arab Republic,507,305,202
2015,428,Latvia,Syrian Arab Republic,22,18,4
2015,578,Norway,Syrian Arab Republic,5536,3508,2028
2015,752,Sweden,Syrian Arab Republic,98216,56701,41515
2015,826,United Kingdom,Syrian Arab Republic,8339,5044,3295
2015,191,Croatia,Syrian Arab Republic,180,157,23
2015,300,Greece,Syrian Arab Republic,9549,4660,4889
2015,380,Italy,Syrian Arab Republic,6128,3910,2218
2015,470,Malta,Syrian Arab Republic,1488,757,731
2015,620,Portugal,Syrian Arab Republic,26,15,11
2015,688,Serbia,Syrian Arab Republic,123,99,24
2015,705,Slovenia,Syrian Arab Republic,61,42,19
2015,724,Spain,Syrian Arab Republic,5910,3904,2006
2015,40,Austria,Syrian Arab Republic,3320,2074,1246
2015,56,Belgium,Syrian Arab Republic,10860,6641,4219
2015,250,France,Syrian Arab Republic,17432,9828,7604
2015,276,Germany,Syrian Arab Republic,44761,26738,18023
2015,528,Netherlands,Syrian Arab Republic,9714,5482,4232
2015,756,Switzerland,Syrian Arab Republic,15204,8858,6346
2015,124,Canada,Syrian Arab Republic,52635,26420,26215
2015,840,United States of America,Syrian Arab Republic,84881,41716,43165
2019,266,Gabon,Syrian Arab Republic,27,17,10
2019,710,South Africa,Syrian Arab Republic,200,94,106
2019,288,Ghana,Syrian Arab Republic,58,32,26
2019,324,Guinea,Syrian Arab Republic,7,7,0
2019,478,Mauritania,Syrian Arab Republic,576,338,238
2019,12,Algeria,Syrian Arab Republic,3058,1609,1449
2019,818,Egypt,Syrian Arab Republic,124688,61506,63182
2019,434,Libya,Syrian Arab Republic,44184,31412,12772
2019,504,Morocco,Syrian Arab Republic,2158,1085,1073
2019,788,Tunisia,Syrian Arab Republic,1248,657,591
2019,51,Armenia,Syrian Arab Republic,17401,8346,9055
2019,48,Bahrain,Syrian Arab Republic,3204,2147,1057
2019,196,Cyprus,Syrian Arab Republic,7548,4063,3485
2019,368,Iraq,Syrian Arab Republic,258144,143559,114585
2019,376,Israel,Syrian Arab Republic,9221,4155,5066
2019,400,Jordan,Syrian Arab Republic,724508,362255,362253
2019,414,Kuwait,Syrian Arab Republic,22596,13639,8957
2019,422,Lebanon,Syrian Arab Republic,1162305,560066,602239
2019,634,Qatar,Syrian Arab Republic,25290,20268,5022
2019,682,Saudi Arabia,Syrian Arab Republic,802915,472586,330329
2019,275,State of Palestine,Syrian Arab Republic,4639,2122,2517
2019,792,Turkey,Syrian Arab Republic,3743494,2378041,1365453
2019,784,United Arab Emirates,Syrian Arab Republic,52142,35827,16315
2019,887,Yemen,Syrian Arab Republic,4000,2079,1921
2019,144,Sri Lanka,Syrian Arab Republic,73,35,38
2019,360,Indonesia,Syrian Arab Republic,2363,1400,963
2019,608,Philippines,Syrian Arab Republic,63,60,3
2019,28,Antigua and Barbuda,Syrian Arab Republic,253,122,131
2019,212,Dominica,Syrian Arab Republic,16,11,5
2019,214,Dominican Republic,Syrian Arab Republic,25,16,9
2019,312,Guadeloupe,Syrian Arab Republic,300,136,164
2019,474,Martinique,Syrian Arab Republic,154,67,87
2019,662,Saint Lucia,Syrian Arab Republic,132,103,29
2019,188,Costa Rica,Syrian Arab Republic,11,10,1
2019,320,Guatemala,Syrian Arab Republic,80,55,25
2019,484,Mexico,Syrian Arab Republic,208,138,70
2019,591,Panama,Syrian Arab Republic,291,174,117
2019,32,Argentina,Syrian Arab Republic,1144,601,543
2019,68,Bolivia (Plurinational State of),Syrian Arab Republic,2,1,1
2019,76,Brazil,Syrian Arab Republic,2771,1593,1178
2019,152,Chile,Syrian Arab Republic,1213,662,551
2019,170,Colombia,Syrian Arab Republic,145,89,56
2019,218,Ecuador,Syrian Arab Republic,154,81,73
2019,862,Venezuela (Bolivarian Republic of),Syrian Arab Republic,15311,9258,6053
2019,36,Australia,Syrian Arab Republic,25825,12900,12925
2019,112,Belarus,Syrian Arab Republic,81,81,0
2019,100,Bulgaria,Syrian Arab Republic,14080,8888,5192
2019,203,Czechia,Syrian Arab Republic,1235,840,395
2019,348,Hungary,Syrian Arab Republic,2006,1471,535
2019,616,Poland,Syrian Arab Republic,622,530,92
2019,642,Romania,Syrian Arab Republic,3829,2878,951
2019,643,Russian Federation,Syrian Arab Republic,3264,2754,510
2019,703,Slovakia,Syrian Arab Republic,265,212,53
2019,804,Ukraine,Syrian Arab Republic,3757,3612,145
2019,208,Denmark,Syrian Arab Republic,37667,21139,16528
2019,233,Estonia,Syrian Arab Republic,79,48,31
2019,246,Finland,Syrian Arab Republic,4816,2789,2027
2019,352,Iceland,Syrian Arab Republic,171,108,63
2019,372,Ireland,Syrian Arab Republic,1112,670,442
2019,428,Latvia,Syrian Arab Republic,24,19,5
2019,578,Norway,Syrian Arab Republic,22603,14181,8422
2019,752,Sweden,Syrian Arab Republic,181793,103893,77900
2019,826,United Kingdom,Syrian Arab Republic,9469,5737,3732
2019,191,Croatia,Syrian Arab Republic,166,145,21
2019,300,Greece,Syrian Arab Republic,23319,11379,11940
2019,380,Italy,Syrian Arab Republic,7076,4427,2649
2019,470,Malta,Syrian Arab Republic,2401,1230,1171
2019,620,Portugal,Syrian Arab Republic,473,261,212
2019,688,Serbia,Syrian Arab Republic,124,100,24
2019,705,Slovenia,Syrian Arab Republic,108,80,28
2019,724,Spain,Syrian Arab Republic,6123,3995,2128
2019,40,Austria,Syrian Arab Republic,11757,7421,4336
2019,56,Belgium,Syrian Arab Republic,26484,15799,10685
2019,250,France,Syrian Arab Republic,18451,10384,8067
2019,276,Germany,Syrian Arab Republic,589628,376490,213138
2019,528,Netherlands,Syrian Arab Republic,70713,42462,28251
2019,756,Switzerland,Syrian Arab Republic,18960,10741,8219
2019,124,Canada,Syrian Arab Republic,56404,28312,28092
2019,840,United States of America,Syrian Arab Republic,91663,44548,47115
1990,818,Egypt,Tajikistan,47,40,7
1990,434,Libya,Tajikistan,133,112,21
1990,31,Azerbaijan,Tajikistan,340,123,217
1990,196,Cyprus,Tajikistan,2,1,1
1990,268,Georgia,Tajikistan,3306,1457,1849
1990,376,Israel,Tajikistan,4484,2251,2233
1990,792,Turkey,Tajikistan,64,50,14
1990,398,Kazakhstan,Tajikistan,5085,2584,2501
1990,417,Kyrgyzstan,Tajikistan,6041,2539,3502
1990,795,Turkmenistan,Tajikistan,1456,714,742
1990,860,Uzbekistan,Tajikistan,4971,2443,2528
1990,4,Afghanistan,Tajikistan,40537,22879,17658
1990,152,Chile,Tajikistan,2,1,1
1990,36,Australia,Tajikistan,41,19,22
1990,112,Belarus,Tajikistan,6587,3336,3251
1990,100,Bulgaria,Tajikistan,5,1,4
1990,203,Czechia,Tajikistan,16,7,9
1990,348,Hungary,Tajikistan,16,9,7
1990,616,Poland,Tajikistan,85,30,55
1990,643,Russian Federation,Tajikistan,424727,208419,216308
1990,804,Ukraine,Tajikistan,34861,14938,19923
1990,208,Denmark,Tajikistan,6,2,4
1990,233,Estonia,Tajikistan,853,431,422
1990,352,Iceland,Tajikistan,97,30,67
1990,372,Ireland,Tajikistan,4,2,2
1990,428,Latvia,Tajikistan,47,20,27
1990,440,Lithuania,Tajikistan,1481,823,658
1990,752,Sweden,Tajikistan,51,19,32
1990,826,United Kingdom,Tajikistan,13,9,4
1990,300,Greece,Tajikistan,15,7,8
1990,380,Italy,Tajikistan,7,2,5
1990,724,Spain,Tajikistan,1,0,1
1990,40,Austria,Tajikistan,157,69,88
1990,56,Belgium,Tajikistan,6,4,2
1990,250,France,Tajikistan,30,14,16
1990,276,Germany,Tajikistan,236,137,99
1990,528,Netherlands,Tajikistan,61,10,51
1990,756,Switzerland,Tajikistan,26,11,15
1990,124,Canada,Tajikistan,111,54,57
1990,840,United States of America,Tajikistan,1693,829,864
1995,818,Egypt,Tajikistan,68,51,17
1995,434,Libya,Tajikistan,313,237,76
1995,31,Azerbaijan,Tajikistan,298,119,179
1995,196,Cyprus,Tajikistan,3,1,2
1995,268,Georgia,Tajikistan,2690,1254,1436
1995,376,Israel,Tajikistan,4238,2089,2149
1995,792,Turkey,Tajikistan,155,119,36
1995,398,Kazakhstan,Tajikistan,8351,4305,4046
1995,417,Kyrgyzstan,Tajikistan,13311,5966,7345
1995,795,Turkmenistan,Tajikistan,21432,9237,12195
1995,860,Uzbekistan,Tajikistan,8292,4119,4173
1995,4,Afghanistan,Tajikistan,36733,20733,16000
1995,68,Bolivia (Plurinational State of),Tajikistan,2,1,1
1995,152,Chile,Tajikistan,2,2,0
1995,36,Australia,Tajikistan,26,10,16
1995,112,Belarus,Tajikistan,6240,3175,3065
1995,100,Bulgaria,Tajikistan,29,12,17
1995,203,Czechia,Tajikistan,24,10,14
1995,348,Hungary,Tajikistan,14,7,7
1995,616,Poland,Tajikistan,72,25,47
1995,643,Russian Federation,Tajikistan,410349,218409,191940
1995,804,Ukraine,Tajikistan,34009,15678,18331
1995,208,Denmark,Tajikistan,7,3,4
1995,233,Estonia,Tajikistan,604,299,305
1995,246,Finland,Tajikistan,2,1,1
1995,352,Iceland,Tajikistan,50,15,35
1995,372,Ireland,Tajikistan,11,4,7
1995,428,Latvia,Tajikistan,434,214,220
1995,440,Lithuania,Tajikistan,659,367,292
1995,752,Sweden,Tajikistan,60,22,38
1995,826,United Kingdom,Tajikistan,54,27,27
1995,300,Greece,Tajikistan,40,15,25
1995,380,Italy,Tajikistan,19,8,11
1995,724,Spain,Tajikistan,3,1,2
1995,40,Austria,Tajikistan,177,79,98
1995,56,Belgium,Tajikistan,6,4,2
1995,250,France,Tajikistan,31,14,17
1995,276,Germany,Tajikistan,4140,1888,2252
1995,528,Netherlands,Tajikistan,89,12,77
1995,756,Switzerland,Tajikistan,73,32,41
1995,124,Canada,Tajikistan,111,54,57
1995,840,United States of America,Tajikistan,2207,1093,1114
2000,818,Egypt,Tajikistan,95,67,28
2000,434,Libya,Tajikistan,499,368,131
2000,31,Azerbaijan,Tajikistan,300,117,183
2000,196,Cyprus,Tajikistan,4,2,2
2000,268,Georgia,Tajikistan,145,53,92
2000,376,Israel,Tajikistan,3754,1833,1921
2000,792,Turkey,Tajikistan,248,188,60
2000,398,Kazakhstan,Tajikistan,11617,6027,5590
2000,417,Kyrgyzstan,Tajikistan,9937,4911,5026
2000,795,Turkmenistan,Tajikistan,15478,6671,8807
2000,860,Uzbekistan,Tajikistan,32002,13793,18209
2000,4,Afghanistan,Tajikistan,32929,18586,14343
2000,68,Bolivia (Plurinational State of),Tajikistan,3,1,2
2000,152,Chile,Tajikistan,2,1,1
2000,36,Australia,Tajikistan,50,25,25
2000,112,Belarus,Tajikistan,5892,3013,2879
2000,100,Bulgaria,Tajikistan,53,23,30
2000,203,Czechia,Tajikistan,32,14,18
2000,348,Hungary,Tajikistan,12,6,6
2000,616,Poland,Tajikistan,62,21,41
2000,643,Russian Federation,Tajikistan,381090,220551,160539
2000,804,Ukraine,Tajikistan,33574,16611,16963
2000,208,Denmark,Tajikistan,7,3,4
2000,233,Estonia,Tajikistan,355,168,187
2000,246,Finland,Tajikistan,3,1,2
2000,352,Iceland,Tajikistan,3,1,2
2000,372,Ireland,Tajikistan,25,10,15
2000,428,Latvia,Tajikistan,821,408,413
2000,440,Lithuania,Tajikistan,516,287,229
2000,578,Norway,Tajikistan,10,3,7
2000,752,Sweden,Tajikistan,65,23,42
2000,826,United Kingdom,Tajikistan,97,45,52
2000,300,Greece,Tajikistan,66,24,42
2000,380,Italy,Tajikistan,30,13,17
2000,724,Spain,Tajikistan,41,19,22
2000,40,Austria,Tajikistan,197,90,107
2000,56,Belgium,Tajikistan,6,4,2
2000,250,France,Tajikistan,32,14,18
2000,276,Germany,Tajikistan,8044,3640,4404
2000,528,Netherlands,Tajikistan,122,14,108
2000,756,Switzerland,Tajikistan,121,53,68
2000,124,Canada,Tajikistan,114,55,59
2000,840,United States of America,Tajikistan,2732,1363,1369
2005,818,Egypt,Tajikistan,113,82,31
2005,434,Libya,Tajikistan,550,432,118
2005,31,Azerbaijan,Tajikistan,285,106,179
2005,196,Cyprus,Tajikistan,6,3,3
2005,268,Georgia,Tajikistan,137,50,87
2005,376,Israel,Tajikistan,2774,1334,1440
2005,792,Turkey,Tajikistan,255,192,63
2005,398,Kazakhstan,Tajikistan,13244,7040,6204
2005,417,Kyrgyzstan,Tajikistan,2320,1139,1181
2005,795,Turkmenistan,Tajikistan,12089,5212,6877
2005,860,Uzbekistan,Tajikistan,42216,18198,24018
2005,4,Afghanistan,Tajikistan,28460,16064,12396
2005,68,Bolivia (Plurinational State of),Tajikistan,2,0,2
2005,152,Chile,Tajikistan,3,2,1
2005,36,Australia,Tajikistan,70,35,35
2005,112,Belarus,Tajikistan,5811,2971,2840
2005,100,Bulgaria,Tajikistan,86,40,46
2005,203,Czechia,Tajikistan,170,112,58
2005,348,Hungary,Tajikistan,15,8,7
2005,616,Poland,Tajikistan,60,18,42
2005,643,Russian Federation,Tajikistan,423794,248341,175453
2005,804,Ukraine,Tajikistan,30677,15199,15478
2005,208,Denmark,Tajikistan,16,5,11
2005,233,Estonia,Tajikistan,381,185,196
2005,246,Finland,Tajikistan,20,10,10
2005,352,Iceland,Tajikistan,4,1,3
2005,372,Ireland,Tajikistan,25,11,14
2005,428,Latvia,Tajikistan,754,376,378
2005,440,Lithuania,Tajikistan,487,266,221
2005,578,Norway,Tajikistan,52,23,29
2005,752,Sweden,Tajikistan,121,52,69
2005,826,United Kingdom,Tajikistan,241,108,133
2005,300,Greece,Tajikistan,83,28,55
2005,380,Italy,Tajikistan,108,30,78
2005,724,Spain,Tajikistan,20,9,11
2005,40,Austria,Tajikistan,220,97,123
2005,56,Belgium,Tajikistan,15,8,7
2005,250,France,Tajikistan,146,51,95
2005,276,Germany,Tajikistan,16462,7943,8519
2005,528,Netherlands,Tajikistan,28,17,11
2005,756,Switzerland,Tajikistan,129,54,75
2005,124,Canada,Tajikistan,574,283,291
2005,840,United States of America,Tajikistan,3220,1616,1604
2010,818,Egypt,Tajikistan,122,87,35
2010,434,Libya,Tajikistan,602,474,128
2010,31,Azerbaijan,Tajikistan,261,103,158
2010,196,Cyprus,Tajikistan,9,5,4
2010,268,Georgia,Tajikistan,138,51,87
2010,376,Israel,Tajikistan,1828,848,980
2010,792,Turkey,Tajikistan,263,197,66
2010,398,Kazakhstan,Tajikistan,14870,8052,6818
2010,417,Kyrgyzstan,Tajikistan,2503,1216,1287
2010,795,Turkmenistan,Tajikistan,3401,1536,1865
2010,860,Uzbekistan,Tajikistan,11945,6208,5737
2010,4,Afghanistan,Tajikistan,23991,13541,10450
2010,68,Bolivia (Plurinational State of),Tajikistan,1,0,1
2010,76,Brazil,Tajikistan,7,7,0
2010,152,Chile,Tajikistan,4,3,1
2010,36,Australia,Tajikistan,100,36,64
2010,112,Belarus,Tajikistan,5729,2928,2801
2010,100,Bulgaria,Tajikistan,115,54,61
2010,203,Czechia,Tajikistan,291,202,89
2010,348,Hungary,Tajikistan,18,10,8
2010,616,Poland,Tajikistan,60,15,45
2010,643,Russian Federation,Tajikistan,457775,271125,186650
2010,804,Ukraine,Tajikistan,29270,14523,14747
2010,208,Denmark,Tajikistan,24,7,17
2010,233,Estonia,Tajikistan,403,199,204
2010,246,Finland,Tajikistan,35,16,19
2010,352,Iceland,Tajikistan,4,0,4
2010,372,Ireland,Tajikistan,21,9,12
2010,428,Latvia,Tajikistan,669,330,339
2010,440,Lithuania,Tajikistan,392,196,196
2010,578,Norway,Tajikistan,92,40,52
2010,752,Sweden,Tajikistan,213,91,122
2010,826,United Kingdom,Tajikistan,253,116,137
2010,300,Greece,Tajikistan,103,33,70
2010,380,Italy,Tajikistan,179,45,134
2010,705,Slovenia,Tajikistan,3,0,3
2010,724,Spain,Tajikistan,55,23,32
2010,40,Austria,Tajikistan,243,105,138
2010,56,Belgium,Tajikistan,31,19,12
2010,250,France,Tajikistan,229,97,132
2010,276,Germany,Tajikistan,23449,11600,11849
2010,528,Netherlands,Tajikistan,27,13,14
2010,756,Switzerland,Tajikistan,161,61,100
2010,124,Canada,Tajikistan,1060,526,534
2010,840,United States of America,Tajikistan,3821,1891,1930
2015,324,Guinea,Tajikistan,1,1,0
2015,818,Egypt,Tajikistan,90,68,22
2015,434,Libya,Tajikistan,678,532,146
2015,31,Azerbaijan,Tajikistan,249,101,148
2015,196,Cyprus,Tajikistan,8,5,3
2015,268,Georgia,Tajikistan,144,53,91
2015,376,Israel,Tajikistan,1885,869,1016
2015,792,Turkey,Tajikistan,277,204,73
2015,398,Kazakhstan,Tajikistan,15816,8683,7133
2015,417,Kyrgyzstan,Tajikistan,2205,1065,1140
2015,795,Turkmenistan,Tajikistan,1478,739,739
2015,860,Uzbekistan,Tajikistan,11496,6060,5436
2015,4,Afghanistan,Tajikistan,15031,6364,8667
2015,68,Bolivia (Plurinational State of),Tajikistan,1,0,1
2015,76,Brazil,Tajikistan,8,8,0
2015,152,Chile,Tajikistan,6,5,1
2015,36,Australia,Tajikistan,160,59,101
2015,112,Belarus,Tajikistan,5679,2905,2774
2015,100,Bulgaria,Tajikistan,151,66,85
2015,203,Czechia,Tajikistan,255,155,100
2015,348,Hungary,Tajikistan,15,6,9
2015,616,Poland,Tajikistan,57,15,42
2015,643,Russian Federation,Tajikistan,466508,275345,191163
2015,804,Ukraine,Tajikistan,29367,14592,14775
2015,208,Denmark,Tajikistan,28,9,19
2015,233,Estonia,Tajikistan,362,175,187
2015,246,Finland,Tajikistan,53,30,23
2015,352,Iceland,Tajikistan,2,0,2
2015,372,Ireland,Tajikistan,21,9,12
2015,428,Latvia,Tajikistan,536,257,279
2015,440,Lithuania,Tajikistan,338,168,170
2015,578,Norway,Tajikistan,109,48,61
2015,752,Sweden,Tajikistan,304,140,164
2015,826,United Kingdom,Tajikistan,323,143,180
2015,300,Greece,Tajikistan,96,28,68
2015,380,Italy,Tajikistan,202,47,155
2015,705,Slovenia,Tajikistan,3,1,2
2015,724,Spain,Tajikistan,84,44,40
2015,40,Austria,Tajikistan,284,124,160
2015,56,Belgium,Tajikistan,48,28,20
2015,250,France,Tajikistan,253,103,150
2015,276,Germany,Tajikistan,24433,12058,12375
2015,528,Netherlands,Tajikistan,53,29,24
2015,756,Switzerland,Tajikistan,222,91,131
2015,124,Canada,Tajikistan,1301,635,666
2015,840,United States of America,Tajikistan,4803,2366,2437
2019,818,Egypt,Tajikistan,128,93,35
2019,434,Libya,Tajikistan,719,565,154
2019,31,Azerbaijan,Tajikistan,239,97,142
2019,196,Cyprus,Tajikistan,7,5,2
2019,268,Georgia,Tajikistan,148,55,93
2019,376,Israel,Tajikistan,1833,845,988
2019,792,Turkey,Tajikistan,374,277,97
2019,398,Kazakhstan,Tajikistan,16527,9074,7453
2019,417,Kyrgyzstan,Tajikistan,2160,1043,1117
2019,795,Turkmenistan,Tajikistan,1468,734,734
2019,860,Uzbekistan,Tajikistan,11471,6051,5420
2019,4,Afghanistan,Tajikistan,4596,1913,2683
2019,68,Bolivia (Plurinational State of),Tajikistan,1,0,1
2019,76,Brazil,Tajikistan,9,9,0
2019,152,Chile,Tajikistan,8,7,1
2019,36,Australia,Tajikistan,169,70,99
2019,112,Belarus,Tajikistan,5608,2869,2739
2019,100,Bulgaria,Tajikistan,175,69,106
2019,203,Czechia,Tajikistan,299,181,118
2019,348,Hungary,Tajikistan,16,8,8
2019,616,Poland,Tajikistan,160,68,92
2019,643,Russian Federation,Tajikistan,466399,275281,191118
2019,804,Ukraine,Tajikistan,29660,14738,14922
2019,208,Denmark,Tajikistan,36,11,25
2019,233,Estonia,Tajikistan,347,164,183
2019,246,Finland,Tajikistan,71,35,36
2019,352,Iceland,Tajikistan,2,0,2
2019,372,Ireland,Tajikistan,23,10,13
2019,428,Latvia,Tajikistan,499,238,261
2019,440,Lithuania,Tajikistan,251,100,151
2019,578,Norway,Tajikistan,119,50,69
2019,752,Sweden,Tajikistan,432,215,217
2019,826,United Kingdom,Tajikistan,366,163,203
2019,300,Greece,Tajikistan,93,30,63
2019,380,Italy,Tajikistan,244,52,192
2019,705,Slovenia,Tajikistan,6,2,4
2019,724,Spain,Tajikistan,87,45,42
2019,40,Austria,Tajikistan,335,150,185
2019,56,Belgium,Tajikistan,68,37,31
2019,250,France,Tajikistan,267,108,159
2019,276,Germany,Tajikistan,26802,15133,11669
2019,528,Netherlands,Tajikistan,77,38,39
2019,756,Switzerland,Tajikistan,270,111,159
2019,124,Canada,Tajikistan,1394,681,713
2019,840,United States of America,Tajikistan,5186,2527,2659
1990,690,Seychelles,Thailand,5,1,4
1990,516,Namibia,Thailand,109,45,64
1990,710,South Africa,Thailand,151,35,116
1990,818,Egypt,Thailand,967,812,155
1990,434,Libya,Thailand,2762,2323,439
1990,48,Bahrain,Thailand,294,210,84
1990,196,Cyprus,Thailand,65,13,52
1990,400,Jordan,Thailand,73,36,37
1990,414,Kuwait,Thailand,1823,1104,719
1990,634,Qatar,Thailand,1377,599,778
1990,792,Turkey,Thailand,35,19,16
1990,784,United Arab Emirates,Thailand,2228,1586,642
1990,50,Bangladesh,Thailand,15503,8372,7131
1990,64,Bhutan,Thailand,28,15,13
1990,462,Maldives,Thailand,67,37,30
1990,144,Sri Lanka,Thailand,3,2,1
1990,156,China,Thailand,5839,2345,3494
1990,344,"China, Hong Kong SAR",Thailand,12860,2498,10362
1990,446,"China, Macao SAR",Thailand,1923,292,1631
1990,408,Dem. People's Republic of Korea,Thailand,232,80,152
1990,392,Japan,Thailand,6726,3427,3299
1990,410,Republic of Korea,Thailand,43,29,14
1990,96,Brunei Darussalam,Thailand,6612,6057,555
1990,116,Cambodia,Thailand,14149,6937,7212
1990,360,Indonesia,Thailand,1458,953,505
1990,418,Lao People's Democratic Republic,Thailand,2277,1326,951
1990,458,Malaysia,Thailand,31127,14856,16271
1990,608,Philippines,Thailand,180,97,83
1990,702,Singapore,Thailand,1438,329,1109
1990,626,Timor-Leste,Thailand,119,49,70
1990,704,Viet Nam,Thailand,1218,629,589
1990,136,Cayman Islands,Thailand,16,15,1
1990,630,Puerto Rico,Thailand,35,17,18
1990,188,Costa Rica,Thailand,4,0,4
1990,484,Mexico,Thailand,35,35,0
1990,591,Panama,Thailand,3,2,1
1990,32,Argentina,Thailand,133,66,67
1990,68,Bolivia (Plurinational State of),Thailand,2,0,2
1990,152,Chile,Thailand,22,10,12
1990,604,Peru,Thailand,12,3,9
1990,862,Venezuela (Bolivarian Republic of),Thailand,62,33,29
1990,36,Australia,Thailand,15834,6237,9597
1990,554,New Zealand,Thailand,2671,1223,1448
1990,100,Bulgaria,Thailand,3,0,3
1990,203,Czechia,Thailand,8,3,5
1990,348,Hungary,Thailand,631,76,555
1990,616,Poland,Thailand,53,24,29
1990,643,Russian Federation,Thailand,75,37,38
1990,703,Slovakia,Thailand,1,0,1
1990,208,Denmark,Thailand,1958,450,1508
1990,234,Faroe Islands,Thailand,5,3,2
1990,246,Finland,Thailand,411,92,319
1990,352,Iceland,Thailand,83,17,66
1990,372,Ireland,Thailand,103,32,71
1990,428,Latvia,Thailand,1,0,1
1990,578,Norway,Thailand,1291,285,1006
1990,752,Sweden,Thailand,8135,2164,5971
1990,826,United Kingdom,Thailand,7189,2130,5059
1990,300,Greece,Thailand,326,13,313
1990,380,Italy,Thailand,568,198,370
1990,470,Malta,Thailand,42,5,37
1990,620,Portugal,Thailand,18,4,14
1990,705,Slovenia,Thailand,5,3,2
1990,724,Spain,Thailand,271,84,187
1990,40,Austria,Thailand,3088,512,2576
1990,56,Belgium,Thailand,3947,845,3102
1990,250,France,Thailand,12071,4580,7491
1990,276,Germany,Thailand,16629,3815,12814
1990,442,Luxembourg,Thailand,168,17,151
1990,528,Netherlands,Thailand,2502,701,1801
1990,756,Switzerland,Thailand,8699,1833,6866
1990,124,Canada,Thailand,5585,2719,2866
1990,304,Greenland,Thailand,3,0,3
1990,840,United States of America,Thailand,106919,39426,67493
1995,690,Seychelles,Thailand,237,46,191
1995,516,Namibia,Thailand,104,44,60
1995,710,South Africa,Thailand,225,60,165
1995,818,Egypt,Thailand,844,695,149
1995,434,Libya,Thailand,2410,1985,425
1995,48,Bahrain,Thailand,323,228,95
1995,196,Cyprus,Thailand,92,15,77
1995,400,Jordan,Thailand,100,57,43
1995,414,Kuwait,Thailand,1460,930,530
1995,634,Qatar,Thailand,2329,1224,1105
1995,792,Turkey,Thailand,85,45,40
1995,784,United Arab Emirates,Thailand,2855,2045,810
1995,50,Bangladesh,Thailand,11945,6451,5494
1995,64,Bhutan,Thailand,33,18,15
1995,462,Maldives,Thailand,78,39,39
1995,144,Sri Lanka,Thailand,34,28,6
1995,156,China,Thailand,8390,3685,4705
1995,344,"China, Hong Kong SAR",Thailand,14353,2711,11642
1995,446,"China, Macao SAR",Thailand,2109,289,1820
1995,408,Dem. People's Republic of Korea,Thailand,300,114,186
1995,392,Japan,Thailand,16255,7803,8452
1995,410,Republic of Korea,Thailand,1588,1048,540
1995,96,Brunei Darussalam,Thailand,10047,7783,2264
1995,116,Cambodia,Thailand,37488,18319,19169
1995,360,Indonesia,Thailand,964,639,325
1995,418,Lao People's Democratic Republic,Thailand,2060,1204,856
1995,458,Malaysia,Thailand,29090,12511,16579
1995,608,Philippines,Thailand,242,129,113
1995,702,Singapore,Thailand,3032,670,2362
1995,626,Timor-Leste,Thailand,130,53,77
1995,704,Viet Nam,Thailand,2995,1623,1372
1995,136,Cayman Islands,Thailand,32,29,3
1995,630,Puerto Rico,Thailand,36,18,18
1995,188,Costa Rica,Thailand,4,0,4
1995,484,Mexico,Thailand,48,29,19
1995,591,Panama,Thailand,3,2,1
1995,32,Argentina,Thailand,130,65,65
1995,68,Bolivia (Plurinational State of),Thailand,6,0,6
1995,152,Chile,Thailand,29,13,16
1995,604,Peru,Thailand,13,3,10
1995,862,Venezuela (Bolivarian Republic of),Thailand,61,33,28
1995,36,Australia,Thailand,18920,7257,11663
1995,554,New Zealand,Thailand,4372,2026,2346
1995,100,Bulgaria,Thailand,5,0,5
1995,203,Czechia,Thailand,12,4,8
1995,348,Hungary,Thailand,559,59,500
1995,616,Poland,Thailand,44,19,25
1995,643,Russian Federation,Thailand,78,38,40
1995,703,Slovakia,Thailand,18,2,16
1995,208,Denmark,Thailand,3777,818,2959
1995,234,Faroe Islands,Thailand,10,1,9
1995,246,Finland,Thailand,960,255,705
1995,352,Iceland,Thailand,322,74,248
1995,372,Ireland,Thailand,285,80,205
1995,428,Latvia,Thailand,1,0,1
1995,578,Norway,Thailand,2238,466,1772
1995,752,Sweden,Thailand,9653,2513,7140
1995,826,United Kingdom,Thailand,11357,3243,8114
1995,300,Greece,Thailand,321,43,278
1995,380,Italy,Thailand,2205,156,2049
1995,470,Malta,Thailand,50,7,43
1995,620,Portugal,Thailand,39,9,30
1995,705,Slovenia,Thailand,10,4,6
1995,724,Spain,Thailand,346,108,238
1995,40,Austria,Thailand,3484,625,2859
1995,56,Belgium,Thailand,3922,832,3090
1995,250,France,Thailand,12461,4598,7863
1995,276,Germany,Thailand,26601,3998,22603
1995,438,Liechtenstein,Thailand,1,0,1
1995,442,Luxembourg,Thailand,159,15,144
1995,528,Netherlands,Thailand,4141,1090,3051
1995,756,Switzerland,Thailand,11088,2711,8377
1995,124,Canada,Thailand,7052,3414,3638
1995,304,Greenland,Thailand,12,3,9
1995,840,United States of America,Thailand,140211,50990,89221
2000,690,Seychelles,Thailand,469,91,378
2000,516,Namibia,Thailand,98,41,57
2000,710,South Africa,Thailand,368,94,274
2000,818,Egypt,Thailand,787,632,155
2000,434,Libya,Thailand,2098,1689,409
2000,48,Bahrain,Thailand,353,244,109
2000,196,Cyprus,Thailand,119,18,101
2000,400,Jordan,Thailand,126,77,49
2000,414,Kuwait,Thailand,1666,1125,541
2000,634,Qatar,Thailand,2935,1672,1263
2000,792,Turkey,Thailand,136,70,66
2000,784,United Arab Emirates,Thailand,3647,2612,1035
2000,50,Bangladesh,Thailand,8386,4529,3857
2000,64,Bhutan,Thailand,38,21,17
2000,462,Maldives,Thailand,84,46,38
2000,144,Sri Lanka,Thailand,67,48,19
2000,156,China,Thailand,10942,5026,5916
2000,344,"China, Hong Kong SAR",Thailand,15845,2924,12921
2000,446,"China, Macao SAR",Thailand,974,234,740
2000,408,Dem. People's Republic of Korea,Thailand,368,148,220
2000,392,Japan,Thailand,29291,13531,15760
2000,410,Republic of Korea,Thailand,3640,2436,1204
2000,96,Brunei Darussalam,Thailand,13482,9510,3972
2000,116,Cambodia,Thailand,60844,29705,31139
2000,360,Indonesia,Thailand,471,325,146
2000,418,Lao People's Democratic Republic,Thailand,1648,979,669
2000,458,Malaysia,Thailand,34501,12999,21502
2000,608,Philippines,Thailand,120,64,56
2000,702,Singapore,Thailand,4921,1034,3887
2000,626,Timor-Leste,Thailand,143,58,85
2000,704,Viet Nam,Thailand,7145,4119,3026
2000,136,Cayman Islands,Thailand,56,50,6
2000,630,Puerto Rico,Thailand,39,19,20
2000,188,Costa Rica,Thailand,5,0,5
2000,484,Mexico,Thailand,64,24,40
2000,591,Panama,Thailand,4,2,2
2000,32,Argentina,Thailand,127,65,62
2000,68,Bolivia (Plurinational State of),Thailand,10,1,9
2000,152,Chile,Thailand,36,16,20
2000,604,Peru,Thailand,16,4,12
2000,862,Venezuela (Bolivarian Republic of),Thailand,60,32,28
2000,36,Australia,Thailand,23040,8523,14517
2000,554,New Zealand,Thailand,5014,2438,2576
2000,100,Bulgaria,Thailand,7,0,7
2000,203,Czechia,Thailand,16,5,11
2000,348,Hungary,Thailand,487,43,444
2000,616,Poland,Thailand,38,16,22
2000,643,Russian Federation,Thailand,80,39,41
2000,703,Slovakia,Thailand,40,3,37
2000,208,Denmark,Thailand,5596,1186,4410
2000,234,Faroe Islands,Thailand,17,2,15
2000,246,Finland,Thailand,1509,419,1090
2000,352,Iceland,Thailand,560,130,430
2000,372,Ireland,Thailand,624,188,436
2000,428,Latvia,Thailand,2,0,2
2000,578,Norway,Thailand,3584,688,2896
2000,752,Sweden,Thailand,10353,2646,7707
2000,826,United Kingdom,Thailand,15716,4388,11328
2000,300,Greece,Thailand,322,70,252
2000,380,Italy,Thailand,3842,114,3728
2000,470,Malta,Thailand,63,10,53
2000,620,Portugal,Thailand,63,14,49
2000,705,Slovenia,Thailand,15,3,12
2000,724,Spain,Thailand,572,185,387
2000,40,Austria,Thailand,3879,738,3141
2000,56,Belgium,Thailand,3782,806,2976
2000,250,France,Thailand,12851,4616,8235
2000,276,Germany,Thailand,36573,4182,32391
2000,438,Liechtenstein,Thailand,2,0,2
2000,442,Luxembourg,Thailand,153,14,139
2000,528,Netherlands,Thailand,5917,1506,4411
2000,756,Switzerland,Thailand,13518,3624,9894
2000,124,Canada,Thailand,8687,4191,4496
2000,304,Greenland,Thailand,35,15,20
2000,840,United States of America,Thailand,174112,62895,111217
2005,690,Seychelles,Thailand,341,96,245
2005,516,Namibia,Thailand,77,32,45
2005,710,South Africa,Thailand,484,109,375
2005,818,Egypt,Thailand,937,764,173
2005,434,Libya,Thailand,2311,1942,369
2005,48,Bahrain,Thailand,591,402,189
2005,196,Cyprus,Thailand,174,25,149
2005,400,Jordan,Thailand,181,119,62
2005,414,Kuwait,Thailand,1800,1188,612
2005,634,Qatar,Thailand,1725,1002,723
2005,792,Turkey,Thailand,140,71,69
2005,784,United Arab Emirates,Thailand,4842,3347,1495
2005,50,Bangladesh,Thailand,9181,4958,4223
2005,64,Bhutan,Thailand,48,26,22
2005,462,Maldives,Thailand,87,52,35
2005,144,Sri Lanka,Thailand,134,73,61
2005,156,China,Thailand,12071,6231,5840
2005,344,"China, Hong Kong SAR",Thailand,17299,2484,14815
2005,446,"China, Macao SAR",Thailand,1129,291,838
2005,408,Dem. People's Republic of Korea,Thailand,440,181,259
2005,392,Japan,Thailand,38934,17734,21200
2005,410,Republic of Korea,Thailand,12233,9268,2965
2005,96,Brunei Darussalam,Thailand,13782,9746,4036
2005,116,Cambodia,Thailand,47494,23855,23639
2005,360,Indonesia,Thailand,10085,5925,4160
2005,418,Lao People's Democratic Republic,Thailand,1538,930,608
2005,458,Malaysia,Thailand,19811,7721,12090
2005,608,Philippines,Thailand,97,53,44
2005,702,Singapore,Thailand,10010,1717,8293
2005,626,Timor-Leste,Thailand,152,61,91
2005,704,Viet Nam,Thailand,8148,4896,3252
2005,136,Cayman Islands,Thailand,51,46,5
2005,630,Puerto Rico,Thailand,30,15,15
2005,188,Costa Rica,Thailand,3,0,3
2005,484,Mexico,Thailand,85,31,54
2005,591,Panama,Thailand,61,54,7
2005,32,Argentina,Thailand,94,49,45
2005,68,Bolivia (Plurinational State of),Thailand,9,1,8
2005,152,Chile,Thailand,54,25,29
2005,604,Peru,Thailand,19,5,14
2005,862,Venezuela (Bolivarian Republic of),Thailand,62,33,29
2005,36,Australia,Thailand,31550,11103,20447
2005,554,New Zealand,Thailand,5890,2859,3031
2005,100,Bulgaria,Thailand,10,0,10
2005,203,Czechia,Thailand,279,21,258
2005,348,Hungary,Thailand,602,63,539
2005,616,Poland,Thailand,68,33,35
2005,643,Russian Federation,Thailand,148,71,77
2005,703,Slovakia,Thailand,45,4,41
2005,208,Denmark,Thailand,8184,1708,6476
2005,234,Faroe Islands,Thailand,47,6,41
2005,246,Finland,Thailand,4286,976,3310
2005,352,Iceland,Thailand,822,215,607
2005,372,Ireland,Thailand,626,215,411
2005,428,Latvia,Thailand,7,0,7
2005,578,Norway,Thailand,7275,1301,5974
2005,752,Sweden,Thailand,18277,4249,14028
2005,826,United Kingdom,Thailand,27817,7079,20738
2005,300,Greece,Thailand,354,56,298
2005,380,Italy,Thailand,6853,784,6069
2005,470,Malta,Thailand,75,13,62
2005,620,Portugal,Thailand,165,74,91
2005,705,Slovenia,Thailand,76,13,63
2005,724,Spain,Thailand,953,238,715
2005,40,Austria,Thailand,4336,741,3595
2005,56,Belgium,Thailand,5707,986,4721
2005,250,France,Thailand,14139,4882,9257
2005,276,Germany,Thailand,50231,7706,42525
2005,438,Liechtenstein,Thailand,40,9,31
2005,442,Luxembourg,Thailand,132,19,113
2005,528,Netherlands,Thailand,9763,2155,7608
2005,756,Switzerland,Thailand,15117,3497,11620
2005,124,Canada,Thailand,11281,4885,6396
2005,304,Greenland,Thailand,62,19,43
2005,840,United States of America,Thailand,195494,71310,124184
2010,690,Seychelles,Thailand,214,101,113
2010,516,Namibia,Thailand,74,31,43
2010,710,South Africa,Thailand,757,169,588
2010,466,Mali,Thailand,367,141,226
2010,818,Egypt,Thailand,1011,817,194
2010,434,Libya,Thailand,2528,2129,399
2010,48,Bahrain,Thailand,960,648,312
2010,196,Cyprus,Thailand,284,44,240
2010,400,Jordan,Thailand,233,157,76
2010,414,Kuwait,Thailand,2383,1553,830
2010,634,Qatar,Thailand,1916,1536,380
2010,792,Turkey,Thailand,144,72,72
2010,784,United Arab Emirates,Thailand,10763,7538,3225
2010,50,Bangladesh,Thailand,10259,5540,4719
2010,64,Bhutan,Thailand,58,31,27
2010,462,Maldives,Thailand,193,68,125
2010,144,Sri Lanka,Thailand,271,150,121
2010,156,China,Thailand,13201,7437,5764
2010,344,"China, Hong Kong SAR",Thailand,18795,2050,16745
2010,446,"China, Macao SAR",Thailand,1287,319,968
2010,408,Dem. People's Republic of Korea,Thailand,511,214,297
2010,392,Japan,Thailand,41279,18566,22713
2010,410,Republic of Korea,Thailand,25661,19579,6082
2010,96,Brunei Darussalam,Thailand,14083,9983,4100
2010,116,Cambodia,Thailand,34143,18004,16139
2010,360,Indonesia,Thailand,20346,11455,8891
2010,418,Lao People's Democratic Republic,Thailand,2415,1783,632
2010,458,Malaysia,Thailand,18929,8011,10918
2010,608,Philippines,Thailand,335,176,159
2010,702,Singapore,Thailand,15658,2485,13173
2010,626,Timor-Leste,Thailand,155,59,96
2010,704,Viet Nam,Thailand,9570,5596,3974
2010,136,Cayman Islands,Thailand,51,45,6
2010,630,Puerto Rico,Thailand,18,8,10
2010,188,Costa Rica,Thailand,7,0,7
2010,484,Mexico,Thailand,117,42,75
2010,591,Panama,Thailand,122,109,13
2010,32,Argentina,Thailand,60,33,27
2010,68,Bolivia (Plurinational State of),Thailand,8,2,6
2010,76,Brazil,Thailand,456,245,211
2010,152,Chile,Thailand,72,33,39
2010,604,Peru,Thailand,20,5,15
2010,862,Venezuela (Bolivarian Republic of),Thailand,66,35,31
2010,36,Australia,Thailand,51570,17732,33838
2010,554,New Zealand,Thailand,7012,3397,3615
2010,100,Bulgaria,Thailand,12,0,12
2010,203,Czechia,Thailand,515,47,468
2010,348,Hungary,Thailand,717,83,634
2010,616,Poland,Thailand,102,51,51
2010,643,Russian Federation,Thailand,213,100,113
2010,703,Slovakia,Thailand,50,5,45
2010,208,Denmark,Thailand,10581,2195,8386
2010,233,Estonia,Thailand,15,1,14
2010,234,Faroe Islands,Thailand,72,12,60
2010,246,Finland,Thailand,7940,1260,6680
2010,352,Iceland,Thailand,1082,301,781
2010,372,Ireland,Thailand,524,154,370
2010,428,Latvia,Thailand,13,1,12
2010,578,Norway,Thailand,13089,2477,10612
2010,752,Sweden,Thailand,31378,6908,24470
2010,826,United Kingdom,Thailand,29304,7906,21398
2010,300,Greece,Thailand,401,45,356
2010,380,Italy,Thailand,9476,1306,8170
2010,470,Malta,Thailand,87,15,72
2010,620,Portugal,Thailand,241,122,119
2010,705,Slovenia,Thailand,197,22,175
2010,724,Spain,Thailand,1630,434,1196
2010,40,Austria,Thailand,4792,744,4048
2010,56,Belgium,Thailand,7194,1554,5640
2010,250,France,Thailand,17044,5877,11167
2010,276,Germany,Thailand,61489,10756,50733
2010,438,Liechtenstein,Thailand,79,18,61
2010,442,Luxembourg,Thailand,114,25,89
2010,528,Netherlands,Thailand,12062,2645,9417
2010,756,Switzerland,Thailand,17860,3338,14522
2010,124,Canada,Thailand,13360,5406,7954
2010,304,Greenland,Thailand,126,49,77
2010,840,United States of America,Thailand,223435,79550,143885
2015,690,Seychelles,Thailand,239,120,119
2015,516,Namibia,Thailand,72,31,41
2015,710,South Africa,Thailand,1365,252,1113
2015,324,Guinea,Thailand,51,31,20
2015,466,Mali,Thailand,454,174,280
2015,818,Egypt,Thailand,749,624,125
2015,434,Libya,Thailand,2850,2394,456
2015,48,Bahrain,Thailand,1159,777,382
2015,196,Cyprus,Thailand,272,43,229
2015,400,Jordan,Thailand,100,61,39
2015,414,Kuwait,Thailand,3755,2267,1488
2015,634,Qatar,Thailand,2291,1867,424
2015,792,Turkey,Thailand,146,72,74
2015,784,United Arab Emirates,Thailand,11760,8097,3663
2015,50,Bangladesh,Thailand,10548,5696,4852
2015,64,Bhutan,Thailand,61,33,28
2015,462,Maldives,Thailand,299,83,216
2015,144,Sri Lanka,Thailand,275,150,125
2015,156,China,Thailand,15192,8862,6330
2015,344,"China, Hong Kong SAR",Thailand,19192,1425,17767
2015,446,"China, Macao SAR",Thailand,1519,386,1133
2015,408,Dem. People's Republic of Korea,Thailand,563,238,325
2015,392,Japan,Thailand,45379,20240,25139
2015,410,Republic of Korea,Thailand,31883,24151,7732
2015,96,Brunei Darussalam,Thailand,14384,10220,4164
2015,116,Cambodia,Thailand,30806,16541,14265
2015,360,Indonesia,Thailand,22525,12896,9629
2015,418,Lao People's Democratic Republic,Thailand,3293,2637,656
2015,458,Malaysia,Thailand,14901,6465,8436
2015,608,Philippines,Thailand,340,179,161
2015,702,Singapore,Thailand,19269,3018,16251
2015,626,Timor-Leste,Thailand,62,28,34
2015,704,Viet Nam,Thailand,11552,6708,4844
2015,136,Cayman Islands,Thailand,55,50,5
2015,630,Puerto Rico,Thailand,18,9,9
2015,188,Costa Rica,Thailand,7,0,7
2015,484,Mexico,Thailand,124,44,80
2015,591,Panama,Thailand,144,129,15
2015,32,Argentina,Thailand,60,33,27
2015,68,Bolivia (Plurinational State of),Thailand,9,2,7
2015,76,Brazil,Thailand,549,295,254
2015,152,Chile,Thailand,109,49,60
2015,604,Peru,Thailand,21,5,16
2015,862,Venezuela (Bolivarian Republic of),Thailand,70,36,34
2015,36,Australia,Thailand,66400,22105,44295
2015,554,New Zealand,Thailand,8023,3880,4143
2015,100,Bulgaria,Thailand,34,4,30
2015,203,Czechia,Thailand,864,79,785
2015,348,Hungary,Thailand,814,119,695
2015,616,Poland,Thailand,98,50,48
2015,643,Russian Federation,Thailand,217,102,115
2015,703,Slovakia,Thailand,71,12,59
2015,208,Denmark,Thailand,12889,2738,10151
2015,233,Estonia,Thailand,44,3,41
2015,234,Faroe Islands,Thailand,112,18,94
2015,246,Finland,Thailand,11485,1923,9562
2015,352,Iceland,Thailand,1196,312,884
2015,372,Ireland,Thailand,535,152,383
2015,428,Latvia,Thailand,8,3,5
2015,578,Norway,Thailand,18218,3426,14792
2015,752,Sweden,Thailand,38792,8443,30349
2015,826,United Kingdom,Thailand,37475,9299,28176
2015,300,Greece,Thailand,376,28,348
2015,380,Italy,Thailand,9864,1341,8523
2015,470,Malta,Thailand,148,34,114
2015,620,Portugal,Thailand,272,131,141
2015,705,Slovenia,Thailand,220,24,196
2015,724,Spain,Thailand,2084,520,1564
2015,40,Austria,Thailand,5604,896,4708
2015,56,Belgium,Thailand,8668,1886,6782
2015,250,France,Thailand,18881,6170,12711
2015,276,Germany,Thailand,64068,11082,52986
2015,438,Liechtenstein,Thailand,88,17,71
2015,442,Luxembourg,Thailand,173,40,133
2015,528,Netherlands,Thailand,13990,3105,10885
2015,756,Switzerland,Thailand,19471,3466,16005
2015,124,Canada,Thailand,14982,5372,9610
2015,304,Greenland,Thailand,151,58,93
2015,840,United States of America,Thailand,267938,94509,173429
2019,690,Seychelles,Thailand,241,121,120
2019,516,Namibia,Thailand,76,33,43
2019,710,South Africa,Thailand,1529,284,1245
2019,324,Guinea,Thailand,48,29,19
2019,466,Mali,Thailand,505,194,311
2019,818,Egypt,Thailand,1067,868,199
2019,434,Libya,Thailand,3023,2540,483
2019,48,Bahrain,Thailand,1219,817,402
2019,196,Cyprus,Thailand,271,45,226
2019,400,Jordan,Thailand,107,66,41
2019,414,Kuwait,Thailand,3976,2401,1575
2019,634,Qatar,Thailand,2336,1873,463
2019,792,Turkey,Thailand,197,98,99
2019,784,United Arab Emirates,Thailand,12630,8696,3934
2019,50,Bangladesh,Thailand,10687,3260,7427
2019,64,Bhutan,Thailand,63,34,29
2019,462,Maldives,Thailand,322,90,232
2019,144,Sri Lanka,Thailand,277,152,125
2019,156,China,Thailand,16012,9341,6671
2019,344,"China, Hong Kong SAR",Thailand,24865,1155,23710
2019,446,"China, Macao SAR",Thailand,1613,410,1203
2019,408,Dem. People's Republic of Korea,Thailand,573,242,331
2019,392,Japan,Thailand,49967,22287,27680
2019,410,Republic of Korea,Thailand,32456,24582,7874
2019,96,Brunei Darussalam,Thailand,15491,11007,4484
2019,116,Cambodia,Thailand,32758,17589,15169
2019,360,Indonesia,Thailand,23524,13468,10056
2019,418,Lao People's Democratic Republic,Thailand,3490,2795,695
2019,458,Malaysia,Thailand,15580,6824,8756
2019,608,Philippines,Thailand,350,184,166
2019,702,Singapore,Thailand,16329,2540,13789
2019,626,Timor-Leste,Thailand,61,28,33
2019,704,Viet Nam,Thailand,12077,7013,5064
2019,136,Cayman Islands,Thailand,60,55,5
2019,630,Puerto Rico,Thailand,17,9,8
2019,188,Costa Rica,Thailand,7,0,7
2019,484,Mexico,Thailand,127,45,82
2019,591,Panama,Thailand,151,137,14
2019,32,Argentina,Thailand,61,34,27
2019,68,Bolivia (Plurinational State of),Thailand,9,2,7
2019,76,Brazil,Thailand,618,332,286
2019,152,Chile,Thailand,145,61,84
2019,604,Peru,Thailand,24,7,17
2019,862,Venezuela (Bolivarian Republic of),Thailand,68,35,33
2019,36,Australia,Thailand,80831,26358,54473
2019,554,New Zealand,Thailand,8246,3988,4258
2019,100,Bulgaria,Thailand,56,9,47
2019,203,Czechia,Thailand,1149,100,1049
2019,348,Hungary,Thailand,988,149,839
2019,616,Poland,Thailand,103,55,48
2019,643,Russian Federation,Thailand,216,102,114
2019,703,Slovakia,Thailand,86,14,72
2019,208,Denmark,Thailand,14592,2961,11631
2019,233,Estonia,Thailand,61,14,47
2019,234,Faroe Islands,Thailand,136,24,112
2019,246,Finland,Thailand,13687,2296,11391
2019,352,Iceland,Thailand,1440,403,1037
2019,372,Ireland,Thailand,587,168,419
2019,428,Latvia,Thailand,18,5,13
2019,578,Norway,Thailand,21846,4025,17821
2019,752,Sweden,Thailand,43741,9376,34365
2019,826,United Kingdom,Thailand,42556,10641,31915
2019,300,Greece,Thailand,367,41,326
2019,380,Italy,Thailand,10885,1590,9295
2019,470,Malta,Thailand,238,56,182
2019,620,Portugal,Thailand,1487,1031,456
2019,705,Slovenia,Thailand,255,29,226
2019,724,Spain,Thailand,2159,500,1659
2019,40,Austria,Thailand,6615,1153,5462
2019,56,Belgium,Thailand,9746,2184,7562
2019,250,France,Thailand,19985,6500,13485
2019,276,Germany,Thailand,70280,11632,58648
2019,438,Liechtenstein,Thailand,87,15,72
2019,442,Luxembourg,Thailand,658,113,545
2019,528,Netherlands,Thailand,15584,3547,12037
2019,756,Switzerland,Thailand,20736,3832,16904
2019,124,Canada,Thailand,16054,5756,10298
2019,304,Greenland,Thailand,148,57,91
2019,840,United States of America,Thailand,289346,100043,189303
1990,132,Cabo Verde,Timor-Leste,11,6,5
1990,360,Indonesia,Timor-Leste,729,476,253
1990,608,Philippines,Timor-Leste,7,3,4
1990,36,Australia,Timor-Leste,9518,4868,4650
1990,372,Ireland,Timor-Leste,1,1,0
1990,826,United Kingdom,Timor-Leste,330,248,82
1990,380,Italy,Timor-Leste,10,3,7
1990,620,Portugal,Timor-Leste,654,315,339
1990,250,France,Timor-Leste,1,1,0
1995,132,Cabo Verde,Timor-Leste,14,8,6
1995,360,Indonesia,Timor-Leste,71378,35745,35633
1995,608,Philippines,Timor-Leste,9,4,5
1995,36,Australia,Timor-Leste,4904,2503,2401
1995,203,Czechia,Timor-Leste,1,1,0
1995,372,Ireland,Timor-Leste,2,1,1
1995,826,United Kingdom,Timor-Leste,1300,884,416
1995,300,Greece,Timor-Leste,3,2,1
1995,380,Italy,Timor-Leste,27,7,20
1995,620,Portugal,Timor-Leste,1411,678,733
1995,250,France,Timor-Leste,1,1,0
2000,132,Cabo Verde,Timor-Leste,17,10,7
2000,360,Indonesia,Timor-Leste,142028,71014,71014
2000,608,Philippines,Timor-Leste,1717,787,930
2000,203,Czechia,Timor-Leste,1,1,0
2000,372,Ireland,Timor-Leste,5,2,3
2000,826,United Kingdom,Timor-Leste,2293,1534,759
2000,300,Greece,Timor-Leste,6,3,3
2000,380,Italy,Timor-Leste,44,12,32
2000,620,Portugal,Timor-Leste,2227,1072,1155
2000,250,France,Timor-Leste,1,1,0
2005,132,Cabo Verde,Timor-Leste,13,8,5
2005,360,Indonesia,Timor-Leste,78666,41882,36784
2005,608,Philippines,Timor-Leste,1389,649,740
2005,36,Australia,Timor-Leste,10710,5347,5363
2005,203,Czechia,Timor-Leste,1,1,0
2005,372,Ireland,Timor-Leste,4,1,3
2005,752,Sweden,Timor-Leste,1,1,0
2005,826,United Kingdom,Timor-Leste,1960,1322,638
2005,300,Greece,Timor-Leste,114,50,64
2005,380,Italy,Timor-Leste,62,25,37
2005,620,Portugal,Timor-Leste,2040,966,1074
2005,250,France,Timor-Leste,6,6,0
2010,132,Cabo Verde,Timor-Leste,8,5,3
2010,360,Indonesia,Timor-Leste,20346,11455,8891
2010,608,Philippines,Timor-Leste,139,63,76
2010,76,Brazil,Timor-Leste,49,0,49
2010,36,Australia,Timor-Leste,10580,5240,5340
2010,203,Czechia,Timor-Leste,1,1,0
2010,372,Ireland,Timor-Leste,3,1,2
2010,752,Sweden,Timor-Leste,4,2,2
2010,826,United Kingdom,Timor-Leste,2064,1406,658
2010,300,Greece,Timor-Leste,230,100,130
2010,380,Italy,Timor-Leste,69,28,41
2010,620,Portugal,Timor-Leste,1516,702,814
2010,250,France,Timor-Leste,11,11,0
2015,132,Cabo Verde,Timor-Leste,8,5,3
2015,360,Indonesia,Timor-Leste,22525,12896,9629
2015,608,Philippines,Timor-Leste,141,64,77
2015,76,Brazil,Timor-Leste,59,0,59
2015,36,Australia,Timor-Leste,10000,5019,4981
2015,203,Czechia,Timor-Leste,1,1,0
2015,372,Ireland,Timor-Leste,3,1,2
2015,752,Sweden,Timor-Leste,4,2,2
2015,826,United Kingdom,Timor-Leste,2639,1773,866
2015,300,Greece,Timor-Leste,215,88,127
2015,380,Italy,Timor-Leste,99,44,55
2015,620,Portugal,Timor-Leste,1717,747,970
2015,250,France,Timor-Leste,12,12,0
2019,132,Cabo Verde,Timor-Leste,8,5,3
2019,360,Indonesia,Timor-Leste,23524,13468,10056
2019,608,Philippines,Timor-Leste,145,66,79
2019,76,Brazil,Timor-Leste,66,0,66
2019,36,Australia,Timor-Leste,10368,5182,5186
2019,203,Czechia,Timor-Leste,1,1,0
2019,372,Ireland,Timor-Leste,3,1,2
2019,752,Sweden,Timor-Leste,8,6,2
2019,826,United Kingdom,Timor-Leste,2996,2016,980
2019,300,Greece,Timor-Leste,209,90,119
2019,380,Italy,Timor-Leste,116,51,65
2019,620,Portugal,Timor-Leste,1746,762,984
2019,250,France,Timor-Leste,12,12,0
1990,800,Uganda,Togo,105,63,42
1990,140,Central African Republic,Togo,5,3,2
1990,178,Congo,Togo,747,338,409
1990,266,Gabon,Togo,7116,3526,3590
1990,204,Benin,Togo,16968,5790,11178
1990,854,Burkina Faso,Togo,6131,1803,4328
1990,384,Côte d'Ivoire,Togo,25298,14096,11202
1990,288,Ghana,Togo,61553,27448,34105
1990,324,Guinea,Togo,1468,954,514
1990,430,Liberia,Togo,250,147,103
1990,466,Mali,Togo,893,526,367
1990,478,Mauritania,Togo,104,27,77
1990,562,Niger,Togo,5521,2000,3521
1990,566,Nigeria,Togo,46886,26304,20582
1990,686,Senegal,Togo,1380,914,466
1990,694,Sierra Leone,Togo,43,29,14
1990,68,Bolivia (Plurinational State of),Togo,1,0,1
1990,152,Chile,Togo,3,1,2
1990,36,Australia,Togo,12,9,3
1990,203,Czechia,Togo,4,3,1
1990,348,Hungary,Togo,2,2,0
1990,208,Denmark,Togo,32,25,7
1990,246,Finland,Togo,3,3,0
1990,372,Ireland,Togo,22,13,9
1990,428,Latvia,Togo,1,1,0
1990,578,Norway,Togo,53,48,5
1990,752,Sweden,Togo,182,112,70
1990,826,United Kingdom,Togo,76,54,22
1990,300,Greece,Togo,11,6,5
1990,380,Italy,Togo,87,30,57
1990,620,Portugal,Togo,8,7,1
1990,724,Spain,Togo,41,32,9
1990,40,Austria,Togo,120,75,45
1990,56,Belgium,Togo,1610,1047,563
1990,250,France,Togo,14522,7919,6603
1990,276,Germany,Togo,1693,1334,359
1990,528,Netherlands,Togo,305,228,77
1990,756,Switzerland,Togo,454,265,189
1990,124,Canada,Togo,120,58,62
1995,800,Uganda,Togo,99,58,41
1995,140,Central African Republic,Togo,9,5,4
1995,178,Congo,Togo,863,368,495
1995,266,Gabon,Togo,9517,4712,4805
1995,204,Benin,Togo,23369,8170,15199
1995,854,Burkina Faso,Togo,7625,2252,5373
1995,384,Côte d'Ivoire,Togo,33605,18605,15000
1995,288,Ghana,Togo,144121,64743,79378
1995,324,Guinea,Togo,1692,1164,528
1995,430,Liberia,Togo,244,141,103
1995,466,Mali,Togo,934,551,383
1995,478,Mauritania,Togo,111,37,74
1995,562,Niger,Togo,7356,2448,4908
1995,566,Nigeria,Togo,52442,29233,23209
1995,686,Senegal,Togo,1443,953,490
1995,694,Sierra Leone,Togo,41,27,14
1995,68,Bolivia (Plurinational State of),Togo,2,0,2
1995,152,Chile,Togo,11,5,6
1995,36,Australia,Togo,6,5,1
1995,203,Czechia,Togo,6,4,2
1995,348,Hungary,Togo,4,3,1
1995,208,Denmark,Togo,66,50,16
1995,246,Finland,Togo,8,7,1
1995,352,Iceland,Togo,1,1,0
1995,372,Ireland,Togo,61,35,26
1995,428,Latvia,Togo,1,1,0
1995,578,Norway,Togo,39,31,8
1995,752,Sweden,Togo,216,132,84
1995,826,United Kingdom,Togo,300,186,114
1995,300,Greece,Togo,12,5,7
1995,380,Italy,Togo,741,374,367
1995,620,Portugal,Togo,18,15,3
1995,724,Spain,Togo,65,48,17
1995,40,Austria,Togo,136,86,50
1995,56,Belgium,Togo,1271,775,496
1995,250,France,Togo,14992,8061,6931
1995,276,Germany,Togo,6485,4557,1928
1995,528,Netherlands,Togo,449,333,116
1995,756,Switzerland,Togo,840,499,341
1995,124,Canada,Togo,426,205,221
2000,800,Uganda,Togo,4,4,0
2000,140,Central African Republic,Togo,13,7,6
2000,178,Congo,Togo,1211,496,715
2000,266,Gabon,Togo,11905,5938,5967
2000,204,Benin,Togo,29771,10551,19220
2000,854,Burkina Faso,Togo,10415,3541,6874
2000,384,Côte d'Ivoire,Togo,35017,19378,15639
2000,288,Ghana,Togo,72060,32371,39689
2000,324,Guinea,Togo,1833,1250,583
2000,430,Liberia,Togo,240,136,104
2000,466,Mali,Togo,856,506,350
2000,478,Mauritania,Togo,114,46,68
2000,562,Niger,Togo,9253,2916,6337
2000,566,Nigeria,Togo,60095,33284,26811
2000,686,Senegal,Togo,1308,844,464
2000,694,Sierra Leone,Togo,39,25,14
2000,68,Bolivia (Plurinational State of),Togo,2,0,2
2000,152,Chile,Togo,19,8,11
2000,36,Australia,Togo,20,10,10
2000,203,Czechia,Togo,8,5,3
2000,348,Hungary,Togo,6,4,2
2000,208,Denmark,Togo,99,74,25
2000,246,Finland,Togo,12,11,1
2000,352,Iceland,Togo,1,1,0
2000,372,Ireland,Togo,133,79,54
2000,428,Latvia,Togo,1,1,0
2000,578,Norway,Togo,63,39,24
2000,752,Sweden,Togo,232,141,91
2000,826,United Kingdom,Togo,530,320,210
2000,300,Greece,Togo,14,4,10
2000,380,Italy,Togo,1395,719,676
2000,620,Portugal,Togo,29,23,6
2000,724,Spain,Togo,119,87,32
2000,40,Austria,Togo,151,96,55
2000,56,Belgium,Togo,895,480,415
2000,250,France,Togo,15461,8202,7259
2000,276,Germany,Togo,11277,7780,3497
2000,528,Netherlands,Togo,609,448,161
2000,756,Switzerland,Togo,1230,735,495
2000,124,Canada,Togo,743,358,385
2005,800,Uganda,Togo,3,3,0
2005,140,Central African Republic,Togo,10,5,5
2005,178,Congo,Togo,770,423,347
2005,266,Gabon,Togo,12981,6539,6442
2005,204,Benin,Togo,57597,19811,37786
2005,854,Burkina Faso,Togo,13040,4720,8320
2005,384,Côte d'Ivoire,Togo,36658,20286,16372
2005,288,Ghana,Togo,86196,38722,47474
2005,324,Guinea,Togo,1354,984,370
2005,430,Liberia,Togo,227,167,60
2005,466,Mali,Togo,3493,2021,1472
2005,478,Mauritania,Togo,139,64,75
2005,562,Niger,Togo,9419,2962,6457
2005,566,Nigeria,Togo,119390,69518,49872
2005,686,Senegal,Togo,1405,924,481
2005,694,Sierra Leone,Togo,33,24,9
2005,68,Bolivia (Plurinational State of),Togo,2,1,1
2005,152,Chile,Togo,28,12,16
2005,36,Australia,Togo,30,15,15
2005,203,Czechia,Togo,11,7,4
2005,348,Hungary,Togo,7,5,2
2005,208,Denmark,Togo,121,82,39
2005,246,Finland,Togo,33,27,6
2005,352,Iceland,Togo,2,1,1
2005,372,Ireland,Togo,133,83,50
2005,578,Norway,Togo,67,38,29
2005,752,Sweden,Togo,253,146,107
2005,826,United Kingdom,Togo,1000,571,429
2005,300,Greece,Togo,14,7,7
2005,380,Italy,Togo,3273,2032,1241
2005,620,Portugal,Togo,51,38,13
2005,724,Spain,Togo,343,261,82
2005,40,Austria,Togo,169,106,63
2005,56,Belgium,Togo,1944,1140,804
2005,250,France,Togo,19915,10307,9608
2005,276,Germany,Togo,11436,7426,4010
2005,528,Netherlands,Togo,1283,903,380
2005,756,Switzerland,Togo,1395,804,591
2005,124,Canada,Togo,1563,885,678
2010,800,Uganda,Togo,3,3,0
2010,140,Central African Republic,Togo,10,5,5
2010,178,Congo,Togo,1834,889,945
2010,266,Gabon,Togo,15035,7715,7320
2010,204,Benin,Togo,85781,29280,56501
2010,854,Burkina Faso,Togo,14721,5285,9436
2010,384,Côte d'Ivoire,Togo,38299,21187,17112
2010,288,Ghana,Togo,73412,39133,34279
2010,324,Guinea,Togo,935,679,256
2010,430,Liberia,Togo,365,238,127
2010,466,Mali,Togo,3144,1761,1383
2010,478,Mauritania,Togo,162,79,83
2010,562,Niger,Togo,9572,3002,6570
2010,566,Nigeria,Togo,121778,70908,50870
2010,686,Senegal,Togo,1570,1055,515
2010,694,Sierra Leone,Togo,29,20,9
2010,764,Thailand,Togo,2,1,1
2010,68,Bolivia (Plurinational State of),Togo,1,1,0
2010,76,Brazil,Togo,9,9,0
2010,152,Chile,Togo,38,17,21
2010,36,Australia,Togo,280,145,135
2010,203,Czechia,Togo,13,8,5
2010,348,Hungary,Togo,8,7,1
2010,208,Denmark,Togo,139,88,51
2010,246,Finland,Togo,59,44,15
2010,352,Iceland,Togo,2,1,1
2010,372,Ireland,Togo,112,67,45
2010,578,Norway,Togo,95,51,44
2010,752,Sweden,Togo,309,184,125
2010,826,United Kingdom,Togo,1053,611,442
2010,300,Greece,Togo,14,11,3
2010,380,Italy,Togo,4859,3152,1707
2010,620,Portugal,Togo,66,47,19
2010,724,Spain,Togo,486,355,131
2010,40,Austria,Togo,187,116,71
2010,56,Belgium,Togo,3727,2202,1525
2010,250,France,Togo,22314,11604,10710
2010,276,Germany,Togo,11529,7103,4426
2010,528,Netherlands,Togo,1183,771,412
2010,756,Switzerland,Togo,1625,898,727
2010,124,Canada,Togo,2390,1416,974
2015,800,Uganda,Togo,3,3,0
2015,140,Central African Republic,Togo,9,5,4
2015,178,Congo,Togo,2437,1127,1310
2015,266,Gabon,Togo,21023,12218,8805
2015,204,Benin,Togo,105441,38103,67338
2015,854,Burkina Faso,Togo,15393,5526,9867
2015,384,Côte d'Ivoire,Togo,39940,22095,17845
2015,288,Ghana,Togo,90343,48147,42196
2015,324,Guinea,Togo,533,387,146
2015,430,Liberia,Togo,418,271,147
2015,466,Mali,Togo,3895,2182,1713
2015,478,Mauritania,Togo,144,69,75
2015,562,Niger,Togo,9702,3039,6663
2015,566,Nigeria,Togo,147698,81034,66664
2015,686,Senegal,Togo,1677,1127,550
2015,694,Sierra Leone,Togo,27,17,10
2015,764,Thailand,Togo,2,1,1
2015,68,Bolivia (Plurinational State of),Togo,1,1,0
2015,76,Brazil,Togo,11,11,0
2015,152,Chile,Togo,57,25,32
2015,36,Australia,Togo,370,193,177
2015,203,Czechia,Togo,14,10,4
2015,348,Hungary,Togo,11,6,5
2015,208,Denmark,Togo,154,98,56
2015,246,Finland,Togo,95,73,22
2015,352,Iceland,Togo,5,4,1
2015,372,Ireland,Togo,114,67,47
2015,578,Norway,Togo,116,63,53
2015,752,Sweden,Togo,363,210,153
2015,826,United Kingdom,Togo,1346,764,582
2015,300,Greece,Togo,11,6,5
2015,380,Italy,Togo,5104,3261,1843
2015,620,Portugal,Togo,74,52,22
2015,705,Slovenia,Togo,3,3,0
2015,724,Spain,Togo,508,345,163
2015,40,Austria,Togo,219,137,82
2015,56,Belgium,Togo,5502,3245,2257
2015,250,France,Togo,24718,12528,12190
2015,276,Germany,Togo,12013,7390,4623
2015,528,Netherlands,Togo,1180,727,453
2015,756,Switzerland,Togo,1968,1064,904
2015,124,Canada,Togo,3329,1903,1426
2019,800,Uganda,Togo,3,3,0
2019,140,Central African Republic,Togo,9,5,4
2019,178,Congo,Togo,2511,1160,1351
2019,266,Gabon,Togo,22842,13267,9575
2019,204,Benin,Togo,112300,40701,71599
2019,854,Burkina Faso,Togo,15874,5699,10175
2019,384,Côte d'Ivoire,Togo,41253,22822,18431
2019,288,Ghana,Togo,101677,54289,47388
2019,324,Guinea,Togo,508,369,139
2019,430,Liberia,Togo,346,224,122
2019,466,Mali,Togo,4337,2430,1907
2019,478,Mauritania,Togo,149,72,77
2019,562,Niger,Togo,10490,3286,7204
2019,566,Nigeria,Togo,154754,84905,69849
2019,686,Senegal,Togo,1742,1169,573
2019,694,Sierra Leone,Togo,24,14,10
2019,764,Thailand,Togo,2,1,1
2019,68,Bolivia (Plurinational State of),Togo,1,1,0
2019,76,Brazil,Togo,12,12,0
2019,152,Chile,Togo,76,31,45
2019,36,Australia,Togo,402,199,203
2019,203,Czechia,Togo,18,14,4
2019,348,Hungary,Togo,14,7,7
2019,208,Denmark,Togo,159,100,59
2019,246,Finland,Togo,119,97,22
2019,352,Iceland,Togo,9,7,2
2019,372,Ireland,Togo,125,74,51
2019,578,Norway,Togo,122,67,55
2019,752,Sweden,Togo,384,221,163
2019,826,United Kingdom,Togo,1528,869,659
2019,300,Greece,Togo,21,11,10
2019,380,Italy,Togo,5735,3775,1960
2019,620,Portugal,Togo,75,53,22
2019,705,Slovenia,Togo,1,1,0
2019,724,Spain,Togo,526,354,172
2019,40,Austria,Togo,258,163,95
2019,56,Belgium,Togo,6194,3585,2609
2019,250,France,Togo,26164,13232,12932
2019,276,Germany,Togo,13177,7744,5433
2019,528,Netherlands,Togo,1211,739,472
2019,756,Switzerland,Togo,2130,1149,981
2019,124,Canada,Togo,3567,2039,1528
1990,36,Australia,Tokelau,53,25,28
1990,554,New Zealand,Tokelau,1467,729,738
1990,16,American Samoa,Tokelau,30,15,15
1990,882,Samoa,Tokelau,131,66,65
1990,300,Greece,Tokelau,3,1,2
1995,36,Australia,Tokelau,181,90,91
1995,554,New Zealand,Tokelau,1465,729,736
1995,16,American Samoa,Tokelau,29,14,15
1995,882,Samoa,Tokelau,133,67,66
1995,300,Greece,Tokelau,2,0,2
2000,36,Australia,Tokelau,280,150,130
2000,554,New Zealand,Tokelau,1617,787,830
2000,16,American Samoa,Tokelau,27,13,14
2000,882,Samoa,Tokelau,135,67,68
2000,300,Greece,Tokelau,2,0,2
2005,36,Australia,Tokelau,420,225,195
2005,554,New Zealand,Tokelau,1517,737,780
2005,16,American Samoa,Tokelau,24,12,12
2005,882,Samoa,Tokelau,127,63,64
2005,100,Bulgaria,Tokelau,1,0,1
2005,300,Greece,Tokelau,1,0,1
2010,36,Australia,Tokelau,570,314,256
2010,554,New Zealand,Tokelau,1465,711,754
2010,16,American Samoa,Tokelau,21,11,10
2010,882,Samoa,Tokelau,111,54,57
2010,100,Bulgaria,Tokelau,1,0,1
2015,36,Australia,Tokelau,670,369,301
2015,554,New Zealand,Tokelau,1390,673,717
2015,16,American Samoa,Tokelau,20,10,10
2015,882,Samoa,Tokelau,91,44,47
2019,36,Australia,Tokelau,708,385,323
2019,554,New Zealand,Tokelau,1428,692,736
2019,16,American Samoa,Tokelau,20,10,10
2019,882,Samoa,Tokelau,86,42,44
1990,152,Chile,Tonga,1,1,0
1990,36,Australia,Tonga,6163,3077,3086
1990,554,New Zealand,Tonga,12834,6413,6421
1990,242,Fiji,Tonga,1221,651,570
1990,598,Papua New Guinea,Tonga,40,21,19
1990,548,Vanuatu,Tonga,24,14,10
1990,583,Micronesia (Fed. States of),Tonga,7,4,3
1990,16,American Samoa,Tonga,1304,706,598
1990,570,Niue,Tonga,48,29,19
1990,882,Samoa,Tonga,47,26,21
1990,203,Czechia,Tonga,2,1,1
1990,208,Denmark,Tonga,4,2,2
1990,752,Sweden,Tonga,15,4,11
1990,826,United Kingdom,Tonga,19,13,6
1990,380,Italy,Tonga,5,2,3
1990,40,Austria,Tonga,4,1,3
1990,250,France,Tonga,164,75,89
1990,124,Canada,Tonga,96,47,49
1990,840,United States of America,Tonga,10668,5110,5558
1995,68,Bolivia (Plurinational State of),Tonga,1,0,1
1995,152,Chile,Tonga,135,44,91
1995,36,Australia,Tonga,7354,3694,3660
1995,554,New Zealand,Tonga,13656,6669,6987
1995,242,Fiji,Tonga,1203,636,567
1995,598,Papua New Guinea,Tonga,40,20,20
1995,548,Vanuatu,Tonga,25,14,11
1995,583,Micronesia (Fed. States of),Tonga,8,3,5
1995,16,American Samoa,Tonga,1223,657,566
1995,570,Niue,Tonga,79,45,34
1995,882,Samoa,Tonga,72,39,33
1995,100,Bulgaria,Tonga,1,1,0
1995,203,Czechia,Tonga,3,1,2
1995,208,Denmark,Tonga,6,4,2
1995,246,Finland,Tonga,1,1,0
1995,352,Iceland,Tonga,1,1,0
1995,372,Ireland,Tonga,1,1,0
1995,752,Sweden,Tonga,18,5,13
1995,826,United Kingdom,Tonga,77,42,35
1995,380,Italy,Tonga,11,2,9
1995,40,Austria,Tonga,5,1,4
1995,250,France,Tonga,170,76,94
1995,124,Canada,Tonga,99,48,51
1995,840,United States of America,Tonga,14154,6855,7299
2000,68,Bolivia (Plurinational State of),Tonga,1,0,1
2000,152,Chile,Tonga,270,87,183
2000,36,Australia,Tonga,8090,4099,3991
2000,554,New Zealand,Tonga,17564,8538,9026
2000,242,Fiji,Tonga,1199,633,566
2000,598,Papua New Guinea,Tonga,29,13,16
2000,548,Vanuatu,Tonga,27,14,13
2000,583,Micronesia (Fed. States of),Tonga,9,4,5
2000,16,American Samoa,Tonga,1142,609,533
2000,570,Niue,Tonga,106,56,50
2000,882,Samoa,Tonga,97,51,46
2000,100,Bulgaria,Tonga,1,1,0
2000,203,Czechia,Tonga,4,1,3
2000,208,Denmark,Tonga,7,5,2
2000,246,Finland,Tonga,1,1,0
2000,352,Iceland,Tonga,1,1,0
2000,372,Ireland,Tonga,2,2,0
2000,752,Sweden,Tonga,20,5,15
2000,826,United Kingdom,Tonga,137,72,65
2000,380,Italy,Tonga,16,1,15
2000,40,Austria,Tonga,5,1,4
2000,250,France,Tonga,175,77,98
2000,124,Canada,Tonga,104,50,54
2000,840,United States of America,Tonga,17707,8645,9062
2005,68,Bolivia (Plurinational State of),Tonga,1,0,1
2005,152,Chile,Tonga,405,135,270
2005,36,Australia,Tonga,8720,4446,4274
2005,554,New Zealand,Tonga,19623,9525,10098
2005,242,Fiji,Tonga,1204,636,568
2005,598,Papua New Guinea,Tonga,33,19,14
2005,548,Vanuatu,Tonga,27,14,13
2005,583,Micronesia (Fed. States of),Tonga,14,7,7
2005,16,American Samoa,Tonga,1217,645,572
2005,570,Niue,Tonga,112,59,53
2005,882,Samoa,Tonga,91,48,43
2005,100,Bulgaria,Tonga,2,1,1
2005,203,Czechia,Tonga,2,0,2
2005,208,Denmark,Tonga,9,5,4
2005,246,Finland,Tonga,1,1,0
2005,352,Iceland,Tonga,1,1,0
2005,372,Ireland,Tonga,2,2,0
2005,752,Sweden,Tonga,24,6,18
2005,826,United Kingdom,Tonga,194,115,79
2005,380,Italy,Tonga,19,4,15
2005,40,Austria,Tonga,6,1,5
2005,250,France,Tonga,50,27,23
2005,124,Canada,Tonga,95,41,54
2005,840,United States of America,Tonga,16892,8295,8597
2010,152,Chile,Tonga,540,183,357
2010,36,Australia,Tonga,10060,5219,4841
2010,554,New Zealand,Tonga,21630,10481,11149
2010,242,Fiji,Tonga,1293,692,601
2010,598,Papua New Guinea,Tonga,27,16,11
2010,548,Vanuatu,Tonga,29,15,14
2010,583,Micronesia (Fed. States of),Tonga,15,8,7
2010,16,American Samoa,Tonga,1291,681,610
2010,570,Niue,Tonga,49,26,23
2010,882,Samoa,Tonga,80,41,39
2010,100,Bulgaria,Tonga,2,1,1
2010,203,Czechia,Tonga,3,0,3
2010,208,Denmark,Tonga,10,5,5
2010,233,Estonia,Tonga,1,1,0
2010,246,Finland,Tonga,1,1,0
2010,352,Iceland,Tonga,1,1,0
2010,372,Ireland,Tonga,1,1,0
2010,752,Sweden,Tonga,27,6,21
2010,826,United Kingdom,Tonga,204,123,81
2010,380,Italy,Tonga,23,7,16
2010,40,Austria,Tonga,6,1,5
2010,250,France,Tonga,90,39,51
2010,124,Canada,Tonga,90,34,56
2010,840,United States of America,Tonga,16576,8024,8552
2015,324,Guinea,Tonga,972,566,406
2015,152,Chile,Tonga,818,266,552
2015,36,Australia,Tonga,11880,6398,5482
2015,554,New Zealand,Tonga,23291,11263,12028
2015,242,Fiji,Tonga,1332,720,612
2015,598,Papua New Guinea,Tonga,27,17,10
2015,548,Vanuatu,Tonga,29,15,14
2015,583,Micronesia (Fed. States of),Tonga,18,9,9
2015,16,American Samoa,Tonga,1288,675,613
2015,570,Niue,Tonga,48,26,22
2015,882,Samoa,Tonga,65,33,32
2015,100,Bulgaria,Tonga,1,0,1
2015,203,Czechia,Tonga,4,0,4
2015,208,Denmark,Tonga,17,9,8
2015,233,Estonia,Tonga,1,1,0
2015,246,Finland,Tonga,2,2,0
2015,352,Iceland,Tonga,1,1,0
2015,372,Ireland,Tonga,1,1,0
2015,752,Sweden,Tonga,31,8,23
2015,826,United Kingdom,Tonga,260,154,106
2015,380,Italy,Tonga,18,7,11
2015,40,Austria,Tonga,7,2,5
2015,250,France,Tonga,99,41,58
2015,124,Canada,Tonga,139,55,84
2015,840,United States of America,Tonga,19652,9463,10189
2019,324,Guinea,Tonga,927,540,387
2019,152,Chile,Tonga,1092,314,778
2019,36,Australia,Tonga,13002,6957,6045
2019,554,New Zealand,Tonga,23940,11577,12363
2019,242,Fiji,Tonga,1359,735,624
2019,598,Papua New Guinea,Tonga,27,17,10
2019,548,Vanuatu,Tonga,29,15,14
2019,583,Micronesia (Fed. States of),Tonga,18,9,9
2019,16,American Samoa,Tonga,1289,676,613
2019,570,Niue,Tonga,48,26,22
2019,882,Samoa,Tonga,61,31,30
2019,100,Bulgaria,Tonga,1,0,1
2019,203,Czechia,Tonga,6,0,6
2019,208,Denmark,Tonga,21,13,8
2019,246,Finland,Tonga,2,2,0
2019,352,Iceland,Tonga,1,1,0
2019,372,Ireland,Tonga,1,1,0
2019,752,Sweden,Tonga,32,9,23
2019,826,United Kingdom,Tonga,295,175,120
2019,380,Italy,Tonga,20,7,13
2019,40,Austria,Tonga,8,3,5
2019,250,France,Tonga,104,43,61
2019,124,Canada,Tonga,148,58,90
2019,840,United States of America,Tonga,21221,10100,11121
1990,710,South Africa,Trinidad and Tobago,26,15,11
1990,196,Cyprus,Trinidad and Tobago,4,1,3
1990,28,Antigua and Barbuda,Trinidad and Tobago,356,171,185
1990,44,Bahamas,Trinidad and Tobago,278,133,145
1990,52,Barbados,Trinidad and Tobago,1750,673,1077
1990,92,British Virgin Islands,Trinidad and Tobago,206,133,73
1990,535,"Bonaire, Sint Eustatius and Saba",Trinidad and Tobago,23,10,13
1990,136,Cayman Islands,Trinidad and Tobago,112,59,53
1990,212,Dominica,Trinidad and Tobago,111,65,46
1990,214,Dominican Republic,Trinidad and Tobago,100,54,46
1990,308,Grenada,Trinidad and Tobago,1647,813,834
1990,388,Jamaica,Trinidad and Tobago,1775,863,912
1990,500,Montserrat,Trinidad and Tobago,66,39,27
1990,630,Puerto Rico,Trinidad and Tobago,337,160,177
1990,659,Saint Kitts and Nevis,Trinidad and Tobago,115,69,46
1990,662,Saint Lucia,Trinidad and Tobago,325,153,172
1990,670,Saint Vincent and the Grenadines,Trinidad and Tobago,837,411,426
1990,850,United States Virgin Islands,Trinidad and Tobago,2475,1167,1308
1990,188,Costa Rica,Trinidad and Tobago,26,11,15
1990,484,Mexico,Trinidad and Tobago,32,20,12
1990,591,Panama,Trinidad and Tobago,64,35,29
1990,32,Argentina,Trinidad and Tobago,75,48,27
1990,68,Bolivia (Plurinational State of),Trinidad and Tobago,4,2,2
1990,152,Chile,Trinidad and Tobago,6,1,5
1990,170,Colombia,Trinidad and Tobago,52,21,31
1990,218,Ecuador,Trinidad and Tobago,15,6,9
1990,328,Guyana,Trinidad and Tobago,189,103,86
1990,862,Venezuela (Bolivarian Republic of),Trinidad and Tobago,3611,1710,1901
1990,36,Australia,Trinidad and Tobago,920,446,474
1990,208,Denmark,Trinidad and Tobago,100,49,51
1990,246,Finland,Trinidad and Tobago,7,2,5
1990,352,Iceland,Trinidad and Tobago,1,0,1
1990,372,Ireland,Trinidad and Tobago,22,9,13
1990,578,Norway,Trinidad and Tobago,221,109,112
1990,752,Sweden,Trinidad and Tobago,183,80,103
1990,826,United Kingdom,Trinidad and Tobago,17191,6975,10216
1990,300,Greece,Trinidad and Tobago,9,4,5
1990,380,Italy,Trinidad and Tobago,21,7,14
1990,470,Malta,Trinidad and Tobago,9,2,7
1990,724,Spain,Trinidad and Tobago,13,5,8
1990,40,Austria,Trinidad and Tobago,38,15,23
1990,250,France,Trinidad and Tobago,269,83,186
1990,276,Germany,Trinidad and Tobago,354,154,200
1990,528,Netherlands,Trinidad and Tobago,225,93,132
1990,756,Switzerland,Trinidad and Tobago,191,85,106
1990,60,Bermuda,Trinidad and Tobago,34,18,16
1990,124,Canada,Trinidad and Tobago,47386,23069,24317
1990,840,United States of America,Trinidad and Tobago,115710,49452,66258
1995,710,South Africa,Trinidad and Tobago,16,9,7
1995,196,Cyprus,Trinidad and Tobago,6,1,5
1995,28,Antigua and Barbuda,Trinidad and Tobago,474,229,245
1995,44,Bahamas,Trinidad and Tobago,299,144,155
1995,52,Barbados,Trinidad and Tobago,1910,753,1157
1995,92,British Virgin Islands,Trinidad and Tobago,243,155,88
1995,535,"Bonaire, Sint Eustatius and Saba",Trinidad and Tobago,48,22,26
1995,136,Cayman Islands,Trinidad and Tobago,211,112,99
1995,212,Dominica,Trinidad and Tobago,147,86,61
1995,214,Dominican Republic,Trinidad and Tobago,111,58,53
1995,308,Grenada,Trinidad and Tobago,1813,731,1082
1995,388,Jamaica,Trinidad and Tobago,2126,1035,1091
1995,500,Montserrat,Trinidad and Tobago,52,31,21
1995,630,Puerto Rico,Trinidad and Tobago,357,170,187
1995,659,Saint Kitts and Nevis,Trinidad and Tobago,152,88,64
1995,662,Saint Lucia,Trinidad and Tobago,438,208,230
1995,670,Saint Vincent and the Grenadines,Trinidad and Tobago,871,428,443
1995,850,United States Virgin Islands,Trinidad and Tobago,2300,1085,1215
1995,188,Costa Rica,Trinidad and Tobago,21,8,13
1995,484,Mexico,Trinidad and Tobago,35,22,13
1995,591,Panama,Trinidad and Tobago,53,30,23
1995,32,Argentina,Trinidad and Tobago,73,47,26
1995,68,Bolivia (Plurinational State of),Trinidad and Tobago,9,3,6
1995,152,Chile,Trinidad and Tobago,8,5,3
1995,170,Colombia,Trinidad and Tobago,46,20,26
1995,218,Ecuador,Trinidad and Tobago,17,7,10
1995,328,Guyana,Trinidad and Tobago,310,169,141
1995,862,Venezuela (Bolivarian Republic of),Trinidad and Tobago,3174,1504,1670
1995,36,Australia,Trinidad and Tobago,1205,594,611
1995,203,Czechia,Trinidad and Tobago,1,1,0
1995,348,Hungary,Trinidad and Tobago,5,2,3
1995,208,Denmark,Trinidad and Tobago,126,58,68
1995,246,Finland,Trinidad and Tobago,10,4,6
1995,352,Iceland,Trinidad and Tobago,2,0,2
1995,372,Ireland,Trinidad and Tobago,60,22,38
1995,578,Norway,Trinidad and Tobago,223,107,116
1995,752,Sweden,Trinidad and Tobago,218,95,123
1995,826,United Kingdom,Trinidad and Tobago,18728,7410,11318
1995,300,Greece,Trinidad and Tobago,9,3,6
1995,380,Italy,Trinidad and Tobago,52,12,40
1995,470,Malta,Trinidad and Tobago,11,2,9
1995,724,Spain,Trinidad and Tobago,21,8,13
1995,40,Austria,Trinidad and Tobago,43,17,26
1995,250,France,Trinidad and Tobago,278,83,195
1995,276,Germany,Trinidad and Tobago,404,160,244
1995,528,Netherlands,Trinidad and Tobago,331,132,199
1995,756,Switzerland,Trinidad and Tobago,210,97,113
1995,60,Bermuda,Trinidad and Tobago,41,21,20
1995,124,Canada,Trinidad and Tobago,55297,26776,28521
1995,840,United States of America,Trinidad and Tobago,158649,67051,91598
2000,710,South Africa,Trinidad and Tobago,11,5,6
2000,196,Cyprus,Trinidad and Tobago,7,1,6
2000,28,Antigua and Barbuda,Trinidad and Tobago,591,286,305
2000,44,Bahamas,Trinidad and Tobago,321,156,165
2000,52,Barbados,Trinidad and Tobago,2070,834,1236
2000,92,British Virgin Islands,Trinidad and Tobago,279,176,103
2000,535,"Bonaire, Sint Eustatius and Saba",Trinidad and Tobago,74,34,40
2000,136,Cayman Islands,Trinidad and Tobago,363,191,172
2000,212,Dominica,Trinidad and Tobago,175,103,72
2000,214,Dominican Republic,Trinidad and Tobago,122,63,59
2000,308,Grenada,Trinidad and Tobago,1980,649,1331
2000,388,Jamaica,Trinidad and Tobago,2476,1207,1269
2000,500,Montserrat,Trinidad and Tobago,39,23,16
2000,630,Puerto Rico,Trinidad and Tobago,378,179,199
2000,659,Saint Kitts and Nevis,Trinidad and Tobago,210,119,91
2000,662,Saint Lucia,Trinidad and Tobago,602,289,313
2000,670,Saint Vincent and the Grenadines,Trinidad and Tobago,907,447,460
2000,850,United States Virgin Islands,Trinidad and Tobago,2130,1004,1126
2000,188,Costa Rica,Trinidad and Tobago,27,9,18
2000,484,Mexico,Trinidad and Tobago,41,25,16
2000,591,Panama,Trinidad and Tobago,46,26,20
2000,32,Argentina,Trinidad and Tobago,71,46,25
2000,68,Bolivia (Plurinational State of),Trinidad and Tobago,14,4,10
2000,152,Chile,Trinidad and Tobago,10,6,4
2000,170,Colombia,Trinidad and Tobago,39,19,20
2000,218,Ecuador,Trinidad and Tobago,19,8,11
2000,328,Guyana,Trinidad and Tobago,430,235,195
2000,862,Venezuela (Bolivarian Republic of),Trinidad and Tobago,2765,1309,1456
2000,36,Australia,Trinidad and Tobago,1410,703,707
2000,203,Czechia,Trinidad and Tobago,1,1,0
2000,348,Hungary,Trinidad and Tobago,9,3,6
2000,208,Denmark,Trinidad and Tobago,151,66,85
2000,246,Finland,Trinidad and Tobago,13,7,6
2000,352,Iceland,Trinidad and Tobago,3,1,2
2000,372,Ireland,Trinidad and Tobago,131,49,82
2000,578,Norway,Trinidad and Tobago,265,126,139
2000,752,Sweden,Trinidad and Tobago,234,101,133
2000,826,United Kingdom,Trinidad and Tobago,20581,7941,12640
2000,300,Greece,Trinidad and Tobago,10,3,7
2000,380,Italy,Trinidad and Tobago,82,16,66
2000,470,Malta,Trinidad and Tobago,13,3,10
2000,724,Spain,Trinidad and Tobago,253,104,149
2000,40,Austria,Trinidad and Tobago,48,19,29
2000,250,France,Trinidad and Tobago,286,82,204
2000,276,Germany,Trinidad and Tobago,454,167,287
2000,528,Netherlands,Trinidad and Tobago,450,176,274
2000,756,Switzerland,Trinidad and Tobago,231,109,122
2000,60,Bermuda,Trinidad and Tobago,47,24,23
2000,124,Canada,Trinidad and Tobago,64523,31126,33397
2000,840,United States of America,Trinidad and Tobago,202410,85126,117284
2005,710,South Africa,Trinidad and Tobago,14,7,7
2005,196,Cyprus,Trinidad and Tobago,10,1,9
2005,28,Antigua and Barbuda,Trinidad and Tobago,634,306,328
2005,44,Bahamas,Trinidad and Tobago,341,162,179
2005,52,Barbados,Trinidad and Tobago,1740,675,1065
2005,92,British Virgin Islands,Trinidad and Tobago,320,202,118
2005,535,"Bonaire, Sint Eustatius and Saba",Trinidad and Tobago,78,36,42
2005,136,Cayman Islands,Trinidad and Tobago,312,158,154
2005,212,Dominica,Trinidad and Tobago,215,127,88
2005,214,Dominican Republic,Trinidad and Tobago,72,38,34
2005,308,Grenada,Trinidad and Tobago,2075,685,1390
2005,388,Jamaica,Trinidad and Tobago,2413,1184,1229
2005,500,Montserrat,Trinidad and Tobago,40,24,16
2005,630,Puerto Rico,Trinidad and Tobago,295,140,155
2005,659,Saint Kitts and Nevis,Trinidad and Tobago,239,136,103
2005,662,Saint Lucia,Trinidad and Tobago,598,283,315
2005,670,Saint Vincent and the Grenadines,Trinidad and Tobago,935,466,469
2005,534,Sint Maarten (Dutch part),Trinidad and Tobago,100,36,64
2005,850,United States Virgin Islands,Trinidad and Tobago,1943,922,1021
2005,188,Costa Rica,Trinidad and Tobago,17,5,12
2005,484,Mexico,Trinidad and Tobago,32,19,13
2005,591,Panama,Trinidad and Tobago,71,39,32
2005,32,Argentina,Trinidad and Tobago,53,35,18
2005,68,Bolivia (Plurinational State of),Trinidad and Tobago,9,3,6
2005,152,Chile,Trinidad and Tobago,15,10,5
2005,170,Colombia,Trinidad and Tobago,34,17,17
2005,218,Ecuador,Trinidad and Tobago,22,9,13
2005,328,Guyana,Trinidad and Tobago,591,326,265
2005,862,Venezuela (Bolivarian Republic of),Trinidad and Tobago,2746,1302,1444
2005,36,Australia,Trinidad and Tobago,1560,791,769
2005,203,Czechia,Trinidad and Tobago,3,2,1
2005,348,Hungary,Trinidad and Tobago,12,5,7
2005,208,Denmark,Trinidad and Tobago,157,69,88
2005,246,Finland,Trinidad and Tobago,20,10,10
2005,352,Iceland,Trinidad and Tobago,3,1,2
2005,372,Ireland,Trinidad and Tobago,131,54,77
2005,428,Latvia,Trinidad and Tobago,1,1,0
2005,578,Norway,Trinidad and Tobago,299,135,164
2005,752,Sweden,Trinidad and Tobago,252,113,139
2005,826,United Kingdom,Trinidad and Tobago,20735,7947,12788
2005,300,Greece,Trinidad and Tobago,14,3,11
2005,380,Italy,Trinidad and Tobago,125,31,94
2005,470,Malta,Trinidad and Tobago,17,3,14
2005,724,Spain,Trinidad and Tobago,122,49,73
2005,40,Austria,Trinidad and Tobago,54,21,33
2005,250,France,Trinidad and Tobago,417,144,273
2005,276,Germany,Trinidad and Tobago,611,232,379
2005,528,Netherlands,Trinidad and Tobago,517,190,327
2005,756,Switzerland,Trinidad and Tobago,257,115,142
2005,60,Bermuda,Trinidad and Tobago,57,30,27
2005,124,Canada,Trinidad and Tobago,63760,29694,34066
2005,840,United States of America,Trinidad and Tobago,217856,92320,125536
2010,710,South Africa,Trinidad and Tobago,21,11,10
2010,196,Cyprus,Trinidad and Tobago,16,2,14
2010,28,Antigua and Barbuda,Trinidad and Tobago,677,327,350
2010,44,Bahamas,Trinidad and Tobago,360,167,193
2010,52,Barbados,Trinidad and Tobago,1419,519,900
2010,92,British Virgin Islands,Trinidad and Tobago,360,227,133
2010,535,"Bonaire, Sint Eustatius and Saba",Trinidad and Tobago,6,6,0
2010,136,Cayman Islands,Trinidad and Tobago,289,137,152
2010,531,Curaçao,Trinidad and Tobago,89,39,50
2010,212,Dominica,Trinidad and Tobago,262,156,106
2010,214,Dominican Republic,Trinidad and Tobago,22,13,9
2010,308,Grenada,Trinidad and Tobago,2170,720,1450
2010,388,Jamaica,Trinidad and Tobago,2349,1161,1188
2010,500,Montserrat,Trinidad and Tobago,42,26,16
2010,630,Puerto Rico,Trinidad and Tobago,176,83,93
2010,659,Saint Kitts and Nevis,Trinidad and Tobago,259,148,111
2010,662,Saint Lucia,Trinidad and Tobago,549,258,291
2010,670,Saint Vincent and the Grenadines,Trinidad and Tobago,966,491,475
2010,534,Sint Maarten (Dutch part),Trinidad and Tobago,200,71,129
2010,850,United States Virgin Islands,Trinidad and Tobago,1758,840,918
2010,188,Costa Rica,Trinidad and Tobago,34,10,24
2010,484,Mexico,Trinidad and Tobago,27,14,13
2010,591,Panama,Trinidad and Tobago,101,55,46
2010,32,Argentina,Trinidad and Tobago,34,23,11
2010,68,Bolivia (Plurinational State of),Trinidad and Tobago,4,2,2
2010,76,Brazil,Trinidad and Tobago,186,84,102
2010,152,Chile,Trinidad and Tobago,20,13,7
2010,170,Colombia,Trinidad and Tobago,35,19,16
2010,218,Ecuador,Trinidad and Tobago,31,13,18
2010,328,Guyana,Trinidad and Tobago,751,417,334
2010,862,Venezuela (Bolivarian Republic of),Trinidad and Tobago,2756,1310,1446
2010,36,Australia,Trinidad and Tobago,1690,851,839
2010,203,Czechia,Trinidad and Tobago,4,3,1
2010,348,Hungary,Trinidad and Tobago,14,6,8
2010,208,Denmark,Trinidad and Tobago,159,70,89
2010,233,Estonia,Trinidad and Tobago,2,0,2
2010,246,Finland,Trinidad and Tobago,33,15,18
2010,352,Iceland,Trinidad and Tobago,3,1,2
2010,372,Ireland,Trinidad and Tobago,109,39,70
2010,428,Latvia,Trinidad and Tobago,2,2,0
2010,578,Norway,Trinidad and Tobago,335,153,182
2010,752,Sweden,Trinidad and Tobago,293,135,158
2010,826,United Kingdom,Trinidad and Tobago,21843,8648,13195
2010,300,Greece,Trinidad and Tobago,18,4,14
2010,380,Italy,Trinidad and Tobago,186,46,140
2010,470,Malta,Trinidad and Tobago,10,5,5
2010,724,Spain,Trinidad and Tobago,182,70,112
2010,40,Austria,Trinidad and Tobago,59,23,36
2010,250,France,Trinidad and Tobago,385,103,282
2010,276,Germany,Trinidad and Tobago,741,287,454
2010,528,Netherlands,Trinidad and Tobago,524,194,330
2010,756,Switzerland,Trinidad and Tobago,306,126,180
2010,60,Bermuda,Trinidad and Tobago,67,36,31
2010,124,Canada,Trinidad and Tobago,67205,30307,36898
2010,840,United States of America,Trinidad and Tobago,240394,99965,140429
2015,710,South Africa,Trinidad and Tobago,36,19,17
2015,196,Cyprus,Trinidad and Tobago,15,2,13
2015,28,Antigua and Barbuda,Trinidad and Tobago,720,348,372
2015,44,Bahamas,Trinidad and Tobago,390,179,211
2015,52,Barbados,Trinidad and Tobago,1490,545,945
2015,92,British Virgin Islands,Trinidad and Tobago,403,254,149
2015,535,"Bonaire, Sint Eustatius and Saba",Trinidad and Tobago,6,6,0
2015,136,Cayman Islands,Trinidad and Tobago,314,149,165
2015,531,Curaçao,Trinidad and Tobago,96,42,54
2015,212,Dominica,Trinidad and Tobago,306,183,123
2015,214,Dominican Republic,Trinidad and Tobago,23,14,9
2015,308,Grenada,Trinidad and Tobago,2196,728,1468
2015,388,Jamaica,Trinidad and Tobago,2299,1137,1162
2015,500,Montserrat,Trinidad and Tobago,43,27,16
2015,630,Puerto Rico,Trinidad and Tobago,174,81,93
2015,659,Saint Kitts and Nevis,Trinidad and Tobago,266,153,113
2015,662,Saint Lucia,Trinidad and Tobago,526,247,279
2015,670,Saint Vincent and the Grenadines,Trinidad and Tobago,976,500,476
2015,534,Sint Maarten (Dutch part),Trinidad and Tobago,208,74,134
2015,850,United States Virgin Islands,Trinidad and Tobago,1759,841,918
2015,188,Costa Rica,Trinidad and Tobago,34,10,24
2015,484,Mexico,Trinidad and Tobago,28,15,13
2015,591,Panama,Trinidad and Tobago,119,65,54
2015,32,Argentina,Trinidad and Tobago,34,23,11
2015,68,Bolivia (Plurinational State of),Trinidad and Tobago,5,3,2
2015,76,Brazil,Trinidad and Tobago,224,101,123
2015,152,Chile,Trinidad and Tobago,30,20,10
2015,170,Colombia,Trinidad and Tobago,39,22,17
2015,218,Ecuador,Trinidad and Tobago,45,19,26
2015,328,Guyana,Trinidad and Tobago,880,488,392
2015,862,Venezuela (Bolivarian Republic of),Trinidad and Tobago,2808,1314,1494
2015,36,Australia,Trinidad and Tobago,1910,981,929
2015,203,Czechia,Trinidad and Tobago,6,5,1
2015,348,Hungary,Trinidad and Tobago,8,2,6
2015,208,Denmark,Trinidad and Tobago,173,71,102
2015,233,Estonia,Trinidad and Tobago,3,0,3
2015,246,Finland,Trinidad and Tobago,44,22,22
2015,352,Iceland,Trinidad and Tobago,3,1,2
2015,372,Ireland,Trinidad and Tobago,111,39,72
2015,428,Latvia,Trinidad and Tobago,1,0,1
2015,578,Norway,Trinidad and Tobago,348,152,196
2015,752,Sweden,Trinidad and Tobago,291,137,154
2015,826,United Kingdom,Trinidad and Tobago,27933,10559,17374
2015,300,Greece,Trinidad and Tobago,16,3,13
2015,380,Italy,Trinidad and Tobago,161,42,119
2015,470,Malta,Trinidad and Tobago,17,9,8
2015,724,Spain,Trinidad and Tobago,206,74,132
2015,40,Austria,Trinidad and Tobago,70,27,43
2015,250,France,Trinidad and Tobago,427,107,320
2015,276,Germany,Trinidad and Tobago,773,299,474
2015,528,Netherlands,Trinidad and Tobago,534,204,330
2015,756,Switzerland,Trinidad and Tobago,332,133,199
2015,60,Bermuda,Trinidad and Tobago,68,37,31
2015,124,Canada,Trinidad and Tobago,64636,29129,35507
2015,840,United States of America,Trinidad and Tobago,255967,105675,150292
2019,710,South Africa,Trinidad and Tobago,39,21,18
2019,196,Cyprus,Trinidad and Tobago,14,2,12
2019,28,Antigua and Barbuda,Trinidad and Tobago,748,362,386
2019,44,Bahamas,Trinidad and Tobago,414,190,224
2019,52,Barbados,Trinidad and Tobago,1504,550,954
2019,92,British Virgin Islands,Trinidad and Tobago,437,276,161
2019,535,"Bonaire, Sint Eustatius and Saba",Trinidad and Tobago,7,7,0
2019,136,Cayman Islands,Trinidad and Tobago,347,165,182
2019,531,Curaçao,Trinidad and Tobago,104,46,58
2019,212,Dominica,Trinidad and Tobago,312,187,125
2019,214,Dominican Republic,Trinidad and Tobago,23,14,9
2019,308,Grenada,Trinidad and Tobago,2216,735,1481
2019,388,Jamaica,Trinidad and Tobago,2328,1152,1176
2019,500,Montserrat,Trinidad and Tobago,43,27,16
2019,630,Puerto Rico,Trinidad and Tobago,165,77,88
2019,659,Saint Kitts and Nevis,Trinidad and Tobago,271,156,115
2019,662,Saint Lucia,Trinidad and Tobago,508,238,270
2019,670,Saint Vincent and the Grenadines,Trinidad and Tobago,996,517,479
2019,534,Sint Maarten (Dutch part),Trinidad and Tobago,215,77,138
2019,850,United States Virgin Islands,Trinidad and Tobago,1759,841,918
2019,188,Costa Rica,Trinidad and Tobago,34,10,24
2019,484,Mexico,Trinidad and Tobago,28,15,13
2019,591,Panama,Trinidad and Tobago,125,69,56
2019,32,Argentina,Trinidad and Tobago,34,23,11
2019,68,Bolivia (Plurinational State of),Trinidad and Tobago,5,3,2
2019,76,Brazil,Trinidad and Tobago,252,114,138
2019,152,Chile,Trinidad and Tobago,40,26,14
2019,170,Colombia,Trinidad and Tobago,39,22,17
2019,218,Ecuador,Trinidad and Tobago,44,19,25
2019,328,Guyana,Trinidad and Tobago,898,499,399
2019,862,Venezuela (Bolivarian Republic of),Trinidad and Tobago,2750,1281,1469
2019,36,Australia,Trinidad and Tobago,1978,979,999
2019,203,Czechia,Trinidad and Tobago,9,8,1
2019,348,Hungary,Trinidad and Tobago,12,6,6
2019,208,Denmark,Trinidad and Tobago,178,75,103
2019,233,Estonia,Trinidad and Tobago,3,0,3
2019,246,Finland,Trinidad and Tobago,59,28,31
2019,352,Iceland,Trinidad and Tobago,9,5,4
2019,372,Ireland,Trinidad and Tobago,121,43,78
2019,578,Norway,Trinidad and Tobago,371,160,211
2019,752,Sweden,Trinidad and Tobago,312,150,162
2019,826,United Kingdom,Trinidad and Tobago,31720,12040,19680
2019,300,Greece,Trinidad and Tobago,15,3,12
2019,380,Italy,Trinidad and Tobago,169,45,124
2019,470,Malta,Trinidad and Tobago,27,15,12
2019,724,Spain,Trinidad and Tobago,213,73,140
2019,40,Austria,Trinidad and Tobago,82,33,49
2019,250,France,Trinidad and Tobago,451,112,339
2019,276,Germany,Trinidad and Tobago,847,377,470
2019,528,Netherlands,Trinidad and Tobago,620,245,375
2019,756,Switzerland,Trinidad and Tobago,347,145,202
2019,60,Bermuda,Trinidad and Tobago,68,37,31
2019,124,Canada,Trinidad and Tobago,69264,31215,38049
2019,840,United States of America,Trinidad and Tobago,276440,112393,164047
1990,266,Gabon,Tunisia,69,38,31
1990,710,South Africa,Tunisia,111,45,66
1990,478,Mauritania,Tunisia,221,92,129
1990,818,Egypt,Tunisia,495,242,253
1990,434,Libya,Tunisia,1414,695,719
1990,504,Morocco,Tunisia,1763,933,830
1990,48,Bahrain,Tunisia,155,111,44
1990,196,Cyprus,Tunisia,9,6,3
1990,368,Iraq,Tunisia,241,205,36
1990,376,Israel,Tunisia,40293,19268,21025
1990,400,Jordan,Tunisia,221,105,116
1990,414,Kuwait,Tunisia,961,582,379
1990,634,Qatar,Tunisia,277,203,74
1990,275,State of Palestine,Tunisia,850,378,472
1990,792,Turkey,Tunisia,132,87,45
1990,784,United Arab Emirates,Tunisia,1175,837,338
1990,608,Philippines,Tunisia,17,9,8
1990,188,Costa Rica,Tunisia,3,1,2
1990,32,Argentina,Tunisia,99,65,34
1990,152,Chile,Tunisia,27,11,16
1990,862,Venezuela (Bolivarian Republic of),Tunisia,13,6,7
1990,36,Australia,Tunisia,411,235,176
1990,540,New Caledonia,Tunisia,546,308,238
1990,100,Bulgaria,Tunisia,18,17,1
1990,203,Czechia,Tunisia,39,33,6
1990,348,Hungary,Tunisia,34,29,5
1990,616,Poland,Tunisia,187,149,38
1990,642,Romania,Tunisia,2,1,1
1990,643,Russian Federation,Tunisia,607,298,309
1990,703,Slovakia,Tunisia,6,5,1
1990,208,Denmark,Tunisia,410,334,76
1990,234,Faroe Islands,Tunisia,9,8,1
1990,246,Finland,Tunisia,163,149,14
1990,352,Iceland,Tunisia,6,5,1
1990,372,Ireland,Tunisia,19,15,4
1990,578,Norway,Tunisia,375,322,53
1990,752,Sweden,Tunisia,2143,1491,652
1990,826,United Kingdom,Tunisia,2367,1440,927
1990,300,Greece,Tunisia,529,290,239
1990,380,Italy,Tunisia,70813,52414,18399
1990,470,Malta,Tunisia,161,90,71
1990,620,Portugal,Tunisia,15,10,5
1990,688,Serbia,Tunisia,4,3,1
1990,705,Slovenia,Tunisia,2,1,1
1990,724,Spain,Tunisia,574,367,207
1990,40,Austria,Tunisia,2033,1420,613
1990,56,Belgium,Tunisia,17755,11594,6161
1990,250,France,Tunisia,276216,160364,115852
1990,276,Germany,Tunisia,27234,17230,10004
1990,442,Luxembourg,Tunisia,114,84,30
1990,528,Netherlands,Tunisia,2632,1847,785
1990,756,Switzerland,Tunisia,5067,3520,1547
1990,124,Canada,Tunisia,2438,1187,1251
1990,840,United States of America,Tunisia,4101,2283,1818
1995,266,Gabon,Tunisia,93,52,41
1995,710,South Africa,Tunisia,69,32,37
1995,478,Mauritania,Tunisia,236,112,124
1995,818,Egypt,Tunisia,513,236,277
1995,434,Libya,Tunisia,1826,945,881
1995,504,Morocco,Tunisia,1618,844,774
1995,48,Bahrain,Tunisia,170,120,50
1995,196,Cyprus,Tunisia,13,8,5
1995,368,Iraq,Tunisia,284,231,53
1995,376,Israel,Tunisia,39320,18522,20798
1995,400,Jordan,Tunisia,269,133,136
1995,414,Kuwait,Tunisia,769,490,279
1995,634,Qatar,Tunisia,300,225,75
1995,275,State of Palestine,Tunisia,830,367,463
1995,792,Turkey,Tunisia,297,183,114
1995,784,United Arab Emirates,Tunisia,1505,1079,426
1995,608,Philippines,Tunisia,22,12,10
1995,188,Costa Rica,Tunisia,2,0,2
1995,32,Argentina,Tunisia,97,64,33
1995,68,Bolivia (Plurinational State of),Tunisia,1,1,0
1995,152,Chile,Tunisia,21,12,9
1995,862,Venezuela (Bolivarian Republic of),Tunisia,12,5,7
1995,36,Australia,Tunisia,469,270,199
1995,540,New Caledonia,Tunisia,633,353,280
1995,100,Bulgaria,Tunisia,30,24,6
1995,203,Czechia,Tunisia,58,49,9
1995,348,Hungary,Tunisia,82,69,13
1995,616,Poland,Tunisia,160,127,33
1995,642,Romania,Tunisia,3,2,1
1995,643,Russian Federation,Tunisia,526,312,214
1995,703,Slovakia,Tunisia,43,40,3
1995,208,Denmark,Tunisia,567,432,135
1995,234,Faroe Islands,Tunisia,2,2,0
1995,246,Finland,Tunisia,208,185,23
1995,352,Iceland,Tunisia,9,7,2
1995,372,Ireland,Tunisia,53,42,11
1995,578,Norway,Tunisia,447,381,66
1995,752,Sweden,Tunisia,2543,1763,780
1995,826,United Kingdom,Tunisia,2644,1664,980
1995,300,Greece,Tunisia,407,237,170
1995,380,Italy,Tunisia,73188,49825,23363
1995,470,Malta,Tunisia,188,106,82
1995,620,Portugal,Tunisia,32,21,11
1995,688,Serbia,Tunisia,30,23,7
1995,705,Slovenia,Tunisia,4,3,1
1995,724,Spain,Tunisia,718,471,247
1995,40,Austria,Tunisia,2294,1614,680
1995,56,Belgium,Tunisia,14184,9066,5118
1995,250,France,Tunisia,285233,163623,121610
1995,276,Germany,Tunisia,25283,16173,9110
1995,442,Luxembourg,Tunisia,115,80,35
1995,528,Netherlands,Tunisia,3118,2170,948
1995,756,Switzerland,Tunisia,6249,4333,1916
1995,124,Canada,Tunisia,3882,1878,2004
1995,840,United States of America,Tunisia,5285,2966,2319
2000,266,Gabon,Tunisia,116,65,51
2000,710,South Africa,Tunisia,48,26,22
2000,478,Mauritania,Tunisia,243,128,115
2000,818,Egypt,Tunisia,572,249,323
2000,434,Libya,Tunisia,2270,1233,1037
2000,504,Morocco,Tunisia,1704,876,828
2000,48,Bahrain,Tunisia,186,129,57
2000,196,Cyprus,Tunisia,16,10,6
2000,368,Iraq,Tunisia,269,206,63
2000,376,Israel,Tunisia,36146,16963,19183
2000,400,Jordan,Tunisia,316,161,155
2000,414,Kuwait,Tunisia,878,593,285
2000,634,Qatar,Tunisia,280,214,66
2000,275,State of Palestine,Tunisia,811,356,455
2000,792,Turkey,Tunisia,475,290,185
2000,784,United Arab Emirates,Tunisia,1922,1377,545
2000,608,Philippines,Tunisia,242,116,126
2000,188,Costa Rica,Tunisia,3,1,2
2000,32,Argentina,Tunisia,95,63,32
2000,68,Bolivia (Plurinational State of),Tunisia,1,1,0
2000,152,Chile,Tunisia,16,9,7
2000,862,Venezuela (Bolivarian Republic of),Tunisia,12,5,7
2000,36,Australia,Tunisia,500,289,211
2000,540,New Caledonia,Tunisia,720,398,322
2000,100,Bulgaria,Tunisia,41,31,10
2000,203,Czechia,Tunisia,77,65,12
2000,348,Hungary,Tunisia,129,108,21
2000,616,Poland,Tunisia,137,108,29
2000,642,Romania,Tunisia,4,3,1
2000,643,Russian Federation,Tunisia,426,314,112
2000,703,Slovakia,Tunisia,94,87,7
2000,208,Denmark,Tunisia,723,529,194
2000,234,Faroe Islands,Tunisia,3,3,0
2000,246,Finland,Tunisia,252,221,31
2000,352,Iceland,Tunisia,12,10,2
2000,372,Ireland,Tunisia,116,94,22
2000,578,Norway,Tunisia,530,429,101
2000,752,Sweden,Tunisia,2728,1886,842
2000,826,United Kingdom,Tunisia,2967,1913,1054
2000,300,Greece,Tunisia,291,184,107
2000,380,Italy,Tunisia,75563,47236,28327
2000,470,Malta,Tunisia,239,137,102
2000,620,Portugal,Tunisia,52,33,19
2000,688,Serbia,Tunisia,41,30,11
2000,705,Slovenia,Tunisia,9,7,2
2000,724,Spain,Tunisia,1172,785,387
2000,40,Austria,Tunisia,2554,1807,747
2000,56,Belgium,Tunisia,10205,6295,3910
2000,250,France,Tunisia,294250,166882,127368
2000,276,Germany,Tunisia,23332,15116,8216
2000,442,Luxembourg,Tunisia,118,77,41
2000,528,Netherlands,Tunisia,3712,2565,1147
2000,756,Switzerland,Tunisia,7454,5167,2287
2000,124,Canada,Tunisia,5418,2614,2804
2000,840,United States of America,Tunisia,6490,3664,2826
2005,266,Gabon,Tunisia,126,71,55
2005,710,South Africa,Tunisia,63,34,29
2005,478,Mauritania,Tunisia,245,134,111
2005,818,Egypt,Tunisia,681,320,361
2005,434,Libya,Tunisia,2501,1562,939
2005,504,Morocco,Tunisia,1748,886,862
2005,48,Bahrain,Tunisia,281,191,90
2005,196,Cyprus,Tunisia,24,15,9
2005,368,Iraq,Tunisia,308,256,52
2005,376,Israel,Tunisia,29309,13751,15558
2005,400,Jordan,Tunisia,455,257,198
2005,414,Kuwait,Tunisia,948,625,323
2005,634,Qatar,Tunisia,423,315,108
2005,275,State of Palestine,Tunisia,708,319,389
2005,792,Turkey,Tunisia,489,295,194
2005,784,United Arab Emirates,Tunisia,2303,1594,709
2005,608,Philippines,Tunisia,195,95,100
2005,188,Costa Rica,Tunisia,2,1,1
2005,32,Argentina,Tunisia,70,47,23
2005,68,Bolivia (Plurinational State of),Tunisia,1,1,0
2005,152,Chile,Tunisia,24,14,10
2005,862,Venezuela (Bolivarian Republic of),Tunisia,12,5,7
2005,36,Australia,Tunisia,540,327,213
2005,540,New Caledonia,Tunisia,767,425,342
2005,100,Bulgaria,Tunisia,60,45,15
2005,203,Czechia,Tunisia,330,301,29
2005,348,Hungary,Tunisia,159,134,25
2005,616,Poland,Tunisia,276,237,39
2005,642,Romania,Tunisia,4,4,0
2005,643,Russian Federation,Tunisia,381,289,92
2005,703,Slovakia,Tunisia,106,98,8
2005,208,Denmark,Tunisia,805,566,239
2005,234,Faroe Islands,Tunisia,7,6,1
2005,246,Finland,Tunisia,417,347,70
2005,352,Iceland,Tunisia,14,11,3
2005,372,Ireland,Tunisia,117,96,21
2005,428,Latvia,Tunisia,1,1,0
2005,578,Norway,Tunisia,650,486,164
2005,752,Sweden,Tunisia,3207,2163,1044
2005,826,United Kingdom,Tunisia,4251,2881,1370
2005,300,Greece,Tunisia,471,346,125
2005,380,Italy,Tunisia,91608,57593,34015
2005,470,Malta,Tunisia,281,162,119
2005,620,Portugal,Tunisia,94,70,24
2005,688,Serbia,Tunisia,41,30,11
2005,705,Slovenia,Tunisia,14,10,4
2005,724,Spain,Tunisia,1931,1355,576
2005,40,Austria,Tunisia,2855,2000,855
2005,56,Belgium,Tunisia,9504,5975,3529
2005,250,France,Tunisia,362087,196405,165682
2005,276,Germany,Tunisia,28888,19329,9559
2005,438,Liechtenstein,Tunisia,8,6,2
2005,442,Luxembourg,Tunisia,102,69,33
2005,528,Netherlands,Tunisia,4241,2807,1434
2005,756,Switzerland,Tunisia,8391,5679,2712
2005,124,Canada,Tunisia,8320,4882,3438
2005,840,United States of America,Tunisia,7375,3695,3680
2010,266,Gabon,Tunisia,146,83,63
2010,710,South Africa,Tunisia,98,53,45
2010,478,Mauritania,Tunisia,247,138,109
2010,818,Egypt,Tunisia,735,331,404
2010,434,Libya,Tunisia,2736,1720,1016
2010,504,Morocco,Tunisia,1956,986,970
2010,48,Bahrain,Tunisia,440,297,143
2010,196,Cyprus,Tunisia,39,25,14
2010,368,Iraq,Tunisia,311,262,49
2010,376,Israel,Tunisia,22828,10674,12154
2010,400,Jordan,Tunisia,585,344,241
2010,414,Kuwait,Tunisia,1256,818,438
2010,634,Qatar,Tunisia,910,730,180
2010,275,State of Palestine,Tunisia,606,282,324
2010,792,Turkey,Tunisia,505,300,205
2010,784,United Arab Emirates,Tunisia,4932,3455,1477
2010,608,Philippines,Tunisia,560,261,299
2010,188,Costa Rica,Tunisia,4,1,3
2010,32,Argentina,Tunisia,45,31,14
2010,68,Bolivia (Plurinational State of),Tunisia,1,1,0
2010,76,Brazil,Tunisia,79,67,12
2010,152,Chile,Tunisia,32,19,13
2010,862,Venezuela (Bolivarian Republic of),Tunisia,13,5,8
2010,36,Australia,Tunisia,570,336,234
2010,540,New Caledonia,Tunisia,814,452,362
2010,100,Bulgaria,Tunisia,76,56,20
2010,203,Czechia,Tunisia,550,507,43
2010,348,Hungary,Tunisia,189,160,29
2010,616,Poland,Tunisia,425,373,52
2010,642,Romania,Tunisia,8,4,4
2010,643,Russian Federation,Tunisia,329,258,71
2010,703,Slovakia,Tunisia,118,109,9
2010,208,Denmark,Tunisia,870,593,277
2010,233,Estonia,Tunisia,7,6,1
2010,234,Faroe Islands,Tunisia,6,4,2
2010,246,Finland,Tunisia,685,552,133
2010,352,Iceland,Tunisia,16,12,4
2010,372,Ireland,Tunisia,98,78,20
2010,428,Latvia,Tunisia,2,2,0
2010,578,Norway,Tunisia,859,597,262
2010,752,Sweden,Tunisia,4065,2670,1395
2010,826,United Kingdom,Tunisia,4478,3065,1413
2010,300,Greece,Tunisia,676,529,147
2010,380,Italy,Tunisia,112624,72153,40471
2010,470,Malta,Tunisia,263,151,112
2010,620,Portugal,Tunisia,121,96,25
2010,688,Serbia,Tunisia,41,30,11
2010,705,Slovenia,Tunisia,37,30,7
2010,724,Spain,Tunisia,2644,1810,834
2010,40,Austria,Tunisia,3155,2192,963
2010,56,Belgium,Tunisia,11460,7399,4061
2010,250,France,Tunisia,364914,203412,161502
2010,276,Germany,Tunisia,33439,22790,10649
2010,438,Liechtenstein,Tunisia,18,13,5
2010,442,Luxembourg,Tunisia,88,62,26
2010,528,Netherlands,Tunisia,4332,2803,1529
2010,756,Switzerland,Tunisia,9849,6492,3357
2010,124,Canada,Tunisia,10985,6985,4000
2010,840,United States of America,Tunisia,8511,4206,4305
2015,266,Gabon,Tunisia,204,128,76
2015,710,South Africa,Tunisia,175,91,84
2015,324,Guinea,Tunisia,533,297,236
2015,478,Mauritania,Tunisia,248,140,108
2015,818,Egypt,Tunisia,544,284,260
2015,434,Libya,Tunisia,3084,1923,1161
2015,504,Morocco,Tunisia,2549,1280,1269
2015,48,Bahrain,Tunisia,468,314,154
2015,196,Cyprus,Tunisia,37,24,13
2015,368,Iraq,Tunisia,312,270,42
2015,376,Israel,Tunisia,23543,10947,12596
2015,400,Jordan,Tunisia,251,125,126
2015,414,Kuwait,Tunisia,1784,1077,707
2015,634,Qatar,Tunisia,978,798,180
2015,275,State of Palestine,Tunisia,600,279,321
2015,792,Turkey,Tunisia,517,303,214
2015,784,United Arab Emirates,Tunisia,5389,3712,1677
2015,608,Philippines,Tunisia,568,265,303
2015,188,Costa Rica,Tunisia,4,1,3
2015,32,Argentina,Tunisia,45,31,14
2015,68,Bolivia (Plurinational State of),Tunisia,1,1,0
2015,76,Brazil,Tunisia,95,81,14
2015,152,Chile,Tunisia,48,29,19
2015,862,Venezuela (Bolivarian Republic of),Tunisia,14,6,8
2015,36,Australia,Tunisia,660,392,268
2015,540,New Caledonia,Tunisia,625,316,309
2015,100,Bulgaria,Tunisia,110,85,25
2015,203,Czechia,Tunisia,776,726,50
2015,348,Hungary,Tunisia,291,229,62
2015,616,Poland,Tunisia,409,360,49
2015,642,Romania,Tunisia,1062,737,325
2015,643,Russian Federation,Tunisia,335,262,73
2015,703,Slovakia,Tunisia,153,142,11
2015,208,Denmark,Tunisia,963,646,317
2015,233,Estonia,Tunisia,15,13,2
2015,234,Faroe Islands,Tunisia,11,8,3
2015,246,Finland,Tunisia,807,640,167
2015,352,Iceland,Tunisia,28,20,8
2015,372,Ireland,Tunisia,100,79,21
2015,428,Latvia,Tunisia,2,2,0
2015,578,Norway,Tunisia,1014,689,325
2015,752,Sweden,Tunisia,4996,3236,1760
2015,826,United Kingdom,Tunisia,5726,3866,1860
2015,300,Greece,Tunisia,634,491,143
2015,380,Italy,Tunisia,101717,63605,38112
2015,470,Malta,Tunisia,446,269,177
2015,620,Portugal,Tunisia,137,107,30
2015,688,Serbia,Tunisia,40,30,10
2015,705,Slovenia,Tunisia,53,45,8
2015,724,Spain,Tunisia,2734,1844,890
2015,40,Austria,Tunisia,3690,2570,1120
2015,56,Belgium,Tunisia,13996,8937,5059
2015,250,France,Tunisia,404246,220408,183838
2015,276,Germany,Tunisia,34842,23720,11122
2015,438,Liechtenstein,Tunisia,24,15,9
2015,442,Luxembourg,Tunisia,134,95,39
2015,528,Netherlands,Tunisia,4568,2936,1632
2015,756,Switzerland,Tunisia,11461,7374,4087
2015,124,Canada,Tunisia,17328,9806,7522
2015,840,United States of America,Tunisia,120883,59434,61449
2019,266,Gabon,Tunisia,221,140,81
2019,710,South Africa,Tunisia,195,102,93
2019,324,Guinea,Tunisia,508,283,225
2019,478,Mauritania,Tunisia,257,145,112
2019,818,Egypt,Tunisia,775,361,414
2019,434,Libya,Tunisia,3272,2041,1231
2019,504,Morocco,Tunisia,2718,1365,1353
2019,48,Bahrain,Tunisia,492,330,162
2019,196,Cyprus,Tunisia,36,24,12
2019,368,Iraq,Tunisia,319,276,43
2019,376,Israel,Tunisia,22894,10645,12249
2019,400,Jordan,Tunisia,269,134,135
2019,414,Kuwait,Tunisia,1889,1141,748
2019,634,Qatar,Tunisia,997,801,196
2019,275,State of Palestine,Tunisia,595,277,318
2019,792,Turkey,Tunisia,699,413,286
2019,784,United Arab Emirates,Tunisia,5788,3987,1801
2019,608,Philippines,Tunisia,585,273,312
2019,188,Costa Rica,Tunisia,4,1,3
2019,32,Argentina,Tunisia,45,31,14
2019,68,Bolivia (Plurinational State of),Tunisia,1,1,0
2019,76,Brazil,Tunisia,106,91,15
2019,152,Chile,Tunisia,64,38,26
2019,862,Venezuela (Bolivarian Republic of),Tunisia,13,6,7
2019,36,Australia,Tunisia,740,413,327
2019,540,New Caledonia,Tunisia,658,332,326
2019,100,Bulgaria,Tunisia,151,113,38
2019,203,Czechia,Tunisia,925,853,72
2019,348,Hungary,Tunisia,416,309,107
2019,616,Poland,Tunisia,433,384,49
2019,642,Romania,Tunisia,1784,1227,557
2019,643,Russian Federation,Tunisia,334,262,72
2019,703,Slovakia,Tunisia,178,165,13
2019,208,Denmark,Tunisia,1023,682,341
2019,233,Estonia,Tunisia,21,20,1
2019,234,Faroe Islands,Tunisia,15,11,4
2019,246,Finland,Tunisia,983,763,220
2019,352,Iceland,Tunisia,37,28,9
2019,372,Ireland,Tunisia,109,87,22
2019,428,Latvia,Tunisia,4,4,0
2019,578,Norway,Tunisia,1144,762,382
2019,752,Sweden,Tunisia,5881,3669,2212
2019,826,United Kingdom,Tunisia,6502,4396,2106
2019,300,Greece,Tunisia,619,485,134
2019,380,Italy,Tunisia,109387,68685,40702
2019,470,Malta,Tunisia,719,436,283
2019,620,Portugal,Tunisia,139,109,30
2019,688,Serbia,Tunisia,40,30,10
2019,705,Slovenia,Tunisia,69,58,11
2019,724,Spain,Tunisia,2832,1888,944
2019,40,Austria,Tunisia,4356,3057,1299
2019,56,Belgium,Tunisia,15682,9967,5715
2019,250,France,Tunisia,427897,232859,195038
2019,276,Germany,Tunisia,38220,26036,12184
2019,438,Liechtenstein,Tunisia,23,14,9
2019,442,Luxembourg,Tunisia,1004,686,318
2019,528,Netherlands,Tunisia,5001,3199,1802
2019,756,Switzerland,Tunisia,12457,7944,4513
2019,124,Canada,Tunisia,18568,10508,8060
2019,840,United States of America,Tunisia,130541,63470,67071
1990,140,Central African Republic,Turkey,6,1,5
1990,516,Namibia,Turkey,52,31,21
1990,710,South Africa,Turkey,792,484,308
1990,818,Egypt,Turkey,770,596,174
1990,434,Libya,Turkey,2197,1705,492
1990,51,Armenia,Turkey,1956,505,1451
1990,31,Azerbaijan,Turkey,2894,2094,800
1990,48,Bahrain,Turkey,1291,923,368
1990,196,Cyprus,Turkey,152,75,77
1990,268,Georgia,Turkey,455,210,245
1990,368,Iraq,Turkey,938,631,307
1990,376,Israel,Turkey,31449,15362,16087
1990,400,Jordan,Turkey,957,599,358
1990,414,Kuwait,Turkey,8007,4848,3159
1990,422,Lebanon,Turkey,437,273,164
1990,634,Qatar,Turkey,2308,1683,625
1990,784,United Arab Emirates,Turkey,9781,6963,2818
1990,398,Kazakhstan,Turkey,19692,9567,10125
1990,417,Kyrgyzstan,Turkey,833,368,465
1990,762,Tajikistan,Turkey,1175,516,659
1990,356,India,Turkey,343,163,180
1990,364,Iran (Islamic Republic of),Turkey,277,158,119
1990,496,Mongolia,Turkey,109,62,47
1990,608,Philippines,Turkey,202,111,91
1990,533,Aruba,Turkey,115,110,5
1990,214,Dominican Republic,Turkey,73,39,34
1990,630,Puerto Rico,Turkey,42,20,22
1990,188,Costa Rica,Turkey,6,4,2
1990,320,Guatemala,Turkey,16,3,13
1990,484,Mexico,Turkey,290,128,162
1990,591,Panama,Turkey,33,21,12
1990,32,Argentina,Turkey,2498,1108,1390
1990,68,Bolivia (Plurinational State of),Turkey,2,0,2
1990,76,Brazil,Turkey,1031,551,480
1990,152,Chile,Turkey,178,90,88
1990,170,Colombia,Turkey,73,30,43
1990,604,Peru,Turkey,32,21,11
1990,862,Venezuela (Bolivarian Republic of),Turkey,115,68,47
1990,36,Australia,Turkey,33246,17541,15705
1990,112,Belarus,Turkey,11,11,0
1990,100,Bulgaria,Turkey,743,469,274
1990,203,Czechia,Turkey,55,41,14
1990,348,Hungary,Turkey,385,171,214
1990,616,Poland,Turkey,641,414,227
1990,498,Republic of Moldova,Turkey,702,470,232
1990,642,Romania,Turkey,878,695,183
1990,643,Russian Federation,Turkey,13032,6395,6637
1990,703,Slovakia,Turkey,10,9,1
1990,804,Ukraine,Turkey,1637,1390,247
1990,208,Denmark,Turkey,19476,10525,8951
1990,246,Finland,Turkey,457,385,72
1990,352,Iceland,Turkey,18,11,7
1990,372,Ireland,Turkey,94,72,22
1990,428,Latvia,Turkey,12,9,3
1990,440,Lithuania,Turkey,40,31,9
1990,578,Norway,Turkey,4977,3076,1901
1990,752,Sweden,Turkey,25061,13287,11774
1990,826,United Kingdom,Turkey,25947,14729,11218
1990,8,Albania,Turkey,2489,1633,856
1990,300,Greece,Turkey,34502,17362,17140
1990,380,Italy,Turkey,7575,4083,3492
1990,470,Malta,Turkey,79,52,27
1990,807,North Macedonia,Turkey,11417,4760,6657
1990,620,Portugal,Turkey,31,22,9
1990,688,Serbia,Turkey,47,33,14
1990,705,Slovenia,Turkey,5,3,2
1990,724,Spain,Turkey,454,290,164
1990,40,Austria,Turkey,88108,46640,41468
1990,56,Belgium,Turkey,188809,95121,93688
1990,250,France,Turkey,241148,129178,111970
1990,276,Germany,Turkey,1586121,807841,778280
1990,438,Liechtenstein,Turkey,820,438,382
1990,442,Luxembourg,Turkey,194,104,90
1990,528,Netherlands,Turkey,140494,75989,64505
1990,756,Switzerland,Turkey,51936,28935,23001
1990,60,Bermuda,Turkey,26,15,11
1990,124,Canada,Turkey,11692,5692,6000
1990,840,United States of America,Turkey,55087,23987,31100
1995,140,Central African Republic,Turkey,8,1,7
1995,516,Namibia,Turkey,49,30,19
1995,710,South Africa,Turkey,551,350,201
1995,818,Egypt,Turkey,685,508,177
1995,434,Libya,Turkey,2014,1483,531
1995,51,Armenia,Turkey,2075,595,1480
1995,31,Azerbaijan,Turkey,2540,1881,659
1995,48,Bahrain,Turkey,1420,1000,420
1995,196,Cyprus,Turkey,215,101,114
1995,268,Georgia,Turkey,513,245,268
1995,368,Iraq,Turkey,17439,10300,7139
1995,376,Israel,Turkey,32492,15618,16874
1995,400,Jordan,Turkey,1101,764,337
1995,414,Kuwait,Turkey,6416,4088,2328
1995,422,Lebanon,Turkey,501,340,161
1995,634,Qatar,Turkey,2508,1870,638
1995,784,United Arab Emirates,Turkey,12534,8978,3556
1995,398,Kazakhstan,Turkey,27068,13414,13654
1995,417,Kyrgyzstan,Turkey,928,429,499
1995,762,Tajikistan,Turkey,955,495,460
1995,356,India,Turkey,236,112,124
1995,364,Iran (Islamic Republic of),Turkey,304,174,130
1995,144,Sri Lanka,Turkey,4,4,0
1995,496,Mongolia,Turkey,120,72,48
1995,608,Philippines,Turkey,271,147,124
1995,533,Aruba,Turkey,63,59,4
1995,214,Dominican Republic,Turkey,81,42,39
1995,630,Puerto Rico,Turkey,44,22,22
1995,188,Costa Rica,Turkey,5,3,2
1995,320,Guatemala,Turkey,16,4,12
1995,484,Mexico,Turkey,317,142,175
1995,591,Panama,Turkey,35,22,13
1995,32,Argentina,Turkey,1914,875,1039
1995,68,Bolivia (Plurinational State of),Turkey,8,4,4
1995,76,Brazil,Turkey,862,409,453
1995,152,Chile,Turkey,215,115,100
1995,170,Colombia,Turkey,62,28,34
1995,604,Peru,Turkey,33,21,12
1995,862,Venezuela (Bolivarian Republic of),Turkey,113,67,46
1995,36,Australia,Turkey,32718,17046,15672
1995,112,Belarus,Turkey,18,17,1
1995,100,Bulgaria,Turkey,1377,943,434
1995,203,Czechia,Turkey,82,61,21
1995,348,Hungary,Turkey,919,588,331
1995,616,Poland,Turkey,548,351,197
1995,498,Republic of Moldova,Turkey,474,313,161
1995,642,Romania,Turkey,1810,1473,337
1995,643,Russian Federation,Turkey,11200,6696,4504
1995,703,Slovakia,Turkey,92,76,16
1995,804,Ukraine,Turkey,1583,1351,232
1995,208,Denmark,Turkey,24783,13189,11594
1995,246,Finland,Turkey,1133,909,224
1995,352,Iceland,Turkey,27,17,10
1995,372,Ireland,Turkey,260,196,64
1995,428,Latvia,Turkey,18,14,4
1995,440,Lithuania,Turkey,45,34,11
1995,578,Norway,Turkey,5974,3381,2593
1995,752,Sweden,Turkey,29740,15662,14078
1995,826,United Kingdom,Turkey,38795,21671,17124
1995,8,Albania,Turkey,2690,1771,919
1995,300,Greece,Turkey,54741,24365,30376
1995,380,Italy,Turkey,8597,4609,3988
1995,470,Malta,Turkey,93,62,31
1995,807,North Macedonia,Turkey,13247,5556,7691
1995,620,Portugal,Turkey,66,46,20
1995,688,Serbia,Turkey,302,207,95
1995,705,Slovenia,Turkey,10,8,2
1995,724,Spain,Turkey,590,387,203
1995,40,Austria,Turkey,99359,53389,45970
1995,56,Belgium,Turkey,163108,82048,81060
1995,250,France,Turkey,248944,131409,117535
1995,276,Germany,Turkey,1617880,833541,784339
1995,438,Liechtenstein,Turkey,997,515,482
1995,442,Luxembourg,Turkey,184,95,89
1995,528,Netherlands,Turkey,155845,82963,72882
1995,756,Switzerland,Turkey,54615,31011,23604
1995,60,Bermuda,Turkey,43,37,6
1995,124,Canada,Turkey,14476,7008,7468
1995,840,United States of America,Turkey,67624,29814,37810
2000,140,Central African Republic,Turkey,10,2,8
2000,516,Namibia,Turkey,48,28,20
2000,710,South Africa,Turkey,475,315,160
2000,818,Egypt,Turkey,654,460,194
2000,434,Libya,Turkey,1865,1298,567
2000,51,Armenia,Turkey,2270,689,1581
2000,31,Azerbaijan,Turkey,2560,1886,674
2000,48,Bahrain,Turkey,1553,1073,480
2000,196,Cyprus,Turkey,278,128,150
2000,268,Georgia,Turkey,455,316,139
2000,368,Iraq,Turkey,13885,8201,5684
2000,376,Israel,Turkey,31716,15181,16535
2000,400,Jordan,Turkey,1245,931,314
2000,414,Kuwait,Turkey,7319,4943,2376
2000,422,Lebanon,Turkey,565,408,157
2000,634,Qatar,Turkey,2335,1781,554
2000,784,United Arab Emirates,Turkey,16050,11508,4542
2000,398,Kazakhstan,Turkey,34443,17261,17182
2000,417,Kyrgyzstan,Turkey,993,474,519
2000,762,Tajikistan,Turkey,822,436,386
2000,356,India,Turkey,129,61,68
2000,364,Iran (Islamic Republic of),Turkey,683,404,279
2000,144,Sri Lanka,Turkey,10,7,3
2000,496,Mongolia,Turkey,133,82,51
2000,608,Philippines,Turkey,922,468,454
2000,764,Thailand,Turkey,1,0,1
2000,533,Aruba,Turkey,11,8,3
2000,214,Dominican Republic,Turkey,89,46,43
2000,630,Puerto Rico,Turkey,47,23,24
2000,188,Costa Rica,Turkey,6,3,3
2000,320,Guatemala,Turkey,15,5,10
2000,484,Mexico,Turkey,359,163,196
2000,591,Panama,Turkey,40,25,15
2000,32,Argentina,Turkey,1331,643,688
2000,68,Bolivia (Plurinational State of),Turkey,13,8,5
2000,76,Brazil,Turkey,693,268,425
2000,152,Chile,Turkey,252,133,119
2000,170,Colombia,Turkey,51,26,25
2000,604,Peru,Turkey,39,25,14
2000,862,Venezuela (Bolivarian Republic of),Turkey,111,65,46
2000,36,Australia,Turkey,34060,17518,16542
2000,112,Belarus,Turkey,25,24,1
2000,100,Bulgaria,Turkey,2010,1417,593
2000,203,Czechia,Turkey,109,81,28
2000,348,Hungary,Turkey,1452,1005,447
2000,616,Poland,Turkey,469,298,171
2000,498,Republic of Moldova,Turkey,320,208,112
2000,642,Romania,Turkey,2797,2294,503
2000,643,Russian Federation,Turkey,8962,6756,2206
2000,703,Slovakia,Turkey,201,165,36
2000,804,Ukraine,Turkey,1550,1329,221
2000,208,Denmark,Turkey,30089,15852,14237
2000,246,Finland,Turkey,1808,1433,375
2000,352,Iceland,Turkey,35,22,13
2000,372,Ireland,Turkey,570,434,136
2000,428,Latvia,Turkey,25,20,5
2000,440,Lithuania,Turkey,35,27,8
2000,578,Norway,Turkey,7300,4115,3185
2000,752,Sweden,Turkey,31894,16698,15196
2000,826,United Kingdom,Turkey,52296,28932,23364
2000,8,Albania,Turkey,2892,1909,983
2000,300,Greece,Turkey,75879,31218,44661
2000,380,Italy,Turkey,9618,5134,4484
2000,470,Malta,Turkey,117,79,38
2000,807,North Macedonia,Turkey,18717,7802,10915
2000,620,Portugal,Turkey,105,73,32
2000,688,Serbia,Turkey,411,278,133
2000,705,Slovenia,Turkey,26,14,12
2000,724,Spain,Turkey,981,657,324
2000,40,Austria,Turkey,110695,60129,50566
2000,56,Belgium,Turkey,132115,64870,67245
2000,250,France,Turkey,256739,133639,123100
2000,276,Germany,Turkey,1649639,859242,790397
2000,438,Liechtenstein,Turkey,1158,577,581
2000,442,Luxembourg,Turkey,177,87,90
2000,528,Netherlands,Turkey,176615,92625,83990
2000,756,Switzerland,Turkey,57493,33268,24225
2000,60,Bermuda,Turkey,60,60,0
2000,124,Canada,Turkey,17605,8493,9112
2000,840,United States of America,Turkey,80368,35794,44574
2005,140,Central African Republic,Turkey,8,2,6
2005,516,Namibia,Turkey,37,22,15
2005,710,South Africa,Turkey,624,403,221
2005,818,Egypt,Turkey,779,562,217
2005,434,Libya,Turkey,2055,1542,513
2005,51,Armenia,Turkey,1502,490,1012
2005,31,Azerbaijan,Turkey,2429,1770,659
2005,48,Bahrain,Turkey,1984,1349,635
2005,196,Cyprus,Turkey,407,186,221
2005,268,Georgia,Turkey,432,300,132
2005,368,Iraq,Turkey,17331,10237,7094
2005,376,Israel,Turkey,29236,13955,15281
2005,400,Jordan,Turkey,1798,1399,399
2005,414,Kuwait,Turkey,7905,5214,2691
2005,422,Lebanon,Turkey,442,324,118
2005,634,Qatar,Turkey,3053,2264,789
2005,784,United Arab Emirates,Turkey,16152,11185,4967
2005,398,Kazakhstan,Turkey,39266,20197,19069
2005,417,Kyrgyzstan,Turkey,1098,525,573
2005,762,Tajikistan,Turkey,792,424,368
2005,356,India,Turkey,119,56,63
2005,364,Iran (Islamic Republic of),Turkey,1024,606,418
2005,144,Sri Lanka,Turkey,22,12,10
2005,496,Mongolia,Turkey,148,85,63
2005,608,Philippines,Turkey,746,385,361
2005,533,Aruba,Turkey,11,8,3
2005,214,Dominican Republic,Turkey,59,33,26
2005,630,Puerto Rico,Turkey,36,17,19
2005,188,Costa Rica,Turkey,4,2,2
2005,320,Guatemala,Turkey,19,7,12
2005,484,Mexico,Turkey,297,160,137
2005,591,Panama,Turkey,66,49,17
2005,32,Argentina,Turkey,982,482,500
2005,68,Bolivia (Plurinational State of),Turkey,23,14,9
2005,76,Brazil,Turkey,530,258,272
2005,152,Chile,Turkey,378,203,175
2005,170,Colombia,Turkey,44,25,19
2005,604,Peru,Turkey,46,29,17
2005,862,Venezuela (Bolivarian Republic of),Turkey,116,68,48
2005,36,Australia,Turkey,37460,19302,18158
2005,112,Belarus,Turkey,24,23,1
2005,100,Bulgaria,Turkey,2963,2137,826
2005,203,Czechia,Turkey,539,424,115
2005,348,Hungary,Turkey,1793,1251,542
2005,616,Poland,Turkey,676,488,188
2005,498,Republic of Moldova,Turkey,221,142,79
2005,642,Romania,Turkey,2927,2369,558
2005,643,Russian Federation,Turkey,9602,7418,2184
2005,703,Slovakia,Turkey,226,186,40
2005,804,Ukraine,Turkey,1416,1215,201
2005,208,Denmark,Turkey,31925,16741,15184
2005,246,Finland,Turkey,3594,2696,898
2005,352,Iceland,Turkey,49,31,18
2005,372,Ireland,Turkey,572,444,128
2005,428,Latvia,Turkey,66,50,16
2005,440,Lithuania,Turkey,59,46,13
2005,578,Norway,Turkey,9124,5178,3946
2005,752,Sweden,Turkey,35853,19033,16820
2005,826,United Kingdom,Turkey,68300,37617,30683
2005,8,Albania,Turkey,2441,1674,767
2005,191,Croatia,Turkey,43,26,17
2005,300,Greece,Turkey,55051,23162,31889
2005,380,Italy,Turkey,15053,8490,6563
2005,470,Malta,Turkey,139,94,45
2005,807,North Macedonia,Turkey,19250,8026,11224
2005,620,Portugal,Turkey,200,127,73
2005,688,Serbia,Turkey,406,273,133
2005,705,Slovenia,Turkey,41,27,14
2005,724,Spain,Turkey,1871,1271,600
2005,40,Austria,Turkey,134325,72226,62099
2005,56,Belgium,Turkey,96234,47186,49048
2005,250,France,Turkey,229714,123372,106342
2005,276,Germany,Turkey,1483727,778000,705727
2005,438,Liechtenstein,Turkey,870,439,431
2005,442,Luxembourg,Turkey,153,80,73
2005,528,Netherlands,Turkey,195774,101972,93802
2005,756,Switzerland,Turkey,64071,35695,28376
2005,60,Bermuda,Turkey,102,73,29
2005,124,Canada,Turkey,21346,10969,10377
2005,840,United States of America,Turkey,89762,40253,49509
2010,140,Central African Republic,Turkey,8,2,6
2010,516,Namibia,Turkey,35,21,14
2010,710,South Africa,Turkey,976,629,347
2010,818,Egypt,Turkey,841,598,243
2010,434,Libya,Turkey,2249,1694,555
2010,51,Armenia,Turkey,1250,436,814
2010,31,Azerbaijan,Turkey,2224,1642,582
2010,48,Bahrain,Turkey,2853,1924,929
2010,196,Cyprus,Turkey,666,309,357
2010,268,Georgia,Turkey,436,303,133
2010,368,Iraq,Turkey,17502,10766,6736
2010,376,Israel,Turkey,27111,12867,14244
2010,400,Jordan,Turkey,2312,1827,485
2010,414,Kuwait,Turkey,10463,6818,3645
2010,422,Lebanon,Turkey,319,240,79
2010,634,Qatar,Turkey,6249,5009,1240
2010,784,United Arab Emirates,Turkey,32055,22449,9606
2010,398,Kazakhstan,Turkey,44089,23134,20955
2010,417,Kyrgyzstan,Turkey,1193,568,625
2010,762,Tajikistan,Turkey,790,425,365
2010,356,India,Turkey,109,51,58
2010,364,Iran (Islamic Republic of),Turkey,2472,1514,958
2010,144,Sri Lanka,Turkey,45,24,21
2010,496,Mongolia,Turkey,180,104,76
2010,608,Philippines,Turkey,866,430,436
2010,764,Thailand,Turkey,1,1,0
2010,533,Aruba,Turkey,10,7,3
2010,214,Dominican Republic,Turkey,29,20,9
2010,630,Puerto Rico,Turkey,22,10,12
2010,188,Costa Rica,Turkey,8,4,4
2010,320,Guatemala,Turkey,22,9,13
2010,484,Mexico,Turkey,270,176,94
2010,591,Panama,Turkey,96,76,20
2010,32,Argentina,Turkey,633,322,311
2010,68,Bolivia (Plurinational State of),Turkey,32,20,12
2010,76,Brazil,Turkey,359,243,116
2010,152,Chile,Turkey,504,272,232
2010,170,Colombia,Turkey,44,28,16
2010,604,Peru,Turkey,50,32,18
2010,862,Venezuela (Bolivarian Republic of),Turkey,124,74,50
2010,36,Australia,Turkey,39810,20708,19102
2010,112,Belarus,Turkey,23,22,1
2010,100,Bulgaria,Turkey,3791,2767,1024
2010,203,Czechia,Turkey,915,729,186
2010,348,Hungary,Turkey,2134,1497,637
2010,616,Poland,Turkey,906,692,214
2010,498,Republic of Moldova,Turkey,381,248,133
2010,642,Romania,Turkey,3710,2975,735
2010,643,Russian Federation,Turkey,10045,7928,2117
2010,703,Slovakia,Turkey,253,209,44
2010,804,Ukraine,Turkey,1351,1160,191
2010,208,Denmark,Turkey,33268,17324,15944
2010,233,Estonia,Turkey,87,75,12
2010,246,Finland,Turkey,6357,4579,1778
2010,352,Iceland,Turkey,62,39,23
2010,372,Ireland,Turkey,479,363,116
2010,428,Latvia,Turkey,106,78,28
2010,440,Lithuania,Turkey,75,57,18
2010,578,Norway,Turkey,10475,5924,4551
2010,752,Sweden,Turkey,42527,23305,19222
2010,826,United Kingdom,Turkey,71951,40292,31659
2010,8,Albania,Turkey,1990,1365,625
2010,191,Croatia,Turkey,85,51,34
2010,300,Greece,Turkey,35608,15725,19883
2010,380,Italy,Turkey,20888,12096,8792
2010,470,Malta,Turkey,188,128,60
2010,499,Montenegro,Turkey,79,4,75
2010,807,North Macedonia,Turkey,19770,9250,10520
2010,620,Portugal,Turkey,262,159,103
2010,688,Serbia,Turkey,397,266,131
2010,705,Slovenia,Turkey,91,64,27
2010,724,Spain,Turkey,3276,2152,1124
2010,40,Austria,Turkey,158045,84319,73726
2010,56,Belgium,Turkey,93561,48257,45304
2010,250,France,Turkey,279301,146842,132459
2010,276,Germany,Turkey,1320171,693316,626855
2010,438,Liechtenstein,Turkey,585,300,285
2010,442,Luxembourg,Turkey,132,75,57
2010,528,Netherlands,Turkey,197219,101779,95440
2010,756,Switzerland,Turkey,75957,40402,35555
2010,60,Bermuda,Turkey,143,85,58
2010,124,Canada,Turkey,25275,13546,11729
2010,840,United States of America,Turkey,102159,45038,57121
2015,140,Central African Republic,Turkey,7,2,5
2015,516,Namibia,Turkey,34,21,13
2015,710,South Africa,Turkey,1760,1103,657
2015,324,Guinea,Turkey,35,24,11
2015,818,Egypt,Turkey,623,467,156
2015,434,Libya,Turkey,2535,1901,634
2015,51,Armenia,Turkey,542,190,352
2015,31,Azerbaijan,Turkey,2121,1578,543
2015,48,Bahrain,Turkey,2170,1453,717
2015,196,Cyprus,Turkey,639,299,340
2015,268,Georgia,Turkey,457,318,139
2015,368,Iraq,Turkey,17515,9809,7706
2015,376,Israel,Turkey,27960,13198,14762
2015,400,Jordan,Turkey,995,740,255
2015,414,Kuwait,Turkey,12297,7423,4874
2015,422,Lebanon,Turkey,268,129,139
2015,634,Qatar,Turkey,5046,4111,935
2015,784,United Arab Emirates,Turkey,35027,24117,10910
2015,398,Kazakhstan,Turkey,46894,24971,21923
2015,417,Kyrgyzstan,Turkey,1051,497,554
2015,762,Tajikistan,Turkey,776,415,361
2015,356,India,Turkey,105,49,56
2015,364,Iran (Islamic Republic of),Turkey,2447,1489,958
2015,144,Sri Lanka,Turkey,45,24,21
2015,496,Mongolia,Turkey,222,103,119
2015,608,Philippines,Turkey,879,436,443
2015,764,Thailand,Turkey,1,1,0
2015,533,Aruba,Turkey,10,7,3
2015,214,Dominican Republic,Turkey,30,21,9
2015,630,Puerto Rico,Turkey,21,10,11
2015,188,Costa Rica,Turkey,8,4,4
2015,320,Guatemala,Turkey,25,10,15
2015,484,Mexico,Turkey,286,186,100
2015,591,Panama,Turkey,112,89,23
2015,32,Argentina,Turkey,635,323,312
2015,68,Bolivia (Plurinational State of),Turkey,37,23,14
2015,76,Brazil,Turkey,432,292,140
2015,152,Chile,Turkey,763,405,358
2015,170,Colombia,Turkey,49,32,17
2015,604,Peru,Turkey,52,33,19
2015,862,Venezuela (Bolivarian Republic of),Turkey,132,78,54
2015,36,Australia,Turkey,39710,20737,18973
2015,112,Belarus,Turkey,25,24,1
2015,100,Bulgaria,Turkey,9284,6648,2636
2015,203,Czechia,Turkey,1617,1202,415
2015,348,Hungary,Turkey,2218,1542,676
2015,616,Poland,Turkey,873,671,202
2015,498,Republic of Moldova,Turkey,596,388,208
2015,642,Romania,Turkey,4476,3221,1255
2015,643,Russian Federation,Turkey,10237,8068,2169
2015,703,Slovakia,Turkey,322,269,53
2015,804,Ukraine,Turkey,1355,1164,191
2015,208,Denmark,Turkey,35781,18809,16972
2015,233,Estonia,Turkey,205,169,36
2015,246,Finland,Turkey,7863,5407,2456
2015,352,Iceland,Turkey,73,45,28
2015,372,Ireland,Turkey,489,369,120
2015,428,Latvia,Turkey,108,83,25
2015,440,Lithuania,Turkey,64,50,14
2015,578,Norway,Turkey,11230,6298,4932
2015,752,Sweden,Turkey,46373,25520,20853
2015,826,United Kingdom,Turkey,92014,50327,41687
2015,8,Albania,Turkey,1961,1345,616
2015,191,Croatia,Turkey,86,52,34
2015,300,Greece,Turkey,33420,13963,19457
2015,380,Italy,Turkey,19572,11214,8358
2015,470,Malta,Turkey,318,224,94
2015,499,Montenegro,Turkey,87,4,83
2015,807,North Macedonia,Turkey,19922,8700,11222
2015,620,Portugal,Turkey,296,175,121
2015,688,Serbia,Turkey,388,260,128
2015,705,Slovenia,Turkey,116,86,30
2015,724,Spain,Turkey,3969,2467,1502
2015,40,Austria,Turkey,184847,99090,85757
2015,56,Belgium,Turkey,98250,50924,47326
2015,250,France,Turkey,309406,158629,150777
2015,276,Germany,Turkey,1370193,718134,652059
2015,438,Liechtenstein,Turkey,608,318,290
2015,442,Luxembourg,Turkey,201,116,85
2015,528,Netherlands,Turkey,204551,105695,98856
2015,756,Switzerland,Turkey,77342,40377,36965
2015,60,Bermuda,Turkey,144,85,59
2015,124,Canada,Turkey,26546,14426,12120
2015,840,United States of America,Turkey,379182,166078,213104
2019,140,Central African Republic,Turkey,7,2,5
2019,516,Namibia,Turkey,35,22,13
2019,710,South Africa,Turkey,1971,1236,735
2019,324,Guinea,Turkey,33,23,10
2019,686,Senegal,Turkey,88,46,42
2019,818,Egypt,Turkey,887,639,248
2019,434,Libya,Turkey,2689,2017,672
2019,51,Armenia,Turkey,539,192,347
2019,31,Azerbaijan,Turkey,2037,1516,521
2019,48,Bahrain,Turkey,2284,1530,754
2019,196,Cyprus,Turkey,638,302,336
2019,268,Georgia,Turkey,471,328,143
2019,368,Iraq,Turkey,17938,10046,7892
2019,376,Israel,Turkey,27190,12835,14355
2019,400,Jordan,Turkey,1070,796,274
2019,414,Kuwait,Turkey,13020,7860,5160
2019,422,Lebanon,Turkey,253,122,131
2019,634,Qatar,Turkey,5146,4125,1021
2019,784,United Arab Emirates,Turkey,37621,25901,11720
2019,398,Kazakhstan,Turkey,49003,26094,22909
2019,417,Kyrgyzstan,Turkey,1029,487,542
2019,762,Tajikistan,Turkey,773,414,359
2019,356,India,Turkey,103,48,55
2019,364,Iran (Islamic Republic of),Turkey,2407,1465,942
2019,144,Sri Lanka,Turkey,45,24,21
2019,496,Mongolia,Turkey,235,109,126
2019,608,Philippines,Turkey,906,450,456
2019,764,Thailand,Turkey,1,1,0
2019,533,Aruba,Turkey,10,7,3
2019,214,Dominican Republic,Turkey,31,22,9
2019,630,Puerto Rico,Turkey,19,10,9
2019,188,Costa Rica,Turkey,8,4,4
2019,320,Guatemala,Turkey,25,10,15
2019,484,Mexico,Turkey,294,191,103
2019,591,Panama,Turkey,118,95,23
2019,32,Argentina,Turkey,646,329,317
2019,68,Bolivia (Plurinational State of),Turkey,40,25,15
2019,76,Brazil,Turkey,486,329,157
2019,152,Chile,Turkey,1019,515,504
2019,170,Colombia,Turkey,50,33,17
2019,604,Peru,Turkey,61,40,21
2019,862,Venezuela (Bolivarian Republic of),Turkey,129,76,53
2019,36,Australia,Turkey,42880,22530,20350
2019,112,Belarus,Turkey,24,24,0
2019,100,Bulgaria,Turkey,11702,8071,3631
2019,203,Czechia,Turkey,2193,1596,597
2019,348,Hungary,Turkey,2502,1750,752
2019,616,Poland,Turkey,924,719,205
2019,498,Republic of Moldova,Turkey,586,382,204
2019,642,Romania,Turkey,8757,6657,2100
2019,643,Russian Federation,Turkey,10234,8066,2168
2019,703,Slovakia,Turkey,368,311,57
2019,804,Ukraine,Turkey,1368,1176,192
2019,208,Denmark,Turkey,34938,18185,16753
2019,233,Estonia,Turkey,304,249,55
2019,246,Finland,Turkey,9137,6235,2902
2019,352,Iceland,Turkey,92,60,32
2019,372,Ireland,Turkey,536,405,131
2019,428,Latvia,Turkey,113,93,20
2019,440,Lithuania,Turkey,41,27,14
2019,578,Norway,Turkey,12455,6962,5493
2019,752,Sweden,Turkey,50188,27423,22765
2019,826,United Kingdom,Turkey,104491,57271,47220
2019,8,Albania,Turkey,1852,1270,582
2019,191,Croatia,Turkey,79,48,31
2019,300,Greece,Turkey,32638,14356,18282
2019,380,Italy,Turkey,20558,11805,8753
2019,470,Malta,Turkey,513,363,150
2019,499,Montenegro,Turkey,87,5,82
2019,807,North Macedonia,Turkey,19991,8731,11260
2019,620,Portugal,Turkey,701,350,351
2019,688,Serbia,Turkey,394,265,129
2019,705,Slovenia,Turkey,152,110,42
2019,724,Spain,Turkey,4112,2519,1593
2019,40,Austria,Turkey,218201,118711,99490
2019,56,Belgium,Turkey,104059,54232,49827
2019,250,France,Turkey,327508,167545,159963
2019,276,Germany,Turkey,1531333,815148,716185
2019,438,Liechtenstein,Turkey,614,316,298
2019,442,Luxembourg,Turkey,1140,637,503
2019,528,Netherlands,Turkey,204702,104315,100387
2019,756,Switzerland,Turkey,80613,42309,38304
2019,60,Bermuda,Turkey,145,86,59
2019,124,Canada,Turkey,28447,15460,12987
2019,840,United States of America,Turkey,409480,176872,232608
1990,818,Egypt,Turkmenistan,21,19,2
1990,434,Libya,Turkmenistan,58,53,5
1990,51,Armenia,Turkmenistan,820,236,584
1990,31,Azerbaijan,Turkmenistan,2352,934,1418
1990,196,Cyprus,Turkmenistan,3,1,2
1990,268,Georgia,Turkmenistan,1609,724,885
1990,376,Israel,Turkmenistan,507,236,271
1990,792,Turkey,Turkmenistan,492,362,130
1990,398,Kazakhstan,Turkmenistan,338,195,143
1990,417,Kyrgyzstan,Turkmenistan,2941,1265,1676
1990,762,Tajikistan,Turkmenistan,1084,476,608
1990,860,Uzbekistan,Turkmenistan,330,186,144
1990,364,Iran (Islamic Republic of),Turkmenistan,216,124,92
1990,152,Chile,Turkmenistan,3,0,3
1990,36,Australia,Turkmenistan,25,9,16
1990,112,Belarus,Turkmenistan,6339,3062,3277
1990,100,Bulgaria,Turkmenistan,7,0,7
1990,203,Czechia,Turkmenistan,12,5,7
1990,616,Poland,Turkmenistan,62,13,49
1990,643,Russian Federation,Turkmenistan,165923,81420,84503
1990,804,Ukraine,Turkmenistan,31201,13370,17831
1990,208,Denmark,Turkmenistan,4,1,3
1990,233,Estonia,Turkmenistan,996,477,519
1990,372,Ireland,Turkmenistan,1,0,1
1990,428,Latvia,Turkmenistan,23,10,13
1990,440,Lithuania,Turkmenistan,3341,1504,1837
1990,752,Sweden,Turkmenistan,44,14,30
1990,826,United Kingdom,Turkmenistan,12,7,5
1990,300,Greece,Turkmenistan,40196,22262,17934
1990,380,Italy,Turkmenistan,7,3,4
1990,688,Serbia,Turkmenistan,3,1,2
1990,724,Spain,Turkmenistan,1,0,1
1990,40,Austria,Turkmenistan,77,26,51
1990,56,Belgium,Turkmenistan,1,1,0
1990,250,France,Turkmenistan,217,99,118
1990,276,Germany,Turkmenistan,28,16,12
1990,756,Switzerland,Turkmenistan,18,4,14
1990,124,Canada,Turkmenistan,106,52,54
1990,840,United States of America,Turkmenistan,569,279,290
1995,818,Egypt,Turkmenistan,27,21,6
1995,434,Libya,Turkmenistan,115,89,26
1995,51,Armenia,Turkmenistan,871,275,596
1995,31,Azerbaijan,Turkmenistan,2065,896,1169
1995,196,Cyprus,Turkmenistan,4,1,3
1995,268,Georgia,Turkmenistan,1335,599,736
1995,376,Israel,Turkmenistan,871,404,467
1995,792,Turkey,Turkmenistan,1190,862,328
1995,398,Kazakhstan,Turkmenistan,555,323,232
1995,417,Kyrgyzstan,Turkmenistan,2427,1047,1380
1995,762,Tajikistan,Turkmenistan,744,347,397
1995,860,Uzbekistan,Turkmenistan,551,312,239
1995,364,Iran (Islamic Republic of),Turkmenistan,237,136,101
1995,68,Bolivia (Plurinational State of),Turkmenistan,1,0,1
1995,152,Chile,Turkmenistan,2,1,1
1995,36,Australia,Turkmenistan,18,5,13
1995,112,Belarus,Turkmenistan,6005,2915,3090
1995,100,Bulgaria,Turkmenistan,61,19,42
1995,203,Czechia,Turkmenistan,18,8,10
1995,616,Poland,Turkmenistan,53,11,42
1995,643,Russian Federation,Turkmenistan,173279,85376,87903
1995,804,Ukraine,Turkmenistan,28347,12632,15715
1995,208,Denmark,Turkmenistan,4,1,3
1995,233,Estonia,Turkmenistan,684,315,369
1995,246,Finland,Turkmenistan,2,1,1
1995,372,Ireland,Turkmenistan,3,1,2
1995,428,Latvia,Turkmenistan,475,229,246
1995,440,Lithuania,Turkmenistan,479,217,262
1995,752,Sweden,Turkmenistan,52,16,36
1995,826,United Kingdom,Turkmenistan,51,19,32
1995,300,Greece,Turkmenistan,19982,11140,8842
1995,380,Italy,Turkmenistan,26,3,23
1995,688,Serbia,Turkmenistan,22,5,17
1995,724,Spain,Turkmenistan,2,0,2
1995,40,Austria,Turkmenistan,87,30,57
1995,56,Belgium,Turkmenistan,1,1,0
1995,250,France,Turkmenistan,224,100,124
1995,276,Germany,Turkmenistan,1774,759,1015
1995,756,Switzerland,Turkmenistan,33,11,22
1995,124,Canada,Turkmenistan,106,51,55
1995,840,United States of America,Turkmenistan,741,368,373
2000,818,Egypt,Turkmenistan,35,25,10
2000,434,Libya,Turkmenistan,175,127,48
2000,51,Armenia,Turkmenistan,953,317,636
2000,31,Azerbaijan,Turkmenistan,2081,886,1195
2000,196,Cyprus,Turkmenistan,5,1,4
2000,268,Georgia,Turkmenistan,197,69,128
2000,376,Israel,Turkmenistan,1187,556,631
2000,792,Turkey,Turkmenistan,1894,1366,528
2000,398,Kazakhstan,Turkmenistan,771,450,321
2000,417,Kyrgyzstan,Turkmenistan,1846,798,1048
2000,762,Tajikistan,Turkmenistan,473,227,246
2000,860,Uzbekistan,Turkmenistan,796,450,346
2000,364,Iran (Islamic Republic of),Turkmenistan,248,147,101
2000,68,Bolivia (Plurinational State of),Turkmenistan,1,0,1
2000,152,Chile,Turkmenistan,2,0,2
2000,36,Australia,Turkmenistan,30,15,15
2000,112,Belarus,Turkmenistan,5670,2768,2902
2000,100,Bulgaria,Turkmenistan,115,39,76
2000,203,Czechia,Turkmenistan,23,10,13
2000,616,Poland,Turkmenistan,46,9,37
2000,643,Russian Federation,Turkmenistan,174352,86268,88084
2000,804,Ukraine,Turkmenistan,25840,12048,13792
2000,208,Denmark,Turkmenistan,4,2,2
2000,233,Estonia,Turkmenistan,371,152,219
2000,246,Finland,Turkmenistan,4,2,2
2000,372,Ireland,Turkmenistan,6,3,3
2000,428,Latvia,Turkmenistan,928,448,480
2000,440,Lithuania,Turkmenistan,375,170,205
2000,578,Norway,Turkmenistan,9,5,4
2000,752,Sweden,Turkmenistan,56,17,39
2000,826,United Kingdom,Turkmenistan,91,30,61
2000,300,Greece,Turkmenistan,97,42,55
2000,380,Italy,Turkmenistan,44,2,42
2000,688,Serbia,Turkmenistan,30,6,24
2000,724,Spain,Turkmenistan,27,5,22
2000,40,Austria,Turkmenistan,97,35,62
2000,250,France,Turkmenistan,230,100,130
2000,276,Germany,Turkmenistan,3519,1501,2018
2000,756,Switzerland,Turkmenistan,49,17,32
2000,124,Canada,Turkmenistan,109,52,57
2000,840,United States of America,Turkmenistan,918,459,459
2005,818,Egypt,Turkmenistan,42,31,11
2005,434,Libya,Turkmenistan,192,150,42
2005,51,Armenia,Turkmenistan,630,223,407
2005,31,Azerbaijan,Turkmenistan,1975,806,1169
2005,196,Cyprus,Turkmenistan,7,1,6
2005,268,Georgia,Turkmenistan,187,66,121
2005,376,Israel,Turkmenistan,1699,801,898
2005,792,Turkey,Turkmenistan,1953,1397,556
2005,398,Kazakhstan,Turkmenistan,879,523,356
2005,417,Kyrgyzstan,Turkmenistan,1502,646,856
2005,762,Tajikistan,Turkmenistan,456,222,234
2005,860,Uzbekistan,Turkmenistan,810,466,344
2005,364,Iran (Islamic Republic of),Turkmenistan,297,176,121
2005,68,Bolivia (Plurinational State of),Turkmenistan,1,0,1
2005,152,Chile,Turkmenistan,3,1,2
2005,36,Australia,Turkmenistan,60,30,30
2005,112,Belarus,Turkmenistan,5592,2729,2863
2005,100,Bulgaria,Turkmenistan,187,67,120
2005,203,Czechia,Turkmenistan,91,39,52
2005,616,Poland,Turkmenistan,50,7,43
2005,643,Russian Federation,Turkmenistan,180124,87695,92429
2005,804,Ukraine,Turkmenistan,23610,11026,12584
2005,208,Denmark,Turkmenistan,10,2,8
2005,233,Estonia,Turkmenistan,366,143,223
2005,246,Finland,Turkmenistan,12,5,7
2005,352,Iceland,Turkmenistan,1,0,1
2005,372,Ireland,Turkmenistan,5,2,3
2005,428,Latvia,Turkmenistan,831,401,430
2005,440,Lithuania,Turkmenistan,356,158,198
2005,578,Norway,Turkmenistan,42,23,19
2005,752,Sweden,Turkmenistan,158,60,98
2005,826,United Kingdom,Turkmenistan,379,146,233
2005,300,Greece,Turkmenistan,108,45,63
2005,380,Italy,Turkmenistan,125,19,106
2005,688,Serbia,Turkmenistan,30,6,24
2005,724,Spain,Turkmenistan,13,2,11
2005,40,Austria,Turkmenistan,109,38,71
2005,56,Belgium,Turkmenistan,2,1,1
2005,250,France,Turkmenistan,156,41,115
2005,276,Germany,Turkmenistan,4529,2040,2489
2005,756,Switzerland,Turkmenistan,64,21,43
2005,124,Canada,Turkmenistan,256,108,148
2005,840,United States of America,Turkmenistan,1350,679,671
2010,818,Egypt,Turkmenistan,45,33,12
2010,434,Libya,Turkmenistan,211,166,45
2010,51,Armenia,Turkmenistan,525,197,328
2010,31,Azerbaijan,Turkmenistan,1808,777,1031
2010,196,Cyprus,Turkmenistan,11,2,9
2010,268,Georgia,Turkmenistan,188,66,122
2010,376,Israel,Turkmenistan,2231,1053,1178
2010,792,Turkey,Turkmenistan,2012,1427,585
2010,398,Kazakhstan,Turkmenistan,987,596,391
2010,417,Kyrgyzstan,Turkmenistan,1136,482,654
2010,762,Tajikistan,Turkmenistan,454,222,232
2010,860,Uzbekistan,Turkmenistan,792,463,329
2010,364,Iran (Islamic Republic of),Turkmenistan,4950,3030,1920
2010,76,Brazil,Turkmenistan,21,6,15
2010,152,Chile,Turkmenistan,4,1,3
2010,36,Australia,Turkmenistan,90,45,45
2010,112,Belarus,Turkmenistan,5513,2690,2823
2010,100,Bulgaria,Turkmenistan,252,93,159
2010,203,Czechia,Turkmenistan,151,67,84
2010,616,Poland,Turkmenistan,56,4,52
2010,643,Russian Federation,Turkmenistan,182189,87373,94816
2010,804,Ukraine,Turkmenistan,22527,10537,11990
2010,208,Denmark,Turkmenistan,14,1,13
2010,233,Estonia,Turkmenistan,358,132,226
2010,246,Finland,Turkmenistan,26,10,16
2010,352,Iceland,Turkmenistan,1,0,1
2010,372,Ireland,Turkmenistan,4,1,3
2010,428,Latvia,Turkmenistan,714,337,377
2010,440,Lithuania,Turkmenistan,289,113,176
2010,578,Norway,Turkmenistan,57,31,26
2010,752,Sweden,Turkmenistan,215,80,135
2010,826,United Kingdom,Turkmenistan,399,159,240
2010,300,Greece,Turkmenistan,123,50,73
2010,380,Italy,Turkmenistan,195,36,159
2010,688,Serbia,Turkmenistan,30,6,24
2010,705,Slovenia,Turkmenistan,4,0,4
2010,724,Spain,Turkmenistan,27,7,20
2010,40,Austria,Turkmenistan,120,40,80
2010,56,Belgium,Turkmenistan,3,2,1
2010,250,France,Turkmenistan,198,84,114
2010,276,Germany,Turkmenistan,5358,2488,2870
2010,756,Switzerland,Turkmenistan,66,19,47
2010,124,Canada,Turkmenistan,425,173,252
2010,840,United States of America,Turkmenistan,1835,818,1017
2015,818,Egypt,Turkmenistan,33,26,7
2015,434,Libya,Turkmenistan,237,186,51
2015,51,Armenia,Turkmenistan,816,307,509
2015,31,Azerbaijan,Turkmenistan,1724,761,963
2015,196,Cyprus,Turkmenistan,10,2,8
2015,268,Georgia,Turkmenistan,197,69,128
2015,376,Israel,Turkmenistan,2301,1080,1221
2015,792,Turkey,Turkmenistan,2040,1433,607
2015,398,Kazakhstan,Turkmenistan,1050,641,409
2015,417,Kyrgyzstan,Turkmenistan,1001,422,579
2015,762,Tajikistan,Turkmenistan,446,217,229
2015,860,Uzbekistan,Turkmenistan,763,452,311
2015,364,Iran (Islamic Republic of),Turkmenistan,4901,2981,1920
2015,76,Brazil,Turkmenistan,25,7,18
2015,152,Chile,Turkmenistan,6,2,4
2015,36,Australia,Turkmenistan,100,29,71
2015,112,Belarus,Turkmenistan,5464,2667,2797
2015,100,Bulgaria,Turkmenistan,285,105,180
2015,203,Czechia,Turkmenistan,162,68,94
2015,616,Poland,Turkmenistan,53,4,49
2015,643,Russian Federation,Turkmenistan,185664,88556,97108
2015,804,Ukraine,Turkmenistan,22602,10589,12013
2015,208,Denmark,Turkmenistan,16,3,13
2015,233,Estonia,Turkmenistan,345,125,220
2015,246,Finland,Turkmenistan,26,9,17
2015,352,Iceland,Turkmenistan,1,0,1
2015,372,Ireland,Turkmenistan,4,1,3
2015,428,Latvia,Turkmenistan,589,278,311
2015,440,Lithuania,Turkmenistan,236,90,146
2015,578,Norway,Turkmenistan,76,37,39
2015,752,Sweden,Turkmenistan,235,84,151
2015,826,United Kingdom,Turkmenistan,510,194,316
2015,300,Greece,Turkmenistan,115,44,71
2015,380,Italy,Turkmenistan,225,35,190
2015,688,Serbia,Turkmenistan,29,6,23
2015,705,Slovenia,Turkmenistan,5,1,4
2015,724,Spain,Turkmenistan,60,20,40
2015,40,Austria,Turkmenistan,140,47,93
2015,56,Belgium,Turkmenistan,9,5,4
2015,250,France,Turkmenistan,218,89,129
2015,276,Germany,Turkmenistan,5583,2586,2997
2015,756,Switzerland,Turkmenistan,116,36,80
2015,124,Canada,Turkmenistan,496,213,283
2015,840,United States of America,Turkmenistan,2306,1023,1283
2019,818,Egypt,Turkmenistan,47,36,11
2019,434,Libya,Turkmenistan,251,197,54
2019,51,Armenia,Turkmenistan,811,310,501
2019,31,Azerbaijan,Turkmenistan,1656,731,925
2019,196,Cyprus,Turkmenistan,9,2,7
2019,268,Georgia,Turkmenistan,203,72,131
2019,376,Israel,Turkmenistan,2237,1050,1187
2019,792,Turkey,Turkmenistan,2758,1946,812
2019,398,Kazakhstan,Turkmenistan,1097,670,427
2019,417,Kyrgyzstan,Turkmenistan,980,413,567
2019,762,Tajikistan,Turkmenistan,444,216,228
2019,860,Uzbekistan,Turkmenistan,761,451,310
2019,364,Iran (Islamic Republic of),Turkmenistan,4821,2933,1888
2019,76,Brazil,Turkmenistan,28,8,20
2019,152,Chile,Turkmenistan,8,3,5
2019,36,Australia,Turkmenistan,126,35,91
2019,112,Belarus,Turkmenistan,5395,2633,2762
2019,100,Bulgaria,Turkmenistan,332,124,208
2019,203,Czechia,Turkmenistan,173,74,99
2019,616,Poland,Turkmenistan,56,7,49
2019,643,Russian Federation,Turkmenistan,185620,88535,97085
2019,804,Ukraine,Turkmenistan,22828,10695,12133
2019,208,Denmark,Turkmenistan,23,4,19
2019,233,Estonia,Turkmenistan,333,121,212
2019,246,Finland,Turkmenistan,38,10,28
2019,352,Iceland,Turkmenistan,1,0,1
2019,372,Ireland,Turkmenistan,4,1,3
2019,428,Latvia,Turkmenistan,538,253,285
2019,440,Lithuania,Turkmenistan,185,67,118
2019,578,Norway,Turkmenistan,87,40,47
2019,752,Sweden,Turkmenistan,254,95,159
2019,826,United Kingdom,Turkmenistan,579,222,357
2019,300,Greece,Turkmenistan,112,46,66
2019,380,Italy,Turkmenistan,271,50,221
2019,688,Serbia,Turkmenistan,29,6,23
2019,705,Slovenia,Turkmenistan,13,8,5
2019,724,Spain,Turkmenistan,62,20,42
2019,40,Austria,Turkmenistan,165,58,107
2019,56,Belgium,Turkmenistan,12,8,4
2019,250,France,Turkmenistan,230,94,136
2019,276,Germany,Turkmenistan,6124,2833,3291
2019,756,Switzerland,Turkmenistan,142,50,92
2019,124,Canada,Turkmenistan,531,228,303
2019,840,United States of America,Turkmenistan,2489,1089,1400
1990,28,Antigua and Barbuda,Turks and Caicos Islands,4,2,2
1990,44,Bahamas,Turks and Caicos Islands,2080,892,1188
1990,214,Dominican Republic,Turks and Caicos Islands,3,3,0
1990,152,Chile,Turks and Caicos Islands,3,2,1
1990,100,Bulgaria,Turks and Caicos Islands,1,1,0
1990,826,United Kingdom,Turks and Caicos Islands,17,11,6
1990,250,France,Turks and Caicos Islands,7,3,4
1990,60,Bermuda,Turks and Caicos Islands,158,73,85
1990,124,Canada,Turks and Caicos Islands,38,19,19
1995,28,Antigua and Barbuda,Turks and Caicos Islands,5,2,3
1995,44,Bahamas,Turks and Caicos Islands,1284,558,726
1995,214,Dominican Republic,Turks and Caicos Islands,4,4,0
1995,152,Chile,Turks and Caicos Islands,2,2,0
1995,100,Bulgaria,Turks and Caicos Islands,2,2,0
1995,372,Ireland,Turks and Caicos Islands,1,1,0
1995,826,United Kingdom,Turks and Caicos Islands,70,34,36
1995,250,France,Turks and Caicos Islands,7,3,4
1995,60,Bermuda,Turks and Caicos Islands,136,63,73
1995,124,Canada,Turks and Caicos Islands,24,12,12
2000,28,Antigua and Barbuda,Turks and Caicos Islands,5,2,3
2000,44,Bahamas,Turks and Caicos Islands,488,224,264
2000,214,Dominican Republic,Turks and Caicos Islands,4,4,0
2000,152,Chile,Turks and Caicos Islands,2,2,0
2000,100,Bulgaria,Turks and Caicos Islands,2,2,0
2000,372,Ireland,Turks and Caicos Islands,2,2,0
2000,826,United Kingdom,Turks and Caicos Islands,126,59,67
2000,250,France,Turks and Caicos Islands,7,3,4
2000,60,Bermuda,Turks and Caicos Islands,113,53,60
2000,124,Canada,Turks and Caicos Islands,10,5,5
2005,28,Antigua and Barbuda,Turks and Caicos Islands,6,3,3
2005,44,Bahamas,Turks and Caicos Islands,957,402,555
2005,214,Dominican Republic,Turks and Caicos Islands,19,9,10
2005,152,Chile,Turks and Caicos Islands,3,3,0
2005,100,Bulgaria,Turks and Caicos Islands,3,3,0
2005,372,Ireland,Turks and Caicos Islands,2,2,0
2005,826,United Kingdom,Turks and Caicos Islands,108,52,56
2005,250,France,Turks and Caicos Islands,1,0,1
2005,60,Bermuda,Turks and Caicos Islands,98,30,68
2005,124,Canada,Turks and Caicos Islands,40,28,12
2010,466,Mali,Turks and Caicos Islands,540,238,302
2010,28,Antigua and Barbuda,Turks and Caicos Islands,6,3,3
2010,44,Bahamas,Turks and Caicos Islands,1426,580,846
2010,214,Dominican Republic,Turks and Caicos Islands,33,14,19
2010,152,Chile,Turks and Caicos Islands,4,4,0
2010,100,Bulgaria,Turks and Caicos Islands,3,3,0
2010,372,Ireland,Turks and Caicos Islands,1,1,0
2010,826,United Kingdom,Turks and Caicos Islands,113,56,57
2010,250,France,Turks and Caicos Islands,7,4,3
2010,60,Bermuda,Turks and Caicos Islands,82,7,75
2010,124,Canada,Turks and Caicos Islands,65,49,16
2015,466,Mali,Turks and Caicos Islands,669,295,374
2015,28,Antigua and Barbuda,Turks and Caicos Islands,6,3,3
2015,44,Bahamas,Turks and Caicos Islands,1545,622,923
2015,214,Dominican Republic,Turks and Caicos Islands,34,14,20
2015,152,Chile,Turks and Caicos Islands,6,6,0
2015,100,Bulgaria,Turks and Caicos Islands,3,3,0
2015,372,Ireland,Turks and Caicos Islands,1,1,0
2015,826,United Kingdom,Turks and Caicos Islands,144,69,75
2015,250,France,Turks and Caicos Islands,8,5,3
2015,60,Bermuda,Turks and Caicos Islands,83,7,76
2015,124,Canada,Turks and Caicos Islands,59,30,29
2019,466,Mali,Turks and Caicos Islands,744,328,416
2019,28,Antigua and Barbuda,Turks and Caicos Islands,6,3,3
2019,44,Bahamas,Turks and Caicos Islands,1640,661,979
2019,214,Dominican Republic,Turks and Caicos Islands,35,15,20
2019,152,Chile,Turks and Caicos Islands,8,8,0
2019,100,Bulgaria,Turks and Caicos Islands,2,2,0
2019,372,Ireland,Turks and Caicos Islands,1,1,0
2019,826,United Kingdom,Turks and Caicos Islands,163,79,84
2019,250,France,Turks and Caicos Islands,8,5,3
2019,60,Bermuda,Turks and Caicos Islands,83,7,76
2019,124,Canada,Turks and Caicos Islands,63,32,31
1990,32,Argentina,Tuvalu,8,4,4
1990,36,Australia,Tuvalu,71,35,36
1990,554,New Zealand,Tuvalu,1026,478,548
1990,242,Fiji,Tuvalu,378,201,177
1990,296,Kiribati,Tuvalu,377,203,174
1990,520,Nauru,Tuvalu,316,183,133
1990,570,Niue,Tuvalu,40,27,13
1990,882,Samoa,Tuvalu,39,21,18
1990,772,Tokelau,Tuvalu,21,14,7
1990,100,Bulgaria,Tuvalu,4,3,1
1990,203,Czechia,Tuvalu,1,1,0
1990,643,Russian Federation,Tuvalu,29,14,15
1990,300,Greece,Tuvalu,20,11,9
1990,724,Spain,Tuvalu,12,6,6
1990,40,Austria,Tuvalu,7,2,5
1990,250,France,Tuvalu,1,0,1
1995,32,Argentina,Tuvalu,8,4,4
1995,36,Australia,Tuvalu,88,44,44
1995,554,New Zealand,Tuvalu,1381,648,733
1995,242,Fiji,Tuvalu,372,196,176
1995,296,Kiribati,Tuvalu,339,177,162
1995,520,Nauru,Tuvalu,292,170,122
1995,570,Niue,Tuvalu,57,35,22
1995,882,Samoa,Tuvalu,66,36,30
1995,772,Tokelau,Tuvalu,20,14,6
1995,100,Bulgaria,Tuvalu,6,4,2
1995,203,Czechia,Tuvalu,1,1,0
1995,643,Russian Federation,Tuvalu,31,15,16
1995,300,Greece,Tuvalu,48,23,25
1995,380,Italy,Tuvalu,1,1,0
1995,724,Spain,Tuvalu,19,10,9
1995,40,Austria,Tuvalu,8,2,6
1995,250,France,Tuvalu,1,0,1
2000,32,Argentina,Tuvalu,8,4,4
2000,36,Australia,Tuvalu,120,59,61
2000,554,New Zealand,Tuvalu,989,481,508
2000,242,Fiji,Tuvalu,371,196,175
2000,296,Kiribati,Tuvalu,302,152,150
2000,520,Nauru,Tuvalu,268,156,112
2000,570,Niue,Tuvalu,73,47,26
2000,882,Samoa,Tuvalu,93,50,43
2000,772,Tokelau,Tuvalu,25,20,5
2000,100,Bulgaria,Tuvalu,8,6,2
2000,203,Czechia,Tuvalu,1,1,0
2000,643,Russian Federation,Tuvalu,33,15,18
2000,300,Greece,Tuvalu,77,35,42
2000,380,Italy,Tuvalu,1,1,0
2000,724,Spain,Tuvalu,232,128,104
2000,40,Austria,Tuvalu,9,3,6
2000,250,France,Tuvalu,1,0,1
2005,32,Argentina,Tuvalu,6,3,3
2005,36,Australia,Tuvalu,140,68,72
2005,554,New Zealand,Tuvalu,1173,570,603
2005,242,Fiji,Tuvalu,372,196,176
2005,296,Kiribati,Tuvalu,295,157,138
2005,520,Nauru,Tuvalu,252,147,105
2005,570,Niue,Tuvalu,74,47,27
2005,882,Samoa,Tuvalu,87,47,40
2005,772,Tokelau,Tuvalu,24,17,7
2005,100,Bulgaria,Tuvalu,11,8,3
2005,203,Czechia,Tuvalu,1,1,0
2005,643,Russian Federation,Tuvalu,305,129,176
2005,246,Finland,Tuvalu,1,0,1
2005,300,Greece,Tuvalu,44,20,24
2005,380,Italy,Tuvalu,4,2,2
2005,724,Spain,Tuvalu,112,61,51
2005,40,Austria,Tuvalu,10,3,7
2005,250,France,Tuvalu,6,6,0
2010,32,Argentina,Tuvalu,4,2,2
2010,36,Australia,Tuvalu,150,63,87
2010,554,New Zealand,Tuvalu,1334,647,687
2010,242,Fiji,Tuvalu,399,213,186
2010,296,Kiribati,Tuvalu,288,162,126
2010,520,Nauru,Tuvalu,21,13,8
2010,570,Niue,Tuvalu,37,23,14
2010,882,Samoa,Tuvalu,76,40,36
2010,772,Tokelau,Tuvalu,39,24,15
2010,100,Bulgaria,Tuvalu,14,10,4
2010,203,Czechia,Tuvalu,1,1,0
2010,643,Russian Federation,Tuvalu,571,239,332
2010,246,Finland,Tuvalu,2,1,1
2010,300,Greece,Tuvalu,11,6,5
2010,380,Italy,Tuvalu,4,1,3
2010,724,Spain,Tuvalu,48,28,20
2010,40,Austria,Tuvalu,11,3,8
2010,250,France,Tuvalu,1,0,1
2015,324,Guinea,Tuvalu,1,1,0
2015,32,Argentina,Tuvalu,4,2,2
2015,36,Australia,Tuvalu,200,106,94
2015,554,New Zealand,Tuvalu,1474,713,761
2015,242,Fiji,Tuvalu,411,222,189
2015,296,Kiribati,Tuvalu,292,165,127
2015,520,Nauru,Tuvalu,33,21,12
2015,570,Niue,Tuvalu,36,23,13
2015,882,Samoa,Tuvalu,63,34,29
2015,772,Tokelau,Tuvalu,45,28,17
2015,100,Bulgaria,Tuvalu,2,1,1
2015,203,Czechia,Tuvalu,1,1,0
2015,643,Russian Federation,Tuvalu,582,242,340
2015,246,Finland,Tuvalu,2,1,1
2015,300,Greece,Tuvalu,10,6,4
2015,380,Italy,Tuvalu,5,3,2
2015,724,Spain,Tuvalu,34,20,14
2015,40,Austria,Tuvalu,12,3,9
2015,250,France,Tuvalu,1,0,1
2019,32,Argentina,Tuvalu,4,2,2
2019,36,Australia,Tuvalu,211,98,113
2019,554,New Zealand,Tuvalu,1515,733,782
2019,242,Fiji,Tuvalu,419,227,192
2019,296,Kiribati,Tuvalu,302,171,131
2019,520,Nauru,Tuvalu,36,23,13
2019,570,Niue,Tuvalu,36,23,13
2019,882,Samoa,Tuvalu,59,32,27
2019,772,Tokelau,Tuvalu,46,29,17
2019,100,Bulgaria,Tuvalu,1,1,0
2019,203,Czechia,Tuvalu,1,1,0
2019,643,Russian Federation,Tuvalu,581,242,339
2019,246,Finland,Tuvalu,1,1,0
2019,300,Greece,Tuvalu,9,6,3
2019,380,Italy,Tuvalu,4,1,3
2019,724,Spain,Tuvalu,35,21,14
2019,40,Austria,Tuvalu,14,4,10
2019,250,France,Tuvalu,2,1,1
1990,108,Burundi,Uganda,1833,898,935
1990,232,Eritrea,Uganda,175,109,66
1990,231,Ethiopia,Uganda,103,54,49
1990,404,Kenya,Uganda,83355,42091,41264
1990,646,Rwanda,Uganda,34106,17682,16424
1990,690,Seychelles,Uganda,5,5,0
1990,834,United Republic of Tanzania,Uganda,19706,10298,9408
1990,894,Zambia,Uganda,349,214,135
1990,180,Democratic Republic of the Congo,Uganda,18418,8866,9552
1990,72,Botswana,Uganda,295,158,137
1990,748,Eswatini,Uganda,1,1,0
1990,426,Lesotho,Uganda,185,102,83
1990,516,Namibia,Uganda,712,360,352
1990,710,South Africa,Uganda,4621,2345,2276
1990,818,Egypt,Uganda,91,81,10
1990,729,Sudan,Uganda,74433,37302,37131
1990,196,Cyprus,Uganda,5,4,1
1990,356,India,Uganda,2058,935,1123
1990,188,Costa Rica,Uganda,8,6,2
1990,32,Argentina,Uganda,1,0,1
1990,68,Bolivia (Plurinational State of),Uganda,2,0,2
1990,152,Chile,Uganda,11,5,6
1990,36,Australia,Uganda,925,508,417
1990,100,Bulgaria,Uganda,1,1,0
1990,203,Czechia,Uganda,4,2,2
1990,348,Hungary,Uganda,6,6,0
1990,616,Poland,Uganda,61,34,27
1990,643,Russian Federation,Uganda,100,49,51
1990,208,Denmark,Uganda,269,118,151
1990,246,Finland,Uganda,10,8,2
1990,352,Iceland,Uganda,3,0,3
1990,372,Ireland,Uganda,29,13,16
1990,428,Latvia,Uganda,1,0,1
1990,578,Norway,Uganda,242,146,96
1990,752,Sweden,Uganda,1880,945,935
1990,826,United Kingdom,Uganda,49648,26028,23620
1990,300,Greece,Uganda,107,59,48
1990,380,Italy,Uganda,53,18,35
1990,620,Portugal,Uganda,17,7,10
1990,724,Spain,Uganda,11,5,6
1990,40,Austria,Uganda,150,79,71
1990,56,Belgium,Uganda,208,115,93
1990,250,France,Uganda,421,181,240
1990,276,Germany,Uganda,1013,659,354
1990,528,Netherlands,Uganda,321,179,142
1990,756,Switzerland,Uganda,367,163,204
1990,124,Canada,Uganda,8598,4186,4412
1990,840,United States of America,Uganda,6684,2845,3839
1995,108,Burundi,Uganda,1546,753,793
1995,232,Eritrea,Uganda,682,427,255
1995,231,Ethiopia,Uganda,135,80,55
1995,404,Kenya,Uganda,134005,62323,71682
1995,646,Rwanda,Uganda,48486,24945,23541
1995,690,Seychelles,Uganda,5,3,2
1995,834,United Republic of Tanzania,Uganda,15546,8116,7430
1995,894,Zambia,Uganda,359,221,138
1995,180,Democratic Republic of the Congo,Uganda,19780,9780,10000
1995,72,Botswana,Uganda,411,227,184
1995,748,Eswatini,Uganda,8,5,3
1995,426,Lesotho,Uganda,160,88,72
1995,516,Namibia,Uganda,680,346,334
1995,710,South Africa,Uganda,2882,1578,1304
1995,818,Egypt,Uganda,75,65,10
1995,729,Sudan,Uganda,57771,29182,28589
1995,196,Cyprus,Uganda,7,5,2
1995,356,India,Uganda,1465,680,785
1995,188,Costa Rica,Uganda,6,4,2
1995,32,Argentina,Uganda,1,0,1
1995,68,Bolivia (Plurinational State of),Uganda,1,0,1
1995,152,Chile,Uganda,6,6,0
1995,36,Australia,Uganda,1218,657,561
1995,100,Bulgaria,Uganda,2,2,0
1995,203,Czechia,Uganda,6,3,3
1995,348,Hungary,Uganda,14,10,4
1995,616,Poland,Uganda,52,29,23
1995,643,Russian Federation,Uganda,93,51,42
1995,208,Denmark,Uganda,605,238,367
1995,246,Finland,Uganda,16,11,5
1995,352,Iceland,Uganda,5,0,5
1995,372,Ireland,Uganda,80,35,45
1995,428,Latvia,Uganda,1,0,1
1995,578,Norway,Uganda,325,188,137
1995,752,Sweden,Uganda,2231,1113,1118
1995,826,United Kingdom,Uganda,51083,26338,24745
1995,300,Greece,Uganda,99,47,52
1995,380,Italy,Uganda,208,78,130
1995,620,Portugal,Uganda,36,14,22
1995,724,Spain,Uganda,17,8,9
1995,40,Austria,Uganda,170,91,79
1995,56,Belgium,Uganda,208,115,93
1995,250,France,Uganda,435,183,252
1995,276,Germany,Uganda,1151,669,482
1995,528,Netherlands,Uganda,472,258,214
1995,756,Switzerland,Uganda,451,211,240
1995,124,Canada,Uganda,9646,4672,4974
1995,840,United States of America,Uganda,9334,4029,5305
2000,108,Burundi,Uganda,949,461,488
2000,232,Eritrea,Uganda,1190,746,444
2000,231,Ethiopia,Uganda,192,121,71
2000,404,Kenya,Uganda,261491,124611,136880
2000,646,Rwanda,Uganda,79241,41063,38178
2000,690,Seychelles,Uganda,6,1,5
2000,834,United Republic of Tanzania,Uganda,12286,6381,5905
2000,894,Zambia,Uganda,370,227,143
2000,180,Democratic Republic of the Congo,Uganda,24177,11858,12319
2000,72,Botswana,Uganda,570,319,251
2000,748,Eswatini,Uganda,30,15,15
2000,426,Lesotho,Uganda,130,72,58
2000,516,Namibia,Uganda,633,323,310
2000,710,South Africa,Uganda,1991,1223,768
2000,818,Egypt,Uganda,64,53,11
2000,729,Sudan,Uganda,47612,24268,23344
2000,196,Cyprus,Uganda,9,7,2
2000,356,India,Uganda,872,426,446
2000,188,Costa Rica,Uganda,7,5,2
2000,32,Argentina,Uganda,1,0,1
2000,152,Chile,Uganda,2,2,0
2000,36,Australia,Uganda,1420,767,653
2000,100,Bulgaria,Uganda,3,3,0
2000,203,Czechia,Uganda,8,4,4
2000,348,Hungary,Uganda,22,14,8
2000,616,Poland,Uganda,45,24,21
2000,643,Russian Federation,Uganda,84,52,32
2000,208,Denmark,Uganda,941,359,582
2000,246,Finland,Uganda,22,14,8
2000,352,Iceland,Uganda,6,0,6
2000,372,Ireland,Uganda,175,79,96
2000,428,Latvia,Uganda,2,1,1
2000,578,Norway,Uganda,459,246,213
2000,752,Sweden,Uganda,2393,1186,1207
2000,826,United Kingdom,Uganda,53378,27028,26350
2000,300,Greece,Uganda,93,36,57
2000,380,Italy,Uganda,363,139,224
2000,620,Portugal,Uganda,58,23,35
2000,705,Slovenia,Uganda,2,2,0
2000,724,Spain,Uganda,214,108,106
2000,40,Austria,Uganda,189,102,87
2000,56,Belgium,Uganda,202,113,89
2000,250,France,Uganda,448,184,264
2000,276,Germany,Uganda,1288,679,609
2000,528,Netherlands,Uganda,640,345,295
2000,756,Switzerland,Uganda,537,259,278
2000,124,Canada,Uganda,10924,5270,5654
2000,840,United States of America,Uganda,12039,5247,6792
2005,108,Burundi,Uganda,805,425,380
2005,232,Eritrea,Uganda,1345,862,483
2005,231,Ethiopia,Uganda,161,93,68
2005,404,Kenya,Uganda,291776,144595,147181
2005,646,Rwanda,Uganda,93430,48405,45025
2005,690,Seychelles,Uganda,15,6,9
2005,834,United Republic of Tanzania,Uganda,9484,4962,4522
2005,894,Zambia,Uganda,355,218,137
2005,180,Democratic Republic of the Congo,Uganda,30111,14769,15342
2005,72,Botswana,Uganda,902,500,402
2005,748,Eswatini,Uganda,39,19,20
2005,426,Lesotho,Uganda,132,73,59
2005,516,Namibia,Uganda,500,254,246
2005,710,South Africa,Uganda,2681,1584,1097
2005,818,Egypt,Uganda,76,64,12
2005,729,Sudan,Uganda,26103,13408,12695
2005,196,Cyprus,Uganda,13,10,3
2005,356,India,Uganda,806,393,413
2005,44,Bahamas,Uganda,6,2,4
2005,188,Costa Rica,Uganda,5,4,1
2005,32,Argentina,Uganda,1,0,1
2005,152,Chile,Uganda,3,3,0
2005,36,Australia,Uganda,1880,977,903
2005,100,Bulgaria,Uganda,4,3,1
2005,203,Czechia,Uganda,16,8,8
2005,348,Hungary,Uganda,27,16,11
2005,616,Poland,Uganda,54,25,29
2005,643,Russian Federation,Uganda,82,49,33
2005,208,Denmark,Uganda,1159,442,717
2005,246,Finland,Uganda,80,44,36
2005,352,Iceland,Uganda,14,2,12
2005,372,Ireland,Uganda,175,85,90
2005,428,Latvia,Uganda,2,2,0
2005,578,Norway,Uganda,635,308,327
2005,752,Sweden,Uganda,2516,1232,1284
2005,826,United Kingdom,Uganda,53634,26325,27309
2005,300,Greece,Uganda,118,45,73
2005,380,Italy,Uganda,665,281,384
2005,620,Portugal,Uganda,44,18,26
2005,705,Slovenia,Uganda,1,1,0
2005,724,Spain,Uganda,103,51,52
2005,40,Austria,Uganda,212,112,100
2005,56,Belgium,Uganda,306,163,143
2005,250,France,Uganda,343,147,196
2005,276,Germany,Uganda,1731,819,912
2005,528,Netherlands,Uganda,872,457,415
2005,756,Switzerland,Uganda,600,274,326
2005,124,Canada,Uganda,11032,5236,5796
2005,840,United States of America,Uganda,22847,10029,12818
2010,108,Burundi,Uganda,731,426,305
2010,232,Eritrea,Uganda,1498,977,521
2010,231,Ethiopia,Uganda,178,93,85
2010,404,Kenya,Uganda,326978,153956,173022
2010,646,Rwanda,Uganda,92808,48077,44731
2010,690,Seychelles,Uganda,25,11,14
2010,728,South Sudan,Uganda,144466,70495,73971
2010,834,United Republic of Tanzania,Uganda,6938,3576,3362
2010,894,Zambia,Uganda,456,279,177
2010,180,Democratic Republic of the Congo,Uganda,33,17,16
2010,72,Botswana,Uganda,280,170,110
2010,748,Eswatini,Uganda,48,23,25
2010,426,Lesotho,Uganda,134,74,60
2010,516,Namibia,Uganda,481,245,236
2010,710,South Africa,Uganda,4199,2475,1724
2010,818,Egypt,Uganda,82,69,13
2010,729,Sudan,Uganda,2079,1047,1032
2010,196,Cyprus,Uganda,21,17,4
2010,356,India,Uganda,739,359,380
2010,44,Bahamas,Uganda,11,3,8
2010,188,Costa Rica,Uganda,9,6,3
2010,32,Argentina,Uganda,1,0,1
2010,76,Brazil,Uganda,64,36,28
2010,152,Chile,Uganda,4,4,0
2010,36,Australia,Uganda,2860,1450,1410
2010,100,Bulgaria,Uganda,5,4,1
2010,203,Czechia,Uganda,23,12,11
2010,348,Hungary,Uganda,32,19,13
2010,616,Poland,Uganda,65,25,40
2010,643,Russian Federation,Uganda,80,46,34
2010,208,Denmark,Uganda,1352,517,835
2010,233,Estonia,Uganda,2,2,0
2010,246,Finland,Uganda,157,76,81
2010,352,Iceland,Uganda,22,5,17
2010,372,Ireland,Uganda,146,65,81
2010,428,Latvia,Uganda,2,2,0
2010,578,Norway,Uganda,839,402,437
2010,752,Sweden,Uganda,3013,1464,1549
2010,826,United Kingdom,Uganda,56501,28323,28178
2010,300,Greece,Uganda,148,57,91
2010,380,Italy,Uganda,996,452,544
2010,620,Portugal,Uganda,24,10,14
2010,705,Slovenia,Uganda,2,2,0
2010,724,Spain,Uganda,195,104,91
2010,40,Austria,Uganda,234,122,112
2010,56,Belgium,Uganda,522,255,267
2010,250,France,Uganda,545,218,327
2010,276,Germany,Uganda,2097,939,1158
2010,528,Netherlands,Uganda,1175,605,570
2010,756,Switzerland,Uganda,710,301,409
2010,124,Canada,Uganda,11750,5509,6241
2010,840,United States of America,Uganda,34638,14937,19701
2015,108,Burundi,Uganda,891,520,371
2015,232,Eritrea,Uganda,1524,1000,524
2015,231,Ethiopia,Uganda,218,111,107
2015,404,Kenya,Uganda,333789,157796,175993
2015,646,Rwanda,Uganda,92195,47755,44440
2015,690,Seychelles,Uganda,28,14,14
2015,728,South Sudan,Uganda,145607,77179,68428
2015,834,United Republic of Tanzania,Uganda,4857,2542,2315
2015,894,Zambia,Uganda,401,245,156
2015,180,Democratic Republic of the Congo,Uganda,6224,1135,5089
2015,72,Botswana,Uganda,305,185,120
2015,748,Eswatini,Uganda,55,27,28
2015,426,Lesotho,Uganda,137,76,61
2015,516,Namibia,Uganda,470,240,230
2015,710,South Africa,Uganda,7574,4307,3267
2015,324,Guinea,Uganda,1,1,0
2015,818,Egypt,Uganda,60,52,8
2015,729,Sudan,Uganda,1250,640,610
2015,196,Cyprus,Uganda,20,17,3
2015,356,India,Uganda,711,345,366
2015,44,Bahamas,Uganda,12,3,9
2015,188,Costa Rica,Uganda,9,6,3
2015,32,Argentina,Uganda,1,0,1
2015,76,Brazil,Uganda,77,43,34
2015,152,Chile,Uganda,6,6,0
2015,36,Australia,Uganda,3800,1936,1864
2015,100,Bulgaria,Uganda,7,5,2
2015,203,Czechia,Uganda,35,19,16
2015,348,Hungary,Uganda,38,23,15
2015,616,Poland,Uganda,62,25,37
2015,643,Russian Federation,Uganda,82,47,35
2015,208,Denmark,Uganda,1543,597,946
2015,233,Estonia,Uganda,6,3,3
2015,246,Finland,Uganda,236,109,127
2015,352,Iceland,Uganda,37,11,26
2015,372,Ireland,Uganda,149,65,84
2015,578,Norway,Uganda,1138,531,607
2015,752,Sweden,Uganda,4195,2071,2124
2015,826,United Kingdom,Uganda,72256,35152,37104
2015,300,Greece,Uganda,138,49,89
2015,380,Italy,Uganda,953,404,549
2015,620,Portugal,Uganda,27,10,17
2015,705,Slovenia,Uganda,4,2,2
2015,724,Spain,Uganda,211,110,101
2015,40,Austria,Uganda,274,144,130
2015,56,Belgium,Uganda,667,297,370
2015,250,France,Uganda,603,232,371
2015,276,Germany,Uganda,2185,976,1209
2015,528,Netherlands,Uganda,1508,719,789
2015,756,Switzerland,Uganda,750,326,424
2015,124,Canada,Uganda,13128,6352,6776
2015,840,United States of America,Uganda,45703,19577,26126
2019,108,Burundi,Uganda,986,576,410
2019,232,Eritrea,Uganda,1539,1010,529
2019,231,Ethiopia,Uganda,235,120,115
2019,404,Kenya,Uganda,309490,146430,163060
2019,646,Rwanda,Uganda,96724,50273,46451
2019,690,Seychelles,Uganda,28,14,14
2019,728,South Sudan,Uganda,149303,79103,70200
2019,834,United Republic of Tanzania,Uganda,4355,2268,2087
2019,894,Zambia,Uganda,516,316,200
2019,180,Democratic Republic of the Congo,Uganda,6019,1011,5008
2019,72,Botswana,Uganda,326,198,128
2019,748,Eswatini,Uganda,54,26,28
2019,426,Lesotho,Uganda,144,80,64
2019,516,Namibia,Uganda,497,254,243
2019,710,South Africa,Uganda,8488,4831,3657
2019,818,Egypt,Uganda,85,73,12
2019,729,Sudan,Uganda,1541,778,763
2019,196,Cyprus,Uganda,19,17,2
2019,356,India,Uganda,699,339,360
2019,44,Bahamas,Uganda,12,3,9
2019,188,Costa Rica,Uganda,9,6,3
2019,32,Argentina,Uganda,1,0,1
2019,76,Brazil,Uganda,86,48,38
2019,152,Chile,Uganda,8,8,0
2019,36,Australia,Uganda,4401,2207,2194
2019,100,Bulgaria,Uganda,9,7,2
2019,203,Czechia,Uganda,38,20,18
2019,348,Hungary,Uganda,49,30,19
2019,616,Poland,Uganda,65,28,37
2019,643,Russian Federation,Uganda,81,47,34
2019,208,Denmark,Uganda,1782,693,1089
2019,233,Estonia,Uganda,8,6,2
2019,246,Finland,Uganda,302,139,163
2019,352,Iceland,Uganda,46,16,30
2019,372,Ireland,Uganda,163,72,91
2019,578,Norway,Uganda,1390,646,744
2019,752,Sweden,Uganda,5051,2468,2583
2019,826,United Kingdom,Uganda,82054,40025,42029
2019,300,Greece,Uganda,134,51,83
2019,380,Italy,Uganda,1084,472,612
2019,620,Portugal,Uganda,27,10,17
2019,705,Slovenia,Uganda,5,2,3
2019,724,Spain,Uganda,218,111,107
2019,40,Austria,Uganda,323,173,150
2019,56,Belgium,Uganda,777,358,419
2019,250,France,Uganda,638,245,393
2019,276,Germany,Uganda,2396,1134,1262
2019,528,Netherlands,Uganda,2042,964,1078
2019,756,Switzerland,Uganda,820,340,480
2019,124,Canada,Uganda,14068,6807,7261
2019,840,United States of America,Uganda,49354,20838,28516
1990,516,Namibia,Ukraine,380,328,52
1990,710,South Africa,Ukraine,1822,832,990
1990,132,Cabo Verde,Ukraine,28,14,14
1990,324,Guinea,Ukraine,84,39,45
1990,818,Egypt,Ukraine,67,35,32
1990,434,Libya,Ukraine,189,98,91
1990,51,Armenia,Ukraine,10066,3708,6358
1990,31,Azerbaijan,Ukraine,3842,817,3025
1990,196,Cyprus,Ukraine,815,287,528
1990,268,Georgia,Ukraine,46581,20387,26194
1990,376,Israel,Ukraine,168081,77361,90720
1990,400,Jordan,Ukraine,45,6,39
1990,422,Lebanon,Ukraine,21,3,18
1990,792,Turkey,Ukraine,1011,342,669
1990,398,Kazakhstan,Ukraine,356063,163654,192409
1990,417,Kyrgyzstan,Ukraine,85115,35522,49593
1990,762,Tajikistan,Ukraine,3990,1752,2238
1990,795,Turkmenistan,Ukraine,12676,6038,6638
1990,860,Uzbekistan,Ukraine,180213,79596,100617
1990,192,Cuba,Ukraine,1367,460,907
1990,214,Dominican Republic,Ukraine,121,49,72
1990,188,Costa Rica,Ukraine,135,48,87
1990,484,Mexico,Ukraine,250,116,134
1990,558,Nicaragua,Ukraine,80,28,52
1990,591,Panama,Ukraine,66,40,26
1990,32,Argentina,Ukraine,3583,1535,2048
1990,152,Chile,Ukraine,35,18,17
1990,170,Colombia,Ukraine,208,79,129
1990,218,Ecuador,Ukraine,134,58,76
1990,604,Peru,Ukraine,149,52,97
1990,862,Venezuela (Bolivarian Republic of),Ukraine,187,77,110
1990,36,Australia,Ukraine,12428,6330,6098
1990,554,New Zealand,Ukraine,247,134,113
1990,112,Belarus,Ukraine,261845,125347,136498
1990,100,Bulgaria,Ukraine,1671,446,1225
1990,203,Czechia,Ukraine,8198,3958,4240
1990,348,Hungary,Ukraine,3040,1351,1689
1990,616,Poland,Ukraine,438692,181106,257586
1990,498,Republic of Moldova,Ukraine,243717,106759,136958
1990,642,Romania,Ukraine,15695,6575,9120
1990,643,Russian Federation,Ukraine,3301922,1620293,1681629
1990,703,Slovakia,Ukraine,2619,1012,1607
1990,208,Denmark,Ukraine,605,231,374
1990,233,Estonia,Ukraine,43063,23002,20061
1990,352,Iceland,Ukraine,11,3,8
1990,372,Ireland,Ukraine,170,83,87
1990,428,Latvia,Ukraine,46572,23774,22798
1990,440,Lithuania,Ukraine,43228,22776,20452
1990,578,Norway,Ukraine,6,3,3
1990,752,Sweden,Ukraine,1146,358,788
1990,826,United Kingdom,Ukraine,3233,2398,835
1990,300,Greece,Ukraine,189,105,84
1990,380,Italy,Ukraine,206,72,134
1990,470,Malta,Ukraine,30,6,24
1990,807,North Macedonia,Ukraine,65,27,38
1990,620,Portugal,Ukraine,3196,2594,602
1990,674,San Marino,Ukraine,4,3,1
1990,688,Serbia,Ukraine,156,29,127
1990,705,Slovenia,Ukraine,89,45,44
1990,724,Spain,Ukraine,408,169,239
1990,40,Austria,Ukraine,4534,1337,3197
1990,56,Belgium,Ukraine,527,182,345
1990,250,France,Ukraine,7869,2753,5116
1990,276,Germany,Ukraine,16108,7429,8679
1990,438,Liechtenstein,Ukraine,3,1,2
1990,442,Luxembourg,Ukraine,169,21,148
1990,528,Netherlands,Ukraine,46,28,18
1990,756,Switzerland,Ukraine,1593,464,1129
1990,124,Canada,Ukraine,50845,24753,26092
1990,840,United States of America,Ukraine,154211,75431,78780
1995,516,Namibia,Ukraine,363,314,49
1995,710,South Africa,Ukraine,1488,706,782
1995,132,Cabo Verde,Ukraine,37,19,18
1995,324,Guinea,Ukraine,96,50,46
1995,818,Egypt,Ukraine,92,36,56
1995,434,Libya,Ukraine,413,183,230
1995,51,Armenia,Ukraine,5665,1807,3858
1995,31,Azerbaijan,Ukraine,3372,878,2494
1995,196,Cyprus,Ukraine,1153,376,777
1995,268,Georgia,Ukraine,23412,10064,13348
1995,376,Israel,Ukraine,170963,77252,93711
1995,400,Jordan,Ukraine,263,36,227
1995,422,Lebanon,Ukraine,120,8,112
1995,792,Turkey,Ukraine,2447,760,1687
1995,398,Kazakhstan,Ukraine,302168,138997,163171
1995,417,Kyrgyzstan,Ukraine,69408,28631,40777
1995,762,Tajikistan,Ukraine,2520,1310,1210
1995,795,Turkmenistan,Ukraine,10354,5420,4934
1995,860,Uzbekistan,Ukraine,153360,67353,86007
1995,192,Cuba,Ukraine,1036,320,716
1995,214,Dominican Republic,Ukraine,135,53,82
1995,188,Costa Rica,Ukraine,102,38,64
1995,484,Mexico,Ukraine,279,123,156
1995,558,Nicaragua,Ukraine,64,22,42
1995,591,Panama,Ukraine,94,57,37
1995,32,Argentina,Ukraine,5809,2635,3174
1995,68,Bolivia (Plurinational State of),Ukraine,57,17,40
1995,152,Chile,Ukraine,96,52,44
1995,170,Colombia,Ukraine,203,78,125
1995,218,Ecuador,Ukraine,151,66,85
1995,604,Peru,Ukraine,150,51,99
1995,862,Venezuela (Bolivarian Republic of),Ukraine,184,76,108
1995,36,Australia,Ukraine,16704,8047,8657
1995,554,New Zealand,Ukraine,330,174,156
1995,112,Belarus,Ukraine,248032,119339,128693
1995,100,Bulgaria,Ukraine,2451,592,1859
1995,203,Czechia,Ukraine,12298,6115,6183
1995,348,Hungary,Ukraine,11454,4544,6910
1995,616,Poland,Ukraine,375267,151564,223703
1995,498,Republic of Moldova,Ukraine,164474,69651,94823
1995,642,Romania,Ukraine,14717,6044,8673
1995,643,Russian Federation,Ukraine,3485074,1694890,1790184
1995,703,Slovakia,Ukraine,4039,1350,2689
1995,208,Denmark,Ukraine,650,249,401
1995,233,Estonia,Ukraine,33755,17538,16217
1995,246,Finland,Ukraine,92,39,53
1995,352,Iceland,Ukraine,17,5,12
1995,372,Ireland,Ukraine,925,438,487
1995,428,Latvia,Ukraine,49867,24807,25060
1995,440,Lithuania,Ukraine,25598,13532,12066
1995,578,Norway,Ukraine,77,31,46
1995,752,Sweden,Ukraine,1360,417,943
1995,826,United Kingdom,Ukraine,7311,4476,2835
1995,300,Greece,Ukraine,8282,2162,6120
1995,380,Italy,Ukraine,6959,1124,5835
1995,470,Malta,Ukraine,36,8,28
1995,807,North Macedonia,Ukraine,61,26,35
1995,620,Portugal,Ukraine,6899,5597,1302
1995,674,San Marino,Ukraine,25,2,23
1995,688,Serbia,Ukraine,994,170,824
1995,705,Slovenia,Ukraine,193,62,131
1995,724,Spain,Ukraine,1038,456,582
1995,40,Austria,Ukraine,5115,1567,3548
1995,56,Belgium,Ukraine,523,179,344
1995,250,France,Ukraine,8124,2754,5370
1995,276,Germany,Ukraine,85683,34982,50701
1995,438,Liechtenstein,Ukraine,6,1,5
1995,442,Luxembourg,Ukraine,160,20,140
1995,528,Netherlands,Ukraine,67,40,27
1995,756,Switzerland,Ukraine,3109,949,2160
1995,124,Canada,Ukraine,51057,24738,26319
1995,840,United States of America,Ukraine,217555,106881,110674
2000,516,Namibia,Ukraine,338,291,47
2000,710,South Africa,Ukraine,1600,758,842
2000,132,Cabo Verde,Ukraine,46,24,22
2000,324,Guinea,Ukraine,104,54,50
2000,818,Egypt,Ukraine,125,40,85
2000,434,Libya,Ukraine,644,275,369
2000,51,Armenia,Ukraine,3008,622,2386
2000,31,Azerbaijan,Ukraine,3399,850,2549
2000,196,Cyprus,Ukraine,1490,465,1025
2000,268,Georgia,Ukraine,11706,5032,6674
2000,376,Israel,Ukraine,164271,73822,90449
2000,400,Jordan,Ukraine,480,67,413
2000,422,Lebanon,Ukraine,218,12,206
2000,792,Turkey,Ukraine,3893,1177,2716
2000,398,Kazakhstan,Ukraine,248273,114341,133932
2000,417,Kyrgyzstan,Ukraine,51798,20896,30902
2000,762,Tajikistan,Ukraine,1279,726,553
2000,795,Turkmenistan,Ukraine,8394,4273,4121
2000,860,Uzbekistan,Ukraine,131027,57167,73860
2000,192,Cuba,Ukraine,705,180,525
2000,214,Dominican Republic,Ukraine,148,56,92
2000,188,Costa Rica,Ukraine,119,43,76
2000,484,Mexico,Ukraine,322,137,185
2000,558,Nicaragua,Ukraine,65,25,40
2000,591,Panama,Ukraine,128,77,51
2000,32,Argentina,Ukraine,8036,3737,4299
2000,68,Bolivia (Plurinational State of),Ukraine,114,35,79
2000,152,Chile,Ukraine,157,84,73
2000,170,Colombia,Ukraine,197,76,121
2000,218,Ecuador,Ukraine,167,73,94
2000,604,Peru,Ukraine,176,58,118
2000,862,Venezuela (Bolivarian Republic of),Ukraine,180,73,107
2000,36,Australia,Ukraine,17040,7754,9286
2000,554,New Zealand,Ukraine,817,398,419
2000,112,Belarus,Ukraine,234219,113332,120887
2000,100,Bulgaria,Ukraine,3230,738,2492
2000,203,Czechia,Ukraine,16397,8271,8126
2000,348,Hungary,Ukraine,19867,7736,12131
2000,616,Poland,Ukraine,321013,126735,194278
2000,498,Republic of Moldova,Ukraine,111007,45350,65657
2000,642,Romania,Ukraine,13688,5492,8196
2000,643,Russian Federation,Ukraine,3541839,1708694,1833145
2000,703,Slovakia,Ukraine,6561,2069,4492
2000,208,Denmark,Ukraine,695,267,428
2000,233,Estonia,Ukraine,24457,12068,12389
2000,246,Finland,Ukraine,183,77,106
2000,352,Iceland,Ukraine,22,7,15
2000,372,Ireland,Ukraine,2189,1072,1117
2000,428,Latvia,Ukraine,53157,25837,27320
2000,440,Lithuania,Ukraine,20051,10581,9470
2000,578,Norway,Ukraine,314,75,239
2000,752,Sweden,Ukraine,1459,441,1018
2000,826,United Kingdom,Ukraine,11512,6621,4891
2000,300,Greece,Ukraine,16512,4144,12368
2000,380,Italy,Ukraine,13711,2175,11536
2000,470,Malta,Ukraine,92,23,69
2000,807,North Macedonia,Ukraine,57,24,33
2000,620,Portugal,Ukraine,10882,8831,2051
2000,674,San Marino,Ukraine,48,1,47
2000,688,Serbia,Ukraine,1352,208,1144
2000,705,Slovenia,Ukraine,438,165,273
2000,724,Spain,Ukraine,2115,955,1160
2000,40,Austria,Ukraine,5696,1797,3899
2000,56,Belgium,Ukraine,505,174,331
2000,250,France,Ukraine,8378,2754,5624
2000,276,Germany,Ukraine,155257,62534,92723
2000,438,Liechtenstein,Ukraine,9,1,8
2000,442,Luxembourg,Ukraine,154,19,135
2000,528,Netherlands,Ukraine,92,53,39
2000,756,Switzerland,Ukraine,4638,1444,3194
2000,124,Canada,Ukraine,52484,25318,27166
2000,840,United States of America,Ukraine,282139,139123,143016
2005,516,Namibia,Ukraine,267,230,37
2005,710,South Africa,Ukraine,2105,949,1156
2005,132,Cabo Verde,Ukraine,34,18,16
2005,324,Guinea,Ukraine,50,34,16
2005,818,Egypt,Ukraine,149,54,95
2005,434,Libya,Ukraine,709,376,333
2005,51,Armenia,Ukraine,1990,464,1526
2005,31,Azerbaijan,Ukraine,3225,731,2494
2005,196,Cyprus,Ukraine,2181,671,1510
2005,268,Georgia,Ukraine,11120,4780,6340
2005,376,Israel,Ukraine,146749,65661,81088
2005,400,Jordan,Ukraine,694,170,524
2005,422,Lebanon,Ukraine,171,16,155
2005,792,Turkey,Ukraine,4011,1149,2862
2005,398,Kazakhstan,Ukraine,283038,134400,148638
2005,417,Kyrgyzstan,Ukraine,41421,16587,24834
2005,762,Tajikistan,Ukraine,1233,752,481
2005,795,Turkmenistan,Ukraine,8325,4279,4046
2005,860,Uzbekistan,Ukraine,132963,59693,73270
2005,44,Bahamas,Ukraine,9,2,7
2005,192,Cuba,Ukraine,472,121,351
2005,214,Dominican Republic,Ukraine,110,40,70
2005,188,Costa Rica,Ukraine,78,28,50
2005,484,Mexico,Ukraine,307,119,188
2005,558,Nicaragua,Ukraine,69,29,40
2005,591,Panama,Ukraine,271,211,60
2005,32,Argentina,Ukraine,5928,2807,3121
2005,68,Bolivia (Plurinational State of),Ukraine,106,30,76
2005,152,Chile,Ukraine,235,128,107
2005,170,Colombia,Ukraine,188,74,114
2005,218,Ecuador,Ukraine,197,89,108
2005,604,Peru,Ukraine,206,70,136
2005,862,Venezuela (Bolivarian Republic of),Ukraine,189,77,112
2005,36,Australia,Ukraine,16800,7228,9572
2005,554,New Zealand,Ukraine,1104,536,568
2005,112,Belarus,Ukraine,230971,111734,119237
2005,100,Bulgaria,Ukraine,4526,1095,3431
2005,203,Czechia,Ukraine,73905,42073,31832
2005,348,Hungary,Ukraine,24540,9821,14719
2005,616,Poland,Ukraine,263473,100752,162721
2005,498,Republic of Moldova,Ukraine,76649,30478,46171
2005,642,Romania,Ukraine,13131,5407,7724
2005,643,Russian Federation,Ukraine,3293929,1557903,1736026
2005,703,Slovakia,Ukraine,7325,2374,4951
2005,208,Denmark,Ukraine,3602,1958,1644
2005,233,Estonia,Ukraine,24004,11681,12323
2005,246,Finland,Ukraine,593,257,336
2005,352,Iceland,Ukraine,118,41,77
2005,372,Ireland,Ukraine,3627,1978,1649
2005,428,Latvia,Ukraine,47145,22647,24498
2005,440,Lithuania,Ukraine,18521,9695,8826
2005,578,Norway,Ukraine,1120,267,853
2005,752,Sweden,Ukraine,2777,808,1969
2005,826,United Kingdom,Ukraine,15544,7147,8397
2005,191,Croatia,Ukraine,377,81,296
2005,300,Greece,Ukraine,18198,4315,13883
2005,380,Italy,Ukraine,117957,25160,92797
2005,470,Malta,Ukraine,145,36,109
2005,807,North Macedonia,Ukraine,58,25,33
2005,620,Portugal,Ukraine,28315,17856,10459
2005,674,San Marino,Ukraine,50,2,48
2005,688,Serbia,Ukraine,1334,192,1142
2005,705,Slovenia,Ukraine,943,255,688
2005,724,Spain,Ukraine,61162,30759,30403
2005,40,Austria,Ukraine,6367,1905,4462
2005,56,Belgium,Ukraine,423,146,277
2005,250,France,Ukraine,12020,3929,8091
2005,276,Germany,Ukraine,186103,76063,110040
2005,438,Liechtenstein,Ukraine,14,2,12
2005,442,Luxembourg,Ukraine,133,23,110
2005,528,Netherlands,Ukraine,427,217,210
2005,756,Switzerland,Ukraine,5401,1491,3910
2005,124,Canada,Ukraine,57232,26461,30771
2005,840,United States of America,Ukraine,298766,148160,150606
2010,516,Namibia,Ukraine,257,222,35
2010,710,South Africa,Ukraine,3297,1480,1817
2010,132,Cabo Verde,Ukraine,21,11,10
2010,324,Guinea,Ukraine,25,17,8
2010,818,Egypt,Ukraine,161,55,106
2010,434,Libya,Ukraine,776,416,360
2010,51,Armenia,Ukraine,1657,429,1228
2010,31,Azerbaijan,Ukraine,2953,753,2200
2010,196,Cyprus,Ukraine,3571,1130,2441
2010,268,Georgia,Ukraine,11231,4828,6403
2010,376,Israel,Ukraine,131007,58132,72875
2010,400,Jordan,Ukraine,892,257,635
2010,422,Lebanon,Ukraine,123,20,103
2010,792,Turkey,Ukraine,4133,1118,3015
2010,398,Kazakhstan,Ukraine,317803,154460,163343
2010,417,Kyrgyzstan,Ukraine,30395,11949,18446
2010,762,Tajikistan,Ukraine,1230,753,477
2010,795,Turkmenistan,Ukraine,8078,4002,4076
2010,860,Uzbekistan,Ukraine,129604,59826,69778
2010,44,Bahamas,Ukraine,17,4,13
2010,192,Cuba,Ukraine,262,66,196
2010,214,Dominican Republic,Ukraine,72,24,48
2010,188,Costa Rica,Ukraine,153,54,99
2010,484,Mexico,Ukraine,329,115,214
2010,558,Nicaragua,Ukraine,73,31,42
2010,591,Panama,Ukraine,428,356,72
2010,32,Argentina,Ukraine,3820,1877,1943
2010,68,Bolivia (Plurinational State of),Ukraine,98,26,72
2010,76,Brazil,Ukraine,727,311,416
2010,152,Chile,Ukraine,314,172,142
2010,170,Colombia,Ukraine,211,86,125
2010,218,Ecuador,Ukraine,276,120,156
2010,604,Peru,Ukraine,231,79,152
2010,862,Venezuela (Bolivarian Republic of),Ukraine,201,83,118
2010,36,Australia,Ukraine,16360,6657,9703
2010,554,New Zealand,Ukraine,1263,612,651
2010,112,Belarus,Ukraine,227722,110136,117586
2010,100,Bulgaria,Ukraine,5631,1404,4227
2010,203,Czechia,Ukraine,124172,73050,51122
2010,348,Hungary,Ukraine,29212,11906,17306
2010,616,Poland,Ukraine,214193,76854,137339
2010,498,Republic of Moldova,Ukraine,55935,22344,33591
2010,642,Romania,Ukraine,14032,5905,8127
2010,643,Russian Federation,Ukraine,2978217,1376105,1602112
2010,703,Slovakia,Ukraine,8258,2782,5476
2010,208,Denmark,Ukraine,6393,3586,2807
2010,233,Estonia,Ukraine,23350,11147,12203
2010,246,Finland,Ukraine,1114,433,681
2010,352,Iceland,Ukraine,213,75,138
2010,372,Ireland,Ukraine,4468,2349,2119
2010,428,Latvia,Ukraine,39933,18518,21415
2010,440,Lithuania,Ukraine,14475,7043,7432
2010,578,Norway,Ukraine,2463,582,1881
2010,752,Sweden,Ukraine,4741,1446,3295
2010,826,United Kingdom,Ukraine,16374,7710,8664
2010,191,Croatia,Ukraine,753,162,591
2010,300,Greece,Ukraine,20687,4673,16014
2010,380,Italy,Ukraine,213559,45333,168226
2010,470,Malta,Ukraine,235,61,174
2010,499,Montenegro,Ukraine,135,88,47
2010,807,North Macedonia,Ukraine,60,26,34
2010,620,Portugal,Ukraine,41047,23939,17108
2010,674,San Marino,Ukraine,53,3,50
2010,688,Serbia,Ukraine,1304,186,1118
2010,705,Slovenia,Ukraine,1382,375,1007
2010,724,Spain,Ukraine,79843,36759,43084
2010,40,Austria,Ukraine,7038,2013,5025
2010,56,Belgium,Ukraine,688,376,312
2010,250,France,Ukraine,14912,4677,10235
2010,276,Germany,Ukraine,211279,87197,124082
2010,438,Liechtenstein,Ukraine,20,3,17
2010,442,Luxembourg,Ukraine,115,28,87
2010,528,Netherlands,Ukraine,681,340,341
2010,756,Switzerland,Ukraine,6128,1440,4688
2010,124,Canada,Ukraine,65450,29290,36160
2010,840,United States of America,Ukraine,325001,158916,166085
2015,516,Namibia,Ukraine,251,217,34
2015,710,South Africa,Ukraine,5946,2503,3443
2015,132,Cabo Verde,Ukraine,22,12,10
2015,324,Guinea,Ukraine,9,6,3
2015,818,Egypt,Ukraine,119,51,68
2015,434,Libya,Ukraine,874,463,411
2015,51,Armenia,Ukraine,2464,638,1826
2015,31,Azerbaijan,Ukraine,2817,763,2054
2015,196,Cyprus,Ukraine,3430,1101,2329
2015,268,Georgia,Ukraine,11792,5069,6723
2015,376,Israel,Ukraine,135112,59587,75525
2015,400,Jordan,Ukraine,384,49,335
2015,422,Lebanon,Ukraine,104,50,54
2015,792,Turkey,Ukraine,4195,1066,3129
2015,398,Kazakhstan,Ukraine,338022,167131,170891
2015,417,Kyrgyzstan,Ukraine,26771,10431,16340
2015,762,Tajikistan,Ukraine,1209,737,472
2015,795,Turkmenistan,Ukraine,8012,4031,3981
2015,860,Uzbekistan,Ukraine,124602,58553,66049
2015,44,Bahamas,Ukraine,18,4,14
2015,192,Cuba,Ukraine,209,51,158
2015,214,Dominican Republic,Ukraine,75,25,50
2015,188,Costa Rica,Ukraine,155,54,101
2015,484,Mexico,Ukraine,349,120,229
2015,558,Nicaragua,Ukraine,78,33,45
2015,591,Panama,Ukraine,502,417,85
2015,32,Argentina,Ukraine,4408,2165,2243
2015,68,Bolivia (Plurinational State of),Ukraine,114,30,84
2015,76,Brazil,Ukraine,875,374,501
2015,152,Chile,Ukraine,475,256,219
2015,170,Colombia,Ukraine,236,98,138
2015,218,Ecuador,Ukraine,401,173,228
2015,604,Peru,Ukraine,245,88,157
2015,862,Venezuela (Bolivarian Republic of),Ukraine,211,85,126
2015,36,Australia,Ukraine,17090,7243,9847
2015,554,New Zealand,Ukraine,1402,678,724
2015,112,Belarus,Ukraine,225734,109228,116506
2015,100,Bulgaria,Ukraine,7039,1921,5118
2015,203,Czechia,Ukraine,100664,55523,45141
2015,348,Hungary,Ukraine,41990,19305,22685
2015,616,Poland,Ukraine,206519,76601,129918
2015,498,Republic of Moldova,Ukraine,43223,17202,26021
2015,642,Romania,Ukraine,11900,5895,6005
2015,643,Russian Federation,Ukraine,3269992,1518786,1751206
2015,703,Slovakia,Ukraine,10092,3945,6147
2015,208,Denmark,Ukraine,7150,3620,3530
2015,233,Estonia,Ukraine,21770,10513,11257
2015,246,Finland,Ukraine,1990,834,1156
2015,352,Iceland,Ukraine,274,90,184
2015,372,Ireland,Ukraine,4564,2373,2191
2015,428,Latvia,Ukraine,34080,15641,18439
2015,440,Lithuania,Ukraine,12347,5923,6424
2015,578,Norway,Ukraine,4270,1115,3155
2015,752,Sweden,Ukraine,7322,2397,4925
2015,826,United Kingdom,Ukraine,20939,9531,11408
2015,191,Croatia,Ukraine,758,162,596
2015,300,Greece,Ukraine,19416,3745,15671
2015,380,Italy,Ukraine,222938,46334,176604
2015,470,Malta,Ukraine,399,124,275
2015,499,Montenegro,Ukraine,150,96,54
2015,807,North Macedonia,Ukraine,64,28,36
2015,620,Portugal,Ukraine,46533,26141,20392
2015,674,San Marino,Ukraine,65,0,65
2015,688,Serbia,Ukraine,1274,179,1095
2015,705,Slovenia,Ukraine,1803,537,1266
2015,724,Spain,Ukraine,81618,34503,47115
2015,40,Austria,Ukraine,8232,2387,5845
2015,56,Belgium,Ukraine,1394,714,680
2015,250,France,Ukraine,16519,4870,11649
2015,276,Germany,Ukraine,220141,90550,129591
2015,438,Liechtenstein,Ukraine,38,10,28
2015,442,Luxembourg,Ukraine,175,45,130
2015,528,Netherlands,Ukraine,1208,587,621
2015,756,Switzerland,Ukraine,9585,2419,7166
2015,124,Canada,Ukraine,72582,33143,39439
2015,840,United States of America,Ukraine,383559,186544,197015
2019,516,Namibia,Ukraine,265,230,35
2019,710,South Africa,Ukraine,6663,2808,3855
2019,132,Cabo Verde,Ukraine,23,13,10
2019,324,Guinea,Ukraine,8,6,2
2019,818,Egypt,Ukraine,169,61,108
2019,434,Libya,Ukraine,927,491,436
2019,51,Armenia,Ukraine,2450,650,1800
2019,31,Azerbaijan,Ukraine,2706,733,1973
2019,196,Cyprus,Ukraine,3428,1124,2304
2019,268,Georgia,Ukraine,12153,5222,6931
2019,376,Israel,Ukraine,131392,57947,73445
2019,400,Jordan,Ukraine,412,52,360
2019,422,Lebanon,Ukraine,98,47,51
2019,792,Turkey,Ukraine,5672,1484,4188
2019,398,Kazakhstan,Ukraine,353225,174648,178577
2019,417,Kyrgyzstan,Ukraine,26231,10220,16011
2019,762,Tajikistan,Ukraine,1204,734,470
2019,795,Turkmenistan,Ukraine,7961,4055,3906
2019,860,Uzbekistan,Ukraine,124337,58480,65857
2019,44,Bahamas,Ukraine,19,5,14
2019,192,Cuba,Ukraine,192,46,146
2019,214,Dominican Republic,Ukraine,77,26,51
2019,188,Costa Rica,Ukraine,157,56,101
2019,484,Mexico,Ukraine,359,123,236
2019,558,Nicaragua,Ukraine,81,34,47
2019,591,Panama,Ukraine,534,445,89
2019,32,Argentina,Ukraine,4485,2199,2286
2019,68,Bolivia (Plurinational State of),Ukraine,124,33,91
2019,76,Brazil,Ukraine,985,421,564
2019,152,Chile,Ukraine,634,326,308
2019,170,Colombia,Ukraine,241,100,141
2019,218,Ecuador,Ukraine,394,170,224
2019,604,Peru,Ukraine,291,112,179
2019,862,Venezuela (Bolivarian Republic of),Ukraine,206,83,123
2019,36,Australia,Ukraine,18239,7631,10608
2019,554,New Zealand,Ukraine,1441,697,744
2019,112,Belarus,Ukraine,222917,107864,115053
2019,100,Bulgaria,Ukraine,10115,3211,6904
2019,203,Czechia,Ukraine,110337,60913,49424
2019,348,Hungary,Ukraine,55609,26966,28643
2019,616,Poland,Ukraine,218716,86408,132308
2019,498,Republic of Moldova,Ukraine,42548,16955,25593
2019,642,Romania,Ukraine,18345,9692,8653
2019,643,Russian Federation,Ukraine,3269248,1518432,1750816
2019,703,Slovakia,Ukraine,10839,4433,6406
2019,208,Denmark,Ukraine,10569,5153,5416
2019,233,Estonia,Ukraine,22445,11260,11185
2019,246,Finland,Ukraine,2767,1174,1593
2019,352,Iceland,Ukraine,377,144,233
2019,372,Ireland,Ukraine,5010,2612,2398
2019,428,Latvia,Ukraine,31141,14314,16827
2019,440,Lithuania,Ukraine,11461,5889,5572
2019,578,Norway,Ukraine,5377,1463,3914
2019,752,Sweden,Ukraine,10652,3719,6933
2019,826,United Kingdom,Ukraine,23778,10856,12922
2019,191,Croatia,Ukraine,699,148,551
2019,300,Greece,Ukraine,18962,4238,14724
2019,380,Italy,Ukraine,246367,54466,191901
2019,470,Malta,Ukraine,643,203,440
2019,499,Montenegro,Ukraine,141,92,49
2019,807,North Macedonia,Ukraine,64,28,36
2019,620,Portugal,Ukraine,47323,26629,20694
2019,674,San Marino,Ukraine,68,11,57
2019,688,Serbia,Ukraine,1294,183,1111
2019,705,Slovenia,Ukraine,2347,775,1572
2019,724,Spain,Ukraine,94120,39182,54938
2019,40,Austria,Ukraine,9717,2936,6781
2019,56,Belgium,Ukraine,1955,968,987
2019,250,France,Ukraine,17485,5127,12358
2019,276,Germany,Ukraine,241486,97270,144216
2019,438,Liechtenstein,Ukraine,42,8,34
2019,442,Luxembourg,Ukraine,1341,367,974
2019,528,Netherlands,Ukraine,2236,1041,1195
2019,756,Switzerland,Ukraine,10474,2695,7779
2019,124,Canada,Ukraine,77779,35516,42263
2019,840,United States of America,Ukraine,414206,199159,215047
1990,710,South Africa,United Arab Emirates,175,67,108
1990,478,Mauritania,United Arab Emirates,62,24,38
1990,818,Egypt,United Arab Emirates,464,302,162
1990,434,Libya,United Arab Emirates,1322,863,459
1990,48,Bahrain,United Arab Emirates,771,313,458
1990,196,Cyprus,United Arab Emirates,38,23,15
1990,368,Iraq,United Arab Emirates,222,168,54
1990,400,Jordan,United Arab Emirates,156,64,92
1990,414,Kuwait,United Arab Emirates,4778,846,3932
1990,512,Oman,United Arab Emirates,2702,1562,1140
1990,634,Qatar,United Arab Emirates,39178,25344,13834
1990,275,State of Palestine,United Arab Emirates,10629,5173,5456
1990,792,Turkey,United Arab Emirates,3344,1762,1582
1990,356,India,United Arab Emirates,9940,4881,5059
1990,144,Sri Lanka,United Arab Emirates,19,10,9
1990,608,Philippines,United Arab Emirates,99,54,45
1990,152,Chile,United Arab Emirates,8,4,4
1990,170,Colombia,United Arab Emirates,38,24,14
1990,36,Australia,United Arab Emirates,561,305,256
1990,112,Belarus,United Arab Emirates,15,9,6
1990,100,Bulgaria,United Arab Emirates,1,1,0
1990,203,Czechia,United Arab Emirates,8,7,1
1990,616,Poland,United Arab Emirates,118,61,57
1990,642,Romania,United Arab Emirates,5,5,0
1990,643,Russian Federation,United Arab Emirates,283,139,144
1990,703,Slovakia,United Arab Emirates,4,3,1
1990,208,Denmark,United Arab Emirates,56,38,18
1990,246,Finland,United Arab Emirates,14,11,3
1990,372,Ireland,United Arab Emirates,39,20,19
1990,428,Latvia,United Arab Emirates,1,1,0
1990,440,Lithuania,United Arab Emirates,17,10,7
1990,578,Norway,United Arab Emirates,27,16,11
1990,752,Sweden,United Arab Emirates,275,140,135
1990,826,United Kingdom,United Arab Emirates,754,506,248
1990,300,Greece,United Arab Emirates,17,9,8
1990,380,Italy,United Arab Emirates,2,1,1
1990,470,Malta,United Arab Emirates,6,3,3
1990,688,Serbia,United Arab Emirates,2,1,1
1990,724,Spain,United Arab Emirates,14,7,7
1990,40,Austria,United Arab Emirates,97,46,51
1990,250,France,United Arab Emirates,266,153,113
1990,528,Netherlands,United Arab Emirates,20,15,5
1990,756,Switzerland,United Arab Emirates,124,75,49
1990,124,Canada,United Arab Emirates,1218,593,625
1990,840,United States of America,United Arab Emirates,1656,1040,616
1995,710,South Africa,United Arab Emirates,109,48,61
1995,478,Mauritania,United Arab Emirates,66,30,36
1995,818,Egypt,United Arab Emirates,475,290,185
1995,434,Libya,United Arab Emirates,1669,1063,606
1995,48,Bahrain,United Arab Emirates,1359,590,769
1995,196,Cyprus,United Arab Emirates,54,32,22
1995,368,Iraq,United Arab Emirates,262,183,79
1995,400,Jordan,United Arab Emirates,205,105,100
1995,414,Kuwait,United Arab Emirates,5852,1924,3928
1995,512,Oman,United Arab Emirates,7470,4299,3171
1995,634,Qatar,United Arab Emirates,41796,28726,13070
1995,275,State of Palestine,United Arab Emirates,10387,5029,5358
1995,792,Turkey,United Arab Emirates,1689,893,796
1995,356,India,United Arab Emirates,12301,6147,6154
1995,144,Sri Lanka,United Arab Emirates,215,170,45
1995,608,Philippines,United Arab Emirates,133,72,61
1995,68,Bolivia (Plurinational State of),United Arab Emirates,1,1,0
1995,152,Chile,United Arab Emirates,6,6,0
1995,170,Colombia,United Arab Emirates,37,23,14
1995,36,Australia,United Arab Emirates,1005,538,467
1995,112,Belarus,United Arab Emirates,19,10,9
1995,100,Bulgaria,United Arab Emirates,14,8,6
1995,203,Czechia,United Arab Emirates,12,10,2
1995,348,Hungary,United Arab Emirates,62,34,28
1995,616,Poland,United Arab Emirates,100,51,49
1995,642,Romania,United Arab Emirates,4,4,0
1995,643,Russian Federation,United Arab Emirates,261,146,115
1995,703,Slovakia,United Arab Emirates,20,13,7
1995,208,Denmark,United Arab Emirates,124,72,52
1995,246,Finland,United Arab Emirates,22,17,5
1995,352,Iceland,United Arab Emirates,1,1,0
1995,372,Ireland,United Arab Emirates,107,53,54
1995,428,Latvia,United Arab Emirates,1,1,0
1995,440,Lithuania,United Arab Emirates,19,12,7
1995,578,Norway,United Arab Emirates,34,16,18
1995,752,Sweden,United Arab Emirates,327,165,162
1995,826,United Kingdom,United Arab Emirates,2965,1721,1244
1995,300,Greece,United Arab Emirates,47,29,18
1995,380,Italy,United Arab Emirates,11,4,7
1995,470,Malta,United Arab Emirates,8,4,4
1995,688,Serbia,United Arab Emirates,18,9,9
1995,724,Spain,United Arab Emirates,22,11,11
1995,40,Austria,United Arab Emirates,109,52,57
1995,250,France,United Arab Emirates,275,156,119
1995,528,Netherlands,United Arab Emirates,29,22,7
1995,756,Switzerland,United Arab Emirates,192,114,78
1995,124,Canada,United Arab Emirates,3822,1846,1976
1995,840,United States of America,United Arab Emirates,4255,2694,1561
2000,710,South Africa,United Arab Emirates,76,40,36
2000,478,Mauritania,United Arab Emirates,68,35,33
2000,818,Egypt,United Arab Emirates,523,301,222
2000,434,Libya,United Arab Emirates,2044,1294,750
2000,48,Bahrain,United Arab Emirates,1952,859,1093
2000,196,Cyprus,United Arab Emirates,69,40,29
2000,368,Iraq,United Arab Emirates,248,155,93
2000,400,Jordan,United Arab Emirates,254,147,107
2000,414,Kuwait,United Arab Emirates,9199,3792,5407
2000,512,Oman,United Arab Emirates,10139,6173,3966
2000,634,Qatar,United Arab Emirates,38184,27896,10288
2000,275,State of Palestine,United Arab Emirates,10145,4884,5261
2000,792,Turkey,United Arab Emirates,41,26,15
2000,356,India,United Arab Emirates,14662,7413,7249
2000,144,Sri Lanka,United Arab Emirates,413,283,130
2000,608,Philippines,United Arab Emirates,453,230,223
2000,68,Bolivia (Plurinational State of),United Arab Emirates,2,2,0
2000,152,Chile,United Arab Emirates,5,5,0
2000,170,Colombia,United Arab Emirates,36,23,13
2000,36,Australia,United Arab Emirates,1390,739,651
2000,112,Belarus,United Arab Emirates,23,11,12
2000,100,Bulgaria,United Arab Emirates,26,15,11
2000,203,Czechia,United Arab Emirates,15,12,3
2000,348,Hungary,United Arab Emirates,123,67,56
2000,616,Poland,United Arab Emirates,86,43,43
2000,642,Romania,United Arab Emirates,4,4,0
2000,643,Russian Federation,United Arab Emirates,230,147,83
2000,703,Slovakia,United Arab Emirates,43,26,17
2000,208,Denmark,United Arab Emirates,192,106,86
2000,246,Finland,United Arab Emirates,30,23,7
2000,352,Iceland,United Arab Emirates,1,1,0
2000,372,Ireland,United Arab Emirates,235,121,114
2000,428,Latvia,United Arab Emirates,2,2,0
2000,440,Lithuania,United Arab Emirates,14,9,5
2000,578,Norway,United Arab Emirates,82,41,41
2000,752,Sweden,United Arab Emirates,351,176,175
2000,826,United Kingdom,United Arab Emirates,5226,2960,2266
2000,300,Greece,United Arab Emirates,77,49,28
2000,380,Italy,United Arab Emirates,19,7,12
2000,470,Malta,United Arab Emirates,9,5,4
2000,688,Serbia,United Arab Emirates,25,12,13
2000,705,Slovenia,United Arab Emirates,2,1,1
2000,724,Spain,United Arab Emirates,266,144,122
2000,40,Austria,United Arab Emirates,121,59,62
2000,250,France,United Arab Emirates,283,159,124
2000,528,Netherlands,United Arab Emirates,41,30,11
2000,756,Switzerland,United Arab Emirates,262,154,108
2000,124,Canada,United Arab Emirates,6517,3144,3373
2000,840,United States of America,United Arab Emirates,6915,4389,2526
2005,710,South Africa,United Arab Emirates,99,49,50
2005,478,Mauritania,United Arab Emirates,68,36,32
2005,818,Egypt,United Arab Emirates,623,375,248
2005,434,Libya,United Arab Emirates,2251,1573,678
2005,48,Bahrain,United Arab Emirates,3429,1716,1713
2005,196,Cyprus,United Arab Emirates,101,59,42
2005,368,Iraq,United Arab Emirates,284,207,77
2005,400,Jordan,United Arab Emirates,366,230,136
2005,414,Kuwait,United Arab Emirates,13635,6304,7331
2005,512,Oman,United Arab Emirates,7711,4514,3197
2005,634,Qatar,United Arab Emirates,18041,11902,6139
2005,275,State of Palestine,United Arab Emirates,10570,5061,5509
2005,792,Turkey,United Arab Emirates,42,27,15
2005,356,India,United Arab Emirates,13547,6834,6713
2005,144,Sri Lanka,United Arab Emirates,816,406,410
2005,608,Philippines,United Arab Emirates,366,189,177
2005,68,Bolivia (Plurinational State of),United Arab Emirates,1,1,0
2005,152,Chile,United Arab Emirates,7,7,0
2005,170,Colombia,United Arab Emirates,34,22,12
2005,36,Australia,United Arab Emirates,2800,1588,1212
2005,112,Belarus,United Arab Emirates,22,10,12
2005,100,Bulgaria,United Arab Emirates,43,25,18
2005,203,Czechia,United Arab Emirates,25,20,5
2005,348,Hungary,United Arab Emirates,152,84,68
2005,616,Poland,United Arab Emirates,106,54,52
2005,642,Romania,United Arab Emirates,3,3,0
2005,643,Russian Federation,United Arab Emirates,292,176,116
2005,703,Slovakia,United Arab Emirates,49,30,19
2005,208,Denmark,United Arab Emirates,258,137,121
2005,246,Finland,United Arab Emirates,56,39,17
2005,352,Iceland,United Arab Emirates,2,1,1
2005,372,Ireland,United Arab Emirates,235,128,107
2005,428,Latvia,United Arab Emirates,5,4,1
2005,440,Lithuania,United Arab Emirates,21,12,9
2005,578,Norway,United Arab Emirates,132,68,64
2005,752,Sweden,United Arab Emirates,484,252,232
2005,826,United Kingdom,United Arab Emirates,7777,4397,3380
2005,300,Greece,United Arab Emirates,83,49,34
2005,380,Italy,United Arab Emirates,195,102,93
2005,470,Malta,United Arab Emirates,13,7,6
2005,688,Serbia,United Arab Emirates,25,12,13
2005,705,Slovenia,United Arab Emirates,5,2,3
2005,724,Spain,United Arab Emirates,128,68,60
2005,40,Austria,United Arab Emirates,136,64,72
2005,250,France,United Arab Emirates,641,322,319
2005,528,Netherlands,United Arab Emirates,426,231,195
2005,756,Switzerland,United Arab Emirates,313,173,140
2005,124,Canada,United Arab Emirates,10402,5444,4958
2005,840,United States of America,United Arab Emirates,8252,4134,4118
2010,710,South Africa,United Arab Emirates,154,76,78
2010,466,Mali,United Arab Emirates,2485,1297,1188
2010,478,Mauritania,United Arab Emirates,68,37,31
2010,818,Egypt,United Arab Emirates,672,394,278
2010,434,Libya,United Arab Emirates,2462,1728,734
2010,48,Bahrain,United Arab Emirates,5663,2955,2708
2010,196,Cyprus,United Arab Emirates,165,98,67
2010,368,Iraq,United Arab Emirates,287,214,73
2010,400,Jordan,United Arab Emirates,471,306,165
2010,414,Kuwait,United Arab Emirates,21472,10477,10995
2010,512,Oman,United Arab Emirates,6529,3729,2800
2010,634,Qatar,United Arab Emirates,12533,8875,3658
2010,275,State of Palestine,United Arab Emirates,10996,5238,5758
2010,792,Turkey,United Arab Emirates,43,28,15
2010,356,India,United Arab Emirates,12432,6255,6177
2010,144,Sri Lanka,United Arab Emirates,1645,833,812
2010,608,Philippines,United Arab Emirates,425,210,215
2010,76,Brazil,United Arab Emirates,32,32,0
2010,152,Chile,United Arab Emirates,10,10,0
2010,170,Colombia,United Arab Emirates,38,25,13
2010,36,Australia,United Arab Emirates,5240,3048,2192
2010,112,Belarus,United Arab Emirates,20,9,11
2010,100,Bulgaria,United Arab Emirates,58,34,24
2010,203,Czechia,United Arab Emirates,33,26,7
2010,348,Hungary,United Arab Emirates,181,101,80
2010,616,Poland,United Arab Emirates,130,67,63
2010,642,Romania,United Arab Emirates,13,13,0
2010,643,Russian Federation,United Arab Emirates,349,202,147
2010,703,Slovakia,United Arab Emirates,55,34,21
2010,208,Denmark,United Arab Emirates,318,165,153
2010,233,Estonia,United Arab Emirates,7,5,2
2010,246,Finland,United Arab Emirates,88,58,30
2010,352,Iceland,United Arab Emirates,2,1,1
2010,372,Ireland,United Arab Emirates,197,101,96
2010,428,Latvia,United Arab Emirates,9,6,3
2010,440,Lithuania,United Arab Emirates,27,14,13
2010,578,Norway,United Arab Emirates,244,119,125
2010,752,Sweden,United Arab Emirates,742,400,342
2010,826,United Kingdom,United Arab Emirates,8192,4705,3487
2010,300,Greece,United Arab Emirates,91,51,40
2010,380,Italy,United Arab Emirates,324,165,159
2010,470,Malta,United Arab Emirates,21,15,6
2010,688,Serbia,United Arab Emirates,25,12,13
2010,705,Slovenia,United Arab Emirates,15,5,10
2010,724,Spain,United Arab Emirates,225,127,98
2010,40,Austria,United Arab Emirates,150,69,81
2010,250,France,United Arab Emirates,736,407,329
2010,528,Netherlands,United Arab Emirates,520,272,248
2010,756,Switzerland,United Arab Emirates,347,188,159
2010,124,Canada,United Arab Emirates,14355,7783,6572
2010,840,United States of America,United Arab Emirates,9880,4883,4997
2015,710,South Africa,United Arab Emirates,276,129,147
2015,466,Mali,United Arab Emirates,3079,1608,1471
2015,478,Mauritania,United Arab Emirates,68,38,30
2015,818,Egypt,United Arab Emirates,498,319,179
2015,434,Libya,United Arab Emirates,2775,1937,838
2015,48,Bahrain,United Arab Emirates,4041,2080,1961
2015,196,Cyprus,United Arab Emirates,158,95,63
2015,368,Iraq,United Arab Emirates,288,226,62
2015,400,Jordan,United Arab Emirates,203,117,86
2015,414,Kuwait,United Arab Emirates,24662,10294,14368
2015,512,Oman,United Arab Emirates,14848,9439,5409
2015,634,Qatar,United Arab Emirates,9682,7042,2640
2015,275,State of Palestine,United Arab Emirates,10888,5173,5715
2015,792,Turkey,United Arab Emirates,43,28,15
2015,356,India,United Arab Emirates,11977,6019,5958
2015,144,Sri Lanka,United Arab Emirates,1676,834,842
2015,608,Philippines,United Arab Emirates,431,213,218
2015,76,Brazil,United Arab Emirates,39,39,0
2015,152,Chile,United Arab Emirates,15,15,0
2015,170,Colombia,United Arab Emirates,42,28,14
2015,36,Australia,United Arab Emirates,8090,4295,3795
2015,112,Belarus,United Arab Emirates,23,11,12
2015,100,Bulgaria,United Arab Emirates,151,80,71
2015,203,Czechia,United Arab Emirates,67,50,17
2015,348,Hungary,United Arab Emirates,281,158,123
2015,616,Poland,United Arab Emirates,125,66,59
2015,642,Romania,United Arab Emirates,13,12,1
2015,643,Russian Federation,United Arab Emirates,355,205,150
2015,703,Slovakia,United Arab Emirates,75,44,31
2015,208,Denmark,United Arab Emirates,387,202,185
2015,233,Estonia,United Arab Emirates,7,7,0
2015,246,Finland,United Arab Emirates,176,102,74
2015,352,Iceland,United Arab Emirates,6,4,2
2015,372,Ireland,United Arab Emirates,201,102,99
2015,428,Latvia,United Arab Emirates,12,5,7
2015,440,Lithuania,United Arab Emirates,35,20,15
2015,578,Norway,United Arab Emirates,437,239,198
2015,752,Sweden,United Arab Emirates,1777,962,815
2015,826,United Kingdom,United Arab Emirates,10476,5885,4591
2015,300,Greece,United Arab Emirates,85,46,39
2015,380,Italy,United Arab Emirates,374,192,182
2015,470,Malta,United Arab Emirates,35,25,10
2015,688,Serbia,United Arab Emirates,24,12,12
2015,705,Slovenia,United Arab Emirates,12,5,7
2015,724,Spain,United Arab Emirates,326,186,140
2015,40,Austria,United Arab Emirates,176,82,94
2015,250,France,United Arab Emirates,815,440,375
2015,528,Netherlands,United Arab Emirates,742,395,347
2015,756,Switzerland,United Arab Emirates,594,309,285
2015,124,Canada,United Arab Emirates,20866,11067,9799
2015,840,United States of America,United Arab Emirates,12419,6106,6313
2019,710,South Africa,United Arab Emirates,308,144,164
2019,466,Mali,United Arab Emirates,3428,1791,1637
2019,478,Mauritania,United Arab Emirates,70,39,31
2019,818,Egypt,United Arab Emirates,709,424,285
2019,434,Libya,United Arab Emirates,2944,2055,889
2019,48,Bahrain,United Arab Emirates,4253,2189,2064
2019,196,Cyprus,United Arab Emirates,157,95,62
2019,368,Iraq,United Arab Emirates,294,231,63
2019,400,Jordan,United Arab Emirates,218,126,92
2019,414,Kuwait,United Arab Emirates,26113,10900,15213
2019,512,Oman,United Arab Emirates,18287,11626,6661
2019,634,Qatar,United Arab Emirates,9875,6991,2884
2019,275,State of Palestine,United Arab Emirates,10812,5137,5675
2019,792,Turkey,United Arab Emirates,58,38,20
2019,356,India,United Arab Emirates,11779,5921,5858
2019,144,Sri Lanka,United Arab Emirates,1689,841,848
2019,608,Philippines,United Arab Emirates,444,220,224
2019,76,Brazil,United Arab Emirates,43,43,0
2019,152,Chile,United Arab Emirates,20,20,0
2019,170,Colombia,United Arab Emirates,42,28,14
2019,36,Australia,United Arab Emirates,10939,5887,5052
2019,112,Belarus,United Arab Emirates,22,11,11
2019,100,Bulgaria,United Arab Emirates,285,158,127
2019,203,Czechia,United Arab Emirates,127,92,35
2019,348,Hungary,United Arab Emirates,421,235,186
2019,616,Poland,United Arab Emirates,132,72,60
2019,642,Romania,United Arab Emirates,296,159,137
2019,643,Russian Federation,United Arab Emirates,354,205,149
2019,703,Slovakia,United Arab Emirates,103,62,41
2019,208,Denmark,United Arab Emirates,594,320,274
2019,233,Estonia,United Arab Emirates,17,14,3
2019,246,Finland,United Arab Emirates,268,158,110
2019,352,Iceland,United Arab Emirates,7,5,2
2019,372,Ireland,United Arab Emirates,220,112,108
2019,428,Latvia,United Arab Emirates,18,11,7
2019,440,Lithuania,United Arab Emirates,36,20,16
2019,578,Norway,United Arab Emirates,553,296,257
2019,752,Sweden,United Arab Emirates,4764,2600,2164
2019,826,United Kingdom,United Arab Emirates,11896,6696,5200
2019,300,Greece,United Arab Emirates,83,47,36
2019,380,Italy,United Arab Emirates,498,274,224
2019,470,Malta,United Arab Emirates,56,40,16
2019,688,Serbia,United Arab Emirates,24,12,12
2019,705,Slovenia,United Arab Emirates,12,5,7
2019,724,Spain,United Arab Emirates,337,189,148
2019,40,Austria,United Arab Emirates,207,98,109
2019,250,France,United Arab Emirates,862,465,397
2019,528,Netherlands,United Arab Emirates,1541,865,676
2019,756,Switzerland,United Arab Emirates,761,390,371
2019,124,Canada,United Arab Emirates,22360,11860,10500
2019,840,United States of America,United Arab Emirates,13411,6521,6890
1990,232,Eritrea,United Kingdom,34,14,20
1990,454,Malawi,United Kingdom,769,399,370
1990,480,Mauritius,United Kingdom,694,304,390
1990,690,Seychelles,United Kingdom,274,127,147
1990,800,Uganda,United Kingdom,1034,546,488
1990,834,United Republic of Tanzania,United Kingdom,682,390,292
1990,894,Zambia,United Kingdom,1987,1090,897
1990,716,Zimbabwe,United Kingdom,19136,10919,8217
1990,72,Botswana,United Kingdom,3289,1848,1441
1990,516,Namibia,United Kingdom,2540,1062,1478
1990,710,South Africa,United Kingdom,117362,47415,69947
1990,132,Cabo Verde,United Kingdom,14,7,7
1990,288,Ghana,United Kingdom,972,469,503
1990,430,Liberia,United Kingdom,1146,608,538
1990,654,Saint Helena,United Kingdom,127,80,47
1990,694,Sierra Leone,United Kingdom,611,345,266
1990,12,Algeria,United Kingdom,2060,1195,865
1990,818,Egypt,United Kingdom,3051,1718,1333
1990,434,Libya,United Kingdom,8712,4926,3786
1990,504,Morocco,United Kingdom,828,438,390
1990,48,Bahrain,United Kingdom,1614,940,674
1990,196,Cyprus,United Kingdom,9055,4361,4694
1990,376,Israel,United Kingdom,14958,7092,7866
1990,400,Jordan,United Kingdom,465,251,214
1990,414,Kuwait,United Kingdom,10010,4226,5784
1990,422,Lebanon,United Kingdom,212,114,98
1990,512,Oman,United Kingdom,4260,2866,1394
1990,634,Qatar,United Kingdom,2886,1742,1144
1990,792,Turkey,United Kingdom,6483,3140,3343
1990,784,United Arab Emirates,United Kingdom,12229,7070,5159
1990,762,Tajikistan,United Kingdom,477,210,267
1990,50,Bangladesh,United Kingdom,9090,4909,4181
1990,64,Bhutan,United Kingdom,17,8,9
1990,356,India,United Kingdom,5063,2394,2669
1990,462,Maldives,United Kingdom,94,52,42
1990,144,Sri Lanka,United Kingdom,48,31,17
1990,156,China,United Kingdom,4737,2935,1802
1990,344,"China, Hong Kong SAR",United Kingdom,11838,7658,4180
1990,408,Dem. People's Republic of Korea,United Kingdom,188,110,78
1990,392,Japan,United Kingdom,10209,5201,5008
1990,496,Mongolia,United Kingdom,65,28,37
1990,410,Republic of Korea,United Kingdom,559,324,235
1990,96,Brunei Darussalam,United Kingdom,1996,1144,852
1990,116,Cambodia,United Kingdom,43,30,13
1990,360,Indonesia,United Kingdom,20883,11363,9520
1990,458,Malaysia,United Kingdom,3433,2154,1279
1990,608,Philippines,United Kingdom,6028,3305,2723
1990,764,Thailand,United Kingdom,21,13,8
1990,704,Viet Nam,United Kingdom,256,140,116
1990,660,Anguilla,United Kingdom,197,70,127
1990,28,Antigua and Barbuda,United Kingdom,623,299,324
1990,44,Bahamas,United Kingdom,1964,1043,921
1990,52,Barbados,United Kingdom,2988,1347,1641
1990,92,British Virgin Islands,United Kingdom,440,250,190
1990,535,"Bonaire, Sint Eustatius and Saba",United Kingdom,50,28,22
1990,136,Cayman Islands,United Kingdom,1040,571,469
1990,192,Cuba,United Kingdom,110,66,44
1990,212,Dominica,United Kingdom,230,118,112
1990,214,Dominican Republic,United Kingdom,581,380,201
1990,312,Guadeloupe,United Kingdom,166,80,86
1990,388,Jamaica,United Kingdom,5469,2617,2852
1990,474,Martinique,United Kingdom,67,33,34
1990,500,Montserrat,United Kingdom,156,81,75
1990,630,Puerto Rico,United Kingdom,336,159,177
1990,662,Saint Lucia,United Kingdom,405,189,216
1990,670,Saint Vincent and the Grenadines,United Kingdom,682,352,330
1990,780,Trinidad and Tobago,United Kingdom,2157,1077,1080
1990,796,Turks and Caicos Islands,United Kingdom,246,128,118
1990,84,Belize,United Kingdom,306,195,111
1990,188,Costa Rica,United Kingdom,451,268,183
1990,222,El Salvador,United Kingdom,135,86,49
1990,320,Guatemala,United Kingdom,125,47,78
1990,340,Honduras,United Kingdom,78,55,23
1990,484,Mexico,United Kingdom,2273,1199,1074
1990,558,Nicaragua,United Kingdom,46,29,17
1990,591,Panama,United Kingdom,319,205,114
1990,32,Argentina,United Kingdom,2391,969,1422
1990,68,Bolivia (Plurinational State of),United Kingdom,580,307,273
1990,76,Brazil,United Kingdom,3849,2086,1763
1990,152,Chile,United Kingdom,1428,745,683
1990,170,Colombia,United Kingdom,991,541,450
1990,218,Ecuador,United Kingdom,719,381,338
1990,238,Falkland Islands (Malvinas),United Kingdom,664,382,282
1990,328,Guyana,United Kingdom,131,71,60
1990,600,Paraguay,United Kingdom,140,73,67
1990,604,Peru,United Kingdom,1053,557,496
1990,858,Uruguay,United Kingdom,535,263,272
1990,862,Venezuela (Bolivarian Republic of),United Kingdom,1881,989,892
1990,36,Australia,United Kingdom,1111203,561186,550017
1990,554,New Zealand,United Kingdom,227889,114932,112957
1990,242,Fiji,United Kingdom,759,432,327
1990,598,Papua New Guinea,United Kingdom,2192,1155,1037
1990,90,Solomon Islands,United Kingdom,85,60,25
1990,548,Vanuatu,United Kingdom,239,138,101
1990,296,Kiribati,United Kingdom,23,19,4
1990,184,Cook Islands,United Kingdom,49,39,10
1990,258,French Polynesia,United Kingdom,76,42,34
1990,882,Samoa,United Kingdom,47,32,15
1990,112,Belarus,United Kingdom,340,178,162
1990,100,Bulgaria,United Kingdom,59,45,14
1990,203,Czechia,United Kingdom,351,241,110
1990,348,Hungary,United Kingdom,521,231,290
1990,616,Poland,United Kingdom,3732,2139,1593
1990,642,Romania,United Kingdom,273,148,125
1990,643,Russian Federation,United Kingdom,899,441,458
1990,703,Slovakia,United Kingdom,34,22,12
1990,830,Channel Islands,United Kingdom,54519,25643,28876
1990,208,Denmark,United Kingdom,9126,5155,3971
1990,233,Estonia,United Kingdom,31,20,11
1990,234,Faroe Islands,United Kingdom,139,76,63
1990,246,Finland,United Kingdom,1738,1119,619
1990,352,Iceland,United Kingdom,647,355,292
1990,372,Ireland,United Kingdom,184671,90869,93802
1990,833,Isle of Man,United Kingdom,30510,14427,16083
1990,428,Latvia,United Kingdom,117,85,32
1990,440,Lithuania,United Kingdom,281,136,145
1990,578,Norway,United Kingdom,14586,7901,6685
1990,752,Sweden,United Kingdom,11473,7379,4094
1990,20,Andorra,United Kingdom,1043,557,486
1990,191,Croatia,United Kingdom,182,53,129
1990,292,Gibraltar,United Kingdom,3025,1587,1438
1990,300,Greece,United Kingdom,34223,14115,20108
1990,380,Italy,United Kingdom,59492,18059,41433
1990,470,Malta,United Kingdom,5333,2289,3044
1990,620,Portugal,United Kingdom,6866,3302,3564
1990,688,Serbia,United Kingdom,79,44,35
1990,705,Slovenia,United Kingdom,75,36,39
1990,724,Spain,United Kingdom,61463,28231,33232
1990,40,Austria,United Kingdom,6067,3247,2820
1990,56,Belgium,United Kingdom,20477,11031,9446
1990,250,France,United Kingdom,102335,48902,53433
1990,276,Germany,United Kingdom,103961,60202,43759
1990,438,Liechtenstein,United Kingdom,27,18,9
1990,442,Luxembourg,United Kingdom,2355,1231,1124
1990,528,Netherlands,United Kingdom,36211,20267,15944
1990,756,Switzerland,United Kingdom,22512,11425,11087
1990,60,Bermuda,United Kingdom,4590,2565,2025
1990,124,Canada,United Kingdom,688691,335273,353418
1990,304,Greenland,United Kingdom,31,22,9
1990,840,United States of America,United Kingdom,640145,313120,327025
1995,232,Eritrea,United Kingdom,38,14,24
1995,454,Malawi,United Kingdom,1639,853,786
1995,480,Mauritius,United Kingdom,450,213,237
1995,690,Seychelles,United Kingdom,223,115,108
1995,800,Uganda,United Kingdom,979,501,478
1995,834,United Republic of Tanzania,United Kingdom,866,495,371
1995,894,Zambia,United Kingdom,1434,787,647
1995,716,Zimbabwe,United Kingdom,18132,10344,7788
1995,72,Botswana,United Kingdom,2034,922,1112
1995,516,Namibia,United Kingdom,2429,1025,1404
1995,710,South Africa,United Kingdom,105771,48929,56842
1995,132,Cabo Verde,United Kingdom,22,12,10
1995,288,Ghana,United Kingdom,969,516,453
1995,430,Liberia,United Kingdom,1119,582,537
1995,654,Saint Helena,United Kingdom,83,51,32
1995,694,Sierra Leone,United Kingdom,595,329,266
1995,12,Algeria,United Kingdom,1430,774,656
1995,818,Egypt,United Kingdom,2573,1400,1173
1995,434,Libya,United Kingdom,6959,3905,3054
1995,504,Morocco,United Kingdom,760,397,363
1995,48,Bahrain,United Kingdom,1493,890,603
1995,196,Cyprus,United Kingdom,12804,5899,6905
1995,376,Israel,United Kingdom,17066,7937,9129
1995,400,Jordan,United Kingdom,724,404,320
1995,414,Kuwait,United Kingdom,6908,3347,3561
1995,422,Lebanon,United Kingdom,329,174,155
1995,512,Oman,United Kingdom,5188,3436,1752
1995,634,Qatar,United Kingdom,2677,1718,959
1995,792,Turkey,United Kingdom,12029,5683,6346
1995,784,United Arab Emirates,United Kingdom,12845,7875,4970
1995,762,Tajikistan,United Kingdom,387,246,141
1995,50,Bangladesh,United Kingdom,16056,8671,7385
1995,64,Bhutan,United Kingdom,19,8,11
1995,356,India,United Kingdom,5508,2614,2894
1995,462,Maldives,United Kingdom,94,47,47
1995,144,Sri Lanka,United Kingdom,182,136,46
1995,156,China,United Kingdom,5649,3459,2190
1995,344,"China, Hong Kong SAR",United Kingdom,13212,8516,4696
1995,408,Dem. People's Republic of Korea,United Kingdom,205,118,87
1995,392,Japan,United Kingdom,12657,6075,6582
1995,496,Mongolia,United Kingdom,71,33,38
1995,410,Republic of Korea,United Kingdom,855,568,287
1995,96,Brunei Darussalam,United Kingdom,1961,1131,830
1995,116,Cambodia,United Kingdom,113,79,34
1995,360,Indonesia,United Kingdom,13817,7683,6134
1995,458,Malaysia,United Kingdom,3930,2471,1459
1995,608,Philippines,United Kingdom,8112,4375,3737
1995,764,Thailand,United Kingdom,36,23,13
1995,704,Viet Nam,United Kingdom,1230,641,589
1995,660,Anguilla,United Kingdom,254,87,167
1995,28,Antigua and Barbuda,United Kingdom,720,350,370
1995,44,Bahamas,United Kingdom,1834,1005,829
1995,52,Barbados,United Kingdom,3262,1500,1762
1995,92,British Virgin Islands,United Kingdom,517,288,229
1995,535,"Bonaire, Sint Eustatius and Saba",United Kingdom,104,58,46
1995,136,Cayman Islands,United Kingdom,1411,778,633
1995,192,Cuba,United Kingdom,84,49,35
1995,212,Dominica,United Kingdom,304,156,148
1995,214,Dominican Republic,United Kingdom,646,417,229
1995,312,Guadeloupe,United Kingdom,222,105,117
1995,388,Jamaica,United Kingdom,5286,2539,2747
1995,474,Martinique,United Kingdom,101,41,60
1995,500,Montserrat,United Kingdom,129,65,64
1995,630,Puerto Rico,United Kingdom,356,169,187
1995,662,Saint Lucia,United Kingdom,547,257,290
1995,670,Saint Vincent and the Grenadines,United Kingdom,719,372,347
1995,780,Trinidad and Tobago,United Kingdom,1958,976,982
1995,796,Turks and Caicos Islands,United Kingdom,316,167,149
1995,84,Belize,United Kingdom,297,186,111
1995,188,Costa Rica,United Kingdom,339,203,136
1995,222,El Salvador,United Kingdom,106,66,40
1995,320,Guatemala,United Kingdom,134,63,71
1995,340,Honduras,United Kingdom,77,53,24
1995,484,Mexico,United Kingdom,3058,1528,1530
1995,558,Nicaragua,United Kingdom,37,23,14
1995,591,Panama,United Kingdom,314,203,111
1995,32,Argentina,United Kingdom,2184,952,1232
1995,68,Bolivia (Plurinational State of),United Kingdom,619,333,286
1995,76,Brazil,United Kingdom,3947,2306,1641
1995,152,Chile,United Kingdom,1537,836,701
1995,170,Colombia,United Kingdom,1009,551,458
1995,218,Ecuador,United Kingdom,807,428,379
1995,238,Falkland Islands (Malvinas),United Kingdom,640,373,267
1995,328,Guyana,United Kingdom,211,115,96
1995,600,Paraguay,United Kingdom,169,91,78
1995,604,Peru,United Kingdom,1034,537,497
1995,858,Uruguay,United Kingdom,523,240,283
1995,862,Venezuela (Bolivarian Republic of),United Kingdom,1761,951,810
1995,36,Australia,United Kingdom,1100221,554569,545652
1995,554,New Zealand,United Kingdom,217660,109231,108429
1995,242,Fiji,United Kingdom,646,365,281
1995,598,Papua New Guinea,United Kingdom,2245,1132,1113
1995,90,Solomon Islands,United Kingdom,85,60,25
1995,548,Vanuatu,United Kingdom,152,80,72
1995,296,Kiribati,United Kingdom,18,14,4
1995,184,Cook Islands,United Kingdom,51,40,11
1995,258,French Polynesia,United Kingdom,83,64,19
1995,882,Samoa,United Kingdom,41,28,13
1995,112,Belarus,United Kingdom,409,178,231
1995,100,Bulgaria,United Kingdom,692,393,299
1995,203,Czechia,United Kingdom,526,366,160
1995,348,Hungary,United Kingdom,2091,1161,930
1995,616,Poland,United Kingdom,3192,1809,1383
1995,642,Romania,United Kingdom,354,214,140
1995,643,Russian Federation,United Kingdom,865,463,402
1995,703,Slovakia,United Kingdom,1426,744,682
1995,830,Channel Islands,United Kingdom,53511,25170,28341
1995,208,Denmark,United Kingdom,11553,6807,4746
1995,233,Estonia,United Kingdom,48,30,18
1995,234,Faroe Islands,United Kingdom,92,41,51
1995,246,Finland,United Kingdom,2018,1383,635
1995,352,Iceland,United Kingdom,684,381,303
1995,372,Ireland,United Kingdom,124169,59132,65037
1995,833,Isle of Man,United Kingdom,32475,15546,16929
1995,428,Latvia,United Kingdom,167,118,49
1995,440,Lithuania,United Kingdom,315,154,161
1995,578,Norway,United Kingdom,13692,7392,6300
1995,752,Sweden,United Kingdom,13616,8720,4896
1995,20,Andorra,United Kingdom,975,516,459
1995,191,Croatia,United Kingdom,186,70,116
1995,292,Gibraltar,United Kingdom,3316,1733,1583
1995,300,Greece,United Kingdom,23503,9463,14040
1995,380,Italy,United Kingdom,45568,14551,31017
1995,470,Malta,United Kingdom,6258,2731,3527
1995,620,Portugal,United Kingdom,8269,4048,4221
1995,688,Serbia,United Kingdom,504,274,230
1995,705,Slovenia,United Kingdom,106,56,50
1995,724,Spain,United Kingdom,74249,34940,39309
1995,40,Austria,United Kingdom,6845,3715,3130
1995,56,Belgium,United Kingdom,22892,12479,10413
1995,250,France,United Kingdom,105643,49554,56089
1995,276,Germany,United Kingdom,107736,62417,45319
1995,438,Liechtenstein,United Kingdom,37,25,12
1995,442,Luxembourg,United Kingdom,3041,1626,1415
1995,528,Netherlands,United Kingdom,39070,21556,17514
1995,756,Switzerland,United Kingdom,26763,14613,12150
1995,60,Bermuda,United Kingdom,4726,2682,2044
1995,124,Canada,United Kingdom,641095,310738,330357
1995,304,Greenland,United Kingdom,21,12,9
1995,840,United States of America,United Kingdom,667769,327800,339969
2000,232,Eritrea,United Kingdom,43,14,29
2000,454,Malawi,United Kingdom,1578,819,759
2000,480,Mauritius,United Kingdom,458,196,262
2000,690,Seychelles,United Kingdom,173,103,70
2000,800,Uganda,United Kingdom,1096,598,498
2000,834,United Republic of Tanzania,United Kingdom,912,522,390
2000,894,Zambia,United Kingdom,1036,569,467
2000,716,Zimbabwe,United Kingdom,23747,13543,10204
2000,72,Botswana,United Kingdom,993,93,900
2000,516,Namibia,United Kingdom,2256,958,1298
2000,710,South Africa,United Kingdom,125874,62258,63616
2000,132,Cabo Verde,United Kingdom,29,16,13
2000,288,Ghana,United Kingdom,1084,530,554
2000,430,Liberia,United Kingdom,1099,557,542
2000,654,Saint Helena,United Kingdom,77,45,32
2000,694,Sierra Leone,United Kingdom,580,314,266
2000,12,Algeria,United Kingdom,800,353,447
2000,818,Egypt,United Kingdom,2299,1193,1106
2000,434,Libya,United Kingdom,5321,3021,2300
2000,504,Morocco,United Kingdom,801,412,389
2000,48,Bahrain,United Kingdom,1378,835,543
2000,196,Cyprus,United Kingdom,16552,7437,9115
2000,268,Georgia,United Kingdom,34,24,10
2000,376,Israel,United Kingdom,18218,8436,9782
2000,400,Jordan,United Kingdom,981,557,424
2000,414,Kuwait,United Kingdom,6491,3809,2682
2000,422,Lebanon,United Kingdom,445,233,212
2000,512,Oman,United Kingdom,4658,3231,1427
2000,634,Qatar,United Kingdom,2070,1444,626
2000,792,Turkey,United Kingdom,17619,8234,9385
2000,784,United Arab Emirates,United Kingdom,14201,9074,5127
2000,762,Tajikistan,United Kingdom,333,230,103
2000,50,Bangladesh,United Kingdom,23021,12432,10589
2000,64,Bhutan,United Kingdom,22,9,13
2000,356,India,United Kingdom,5952,2833,3119
2000,462,Maldives,United Kingdom,89,49,40
2000,144,Sri Lanka,United Kingdom,317,213,104
2000,156,China,United Kingdom,6561,3982,2579
2000,344,"China, Hong Kong SAR",United Kingdom,14585,9373,5212
2000,408,Dem. People's Republic of Korea,United Kingdom,221,125,96
2000,392,Japan,United Kingdom,16526,7635,8891
2000,496,Mongolia,United Kingdom,79,39,40
2000,410,Republic of Korea,United Kingdom,1425,1011,414
2000,96,Brunei Darussalam,United Kingdom,1926,1119,807
2000,116,Cambodia,United Kingdom,182,127,55
2000,360,Indonesia,United Kingdom,6751,4003,2748
2000,458,Malaysia,United Kingdom,5547,3479,2068
2000,608,Philippines,United Kingdom,33603,16101,17502
2000,764,Thailand,United Kingdom,59,36,23
2000,704,Viet Nam,United Kingdom,3613,1996,1617
2000,660,Anguilla,United Kingdom,311,104,207
2000,28,Antigua and Barbuda,United Kingdom,817,402,415
2000,44,Bahamas,United Kingdom,1705,968,737
2000,52,Barbados,United Kingdom,3535,1652,1883
2000,92,British Virgin Islands,United Kingdom,594,327,267
2000,535,"Bonaire, Sint Eustatius and Saba",United Kingdom,158,87,71
2000,136,Cayman Islands,United Kingdom,2134,1179,955
2000,192,Cuba,United Kingdom,57,31,26
2000,212,Dominica,United Kingdom,362,188,174
2000,214,Dominican Republic,United Kingdom,710,454,256
2000,312,Guadeloupe,United Kingdom,277,129,148
2000,388,Jamaica,United Kingdom,5103,2461,2642
2000,474,Martinique,United Kingdom,135,48,87
2000,500,Montserrat,United Kingdom,94,49,45
2000,630,Puerto Rico,United Kingdom,377,179,198
2000,662,Saint Lucia,United Kingdom,751,357,394
2000,670,Saint Vincent and the Grenadines,United Kingdom,748,383,365
2000,780,Trinidad and Tobago,United Kingdom,2090,1089,1001
2000,796,Turks and Caicos Islands,United Kingdom,386,211,175
2000,84,Belize,United Kingdom,288,177,111
2000,188,Costa Rica,United Kingdom,397,235,162
2000,222,El Salvador,United Kingdom,77,47,30
2000,320,Guatemala,United Kingdom,142,79,63
2000,340,Honduras,United Kingdom,76,52,24
2000,484,Mexico,United Kingdom,3976,1932,2044
2000,558,Nicaragua,United Kingdom,48,31,17
2000,591,Panama,United Kingdom,329,213,116
2000,32,Argentina,United Kingdom,1978,937,1041
2000,68,Bolivia (Plurinational State of),United Kingdom,651,354,297
2000,76,Brazil,United Kingdom,4044,2526,1518
2000,152,Chile,United Kingdom,1646,891,755
2000,170,Colombia,United Kingdom,1026,560,466
2000,218,Ecuador,United Kingdom,895,475,420
2000,238,Falkland Islands (Malvinas),United Kingdom,704,418,286
2000,328,Guyana,United Kingdom,290,158,132
2000,600,Paraguay,United Kingdom,198,108,90
2000,604,Peru,United Kingdom,1209,631,578
2000,858,Uruguay,United Kingdom,513,218,295
2000,862,Venezuela (Bolivarian Republic of),United Kingdom,1635,905,730
2000,36,Australia,United Kingdom,1128510,569426,559084
2000,554,New Zealand,United Kingdom,211532,102813,108719
2000,242,Fiji,United Kingdom,528,293,235
2000,598,Papua New Guinea,United Kingdom,1680,822,858
2000,90,Solomon Islands,United Kingdom,81,57,24
2000,548,Vanuatu,United Kingdom,95,48,47
2000,296,Kiribati,United Kingdom,13,9,4
2000,184,Cook Islands,United Kingdom,53,42,11
2000,258,French Polynesia,United Kingdom,89,85,4
2000,882,Samoa,United Kingdom,35,23,12
2000,112,Belarus,United Kingdom,478,178,300
2000,100,Bulgaria,United Kingdom,1324,741,583
2000,203,Czechia,United Kingdom,701,491,210
2000,348,Hungary,United Kingdom,3661,2092,1569
2000,616,Poland,United Kingdom,2731,1530,1201
2000,642,Romania,United Kingdom,439,282,157
2000,643,Russian Federation,United Kingdom,800,467,333
2000,703,Slovakia,United Kingdom,3211,1662,1549
2000,830,Channel Islands,United Kingdom,56856,26733,30123
2000,208,Denmark,United Kingdom,14074,8453,5621
2000,233,Estonia,United Kingdom,64,40,24
2000,234,Faroe Islands,United Kingdom,88,40,48
2000,246,Finland,United Kingdom,2297,1646,651
2000,352,Iceland,United Kingdom,721,407,314
2000,372,Ireland,United Kingdom,131924,65087,66837
2000,833,Isle of Man,United Kingdom,34442,16664,17778
2000,428,Latvia,United Kingdom,218,152,66
2000,440,Lithuania,United Kingdom,246,120,126
2000,578,Norway,United Kingdom,14347,8065,6282
2000,752,Sweden,United Kingdom,14602,9317,5285
2000,20,Andorra,United Kingdom,907,476,431
2000,191,Croatia,United Kingdom,171,81,90
2000,292,Gibraltar,United Kingdom,3607,1880,1727
2000,300,Greece,United Kingdom,13169,4712,8457
2000,380,Italy,United Kingdom,31644,11043,20601
2000,470,Malta,United Kingdom,7313,3299,4014
2000,620,Portugal,United Kingdom,10009,4974,5035
2000,688,Serbia,United Kingdom,686,366,320
2000,705,Slovenia,United Kingdom,201,103,98
2000,724,Spain,United Kingdom,118972,57736,61236
2000,40,Austria,United Kingdom,7622,4183,3439
2000,56,Belgium,United Kingdom,24643,13605,11038
2000,250,France,United Kingdom,108951,50207,58744
2000,276,Germany,United Kingdom,111510,64632,46878
2000,438,Liechtenstein,United Kingdom,47,32,15
2000,442,Luxembourg,United Kingdom,3760,2040,1720
2000,528,Netherlands,United Kingdom,43294,23549,19745
2000,756,Switzerland,United Kingdom,31112,17890,13222
2000,60,Bermuda,United Kingdom,4883,2805,2078
2000,124,Canada,United Kingdom,608742,293662,315080
2000,304,Greenland,United Kingdom,23,15,8
2000,840,United States of America,United Kingdom,694961,342683,352278
2005,232,Eritrea,United Kingdom,49,17,32
2005,454,Malawi,United Kingdom,1504,778,726
2005,480,Mauritius,United Kingdom,415,182,233
2005,690,Seychelles,United Kingdom,216,118,98
2005,800,Uganda,United Kingdom,1061,571,490
2005,834,United Republic of Tanzania,United Kingdom,1015,593,422
2005,894,Zambia,United Kingdom,1154,634,520
2005,716,Zimbabwe,United Kingdom,19394,11061,8333
2005,120,Cameroon,United Kingdom,256,149,107
2005,72,Botswana,United Kingdom,1061,439,622
2005,516,Namibia,United Kingdom,1783,751,1032
2005,710,South Africa,United Kingdom,165691,79637,86054
2005,132,Cabo Verde,United Kingdom,40,21,19
2005,288,Ghana,United Kingdom,1524,792,732
2005,430,Liberia,United Kingdom,499,324,175
2005,654,Saint Helena,United Kingdom,111,59,52
2005,694,Sierra Leone,United Kingdom,315,182,133
2005,12,Algeria,United Kingdom,631,279,352
2005,818,Egypt,United Kingdom,2737,1502,1235
2005,434,Libya,United Kingdom,5863,3782,2081
2005,504,Morocco,United Kingdom,822,417,405
2005,48,Bahrain,United Kingdom,1602,1009,593
2005,196,Cyprus,United Kingdom,24227,10800,13427
2005,268,Georgia,United Kingdom,32,23,9
2005,376,Israel,United Kingdom,19593,9037,10556
2005,400,Jordan,United Kingdom,1417,880,537
2005,414,Kuwait,United Kingdom,6443,3886,2557
2005,422,Lebanon,United Kingdom,349,190,159
2005,512,Oman,United Kingdom,4061,2760,1301
2005,634,Qatar,United Kingdom,2433,1704,729
2005,792,Turkey,United Kingdom,18156,8267,9889
2005,784,United Arab Emirates,United Kingdom,13007,8397,4610
2005,762,Tajikistan,United Kingdom,321,237,84
2005,50,Bangladesh,United Kingdom,27337,14762,12575
2005,64,Bhutan,United Kingdom,28,12,16
2005,356,India,United Kingdom,5500,2611,2889
2005,462,Maldives,United Kingdom,101,60,41
2005,144,Sri Lanka,United Kingdom,594,299,295
2005,156,China,United Kingdom,7238,4693,2545
2005,344,"China, Hong Kong SAR",United Kingdom,15924,9948,5976
2005,408,Dem. People's Republic of Korea,United Kingdom,249,142,107
2005,392,Japan,United Kingdom,15133,6893,8240
2005,496,Mongolia,United Kingdom,75,46,29
2005,410,Republic of Korea,United Kingdom,2199,1636,563
2005,96,Brunei Darussalam,United Kingdom,1969,1149,820
2005,116,Cambodia,United Kingdom,142,100,42
2005,360,Indonesia,United Kingdom,16969,9565,7404
2005,458,Malaysia,United Kingdom,7431,4793,2638
2005,608,Philippines,United Kingdom,27198,13254,13944
2005,764,Thailand,United Kingdom,951,644,307
2005,704,Viet Nam,United Kingdom,2803,1610,1193
2005,660,Anguilla,United Kingdom,358,121,237
2005,28,Antigua and Barbuda,United Kingdom,876,430,446
2005,44,Bahamas,United Kingdom,1772,1017,755
2005,52,Barbados,United Kingdom,2955,1343,1612
2005,92,British Virgin Islands,United Kingdom,680,374,306
2005,535,"Bonaire, Sint Eustatius and Saba",United Kingdom,168,93,75
2005,136,Cayman Islands,United Kingdom,1965,1064,901
2005,192,Cuba,United Kingdom,38,21,17
2005,212,Dominica,United Kingdom,446,230,216
2005,214,Dominican Republic,United Kingdom,586,350,236
2005,312,Guadeloupe,United Kingdom,340,156,184
2005,388,Jamaica,United Kingdom,4973,2415,2558
2005,474,Martinique,United Kingdom,141,48,93
2005,500,Montserrat,United Kingdom,97,50,47
2005,630,Puerto Rico,United Kingdom,295,141,154
2005,662,Saint Lucia,United Kingdom,820,386,434
2005,670,Saint Vincent and the Grenadines,United Kingdom,770,398,372
2005,534,Sint Maarten (Dutch part),United Kingdom,25,13,12
2005,780,Trinidad and Tobago,United Kingdom,2243,1167,1076
2005,796,Turks and Caicos Islands,United Kingdom,398,216,182
2005,84,Belize,United Kingdom,318,195,123
2005,188,Costa Rica,United Kingdom,260,152,108
2005,222,El Salvador,United Kingdom,82,49,33
2005,320,Guatemala,United Kingdom,168,102,66
2005,340,Honduras,United Kingdom,75,52,23
2005,484,Mexico,United Kingdom,3475,1829,1646
2005,558,Nicaragua,United Kingdom,62,40,22
2005,591,Panama,United Kingdom,999,647,352
2005,32,Argentina,United Kingdom,1459,703,756
2005,68,Bolivia (Plurinational State of),United Kingdom,714,383,331
2005,76,Brazil,United Kingdom,4506,2790,1716
2005,152,Chile,United Kingdom,2471,1356,1115
2005,170,Colombia,United Kingdom,1004,551,453
2005,218,Ecuador,United Kingdom,1056,571,485
2005,238,Falkland Islands (Malvinas),United Kingdom,650,374,276
2005,328,Guyana,United Kingdom,390,214,176
2005,600,Paraguay,United Kingdom,188,103,85
2005,604,Peru,United Kingdom,1421,746,675
2005,858,Uruguay,United Kingdom,475,202,273
2005,862,Venezuela (Bolivarian Republic of),United Kingdom,1679,908,771
2005,36,Australia,United Kingdom,1116890,565203,551687
2005,554,New Zealand,United Kingdom,232954,113070,119884
2005,242,Fiji,United Kingdom,308,163,145
2005,598,Papua New Guinea,United Kingdom,1880,1028,852
2005,90,Solomon Islands,United Kingdom,59,39,20
2005,548,Vanuatu,United Kingdom,100,47,53
2005,296,Kiribati,United Kingdom,11,7,4
2005,184,Cook Islands,United Kingdom,70,52,18
2005,258,French Polynesia,United Kingdom,92,89,3
2005,882,Samoa,United Kingdom,33,22,11
2005,112,Belarus,United Kingdom,460,171,289
2005,100,Bulgaria,United Kingdom,2165,1227,938
2005,203,Czechia,United Kingdom,2383,1844,539
2005,348,Hungary,United Kingdom,4522,2619,1903
2005,616,Poland,United Kingdom,18982,9987,8995
2005,642,Romania,United Kingdom,701,412,289
2005,643,Russian Federation,United Kingdom,1267,720,547
2005,703,Slovakia,United Kingdom,3601,1903,1698
2005,830,Channel Islands,United Kingdom,56412,26708,29704
2005,208,Denmark,United Kingdom,15496,9443,6053
2005,233,Estonia,United Kingdom,295,203,92
2005,234,Faroe Islands,United Kingdom,86,37,49
2005,246,Finland,United Kingdom,3528,2547,981
2005,352,Iceland,United Kingdom,918,542,376
2005,372,Ireland,United Kingdom,207764,107625,100139
2005,833,Isle of Man,United Kingdom,36200,17945,18255
2005,428,Latvia,United Kingdom,803,479,324
2005,440,Lithuania,United Kingdom,2224,1179,1045
2005,578,Norway,United Kingdom,14601,8333,6268
2005,752,Sweden,United Kingdom,17175,11260,5915
2005,20,Andorra,United Kingdom,1085,573,512
2005,191,Croatia,United Kingdom,419,219,200
2005,292,Gibraltar,United Kingdom,4462,2335,2127
2005,300,Greece,United Kingdom,15618,6021,9597
2005,380,Italy,United Kingdom,48310,19101,29209
2005,470,Malta,United Kingdom,8005,3746,4259
2005,620,Portugal,United Kingdom,14299,7202,7097
2005,688,Serbia,United Kingdom,677,357,320
2005,705,Slovenia,United Kingdom,215,110,105
2005,724,Spain,United Kingdom,222431,110840,111591
2005,40,Austria,United Kingdom,8519,4583,3936
2005,56,Belgium,United Kingdom,23335,12838,10497
2005,250,France,United Kingdom,143491,70912,72579
2005,276,Germany,United Kingdom,96506,57358,39148
2005,438,Liechtenstein,United Kingdom,51,31,20
2005,442,Luxembourg,United Kingdom,4047,2193,1854
2005,528,Netherlands,United Kingdom,47459,26154,21305
2005,756,Switzerland,United Kingdom,35657,19764,15893
2005,60,Bermuda,United Kingdom,4436,2067,2369
2005,124,Canada,United Kingdom,559313,269496,289817
2005,304,Greenland,United Kingdom,15,10,5
2005,840,United States of America,United Kingdom,696965,345623,351342
2010,232,Eritrea,United Kingdom,56,21,35
2010,454,Malawi,United Kingdom,1478,763,715
2010,480,Mauritius,United Kingdom,395,189,206
2010,690,Seychelles,United Kingdom,259,132,127
2010,800,Uganda,United Kingdom,1067,569,498
2010,834,United Republic of Tanzania,United Kingdom,1040,610,430
2010,894,Zambia,United Kingdom,1286,680,606
2010,716,Zimbabwe,United Kingdom,12174,6944,5230
2010,120,Cameroon,United Kingdom,204,123,81
2010,72,Botswana,United Kingdom,1130,720,410
2010,516,Namibia,United Kingdom,1718,726,992
2010,710,South Africa,United Kingdom,129780,62123,67657
2010,132,Cabo Verde,United Kingdom,50,25,25
2010,288,Ghana,United Kingdom,1130,550,580
2010,430,Liberia,United Kingdom,230,105,125
2010,654,Saint Helena,United Kingdom,163,92,71
2010,694,Sierra Leone,United Kingdom,229,137,92
2010,12,Algeria,United Kingdom,693,290,403
2010,818,Egypt,United Kingdom,2954,1570,1384
2010,434,Libya,United Kingdom,6415,4165,2250
2010,504,Morocco,United Kingdom,920,464,456
2010,48,Bahrain,United Kingdom,2181,1408,773
2010,196,Cyprus,United Kingdom,39673,17960,21713
2010,268,Georgia,United Kingdom,32,23,9
2010,376,Israel,United Kingdom,21205,9726,11479
2010,400,Jordan,United Kingdom,1822,1171,651
2010,414,Kuwait,United Kingdom,8002,4963,3039
2010,422,Lebanon,United Kingdom,252,146,106
2010,512,Oman,United Kingdom,4120,2792,1328
2010,634,Qatar,United Kingdom,4771,3739,1032
2010,792,Turkey,United Kingdom,18709,8288,10421
2010,784,United Arab Emirates,United Kingdom,24505,16480,8025
2010,762,Tajikistan,United Kingdom,320,237,83
2010,50,Bangladesh,United Kingdom,31619,17075,14544
2010,64,Bhutan,United Kingdom,34,15,19
2010,356,India,United Kingdom,5047,2389,2658
2010,462,Maldives,United Kingdom,102,63,39
2010,144,Sri Lanka,United Kingdom,1163,590,573
2010,156,China,United Kingdom,7915,5403,2512
2010,344,"China, Hong Kong SAR",United Kingdom,17301,10546,6755
2010,408,Dem. People's Republic of Korea,United Kingdom,276,159,117
2010,392,Japan,United Kingdom,16044,7216,8828
2010,496,Mongolia,United Kingdom,80,61,19
2010,410,Republic of Korea,United Kingdom,3842,2871,971
2010,96,Brunei Darussalam,United Kingdom,2012,1179,833
2010,116,Cambodia,United Kingdom,102,73,29
2010,360,Indonesia,United Kingdom,28276,14939,13337
2010,458,Malaysia,United Kingdom,8842,5840,3002
2010,608,Philippines,United Kingdom,4217,1968,2249
2010,764,Thailand,United Kingdom,1913,1305,608
2010,704,Viet Nam,United Kingdom,927,504,423
2010,660,Anguilla,United Kingdom,390,133,257
2010,28,Antigua and Barbuda,United Kingdom,935,459,476
2010,44,Bahamas,United Kingdom,1839,1066,773
2010,52,Barbados,United Kingdom,2389,1040,1349
2010,92,British Virgin Islands,United Kingdom,714,394,320
2010,535,"Bonaire, Sint Eustatius and Saba",United Kingdom,49,39,10
2010,136,Cayman Islands,United Kingdom,1969,1042,927
2010,192,Cuba,United Kingdom,21,12,9
2010,531,Curaçao,United Kingdom,23,9,14
2010,212,Dominica,United Kingdom,543,282,261
2010,214,Dominican Republic,United Kingdom,457,243,214
2010,312,Guadeloupe,United Kingdom,402,183,219
2010,388,Jamaica,United Kingdom,4843,2370,2473
2010,474,Martinique,United Kingdom,148,49,99
2010,500,Montserrat,United Kingdom,100,51,49
2010,630,Puerto Rico,United Kingdom,176,83,93
2010,662,Saint Lucia,United Kingdom,826,397,429
2010,670,Saint Vincent and the Grenadines,United Kingdom,798,417,381
2010,534,Sint Maarten (Dutch part),United Kingdom,50,26,24
2010,780,Trinidad and Tobago,United Kingdom,2286,1211,1075
2010,796,Turks and Caicos Islands,United Kingdom,410,227,183
2010,84,Belize,United Kingdom,347,213,134
2010,188,Costa Rica,United Kingdom,512,300,212
2010,222,El Salvador,United Kingdom,86,51,35
2010,320,Guatemala,United Kingdom,194,125,69
2010,340,Honduras,United Kingdom,73,51,22
2010,484,Mexico,United Kingdom,3379,1942,1437
2010,558,Nicaragua,United Kingdom,66,43,23
2010,591,Panama,United Kingdom,1717,1116,601
2010,32,Argentina,United Kingdom,940,470,470
2010,68,Bolivia (Plurinational State of),United Kingdom,776,411,365
2010,76,Brazil,United Kingdom,4904,3013,1891
2010,152,Chile,United Kingdom,3295,1820,1475
2010,170,Colombia,United Kingdom,1155,644,511
2010,218,Ecuador,United Kingdom,1484,785,699
2010,238,Falkland Islands (Malvinas),United Kingdom,798,450,348
2010,328,Guyana,United Kingdom,490,271,219
2010,600,Paraguay,United Kingdom,179,98,81
2010,604,Peru,United Kingdom,1904,1043,861
2010,858,Uruguay,United Kingdom,440,185,255
2010,862,Venezuela (Bolivarian Republic of),United Kingdom,1742,919,823
2010,36,Australia,United Kingdom,1185070,602853,582217
2010,554,New Zealand,United Kingdom,250997,121621,129376
2010,242,Fiji,United Kingdom,331,177,154
2010,598,Papua New Guinea,United Kingdom,1594,908,686
2010,90,Solomon Islands,United Kingdom,42,24,18
2010,548,Vanuatu,United Kingdom,107,54,53
2010,296,Kiribati,United Kingdom,9,4,5
2010,184,Cook Islands,United Kingdom,86,61,25
2010,258,French Polynesia,United Kingdom,89,86,3
2010,882,Samoa,United Kingdom,29,19,10
2010,112,Belarus,United Kingdom,441,164,277
2010,100,Bulgaria,United Kingdom,2914,1660,1254
2010,203,Czechia,United Kingdom,3833,3039,794
2010,348,Hungary,United Kingdom,5383,3146,2237
2010,616,Poland,United Kingdom,35829,18698,17131
2010,642,Romania,United Kingdom,1063,597,466
2010,643,Russian Federation,United Kingdom,1708,958,750
2010,703,Slovakia,United Kingdom,4037,2159,1878
2010,830,Channel Islands,United Kingdom,55971,26678,29293
2010,208,Denmark,United Kingdom,16712,10248,6464
2010,233,Estonia,United Kingdom,524,365,159
2010,234,Faroe Islands,United Kingdom,92,42,50
2010,246,Finland,United Kingdom,5677,3989,1688
2010,352,Iceland,United Kingdom,1113,676,437
2010,372,Ireland,United Kingdom,249392,119746,129646
2010,833,Isle of Man,United Kingdom,37521,18922,18599
2010,428,Latvia,United Kingdom,1369,789,580
2010,440,Lithuania,United Kingdom,3901,2025,1876
2010,578,Norway,United Kingdom,16868,10002,6866
2010,752,Sweden,United Kingdom,20839,13836,7003
2010,20,Andorra,United Kingdom,1125,594,531
2010,191,Croatia,United Kingdom,666,357,309
2010,292,Gibraltar,United Kingdom,5317,2790,2527
2010,300,Greece,United Kingdom,18798,7632,11166
2010,380,Italy,United Kingdom,68044,28310,39734
2010,470,Malta,United Kingdom,8482,4586,3896
2010,499,Montenegro,United Kingdom,98,15,83
2010,620,Portugal,United Kingdom,16215,8249,7966
2010,688,Serbia,United Kingdom,662,348,314
2010,705,Slovenia,United Kingdom,524,298,226
2010,724,Spain,United Kingdom,319145,160319,158826
2010,40,Austria,United Kingdom,9416,4983,4433
2010,56,Belgium,United Kingdom,23752,12351,11401
2010,250,France,United Kingdom,174048,85051,88997
2010,276,Germany,United Kingdom,83616,50702,32914
2010,438,Liechtenstein,United Kingdom,57,31,26
2010,442,Luxembourg,United Kingdom,4329,2349,1980
2010,528,Netherlands,United Kingdom,47297,26182,21115
2010,756,Switzerland,United Kingdom,41104,21698,19406
2010,60,Bermuda,United Kingdom,4008,1333,2675
2010,124,Canada,United Kingdom,537040,259189,277851
2010,304,Greenland,United Kingdom,18,15,3
2010,840,United States of America,United Kingdom,720428,352262,368166
2015,232,Eritrea,United Kingdom,56,21,35
2015,454,Malawi,United Kingdom,1460,753,707
2015,480,Mauritius,United Kingdom,454,229,225
2015,690,Seychelles,United Kingdom,290,156,134
2015,800,Uganda,United Kingdom,1072,567,505
2015,834,United Republic of Tanzania,United Kingdom,1061,448,613
2015,894,Zambia,United Kingdom,1132,597,535
2015,716,Zimbabwe,United Kingdom,12243,6896,5347
2015,120,Cameroon,United Kingdom,260,142,118
2015,72,Botswana,United Kingdom,1233,786,447
2015,516,Namibia,United Kingdom,1681,713,968
2015,710,South Africa,United Kingdom,117150,52971,64179
2015,132,Cabo Verde,United Kingdom,52,26,26
2015,288,Ghana,United Kingdom,1390,677,713
2015,324,Guinea,United Kingdom,8,5,3
2015,430,Liberia,United Kingdom,263,119,144
2015,654,Saint Helena,United Kingdom,247,168,79
2015,694,Sierra Leone,United Kingdom,167,103,64
2015,12,Algeria,United Kingdom,764,319,445
2015,818,Egypt,United Kingdom,2190,1297,893
2015,434,Libya,United Kingdom,7232,4661,2571
2015,504,Morocco,United Kingdom,1199,603,596
2015,48,Bahrain,United Kingdom,1657,1061,596
2015,196,Cyprus,United Kingdom,37704,17005,20699
2015,268,Georgia,United Kingdom,33,24,9
2015,376,Israel,United Kingdom,21869,9973,11896
2015,400,Jordan,United Kingdom,784,441,343
2015,414,Kuwait,United Kingdom,9394,5335,4059
2015,422,Lebanon,United Kingdom,212,102,110
2015,512,Oman,United Kingdom,9369,6804,2565
2015,634,Qatar,United Kingdom,3841,3065,776
2015,792,Turkey,United Kingdom,18992,8175,10817
2015,784,United Arab Emirates,United Kingdom,26777,17663,9114
2015,762,Tajikistan,United Kingdom,314,232,82
2015,50,Bangladesh,United Kingdom,33470,18074,15396
2015,64,Bhutan,United Kingdom,36,15,21
2015,356,India,United Kingdom,4862,2299,2563
2015,462,Maldives,United Kingdom,103,65,38
2015,144,Sri Lanka,United Kingdom,1184,590,594
2015,156,China,United Kingdom,9108,6350,2758
2015,344,"China, Hong Kong SAR",United Kingdom,17666,10499,7167
2015,408,Dem. People's Republic of Korea,United Kingdom,304,176,128
2015,392,Japan,United Kingdom,15826,7060,8766
2015,496,Mongolia,United Kingdom,99,70,29
2015,410,Republic of Korea,United Kingdom,4773,3539,1234
2015,96,Brunei Darussalam,United Kingdom,2055,1209,846
2015,116,Cambodia,United Kingdom,92,66,26
2015,360,Indonesia,United Kingdom,31304,16858,14446
2015,458,Malaysia,United Kingdom,10782,7169,3613
2015,608,Philippines,United Kingdom,4282,2001,2281
2015,764,Thailand,United Kingdom,2068,1409,659
2015,704,Viet Nam,United Kingdom,1119,603,516
2015,660,Anguilla,United Kingdom,418,143,275
2015,28,Antigua and Barbuda,United Kingdom,994,487,507
2015,44,Bahamas,United Kingdom,1993,1149,844
2015,52,Barbados,United Kingdom,2509,1092,1417
2015,92,British Virgin Islands,United Kingdom,800,442,358
2015,535,"Bonaire, Sint Eustatius and Saba",United Kingdom,55,44,11
2015,136,Cayman Islands,United Kingdom,2144,1133,1011
2015,192,Cuba,United Kingdom,16,9,7
2015,531,Curaçao,United Kingdom,24,9,15
2015,212,Dominica,United Kingdom,633,329,304
2015,214,Dominican Republic,United Kingdom,482,256,226
2015,312,Guadeloupe,United Kingdom,417,188,229
2015,388,Jamaica,United Kingdom,4739,2319,2420
2015,474,Martinique,United Kingdom,153,50,103
2015,500,Montserrat,United Kingdom,104,53,51
2015,630,Puerto Rico,United Kingdom,173,81,92
2015,662,Saint Lucia,United Kingdom,791,379,412
2015,670,Saint Vincent and the Grenadines,United Kingdom,805,427,378
2015,534,Sint Maarten (Dutch part),United Kingdom,53,28,25
2015,780,Trinidad and Tobago,United Kingdom,2368,1273,1095
2015,796,Turks and Caicos Islands,United Kingdom,416,231,185
2015,84,Belize,United Kingdom,409,251,158
2015,188,Costa Rica,United Kingdom,519,303,216
2015,222,El Salvador,United Kingdom,90,54,36
2015,320,Guatemala,United Kingdom,223,145,78
2015,340,Honduras,United Kingdom,102,72,30
2015,484,Mexico,United Kingdom,3588,1790,1798
2015,558,Nicaragua,United Kingdom,71,47,24
2015,591,Panama,United Kingdom,2017,1309,708
2015,32,Argentina,United Kingdom,943,471,472
2015,68,Bolivia (Plurinational State of),United Kingdom,903,478,425
2015,76,Brazil,United Kingdom,5905,3628,2277
2015,152,Chile,United Kingdom,4991,2709,2282
2015,170,Colombia,United Kingdom,1293,727,566
2015,218,Ecuador,United Kingdom,2158,1134,1024
2015,238,Falkland Islands (Malvinas),United Kingdom,872,486,386
2015,328,Guyana,United Kingdom,574,317,257
2015,600,Paraguay,United Kingdom,174,95,79
2015,604,Peru,United Kingdom,2945,1687,1258
2015,858,Uruguay,United Kingdom,454,191,263
2015,862,Venezuela (Bolivarian Republic of),United Kingdom,1803,939,864
2015,36,Australia,United Kingdom,1206060,619846,586214
2015,554,New Zealand,United Kingdom,265014,128154,136860
2015,242,Fiji,United Kingdom,341,184,157
2015,598,Papua New Guinea,United Kingdom,1616,931,685
2015,90,Solomon Islands,United Kingdom,39,23,16
2015,548,Vanuatu,United Kingdom,108,54,54
2015,296,Kiribati,United Kingdom,8,4,4
2015,184,Cook Islands,United Kingdom,79,56,23
2015,258,French Polynesia,United Kingdom,84,82,2
2015,882,Samoa,United Kingdom,23,16,7
2015,112,Belarus,United Kingdom,461,171,290
2015,100,Bulgaria,United Kingdom,6738,3738,3000
2015,203,Czechia,United Kingdom,4851,3863,988
2015,348,Hungary,United Kingdom,7928,4430,3498
2015,616,Poland,United Kingdom,34545,18340,16205
2015,642,Romania,United Kingdom,5208,2809,2399
2015,643,Russian Federation,United Kingdom,1741,973,768
2015,703,Slovakia,United Kingdom,5501,3099,2402
2015,830,Channel Islands,United Kingdom,59380,28378,31002
2015,208,Denmark,United Kingdom,19312,11908,7404
2015,233,Estonia,United Kingdom,654,472,182
2015,234,Faroe Islands,United Kingdom,100,48,52
2015,246,Finland,United Kingdom,6887,4862,2025
2015,352,Iceland,United Kingdom,1307,783,524
2015,372,Ireland,United Kingdom,267364,135582,131782
2015,833,Isle of Man,United Kingdom,33553,16647,16906
2015,428,Latvia,United Kingdom,2218,1318,900
2015,440,Lithuania,United Kingdom,4306,2185,2121
2015,578,Norway,United Kingdom,19547,11963,7584
2015,752,Sweden,United Kingdom,25266,16681,8585
2015,20,Andorra,United Kingdom,1054,568,486
2015,191,Croatia,United Kingdom,670,358,312
2015,292,Gibraltar,United Kingdom,5673,3012,2661
2015,300,Greece,United Kingdom,17643,6716,10927
2015,380,Italy,United Kingdom,61905,25595,36310
2015,470,Malta,United Kingdom,14361,7613,6748
2015,499,Montenegro,United Kingdom,103,17,86
2015,620,Portugal,United Kingdom,18383,8888,9495
2015,688,Serbia,United Kingdom,647,340,307
2015,705,Slovenia,United Kingdom,559,321,238
2015,724,Spain,United Kingdom,305969,152548,153421
2015,40,Austria,United Kingdom,11013,5857,5156
2015,56,Belgium,United Kingdom,22484,11844,10640
2015,250,France,United Kingdom,166907,82935,83972
2015,276,Germany,United Kingdom,87123,52748,34375
2015,438,Liechtenstein,United Kingdom,67,35,32
2015,442,Luxembourg,United Kingdom,6604,3630,2974
2015,528,Netherlands,United Kingdom,49549,27466,22083
2015,756,Switzerland,United Kingdom,45658,24280,21378
2015,60,Bermuda,United Kingdom,4061,1355,2706
2015,124,Canada,United Kingdom,496059,241618,254441
2015,304,Greenland,United Kingdom,14,12,2
2015,840,United States of America,United Kingdom,683475,335023,348452
2019,232,Eritrea,United Kingdom,56,21,35
2019,454,Malawi,United Kingdom,1481,764,717
2019,480,Mauritius,United Kingdom,458,231,227
2019,690,Seychelles,United Kingdom,293,158,135
2019,800,Uganda,United Kingdom,1074,566,508
2019,834,United Republic of Tanzania,United Kingdom,951,399,552
2019,894,Zambia,United Kingdom,1458,771,687
2019,716,Zimbabwe,United Kingdom,12572,7141,5431
2019,120,Cameroon,United Kingdom,258,141,117
2019,72,Botswana,United Kingdom,1320,842,478
2019,516,Namibia,United Kingdom,1779,755,1024
2019,710,South Africa,United Kingdom,131310,59442,71868
2019,132,Cabo Verde,United Kingdom,54,27,27
2019,288,Ghana,United Kingdom,1564,764,800
2019,324,Guinea,United Kingdom,7,5,2
2019,430,Liberia,United Kingdom,218,99,119
2019,654,Saint Helena,United Kingdom,284,201,83
2019,694,Sierra Leone,United Kingdom,147,92,55
2019,12,Algeria,United Kingdom,794,332,462
2019,818,Egypt,United Kingdom,3121,1698,1423
2019,434,Libya,United Kingdom,7673,4946,2727
2019,504,Morocco,United Kingdom,1278,643,635
2019,48,Bahrain,United Kingdom,1744,1117,627
2019,196,Cyprus,United Kingdom,37684,17207,20477
2019,268,Georgia,United Kingdom,34,25,9
2019,376,Israel,United Kingdom,21266,9698,11568
2019,400,Jordan,United Kingdom,843,475,368
2019,414,Kuwait,United Kingdom,9946,5649,4297
2019,422,Lebanon,United Kingdom,200,97,103
2019,512,Oman,United Kingdom,11539,8380,3159
2019,634,Qatar,United Kingdom,6917,5420,1497
2019,792,Turkey,United Kingdom,25680,11199,14481
2019,784,United Arab Emirates,United Kingdom,28760,18970,9790
2019,762,Tajikistan,United Kingdom,312,231,81
2019,50,Bangladesh,United Kingdom,33910,10341,23569
2019,64,Bhutan,United Kingdom,37,16,21
2019,356,India,United Kingdom,4782,2261,2521
2019,462,Maldives,United Kingdom,110,70,40
2019,144,Sri Lanka,United Kingdom,1193,595,598
2019,156,China,United Kingdom,9599,6693,2906
2019,344,"China, Hong Kong SAR",United Kingdom,22888,13324,9564
2019,408,Dem. People's Republic of Korea,United Kingdom,309,179,130
2019,392,Japan,United Kingdom,17255,7698,9557
2019,496,Mongolia,United Kingdom,105,75,30
2019,410,Republic of Korea,United Kingdom,4858,3602,1256
2019,96,Brunei Darussalam,United Kingdom,2213,1302,911
2019,116,Cambodia,United Kingdom,97,70,27
2019,360,Indonesia,United Kingdom,32693,17606,15087
2019,458,Malaysia,United Kingdom,11273,7523,3750
2019,608,Philippines,United Kingdom,4416,2064,2352
2019,764,Thailand,United Kingdom,2156,1469,687
2019,704,Viet Nam,United Kingdom,1169,630,539
2019,660,Anguilla,United Kingdom,433,148,285
2019,28,Antigua and Barbuda,United Kingdom,1033,506,527
2019,44,Bahamas,United Kingdom,2115,1219,896
2019,52,Barbados,United Kingdom,2533,1103,1430
2019,92,British Virgin Islands,United Kingdom,868,480,388
2019,535,"Bonaire, Sint Eustatius and Saba",United Kingdom,65,52,13
2019,136,Cayman Islands,United Kingdom,2374,1255,1119
2019,192,Cuba,United Kingdom,14,8,6
2019,531,Curaçao,United Kingdom,26,10,16
2019,212,Dominica,United Kingdom,646,336,310
2019,214,Dominican Republic,United Kingdom,498,265,233
2019,312,Guadeloupe,United Kingdom,423,191,232
2019,388,Jamaica,United Kingdom,4800,2349,2451
2019,474,Martinique,United Kingdom,152,50,102
2019,500,Montserrat,United Kingdom,105,54,51
2019,630,Puerto Rico,United Kingdom,164,77,87
2019,662,Saint Lucia,United Kingdom,764,365,399
2019,670,Saint Vincent and the Grenadines,United Kingdom,819,440,379
2019,534,Sint Maarten (Dutch part),United Kingdom,54,29,25
2019,780,Trinidad and Tobago,United Kingdom,2549,1425,1124
2019,796,Turks and Caicos Islands,United Kingdom,449,250,199
2019,84,Belize,United Kingdom,448,275,173
2019,188,Costa Rica,United Kingdom,526,309,217
2019,222,El Salvador,United Kingdom,91,55,36
2019,320,Guatemala,United Kingdom,228,148,80
2019,340,Honduras,United Kingdom,103,73,30
2019,484,Mexico,United Kingdom,3699,1846,1853
2019,558,Nicaragua,United Kingdom,74,49,25
2019,591,Panama,United Kingdom,2146,1393,753
2019,32,Argentina,United Kingdom,959,478,481
2019,68,Bolivia (Plurinational State of),United Kingdom,985,521,464
2019,76,Brazil,United Kingdom,6650,4086,2564
2019,152,Chile,United Kingdom,6668,3450,3218
2019,170,Colombia,United Kingdom,1322,744,578
2019,218,Ecuador,United Kingdom,2124,1116,1008
2019,238,Falkland Islands (Malvinas),United Kingdom,1055,588,467
2019,328,Guyana,United Kingdom,585,323,262
2019,600,Paraguay,United Kingdom,178,97,81
2019,604,Peru,United Kingdom,3402,2004,1398
2019,858,Uruguay,United Kingdom,469,198,271
2019,862,Venezuela (Bolivarian Republic of),United Kingdom,1766,916,850
2019,36,Australia,United Kingdom,1262204,647681,614523
2019,554,New Zealand,United Kingdom,272436,131734,140702
2019,242,Fiji,United Kingdom,348,188,160
2019,598,Papua New Guinea,United Kingdom,1630,942,688
2019,90,Solomon Islands,United Kingdom,38,23,15
2019,548,Vanuatu,United Kingdom,109,55,54
2019,296,Kiribati,United Kingdom,8,4,4
2019,184,Cook Islands,United Kingdom,79,56,23
2019,258,French Polynesia,United Kingdom,87,85,2
2019,882,Samoa,United Kingdom,21,15,6
2019,112,Belarus,United Kingdom,455,169,286
2019,100,Bulgaria,United Kingdom,9992,5413,4579
2019,203,Czechia,United Kingdom,5327,4241,1086
2019,348,Hungary,United Kingdom,11111,6032,5079
2019,616,Poland,United Kingdom,36585,20082,16503
2019,642,Romania,United Kingdom,16828,9222,7606
2019,643,Russian Federation,United Kingdom,1740,973,767
2019,703,Slovakia,United Kingdom,7267,4073,3194
2019,830,Channel Islands,United Kingdom,60480,28904,31576
2019,208,Denmark,United Kingdom,21837,13376,8461
2019,233,Estonia,United Kingdom,789,563,226
2019,234,Faroe Islands,United Kingdom,126,67,59
2019,246,Finland,United Kingdom,7948,5621,2327
2019,352,Iceland,United Kingdom,1677,1017,660
2019,372,Ireland,United Kingdom,293061,148959,144102
2019,833,Isle of Man,United Kingdom,34050,16896,17154
2019,428,Latvia,United Kingdom,2985,1743,1242
2019,440,Lithuania,United Kingdom,4568,2298,2270
2019,578,Norway,United Kingdom,21036,12829,8207
2019,752,Sweden,United Kingdom,30265,19803,10462
2019,20,Andorra,United Kingdom,1124,610,514
2019,191,Croatia,United Kingdom,618,330,288
2019,292,Gibraltar,United Kingdom,5730,3041,2689
2019,300,Greece,United Kingdom,17230,6963,10267
2019,380,Italy,United Kingdom,65645,27659,37986
2019,470,Malta,United Kingdom,23213,12359,10854
2019,499,Montenegro,United Kingdom,103,18,85
2019,620,Portugal,United Kingdom,18695,9060,9635
2019,688,Serbia,United Kingdom,657,346,311
2019,705,Slovenia,United Kingdom,604,351,253
2019,724,Spain,United Kingdom,302020,148749,153271
2019,40,Austria,United Kingdom,13000,7019,5981
2019,56,Belgium,United Kingdom,23231,12414,10817
2019,250,France,United Kingdom,176672,87585,89087
2019,276,Germany,United Kingdom,98553,62127,36426
2019,438,Liechtenstein,United Kingdom,64,33,31
2019,442,Luxembourg,United Kingdom,5852,3349,2503
2019,528,Netherlands,United Kingdom,55445,30878,24567
2019,756,Switzerland,United Kingdom,47083,25111,21972
2019,60,Bermuda,United Kingdom,4105,1370,2735
2019,124,Canada,United Kingdom,531584,258922,272662
2019,304,Greenland,United Kingdom,13,12,1
2019,840,United States of America,United Kingdom,716260,350341,365919
1990,108,Burundi,United Republic of Tanzania,11912,5838,6074
1990,174,Comoros,United Republic of Tanzania,163,79,84
1990,232,Eritrea,United Republic of Tanzania,218,113,105
1990,404,Kenya,United Republic of Tanzania,66464,35782,30682
1990,454,Malawi,United Republic of Tanzania,3279,1118,2161
1990,508,Mozambique,United Republic of Tanzania,2722,1543,1179
1990,646,Rwanda,United Republic of Tanzania,15825,7947,7878
1990,800,Uganda,United Republic of Tanzania,31528,17908,13620
1990,894,Zambia,United Republic of Tanzania,6930,3879,3051
1990,72,Botswana,United Republic of Tanzania,460,257,203
1990,426,Lesotho,United Republic of Tanzania,116,57,59
1990,516,Namibia,United Republic of Tanzania,1624,794,830
1990,710,South Africa,United Republic of Tanzania,26,14,12
1990,288,Ghana,United Republic of Tanzania,6,3,3
1990,818,Egypt,United Republic of Tanzania,156,129,27
1990,434,Libya,United Republic of Tanzania,445,369,76
1990,196,Cyprus,United Republic of Tanzania,36,18,18
1990,792,Turkey,United Republic of Tanzania,53,48,5
1990,136,Cayman Islands,United Republic of Tanzania,4,0,4
1990,188,Costa Rica,United Republic of Tanzania,3,1,2
1990,32,Argentina,United Republic of Tanzania,1,1,0
1990,68,Bolivia (Plurinational State of),United Republic of Tanzania,1,0,1
1990,152,Chile,United Republic of Tanzania,27,15,12
1990,36,Australia,United Republic of Tanzania,1422,788,634
1990,598,Papua New Guinea,United Republic of Tanzania,38,22,16
1990,100,Bulgaria,United Republic of Tanzania,7,7,0
1990,203,Czechia,United Republic of Tanzania,5,4,1
1990,348,Hungary,United Republic of Tanzania,28,24,4
1990,616,Poland,United Republic of Tanzania,71,55,16
1990,643,Russian Federation,United Republic of Tanzania,269,132,137
1990,208,Denmark,United Republic of Tanzania,439,221,218
1990,246,Finland,United Republic of Tanzania,86,57,29
1990,352,Iceland,United Republic of Tanzania,9,4,5
1990,372,Ireland,United Republic of Tanzania,24,11,13
1990,578,Norway,United Republic of Tanzania,248,157,91
1990,752,Sweden,United Republic of Tanzania,664,327,337
1990,826,United Kingdom,United Republic of Tanzania,29112,15233,13879
1990,300,Greece,United Republic of Tanzania,268,149,119
1990,380,Italy,United Republic of Tanzania,135,47,88
1990,620,Portugal,United Republic of Tanzania,48,17,31
1990,724,Spain,United Republic of Tanzania,28,14,14
1990,40,Austria,United Republic of Tanzania,86,44,42
1990,56,Belgium,United Republic of Tanzania,228,117,111
1990,250,France,United Republic of Tanzania,629,278,351
1990,276,Germany,United Republic of Tanzania,816,536,280
1990,528,Netherlands,United Republic of Tanzania,546,280,266
1990,756,Switzerland,United Republic of Tanzania,522,254,268
1990,124,Canada,United Republic of Tanzania,19061,9279,9782
1990,840,United States of America,United Republic of Tanzania,6282,3217,3065
1995,108,Burundi,United Republic of Tanzania,9780,4763,5017
1995,174,Comoros,United Republic of Tanzania,162,78,84
1995,232,Eritrea,United Republic of Tanzania,296,149,147
1995,404,Kenya,United Republic of Tanzania,73119,38837,34282
1995,454,Malawi,United Republic of Tanzania,10676,4777,5899
1995,508,Mozambique,United Republic of Tanzania,3744,2129,1615
1995,646,Rwanda,United Republic of Tanzania,24121,12110,12011
1995,800,Uganda,United Republic of Tanzania,29873,16531,13342
1995,894,Zambia,United Republic of Tanzania,6172,3455,2717
1995,72,Botswana,United Republic of Tanzania,743,395,348
1995,426,Lesotho,United Republic of Tanzania,100,49,51
1995,516,Namibia,United Republic of Tanzania,1553,765,788
1995,710,South Africa,United Republic of Tanzania,1698,1150,548
1995,288,Ghana,United Republic of Tanzania,6,3,3
1995,818,Egypt,United Republic of Tanzania,126,101,25
1995,434,Libya,United Republic of Tanzania,317,249,68
1995,196,Cyprus,United Republic of Tanzania,51,24,27
1995,792,Turkey,United Republic of Tanzania,129,116,13
1995,136,Cayman Islands,United Republic of Tanzania,8,0,8
1995,188,Costa Rica,United Republic of Tanzania,2,0,2
1995,32,Argentina,United Republic of Tanzania,1,1,0
1995,68,Bolivia (Plurinational State of),United Republic of Tanzania,1,0,1
1995,152,Chile,United Republic of Tanzania,18,9,9
1995,36,Australia,United Republic of Tanzania,1768,976,792
1995,598,Papua New Guinea,United Republic of Tanzania,38,23,15
1995,100,Bulgaria,United Republic of Tanzania,8,8,0
1995,203,Czechia,United Republic of Tanzania,7,5,2
1995,348,Hungary,United Republic of Tanzania,34,26,8
1995,616,Poland,United Republic of Tanzania,60,47,13
1995,643,Russian Federation,United Republic of Tanzania,244,139,105
1995,208,Denmark,United Republic of Tanzania,616,286,330
1995,246,Finland,United Republic of Tanzania,116,74,42
1995,352,Iceland,United Republic of Tanzania,10,4,6
1995,372,Ireland,United Republic of Tanzania,67,29,38
1995,578,Norway,United Republic of Tanzania,350,201,149
1995,752,Sweden,United Republic of Tanzania,788,385,403
1995,826,United Kingdom,United Republic of Tanzania,30079,15560,14519
1995,300,Greece,United Republic of Tanzania,330,183,147
1995,380,Italy,United Republic of Tanzania,461,168,293
1995,620,Portugal,United Republic of Tanzania,104,38,66
1995,724,Spain,United Republic of Tanzania,43,22,21
1995,40,Austria,United Republic of Tanzania,98,51,47
1995,56,Belgium,United Republic of Tanzania,228,117,111
1995,250,France,United Republic of Tanzania,650,281,369
1995,276,Germany,United Republic of Tanzania,907,544,363
1995,528,Netherlands,United Republic of Tanzania,804,403,401
1995,756,Switzerland,United Republic of Tanzania,570,285,285
1995,124,Canada,United Republic of Tanzania,19140,9273,9867
1995,840,United States of America,United Republic of Tanzania,8953,4632,4321
2000,108,Burundi,United Republic of Tanzania,5692,2768,2924
2000,174,Comoros,United Republic of Tanzania,160,77,83
2000,232,Eritrea,United Republic of Tanzania,375,186,189
2000,404,Kenya,United Republic of Tanzania,51289,25674,25615
2000,454,Malawi,United Republic of Tanzania,10278,4583,5695
2000,508,Mozambique,United Republic of Tanzania,4355,2415,1940
2000,646,Rwanda,United Republic of Tanzania,36766,18453,18313
2000,800,Uganda,United Republic of Tanzania,22351,11258,11093
2000,894,Zambia,United Republic of Tanzania,4322,2221,2101
2000,72,Botswana,United Republic of Tanzania,1104,574,530
2000,426,Lesotho,United Republic of Tanzania,81,40,41
2000,516,Namibia,United Republic of Tanzania,1442,712,730
2000,710,South Africa,United Republic of Tanzania,3911,2627,1284
2000,288,Ghana,United Republic of Tanzania,7,4,3
2000,818,Egypt,United Republic of Tanzania,107,82,25
2000,434,Libya,United Republic of Tanzania,196,136,60
2000,196,Cyprus,United Republic of Tanzania,66,31,35
2000,792,Turkey,United Republic of Tanzania,207,185,22
2000,136,Cayman Islands,United Republic of Tanzania,15,0,15
2000,188,Costa Rica,United Republic of Tanzania,3,1,2
2000,32,Argentina,United Republic of Tanzania,1,1,0
2000,152,Chile,United Republic of Tanzania,9,4,5
2000,36,Australia,United Republic of Tanzania,1970,1084,886
2000,598,Papua New Guinea,United Republic of Tanzania,28,19,9
2000,100,Bulgaria,United Republic of Tanzania,9,9,0
2000,203,Czechia,United Republic of Tanzania,9,6,3
2000,348,Hungary,United Republic of Tanzania,40,28,12
2000,616,Poland,United Republic of Tanzania,52,40,12
2000,643,Russian Federation,United Republic of Tanzania,211,140,71
2000,208,Denmark,United Republic of Tanzania,792,350,442
2000,246,Finland,United Republic of Tanzania,145,91,54
2000,352,Iceland,United Republic of Tanzania,10,4,6
2000,372,Ireland,United Republic of Tanzania,147,65,82
2000,578,Norway,United Republic of Tanzania,507,266,241
2000,752,Sweden,United Republic of Tanzania,846,411,435
2000,826,United Kingdom,United Republic of Tanzania,31553,16111,15442
2000,300,Greece,United Republic of Tanzania,398,217,181
2000,380,Italy,United Republic of Tanzania,786,288,498
2000,620,Portugal,United Republic of Tanzania,165,61,104
2000,705,Slovenia,United Republic of Tanzania,3,2,1
2000,40,Austria,United Republic of Tanzania,109,58,51
2000,56,Belgium,United Republic of Tanzania,219,110,109
2000,250,France,United Republic of Tanzania,670,284,386
2000,276,Germany,United Republic of Tanzania,997,551,446
2000,528,Netherlands,United Republic of Tanzania,1091,539,552
2000,756,Switzerland,United Republic of Tanzania,622,319,303
2000,124,Canada,United Republic of Tanzania,19675,9491,10184
2000,840,United States of America,United Republic of Tanzania,11678,6081,5597
2005,108,Burundi,United Republic of Tanzania,13732,6449,7283
2005,174,Comoros,United Republic of Tanzania,153,74,79
2005,232,Eritrea,United Republic of Tanzania,446,225,221
2005,404,Kenya,United Republic of Tanzania,42082,21801,20281
2005,454,Malawi,United Republic of Tanzania,9794,4351,5443
2005,508,Mozambique,United Republic of Tanzania,5891,3022,2869
2005,646,Rwanda,United Republic of Tanzania,43346,21750,21596
2005,800,Uganda,United Republic of Tanzania,21648,10728,10920
2005,894,Zambia,United Republic of Tanzania,5057,2599,2458
2005,72,Botswana,United Republic of Tanzania,1666,856,810
2005,426,Lesotho,United Republic of Tanzania,82,41,41
2005,516,Namibia,United Republic of Tanzania,1140,560,580
2005,710,South Africa,United Republic of Tanzania,5296,3431,1865
2005,288,Ghana,United Republic of Tanzania,10,6,4
2005,818,Egypt,United Republic of Tanzania,127,99,28
2005,434,Libya,United Republic of Tanzania,215,161,54
2005,196,Cyprus,United Republic of Tanzania,97,46,51
2005,792,Turkey,United Republic of Tanzania,213,190,23
2005,136,Cayman Islands,United Republic of Tanzania,14,1,13
2005,188,Costa Rica,United Republic of Tanzania,2,1,1
2005,32,Argentina,United Republic of Tanzania,1,1,0
2005,68,Bolivia (Plurinational State of),United Republic of Tanzania,2,0,2
2005,152,Chile,United Republic of Tanzania,13,6,7
2005,36,Australia,United Republic of Tanzania,2300,1297,1003
2005,598,Papua New Guinea,United Republic of Tanzania,34,25,9
2005,100,Bulgaria,United Republic of Tanzania,11,11,0
2005,203,Czechia,United Republic of Tanzania,16,11,5
2005,348,Hungary,United Republic of Tanzania,49,34,15
2005,616,Poland,United Republic of Tanzania,61,42,19
2005,643,Russian Federation,United Republic of Tanzania,214,142,72
2005,208,Denmark,United Republic of Tanzania,902,386,516
2005,246,Finland,United Republic of Tanzania,296,185,111
2005,352,Iceland,United Republic of Tanzania,16,6,10
2005,372,Ireland,United Republic of Tanzania,147,70,77
2005,578,Norway,United Republic of Tanzania,653,309,344
2005,752,Sweden,United Republic of Tanzania,1073,509,564
2005,826,United Kingdom,United Republic of Tanzania,31706,15775,15931
2005,300,Greece,United Republic of Tanzania,401,218,183
2005,380,Italy,United Republic of Tanzania,1195,489,706
2005,620,Portugal,United Republic of Tanzania,123,51,72
2005,724,Spain,United Republic of Tanzania,253,135,118
2005,40,Austria,United Republic of Tanzania,122,63,59
2005,56,Belgium,United Republic of Tanzania,312,168,144
2005,250,France,United Republic of Tanzania,526,218,308
2005,276,Germany,United Republic of Tanzania,455,256,199
2005,528,Netherlands,United Republic of Tanzania,1318,649,669
2005,756,Switzerland,United Republic of Tanzania,682,334,348
2005,124,Canada,United Republic of Tanzania,18937,9290,9647
2005,840,United States of America,United Republic of Tanzania,22162,11600,10562
2010,108,Burundi,United Republic of Tanzania,22974,10685,12289
2010,174,Comoros,United Republic of Tanzania,146,71,75
2010,232,Eritrea,United Republic of Tanzania,517,264,253
2010,404,Kenya,United Republic of Tanzania,39120,19347,19773
2010,454,Malawi,United Republic of Tanzania,9620,4265,5355
2010,508,Mozambique,United Republic of Tanzania,6822,3499,3323
2010,646,Rwanda,United Republic of Tanzania,43060,21605,21455
2010,800,Uganda,United Republic of Tanzania,21802,10681,11121
2010,894,Zambia,United Republic of Tanzania,5918,2965,2953
2010,72,Botswana,United Republic of Tanzania,700,390,310
2010,426,Lesotho,United Republic of Tanzania,83,42,41
2010,516,Namibia,United Republic of Tanzania,1098,541,557
2010,710,South Africa,United Republic of Tanzania,8295,5363,2932
2010,288,Ghana,United Republic of Tanzania,7,3,4
2010,466,Mali,United Republic of Tanzania,723,280,443
2010,818,Egypt,United Republic of Tanzania,137,106,31
2010,434,Libya,United Republic of Tanzania,235,176,59
2010,196,Cyprus,United Republic of Tanzania,158,76,82
2010,792,Turkey,United Republic of Tanzania,219,195,24
2010,136,Cayman Islands,United Republic of Tanzania,15,2,13
2010,188,Costa Rica,United Republic of Tanzania,4,1,3
2010,32,Argentina,United Republic of Tanzania,1,1,0
2010,68,Bolivia (Plurinational State of),United Republic of Tanzania,4,1,3
2010,76,Brazil,United Republic of Tanzania,87,51,36
2010,152,Chile,United Republic of Tanzania,18,9,9
2010,36,Australia,United Republic of Tanzania,3820,2075,1745
2010,598,Papua New Guinea,United Republic of Tanzania,28,19,9
2010,100,Bulgaria,United Republic of Tanzania,13,13,0
2010,203,Czechia,United Republic of Tanzania,21,15,6
2010,348,Hungary,United Republic of Tanzania,57,39,18
2010,616,Poland,United Republic of Tanzania,72,45,27
2010,643,Russian Federation,United Republic of Tanzania,213,141,72
2010,208,Denmark,United Republic of Tanzania,993,414,579
2010,233,Estonia,United Republic of Tanzania,4,3,1
2010,246,Finland,United Republic of Tanzania,512,301,211
2010,352,Iceland,United Republic of Tanzania,21,8,13
2010,372,Ireland,United Republic of Tanzania,122,53,69
2010,428,Latvia,United Republic of Tanzania,1,1,0
2010,578,Norway,United Republic of Tanzania,844,412,432
2010,752,Sweden,United Republic of Tanzania,1416,689,727
2010,826,United Kingdom,United Republic of Tanzania,33400,16962,16438
2010,300,Greece,United Republic of Tanzania,420,228,192
2010,380,Italy,United Republic of Tanzania,1631,709,922
2010,620,Portugal,United Republic of Tanzania,61,32,29
2010,705,Slovenia,United Republic of Tanzania,1,0,1
2010,724,Spain,United Republic of Tanzania,293,161,132
2010,40,Austria,United Republic of Tanzania,134,68,66
2010,56,Belgium,United Republic of Tanzania,450,224,226
2010,250,France,United Republic of Tanzania,604,249,355
2010,276,Germany,United Republic of Tanzania,795,437,358
2010,528,Netherlands,United Republic of Tanzania,1545,766,779
2010,756,Switzerland,United Republic of Tanzania,823,378,445
2010,124,Canada,United Republic of Tanzania,19465,9738,9727
2010,840,United States of America,United Republic of Tanzania,33600,17367,16233
2015,108,Burundi,United Republic of Tanzania,28008,13037,14971
2015,174,Comoros,United Republic of Tanzania,145,71,74
2015,232,Eritrea,United Republic of Tanzania,526,272,254
2015,404,Kenya,United Republic of Tanzania,39935,19823,20112
2015,454,Malawi,United Republic of Tanzania,9507,4211,5296
2015,508,Mozambique,United Republic of Tanzania,7163,3674,3489
2015,646,Rwanda,United Republic of Tanzania,42776,21461,21315
2015,800,Uganda,United Republic of Tanzania,21916,10629,11287
2015,894,Zambia,United Republic of Tanzania,4726,2176,2550
2015,72,Botswana,United Republic of Tanzania,764,426,338
2015,426,Lesotho,United Republic of Tanzania,85,43,42
2015,516,Namibia,United Republic of Tanzania,1074,531,543
2015,710,South Africa,United Republic of Tanzania,14962,9405,5557
2015,288,Ghana,United Republic of Tanzania,8,4,4
2015,324,Guinea,United Republic of Tanzania,2,2,0
2015,466,Mali,United Republic of Tanzania,895,347,548
2015,818,Egypt,United Republic of Tanzania,101,81,20
2015,434,Libya,United Republic of Tanzania,264,197,67
2015,196,Cyprus,United Republic of Tanzania,151,73,78
2015,792,Turkey,United Republic of Tanzania,222,198,24
2015,136,Cayman Islands,United Republic of Tanzania,15,2,13
2015,188,Costa Rica,United Republic of Tanzania,4,1,3
2015,32,Argentina,United Republic of Tanzania,1,1,0
2015,68,Bolivia (Plurinational State of),United Republic of Tanzania,5,2,3
2015,76,Brazil,United Republic of Tanzania,105,62,43
2015,152,Chile,United Republic of Tanzania,27,14,13
2015,36,Australia,United Republic of Tanzania,4500,2410,2090
2015,598,Papua New Guinea,United Republic of Tanzania,28,21,7
2015,100,Bulgaria,United Republic of Tanzania,11,10,1
2015,203,Czechia,United Republic of Tanzania,20,14,6
2015,348,Hungary,United Republic of Tanzania,66,45,21
2015,616,Poland,United Republic of Tanzania,69,44,25
2015,643,Russian Federation,United Republic of Tanzania,217,143,74
2015,208,Denmark,United Republic of Tanzania,1109,466,643
2015,233,Estonia,United Republic of Tanzania,4,3,1
2015,246,Finland,United Republic of Tanzania,656,382,274
2015,352,Iceland,United Republic of Tanzania,28,11,17
2015,372,Ireland,United Republic of Tanzania,125,54,71
2015,428,Latvia,United Republic of Tanzania,2,2,0
2015,578,Norway,United Republic of Tanzania,941,455,486
2015,752,Sweden,United Republic of Tanzania,1700,835,865
2015,826,United Kingdom,United Republic of Tanzania,42713,21068,21645
2015,300,Greece,United Republic of Tanzania,394,207,187
2015,380,Italy,United Republic of Tanzania,1596,672,924
2015,620,Portugal,United Republic of Tanzania,68,33,35
2015,705,Slovenia,United Republic of Tanzania,2,1,1
2015,724,Spain,United Republic of Tanzania,360,175,185
2015,40,Austria,United Republic of Tanzania,157,80,77
2015,56,Belgium,United Republic of Tanzania,615,298,317
2015,250,France,United Republic of Tanzania,669,265,404
2015,276,Germany,United Republic of Tanzania,1136,608,528
2015,528,Netherlands,United Republic of Tanzania,1454,692,762
2015,756,Switzerland,United Republic of Tanzania,858,379,479
2015,124,Canada,United Republic of Tanzania,20473,9819,10654
2015,840,United States of America,United Republic of Tanzania,50245,24693,25552
2019,108,Burundi,United Republic of Tanzania,31024,14441,16583
2019,174,Comoros,United Republic of Tanzania,144,71,73
2019,232,Eritrea,United Republic of Tanzania,531,275,256
2019,404,Kenya,United Republic of Tanzania,37027,18393,18634
2019,454,Malawi,United Republic of Tanzania,9644,4272,5372
2019,508,Mozambique,United Republic of Tanzania,7449,3821,3628
2019,646,Rwanda,United Republic of Tanzania,44877,22597,22280
2019,800,Uganda,United Republic of Tanzania,21979,10604,11375
2019,894,Zambia,United Republic of Tanzania,6090,2812,3278
2019,72,Botswana,United Republic of Tanzania,818,457,361
2019,426,Lesotho,United Republic of Tanzania,89,45,44
2019,516,Namibia,United Republic of Tanzania,1136,562,574
2019,710,South Africa,United Republic of Tanzania,16769,10548,6221
2019,288,Ghana,United Republic of Tanzania,9,5,4
2019,324,Guinea,United Republic of Tanzania,1,1,0
2019,466,Mali,United Republic of Tanzania,996,386,610
2019,818,Egypt,United Republic of Tanzania,143,112,31
2019,434,Libya,United Republic of Tanzania,280,209,71
2019,196,Cyprus,United Republic of Tanzania,150,73,77
2019,792,Turkey,United Republic of Tanzania,300,268,32
2019,136,Cayman Islands,United Republic of Tanzania,16,2,14
2019,188,Costa Rica,United Republic of Tanzania,4,1,3
2019,32,Argentina,United Republic of Tanzania,1,1,0
2019,68,Bolivia (Plurinational State of),United Republic of Tanzania,5,2,3
2019,76,Brazil,United Republic of Tanzania,118,70,48
2019,152,Chile,United Republic of Tanzania,36,18,18
2019,36,Australia,United Republic of Tanzania,4972,2628,2344
2019,598,Papua New Guinea,United Republic of Tanzania,28,21,7
2019,100,Bulgaria,United Republic of Tanzania,14,13,1
2019,203,Czechia,United Republic of Tanzania,27,17,10
2019,348,Hungary,United Republic of Tanzania,57,38,19
2019,616,Poland,United Republic of Tanzania,73,48,25
2019,643,Russian Federation,United Republic of Tanzania,216,143,73
2019,208,Denmark,United Republic of Tanzania,1123,469,654
2019,233,Estonia,United Republic of Tanzania,5,3,2
2019,246,Finland,United Republic of Tanzania,733,425,308
2019,352,Iceland,United Republic of Tanzania,27,9,18
2019,372,Ireland,United Republic of Tanzania,137,60,77
2019,428,Latvia,United Republic of Tanzania,2,2,0
2019,578,Norway,United Republic of Tanzania,1003,484,519
2019,752,Sweden,United Republic of Tanzania,2019,991,1028
2019,826,United Kingdom,United Republic of Tanzania,48505,23987,24518
2019,300,Greece,United Republic of Tanzania,384,209,175
2019,380,Italy,United Republic of Tanzania,1786,748,1038
2019,620,Portugal,United Republic of Tanzania,69,34,35
2019,705,Slovenia,United Republic of Tanzania,3,2,1
2019,724,Spain,United Republic of Tanzania,373,177,196
2019,40,Austria,United Republic of Tanzania,185,96,89
2019,56,Belgium,United Republic of Tanzania,683,323,360
2019,250,France,United Republic of Tanzania,708,280,428
2019,276,Germany,United Republic of Tanzania,1477,770,707
2019,528,Netherlands,United Republic of Tanzania,1494,704,790
2019,756,Switzerland,United Republic of Tanzania,897,404,493
2019,124,Canada,United Republic of Tanzania,21939,10523,11416
2019,840,United States of America,United Republic of Tanzania,54259,26370,27889
1990,480,Mauritius,United States of America,37,16,21
1990,800,Uganda,United States of America,485,235,250
1990,834,United Republic of Tanzania,United States of America,808,462,346
1990,894,Zambia,United States of America,459,239,220
1990,140,Central African Republic,United States of America,476,412,64
1990,178,Congo,United States of America,51,30,21
1990,266,Gabon,United States of America,169,91,78
1990,72,Botswana,United States of America,603,326,277
1990,748,Eswatini,United States of America,281,126,155
1990,426,Lesotho,United States of America,95,49,46
1990,516,Namibia,United States of America,1553,647,906
1990,710,South Africa,United States of America,9267,4264,5003
1990,132,Cabo Verde,United States of America,188,97,91
1990,288,Ghana,United States of America,437,201,236
1990,324,Guinea,United States of America,552,276,276
1990,624,Guinea-Bissau,United States of America,200,81,119
1990,430,Liberia,United States of America,2959,1418,1541
1990,466,Mali,United States of America,233,127,106
1990,478,Mauritania,United States of America,99,47,52
1990,686,Senegal,United States of America,662,322,340
1990,694,Sierra Leone,United States of America,506,255,251
1990,768,Togo,United States of America,179,95,84
1990,12,Algeria,United States of America,4509,2471,2038
1990,818,Egypt,United States of America,6679,3536,3143
1990,434,Libya,United States of America,19067,10144,8923
1990,504,Morocco,United States of America,1250,661,589
1990,788,Tunisia,United States of America,236,117,119
1990,48,Bahrain,United States of America,453,324,129
1990,196,Cyprus,United States of America,791,393,398
1990,376,Israel,United States of America,47532,23400,24132
1990,400,Jordan,United States of America,1691,733,958
1990,414,Kuwait,United States of America,2808,1700,1108
1990,422,Lebanon,United States of America,773,335,438
1990,634,Qatar,United States of America,809,591,218
1990,275,State of Palestine,United States of America,8436,4043,4393
1990,792,Turkey,United States of America,12868,7695,5173
1990,784,United Arab Emirates,United States of America,3431,2443,988
1990,762,Tajikistan,United States of America,417,184,233
1990,50,Bangladesh,United States of America,28559,15422,13137
1990,64,Bhutan,United States of America,63,33,30
1990,356,India,United States of America,5649,2711,2938
1990,462,Maldives,United States of America,24,13,11
1990,144,Sri Lanka,United States of America,18,12,6
1990,156,China,United States of America,16962,9795,7167
1990,344,"China, Hong Kong SAR",United States of America,7599,4255,3344
1990,408,Dem. People's Republic of Korea,United States of America,672,360,312
1990,392,Japan,United States of America,38375,19550,18825
1990,496,Mongolia,United States of America,247,135,112
1990,410,Republic of Korea,United States of America,11713,6715,4998
1990,96,Brunei Darussalam,United States of America,113,80,33
1990,116,Cambodia,United States of America,91,52,39
1990,360,Indonesia,United States of America,8745,4280,4465
1990,608,Philippines,United States of America,17746,10685,7061
1990,702,Singapore,United States of America,3423,1880,1543
1990,764,Thailand,United States of America,1640,1191,449
1990,626,Timor-Leste,United States of America,64,26,38
1990,704,Viet Nam,United States of America,263,158,105
1990,660,Anguilla,United States of America,215,67,148
1990,28,Antigua and Barbuda,United States of America,1308,629,679
1990,533,Aruba,United States of America,425,204,221
1990,44,Bahamas,United States of America,4247,1893,2354
1990,52,Barbados,United States of America,1112,499,613
1990,92,British Virgin Islands,United States of America,674,319,355
1990,535,"Bonaire, Sint Eustatius and Saba",United States of America,346,184,162
1990,136,Cayman Islands,United States of America,1619,816,803
1990,192,Cuba,United States of America,1186,577,609
1990,212,Dominica,United States of America,226,137,89
1990,214,Dominican Republic,United States of America,9115,4980,4135
1990,312,Guadeloupe,United States of America,197,95,102
1990,332,Haiti,United States of America,1607,857,750
1990,388,Jamaica,United States of America,4575,2266,2309
1990,500,Montserrat,United States of America,173,91,82
1990,630,Puerto Rico,United States of America,227483,109679,117804
1990,662,Saint Lucia,United States of America,276,144,132
1990,670,Saint Vincent and the Grenadines,United States of America,291,149,142
1990,780,Trinidad and Tobago,United States of America,2430,1206,1224
1990,796,Turks and Caicos Islands,United States of America,454,233,221
1990,850,United States Virgin Islands,United States of America,14246,7129,7117
1990,84,Belize,United States of America,1901,1003,898
1990,188,Costa Rica,United States of America,8586,4858,3728
1990,222,El Salvador,United States of America,8033,4032,4001
1990,320,Guatemala,United States of America,5822,2013,3809
1990,340,Honduras,United States of America,2692,1535,1157
1990,484,Mexico,United States of America,198230,97160,101070
1990,558,Nicaragua,United States of America,3721,1838,1883
1990,591,Panama,United States of America,3318,2030,1288
1990,32,Argentina,United States of America,9992,5035,4957
1990,68,Bolivia (Plurinational State of),United States of America,3078,1559,1519
1990,76,Brazil,United States of America,11806,6432,5374
1990,152,Chile,United States of America,5650,3058,2592
1990,170,Colombia,United States of America,13478,6802,6676
1990,218,Ecuador,United States of America,8595,4283,4312
1990,238,Falkland Islands (Malvinas),United States of America,15,8,7
1990,328,Guyana,United States of America,285,154,131
1990,600,Paraguay,United States of America,1582,837,745
1990,604,Peru,United States of America,6146,3265,2881
1990,858,Uruguay,United States of America,1525,849,676
1990,862,Venezuela (Bolivarian Republic of),United States of America,11639,5891,5748
1990,36,Australia,United States of America,53575,28252,25323
1990,554,New Zealand,United States of America,8305,4310,3995
1990,598,Papua New Guinea,United States of America,1110,709,401
1990,90,Solomon Islands,United States of America,135,78,57
1990,316,Guam,United States of America,27990,17285,10705
1990,296,Kiribati,United States of America,43,16,27
1990,584,Marshall Islands,United States of America,633,399,234
1990,583,Micronesia (Fed. States of),United States of America,234,134,100
1990,580,Northern Mariana Islands,United States of America,1203,734,469
1990,585,Palau,United States of America,315,196,119
1990,16,American Samoa,United States of America,3510,1872,1638
1990,184,Cook Islands,United States of America,17,12,5
1990,258,French Polynesia,United States of America,372,210,162
1990,570,Niue,United States of America,11,6,5
1990,882,Samoa,United States of America,266,134,132
1990,798,Tuvalu,United States of America,41,37,4
1990,112,Belarus,United States of America,42,23,19
1990,100,Bulgaria,United States of America,139,76,63
1990,203,Czechia,United States of America,517,307,210
1990,348,Hungary,United States of America,2956,1313,1643
1990,616,Poland,United States of America,12778,5470,7308
1990,642,Romania,United States of America,705,330,375
1990,643,Russian Federation,United States of America,3077,1510,1567
1990,703,Slovakia,United States of America,290,95,195
1990,804,Ukraine,United States of America,3308,1697,1611
1990,208,Denmark,United States of America,6411,3175,3236
1990,233,Estonia,United States of America,91,45,46
1990,234,Faroe Islands,United States of America,21,16,5
1990,246,Finland,United States of America,2545,1164,1381
1990,352,Iceland,United States of America,1077,551,526
1990,372,Ireland,United States of America,15922,7656,8266
1990,833,Isle of Man,United States of America,242,108,134
1990,428,Latvia,United States of America,167,82,85
1990,440,Lithuania,United States of America,1170,481,689
1990,578,Norway,United States of America,15827,7364,8463
1990,752,Sweden,United States of America,11325,6010,5315
1990,826,United Kingdom,United States of America,141818,71043,70775
1990,8,Albania,United States of America,3011,1784,1227
1990,20,Andorra,United States of America,100,53,47
1990,191,Croatia,United States of America,1187,392,795
1990,300,Greece,United States of America,43336,22800,20536
1990,380,Italy,United States of America,63755,22634,41121
1990,470,Malta,United States of America,832,374,458
1990,620,Portugal,United States of America,5467,2608,2859
1990,688,Serbia,United States of America,157,82,75
1990,705,Slovenia,United States of America,734,260,474
1990,724,Spain,United States of America,12187,5596,6591
1990,40,Austria,United States of America,6088,3020,3068
1990,56,Belgium,United States of America,15122,7273,7849
1990,250,France,United States of America,40260,17982,22278
1990,276,Germany,United States of America,99835,55852,43983
1990,438,Liechtenstein,United States of America,20,9,11
1990,442,Luxembourg,United States of America,1098,565,533
1990,528,Netherlands,United States of America,13659,7029,6630
1990,756,Switzerland,United States of America,19316,9577,9739
1990,60,Bermuda,United States of America,3468,1659,1809
1990,124,Canada,United States of America,238998,116350,122648
1990,304,Greenland,United States of America,29,21,8
1990,666,Saint Pierre and Miquelon,United States of America,72,31,41
1995,480,Mauritius,United States of America,30,15,15
1995,800,Uganda,United States of America,459,215,244
1995,834,United Republic of Tanzania,United States of America,1027,587,440
1995,894,Zambia,United States of America,460,240,220
1995,140,Central African Republic,United States of America,683,592,91
1995,178,Congo,United States of America,59,33,26
1995,266,Gabon,United States of America,226,121,105
1995,72,Botswana,United States of America,313,166,147
1995,748,Eswatini,United States of America,112,57,55
1995,426,Lesotho,United States of America,91,47,44
1995,516,Namibia,United States of America,1485,625,860
1995,710,South Africa,United States of America,7115,3332,3783
1995,132,Cabo Verde,United States of America,232,123,109
1995,288,Ghana,United States of America,435,222,213
1995,324,Guinea,United States of America,636,353,283
1995,624,Guinea-Bissau,United States of America,257,107,150
1995,430,Liberia,United States of America,2891,1352,1539
1995,466,Mali,United States of America,242,132,110
1995,478,Mauritania,United States of America,105,55,50
1995,686,Senegal,United States of America,692,335,357
1995,694,Sierra Leone,United States of America,493,242,251
1995,768,Togo,United States of America,179,95,84
1995,12,Algeria,United States of America,2802,1504,1298
1995,818,Egypt,United States of America,5336,2800,2536
1995,434,Libya,United States of America,13063,7147,5916
1995,504,Morocco,United States of America,1147,599,548
1995,788,Tunisia,United States of America,234,118,116
1995,48,Bahrain,United States of America,498,351,147
1995,196,Cyprus,United States of America,1119,533,586
1995,376,Israel,United States of America,56033,27127,28906
1995,400,Jordan,United States of America,2433,1253,1180
1995,414,Kuwait,United States of America,2250,1434,816
1995,422,Lebanon,United States of America,1108,540,568
1995,634,Qatar,United States of America,879,657,222
1995,275,State of Palestine,United States of America,8244,3930,4314
1995,792,Turkey,United States of America,12735,7324,5411
1995,784,United Arab Emirates,United States of America,4396,3149,1247
1995,762,Tajikistan,United States of America,338,174,164
1995,50,Bangladesh,United States of America,30085,16246,13839
1995,64,Bhutan,United States of America,74,39,35
1995,356,India,United States of America,4490,2176,2314
1995,462,Maldives,United States of America,20,10,10
1995,144,Sri Lanka,United States of America,87,67,20
1995,156,China,United States of America,18124,10366,7758
1995,344,"China, Hong Kong SAR",United States of America,10698,6001,4697
1995,408,Dem. People's Republic of Korea,United States of America,661,349,312
1995,392,Japan,United States of America,43792,21020,22772
1995,496,Mongolia,United States of America,272,155,117
1995,410,Republic of Korea,United States of America,16092,8758,7334
1995,96,Brunei Darussalam,United States of America,129,91,38
1995,116,Cambodia,United States of America,239,136,103
1995,360,Indonesia,United States of America,5786,2909,2877
1995,608,Philippines,United States of America,23882,14191,9691
1995,702,Singapore,United States of America,3949,2159,1790
1995,764,Thailand,United States of America,2742,1966,776
1995,626,Timor-Leste,United States of America,64,27,37
1995,704,Viet Nam,United States of America,585,341,244
1995,660,Anguilla,United States of America,277,82,195
1995,28,Antigua and Barbuda,United States of America,1733,854,879
1995,533,Aruba,United States of America,553,282,271
1995,44,Bahamas,United States of America,4294,2033,2261
1995,52,Barbados,United States of America,1213,555,658
1995,92,British Virgin Islands,United States of America,792,364,428
1995,535,"Bonaire, Sint Eustatius and Saba",United States of America,722,382,340
1995,136,Cayman Islands,United States of America,1541,772,769
1995,192,Cuba,United States of America,899,418,481
1995,212,Dominica,United States of America,299,182,117
1995,214,Dominican Republic,United States of America,10124,5420,4704
1995,312,Guadeloupe,United States of America,263,124,139
1995,332,Haiti,United States of America,1526,814,712
1995,388,Jamaica,United States of America,5615,2823,2792
1995,500,Montserrat,United States of America,138,73,65
1995,630,Puerto Rico,United States of America,230426,110220,120206
1995,662,Saint Lucia,United States of America,372,196,176
1995,670,Saint Vincent and the Grenadines,United States of America,303,156,147
1995,780,Trinidad and Tobago,United States of America,2205,1092,1113
1995,796,Turks and Caicos Islands,United States of America,565,298,267
1995,850,United States Virgin Islands,United States of America,14965,7491,7474
1995,84,Belize,United States of America,1908,1008,900
1995,188,Costa Rica,United States of America,7301,4222,3079
1995,222,El Salvador,United States of America,6306,3160,3146
1995,320,Guatemala,United States of America,5639,2334,3305
1995,340,Honduras,United States of America,3877,2140,1737
1995,484,Mexico,United States of America,272472,134898,137574
1995,558,Nicaragua,United States of America,2952,1447,1505
1995,591,Panama,United States of America,4134,2474,1660
1995,32,Argentina,United States of America,9678,4958,4720
1995,68,Bolivia (Plurinational State of),United States of America,3385,1747,1638
1995,76,Brazil,United States of America,12894,7312,5582
1995,152,Chile,United States of America,6770,3766,3004
1995,170,Colombia,United States of America,14273,7246,7027
1995,218,Ecuador,United States of America,9854,5068,4786
1995,238,Falkland Islands (Malvinas),United States of America,20,12,8
1995,328,Guyana,United States of America,459,248,211
1995,600,Paraguay,United States of America,1684,899,785
1995,604,Peru,United States of America,6151,3233,2918
1995,858,Uruguay,United States of America,1036,562,474
1995,862,Venezuela (Bolivarian Republic of),United States of America,10925,5590,5335
1995,36,Australia,United States of America,55234,29511,25723
1995,554,New Zealand,United States of America,11309,5783,5526
1995,598,Papua New Guinea,United States of America,1137,803,334
1995,90,Solomon Islands,United States of America,134,77,57
1995,316,Guam,United States of America,23543,14198,9345
1995,296,Kiribati,United States of America,40,20,20
1995,584,Marshall Islands,United States of America,716,436,280
1995,583,Micronesia (Fed. States of),United States of America,212,135,77
1995,580,Northern Mariana Islands,United States of America,1530,929,601
1995,585,Palau,United States of America,535,303,232
1995,16,American Samoa,United States of America,3544,1875,1669
1995,184,Cook Islands,United States of America,18,13,5
1995,258,French Polynesia,United States of America,408,226,182
1995,570,Niue,United States of America,14,8,6
1995,882,Samoa,United States of America,365,181,184
1995,798,Tuvalu,United States of America,21,19,2
1995,112,Belarus,United States of America,66,30,36
1995,100,Bulgaria,United States of America,352,185,167
1995,203,Czechia,United States of America,775,469,306
1995,348,Hungary,United States of America,3967,1909,2058
1995,616,Poland,United States of America,10929,4583,6346
1995,642,Romania,United States of America,1055,470,585
1995,643,Russian Federation,United States of America,3051,1583,1468
1995,703,Slovakia,United States of America,743,331,412
1995,804,Ukraine,United States of America,3200,1686,1514
1995,208,Denmark,United States of America,7504,3834,3670
1995,233,Estonia,United States of America,141,70,71
1995,234,Faroe Islands,United States of America,22,13,9
1995,246,Finland,United States of America,2494,1263,1231
1995,352,Iceland,United States of America,1190,631,559
1995,372,Ireland,United States of America,12608,5860,6748
1995,833,Isle of Man,United States of America,210,89,121
1995,428,Latvia,United States of America,323,175,148
1995,440,Lithuania,United States of America,1310,542,768
1995,578,Norway,United States of America,15407,7158,8249
1995,752,Sweden,United States of America,13439,7084,6355
1995,826,United Kingdom,United States of America,146271,71391,74880
1995,8,Albania,United States of America,3255,1936,1319
1995,20,Andorra,United States of America,95,50,45
1995,191,Croatia,United States of America,1068,367,701
1995,300,Greece,United States of America,32841,16453,16388
1995,380,Italy,United States of America,45212,16514,28698
1995,470,Malta,United States of America,974,446,528
1995,620,Portugal,United States of America,6236,3017,3219
1995,688,Serbia,United States of America,1003,514,489
1995,705,Slovenia,United States of America,564,210,354
1995,724,Spain,United States of America,14474,6849,7625
1995,40,Austria,United States of America,6869,3464,3405
1995,56,Belgium,United States of America,15534,7604,7930
1995,250,France,United States of America,41562,18177,23385
1995,276,Germany,United States of America,104837,58328,46509
1995,438,Liechtenstein,United States of America,40,19,21
1995,442,Luxembourg,United States of America,1066,550,516
1995,528,Netherlands,United States of America,16636,8400,8236
1995,756,Switzerland,United States of America,22377,11607,10770
1995,60,Bermuda,United States of America,3454,1684,1770
1995,124,Canada,United States of America,244567,118489,126078
1995,304,Greenland,United States of America,26,14,12
1995,666,Saint Pierre and Miquelon,United States of America,87,46,41
2000,480,Mauritius,United States of America,41,20,21
2000,800,Uganda,United States of America,878,450,428
2000,834,United Republic of Tanzania,United States of America,1082,619,463
2000,894,Zambia,United States of America,462,241,221
2000,140,Central African Republic,United States of America,831,721,110
2000,178,Congo,United States of America,83,46,37
2000,266,Gabon,United States of America,283,153,130
2000,72,Botswana,United States of America,55,22,33
2000,748,Eswatini,United States of America,146,74,72
2000,426,Lesotho,United States of America,85,44,41
2000,516,Namibia,United States of America,1379,583,796
2000,710,South Africa,United States of America,7087,3230,3857
2000,132,Cabo Verde,United States of America,275,148,127
2000,288,Ghana,United States of America,487,227,260
2000,324,Guinea,United States of America,689,377,312
2000,624,Guinea-Bissau,United States of America,313,133,180
2000,430,Liberia,United States of America,2837,1285,1552
2000,466,Mali,United States of America,223,122,101
2000,478,Mauritania,United States of America,108,62,46
2000,686,Senegal,United States of America,626,291,335
2000,694,Sierra Leone,United States of America,480,229,251
2000,768,Togo,United States of America,179,95,84
2000,12,Algeria,United States of America,1094,536,558
2000,818,Egypt,United States of America,4416,2287,2129
2000,434,Libya,United States of America,7274,4406,2868
2000,504,Morocco,United States of America,1208,621,587
2000,788,Tunisia,United States of America,279,146,133
2000,48,Bahrain,United States of America,545,377,168
2000,196,Cyprus,United States of America,1446,673,773
2000,268,Georgia,United States of America,107,65,42
2000,376,Israel,United States of America,61396,29644,31752
2000,400,Jordan,United States of America,3176,1780,1396
2000,414,Kuwait,United States of America,2567,1734,833
2000,422,Lebanon,United States of America,1442,745,697
2000,634,Qatar,United States of America,819,626,193
2000,275,State of Palestine,United States of America,8052,3816,4236
2000,792,Turkey,United States of America,12649,6970,5679
2000,784,United Arab Emirates,United States of America,5615,4022,1593
2000,762,Tajikistan,United States of America,291,154,137
2000,50,Bangladesh,United States of America,31610,17070,14540
2000,64,Bhutan,United States of America,85,45,40
2000,356,India,United States of America,3330,1640,1690
2000,462,Maldives,United States of America,16,9,7
2000,144,Sri Lanka,United States of America,158,108,50
2000,156,China,United States of America,19286,10937,8349
2000,344,"China, Hong Kong SAR",United States of America,13796,7747,6049
2000,408,Dem. People's Republic of Korea,United States of America,649,338,311
2000,392,Japan,United States of America,44859,20724,24135
2000,496,Mongolia,United States of America,301,177,124
2000,410,Republic of Korea,United States of America,25592,14051,11541
2000,96,Brunei Darussalam,United States of America,144,102,42
2000,116,Cambodia,United States of America,386,220,166
2000,360,Indonesia,United States of America,2827,1538,1289
2000,608,Philippines,United States of America,35977,18874,17103
2000,702,Singapore,United States of America,4858,2615,2243
2000,764,Thailand,United States of America,4411,3128,1283
2000,626,Timor-Leste,United States of America,66,28,38
2000,704,Viet Nam,United States of America,1359,812,547
2000,660,Anguilla,United States of America,339,97,242
2000,28,Antigua and Barbuda,United States of America,2157,1079,1078
2000,533,Aruba,United States of America,681,360,321
2000,44,Bahamas,United States of America,4300,2103,2197
2000,52,Barbados,United States of America,1315,611,704
2000,92,British Virgin Islands,United States of America,910,410,500
2000,535,"Bonaire, Sint Eustatius and Saba",United States of America,1098,580,518
2000,136,Cayman Islands,United States of America,1821,928,893
2000,192,Cuba,United States of America,612,260,352
2000,212,Dominica,United States of America,356,218,138
2000,214,Dominican Republic,United States of America,11133,5860,5273
2000,312,Guadeloupe,United States of America,329,153,176
2000,332,Haiti,United States of America,1449,773,676
2000,388,Jamaica,United States of America,6668,3384,3284
2000,500,Montserrat,United States of America,104,55,49
2000,630,Puerto Rico,United States of America,233924,111006,122918
2000,662,Saint Lucia,United States of America,511,271,240
2000,670,Saint Vincent and the Grenadines,United States of America,318,166,152
2000,780,Trinidad and Tobago,United States of America,3501,1832,1669
2000,796,Turks and Caicos Islands,United States of America,676,362,314
2000,850,United States Virgin Islands,United States of America,15712,7862,7850
2000,84,Belize,United States of America,1914,1012,902
2000,188,Costa Rica,United States of America,9667,5570,4097
2000,222,El Salvador,United States of America,4603,2282,2321
2000,320,Guatemala,United States of America,5456,2656,2800
2000,340,Honduras,United States of America,5061,2744,2317
2000,484,Mexico,United States of America,358399,179268,179131
2000,558,Nicaragua,United States of America,3006,1542,1464
2000,591,Panama,United States of America,5212,3065,2147
2000,32,Argentina,United States of America,9364,4881,4483
2000,68,Bolivia (Plurinational State of),United States of America,3656,1914,1742
2000,76,Brazil,United States of America,13981,8192,5789
2000,152,Chile,United States of America,7884,4366,3518
2000,170,Colombia,United States of America,15068,7691,7377
2000,218,Ecuador,United States of America,11112,5853,5259
2000,238,Falkland Islands (Malvinas),United States of America,21,13,8
2000,328,Guyana,United States of America,632,342,290
2000,600,Paraguay,United States of America,1781,954,827
2000,604,Peru,United States of America,7188,3795,3393
2000,858,Uruguay,United States of America,705,372,333
2000,862,Venezuela (Bolivarian Republic of),United States of America,10159,5246,4913
2000,36,Australia,United States of America,59690,30729,28961
2000,554,New Zealand,United States of America,12984,6312,6672
2000,598,Papua New Guinea,United States of America,851,685,166
2000,90,Solomon Islands,United States of America,128,73,55
2000,316,Guam,United States of America,19095,11110,7985
2000,296,Kiribati,United States of America,38,25,13
2000,584,Marshall Islands,United States of America,856,515,341
2000,583,Micronesia (Fed. States of),United States of America,197,110,87
2000,580,Northern Mariana Islands,United States of America,1951,1144,807
2000,585,Palau,United States of America,516,333,183
2000,16,American Samoa,United States of America,3578,1878,1700
2000,184,Cook Islands,United States of America,18,13,5
2000,258,French Polynesia,United States of America,437,238,199
2000,570,Niue,United States of America,18,11,7
2000,882,Samoa,United States of America,463,227,236
2000,798,Tuvalu,United States of America,11,10,1
2000,112,Belarus,United States of America,90,38,52
2000,100,Bulgaria,United States of America,565,294,271
2000,203,Czechia,United States of America,1033,631,402
2000,348,Hungary,United States of America,4977,2504,2473
2000,616,Poland,United States of America,9349,3838,5511
2000,642,Romania,United States of America,1425,617,808
2000,643,Russian Federation,United States of America,2915,1598,1317
2000,703,Slovakia,United States of America,1402,658,744
2000,804,Ukraine,United States of America,3132,1695,1437
2000,208,Denmark,United States of America,8596,4492,4104
2000,233,Estonia,United States of America,191,95,96
2000,234,Faroe Islands,United States of America,26,16,10
2000,246,Finland,United States of America,2442,1362,1080
2000,352,Iceland,United States of America,1392,736,656
2000,372,Ireland,United States of America,16225,7824,8401
2000,833,Isle of Man,United States of America,178,71,107
2000,428,Latvia,United States of America,479,268,211
2000,440,Lithuania,United States of America,1026,424,602
2000,578,Norway,United States of America,14956,7090,7866
2000,752,Sweden,United States of America,14413,7553,6860
2000,826,United Kingdom,United States of America,153185,72746,80439
2000,8,Albania,United States of America,3498,2088,1410
2000,20,Andorra,United States of America,89,47,42
2000,191,Croatia,United States of America,835,312,523
2000,300,Greece,United States of America,22885,10079,12806
2000,380,Italy,United States of America,26750,10381,16369
2000,470,Malta,United States of America,1051,506,545
2000,620,Portugal,United States of America,7258,3559,3699
2000,688,Serbia,United States of America,1364,685,679
2000,705,Slovenia,United States of America,668,244,424
2000,724,Spain,United States of America,22987,11253,11734
2000,40,Austria,United States of America,7649,3907,3742
2000,56,Belgium,United States of America,15495,7743,7752
2000,250,France,United States of America,42863,18371,24492
2000,276,Germany,United States of America,109838,60803,49035
2000,438,Liechtenstein,United States of America,60,29,31
2000,442,Luxembourg,United States of America,965,500,465
2000,528,Netherlands,United States of America,20186,10037,10149
2000,756,Switzerland,United States of America,25521,13712,11809
2000,60,Bermuda,United States of America,3439,1708,1731
2000,124,Canada,United States of America,255952,123473,132479
2000,304,Greenland,United States of America,26,14,12
2000,666,Saint Pierre and Miquelon,United States of America,98,58,40
2005,480,Mauritius,United States of America,40,19,21
2005,800,Uganda,United States of America,850,429,421
2005,834,United Republic of Tanzania,United States of America,1204,689,515
2005,894,Zambia,United States of America,662,346,316
2005,120,Cameroon,United States of America,823,418,405
2005,140,Central African Republic,United States of America,635,551,84
2005,178,Congo,United States of America,53,35,18
2005,266,Gabon,United States of America,310,170,140
2005,72,Botswana,United States of America,507,201,306
2005,748,Eswatini,United States of America,190,86,104
2005,426,Lesotho,United States of America,86,45,41
2005,516,Namibia,United States of America,1090,457,633
2005,710,South Africa,United States of America,9323,4025,5298
2005,132,Cabo Verde,United States of America,307,158,149
2005,288,Ghana,United States of America,685,341,344
2005,324,Guinea,United States of America,550,334,216
2005,624,Guinea-Bissau,United States of America,303,128,175
2005,430,Liberia,United States of America,1236,772,464
2005,466,Mali,United States of America,907,484,423
2005,478,Mauritania,United States of America,108,64,44
2005,686,Senegal,United States of America,672,322,350
2005,694,Sierra Leone,United States of America,330,199,131
2005,768,Togo,United States of America,179,95,84
2005,12,Algeria,United States of America,863,423,440
2005,818,Egypt,United States of America,5257,2879,2378
2005,434,Libya,United States of America,8015,5420,2595
2005,504,Morocco,United States of America,1239,628,611
2005,788,Tunisia,United States of America,259,133,126
2005,48,Bahrain,United States of America,771,524,247
2005,196,Cyprus,United States of America,2116,977,1139
2005,268,Georgia,United States of America,101,62,39
2005,376,Israel,United States of America,68622,33070,35552
2005,400,Jordan,United States of America,4587,2815,1772
2005,414,Kuwait,United States of America,2772,1829,943
2005,422,Lebanon,United States of America,1129,606,523
2005,634,Qatar,United States of America,1149,854,295
2005,275,State of Palestine,United States of America,7978,3752,4226
2005,792,Turkey,United States of America,13034,7050,5984
2005,784,United Arab Emirates,United States of America,6294,4355,1939
2005,762,Tajikistan,United States of America,280,149,131
2005,50,Bangladesh,United States of America,37560,20283,17277
2005,64,Bhutan,United States of America,107,56,51
2005,356,India,United States of America,3077,1512,1565
2005,462,Maldives,United States of America,32,21,11
2005,144,Sri Lanka,United States of America,302,154,148
2005,156,China,United States of America,21277,13035,8242
2005,344,"China, Hong Kong SAR",United States of America,13370,7461,5909
2005,408,Dem. People's Republic of Korea,United States of America,792,417,375
2005,392,Japan,United States of America,47789,21768,26021
2005,496,Mongolia,United States of America,447,250,197
2005,410,Republic of Korea,United States of America,33075,23923,9152
2005,96,Brunei Darussalam,United States of America,147,104,43
2005,116,Cambodia,United States of America,301,175,126
2005,360,Indonesia,United States of America,6654,3906,2748
2005,608,Philippines,United States of America,29119,15493,13626
2005,702,Singapore,United States of America,9340,4880,4460
2005,764,Thailand,United States of America,3939,2799,1140
2005,626,Timor-Leste,United States of America,70,26,44
2005,704,Viet Nam,United States of America,1812,1108,704
2005,660,Anguilla,United States of America,390,112,278
2005,28,Antigua and Barbuda,United States of America,2313,1156,1157
2005,533,Aruba,United States of America,638,326,312
2005,44,Bahamas,United States of America,6587,3228,3359
2005,52,Barbados,United States of America,1147,531,616
2005,92,British Virgin Islands,United States of America,1042,469,573
2005,535,"Bonaire, Sint Eustatius and Saba",United States of America,1170,618,552
2005,136,Cayman Islands,United States of America,2133,1078,1055
2005,192,Cuba,United States of America,409,174,235
2005,212,Dominica,United States of America,439,268,171
2005,214,Dominican Republic,United States of America,17858,9361,8497
2005,312,Guadeloupe,United States of America,404,186,218
2005,332,Haiti,United States of America,1376,734,642
2005,388,Jamaica,United States of America,6493,3321,3172
2005,500,Montserrat,United States of America,109,57,52
2005,630,Puerto Rico,United States of America,223949,106093,117856
2005,662,Saint Lucia,United States of America,742,389,353
2005,670,Saint Vincent and the Grenadines,United States of America,328,171,157
2005,534,Sint Maarten (Dutch part),United States of America,150,68,82
2005,780,Trinidad and Tobago,United States of America,3757,1962,1795
2005,796,Turks and Caicos Islands,United States of America,695,366,329
2005,850,United States Virgin Islands,United States of America,16281,8027,8254
2005,84,Belize,United States of America,2694,1416,1278
2005,188,Costa Rica,United States of America,6332,3614,2718
2005,222,El Salvador,United States of America,4871,2416,2455
2005,320,Guatemala,United States of America,6473,3393,3080
2005,340,Honduras,United States of America,4946,2719,2227
2005,484,Mexico,United States of America,520053,262552,257501
2005,558,Nicaragua,United States of America,3085,1646,1439
2005,591,Panama,United States of America,8384,4953,3431
2005,32,Argentina,United States of America,6907,3653,3254
2005,68,Bolivia (Plurinational State of),United States of America,3935,2055,1880
2005,76,Brazil,United States of America,18779,10890,7889
2005,152,Chile,United States of America,8953,5012,3941
2005,170,Colombia,United States of America,15025,7747,7278
2005,218,Ecuador,United States of America,13118,7041,6077
2005,238,Falkland Islands (Malvinas),United States of America,30,18,12
2005,328,Guyana,United States of America,852,465,387
2005,600,Paraguay,United States of America,1696,909,787
2005,604,Peru,United States of America,8444,4483,3961
2005,858,Uruguay,United States of America,652,345,307
2005,862,Venezuela (Bolivarian Republic of),United States of America,10445,5345,5100
2005,36,Australia,United States of America,70520,35850,34670
2005,554,New Zealand,United States of America,16972,8238,8734
2005,598,Papua New Guinea,United States of America,851,689,162
2005,90,Solomon Islands,United States of America,77,45,32
2005,316,Guam,United States of America,18719,10289,8430
2005,296,Kiribati,United States of America,39,27,12
2005,584,Marshall Islands,United States of America,1053,648,405
2005,583,Micronesia (Fed. States of),United States of America,183,100,83
2005,580,Northern Mariana Islands,United States of America,1953,1085,868
2005,585,Palau,United States of America,377,199,178
2005,16,American Samoa,United States of America,3066,1578,1488
2005,184,Cook Islands,United States of America,24,16,8
2005,258,French Polynesia,United States of America,457,250,207
2005,570,Niue,United States of America,19,12,7
2005,882,Samoa,United States of America,436,212,224
2005,798,Tuvalu,United States of America,7,6,1
2005,112,Belarus,United States of America,86,35,51
2005,100,Bulgaria,United States of America,867,460,407
2005,203,Czechia,United States of America,2286,1464,822
2005,348,Hungary,United States of America,6147,3147,3000
2005,616,Poland,United States of America,11582,5338,6244
2005,642,Romania,United States of America,1960,923,1037
2005,643,Russian Federation,United States of America,3747,2054,1693
2005,703,Slovakia,United States of America,1573,753,820
2005,804,Ukraine,United States of America,2861,1550,1311
2005,208,Denmark,United States of America,9906,5152,4754
2005,233,Estonia,United States of America,409,241,168
2005,234,Faroe Islands,United States of America,31,18,13
2005,246,Finland,United States of America,3358,1895,1463
2005,352,Iceland,United States of America,1606,871,735
2005,372,Ireland,United States of America,25210,12433,12777
2005,833,Isle of Man,United States of America,223,83,140
2005,428,Latvia,United States of America,603,335,268
2005,440,Lithuania,United States of America,936,430,506
2005,578,Norway,United States of America,14507,6920,7587
2005,752,Sweden,United States of America,15522,8284,7238
2005,826,United Kingdom,United States of America,164325,76271,88054
2005,8,Albania,United States of America,2953,1854,1099
2005,20,Andorra,United States of America,101,53,48
2005,191,Croatia,United States of America,1221,531,690
2005,300,Greece,United States of America,23058,10067,12991
2005,380,Italy,United States of America,40484,16952,23532
2005,470,Malta,United States of America,1087,551,536
2005,620,Portugal,United States of America,7303,3572,3731
2005,688,Serbia,United States of America,1346,668,678
2005,705,Slovenia,United States of America,655,284,371
2005,724,Spain,United States of America,30491,15053,15438
2005,40,Austria,United States of America,8550,4267,4283
2005,56,Belgium,United States of America,14706,7278,7428
2005,250,France,United States of America,47875,21912,25963
2005,276,Germany,United States of America,110843,62230,48613
2005,438,Liechtenstein,United States of America,91,47,44
2005,442,Luxembourg,United States of America,836,457,379
2005,528,Netherlands,United States of America,22615,11146,11469
2005,756,Switzerland,United States of America,28796,14763,14033
2005,60,Bermuda,United States of America,3460,1772,1688
2005,124,Canada,United States of America,273338,127449,145889
2005,304,Greenland,United States of America,27,19,8
2005,666,Saint Pierre and Miquelon,United States of America,74,46,28
2010,480,Mauritius,United States of America,43,20,23
2010,800,Uganda,United States of America,858,429,429
2010,834,United Republic of Tanzania,United States of America,1234,706,528
2010,894,Zambia,United States of America,949,502,447
2010,120,Cameroon,United States of America,655,347,308
2010,140,Central African Republic,United States of America,628,545,83
2010,178,Congo,United States of America,125,77,48
2010,266,Gabon,United States of America,359,200,159
2010,72,Botswana,United States of America,790,370,420
2010,748,Eswatini,United States of America,228,93,135
2010,426,Lesotho,United States of America,87,46,41
2010,516,Namibia,United States of America,1050,442,608
2010,710,South Africa,United States of America,14644,6309,8335
2010,132,Cabo Verde,United States of America,338,168,170
2010,288,Ghana,United States of America,508,236,272
2010,324,Guinea,United States of America,472,286,186
2010,624,Guinea-Bissau,United States of America,293,124,169
2010,430,Liberia,United States of America,451,238,213
2010,466,Mali,United States of America,1166,734,432
2010,478,Mauritania,United States of America,108,65,43
2010,686,Senegal,United States of America,752,375,377
2010,694,Sierra Leone,United States of America,243,148,95
2010,768,Togo,United States of America,182,87,95
2010,12,Algeria,United States of America,948,444,504
2010,818,Egypt,United States of America,5674,3010,2664
2010,434,Libya,United States of America,8768,5962,2806
2010,504,Morocco,United States of America,1386,699,687
2010,788,Tunisia,United States of America,470,242,228
2010,48,Bahrain,United States of America,1169,788,381
2010,196,Cyprus,United States of America,3465,1624,1841
2010,268,Georgia,United States of America,102,63,39
2010,376,Israel,United States of America,76680,36824,39856
2010,400,Jordan,United States of America,5899,3749,2150
2010,414,Kuwait,United States of America,3669,2391,1278
2010,422,Lebanon,United States of America,815,466,349
2010,634,Qatar,United States of America,2412,1933,479
2010,275,State of Palestine,United States of America,7904,3687,4217
2010,792,Turkey,United States of America,13431,7126,6305
2010,784,United Arab Emirates,United States of America,13114,9183,3931
2010,762,Tajikistan,United States of America,279,149,130
2010,50,Bangladesh,United States of America,43455,23466,19989
2010,64,Bhutan,United States of America,129,67,62
2010,356,India,United States of America,2823,1383,1440
2010,462,Maldives,United States of America,38,31,7
2010,144,Sri Lanka,United States of America,598,307,291
2010,156,China,United States of America,23268,15133,8135
2010,344,"China, Hong Kong SAR",United States of America,12976,7193,5783
2010,408,Dem. People's Republic of Korea,United States of America,934,496,438
2010,392,Japan,United States of America,50667,22788,27879
2010,496,Mongolia,United States of America,646,373,273
2010,410,Republic of Korea,United States of America,53619,42684,10935
2010,96,Brunei Darussalam,United States of America,150,106,44
2010,116,Cambodia,United States of America,216,130,86
2010,360,Indonesia,United States of America,10909,6227,4682
2010,608,Philippines,United States of America,35015,17968,17047
2010,702,Singapore,United States of America,14344,7431,6913
2010,764,Thailand,United States of America,3750,2693,1057
2010,626,Timor-Leste,United States of America,72,21,51
2010,704,Viet Nam,United States of America,2625,1536,1089
2010,660,Anguilla,United States of America,424,122,302
2010,28,Antigua and Barbuda,United States of America,2469,1233,1236
2010,533,Aruba,United States of America,582,286,296
2010,44,Bahamas,United States of America,8919,4365,4554
2010,52,Barbados,United States of America,985,454,531
2010,92,British Virgin Islands,United States of America,1537,703,834
2010,535,"Bonaire, Sint Eustatius and Saba",United States of America,517,340,177
2010,136,Cayman Islands,United States of America,2640,1333,1307
2010,192,Cuba,United States of America,227,96,131
2010,531,Curaçao,United States of America,304,158,146
2010,212,Dominica,United States of America,534,328,206
2010,214,Dominican Republic,United States of America,24457,12797,11660
2010,312,Guadeloupe,United States of America,478,218,260
2010,332,Haiti,United States of America,1444,770,674
2010,388,Jamaica,United States of America,6329,3256,3073
2010,500,Montserrat,United States of America,115,60,55
2010,630,Puerto Rico,United States of America,185814,87095,98719
2010,662,Saint Lucia,United States of America,916,490,426
2010,670,Saint Vincent and the Grenadines,United States of America,337,176,161
2010,534,Sint Maarten (Dutch part),United States of America,300,135,165
2010,780,Trinidad and Tobago,United States of America,5597,2887,2710
2010,796,Turks and Caicos Islands,United States of America,715,385,330
2010,850,United States Virgin Islands,United States of America,16851,8191,8660
2010,84,Belize,United States of America,3474,1826,1648
2010,188,Costa Rica,United States of America,12480,7137,5343
2010,222,El Salvador,United States of America,5176,2562,2614
2010,320,Guatemala,United States of America,7514,4124,3390
2010,340,Honduras,United States of America,4851,2683,2168
2010,484,Mexico,United States of America,741918,376724,365194
2010,558,Nicaragua,United States of America,3298,1771,1527
2010,591,Panama,United States of America,11956,7131,4825
2010,32,Argentina,United States of America,4450,2425,2025
2010,68,Bolivia (Plurinational State of),United States of America,4206,2192,2014
2010,76,Brazil,United States of America,23308,13423,9885
2010,152,Chile,United States of America,10019,5656,4363
2010,170,Colombia,United States of America,17587,9257,8330
2010,218,Ecuador,United States of America,18426,9673,8753
2010,238,Falkland Islands (Malvinas),United States of America,17,7,10
2010,328,Guyana,United States of America,1071,588,483
2010,600,Paraguay,United States of America,1615,864,751
2010,604,Peru,United States of America,12739,7476,5263
2010,858,Uruguay,United States of America,604,317,287
2010,862,Venezuela (Bolivarian Republic of),United States of America,10848,5505,5343
2010,36,Australia,United States of America,85330,43109,42221
2010,554,New Zealand,United States of America,19794,9590,10204
2010,598,Papua New Guinea,United States of America,721,589,132
2010,90,Solomon Islands,United States of America,31,18,13
2010,316,Guam,United States of America,18343,9468,8875
2010,296,Kiribati,United States of America,40,29,11
2010,584,Marshall Islands,United States of America,1346,826,520
2010,583,Micronesia (Fed. States of),United States of America,176,96,80
2010,580,Northern Mariana Islands,United States of America,1395,725,670
2010,585,Palau,United States of America,361,182,179
2010,16,American Samoa,United States of America,2553,1278,1275
2010,184,Cook Islands,United States of America,29,18,11
2010,258,French Polynesia,United States of America,441,247,194
2010,570,Niue,United States of America,11,8,3
2010,882,Samoa,United States of America,381,183,198
2010,798,Tuvalu,United States of America,4,3,1
2010,112,Belarus,United States of America,82,33,49
2010,100,Bulgaria,United States of America,1132,605,527
2010,203,Czechia,United States of America,3320,2191,1129
2010,348,Hungary,United States of America,7317,3790,3527
2010,616,Poland,United States of America,14179,6964,7215
2010,642,Romania,United States of America,2758,1340,1418
2010,643,Russian Federation,United States of America,4502,2468,2034
2010,703,Slovakia,United States of America,1764,858,906
2010,804,Ukraine,United States of America,2729,1480,1249
2010,208,Denmark,United States of America,11017,5713,5304
2010,233,Estonia,United States of America,624,384,240
2010,234,Faroe Islands,United States of America,39,21,18
2010,246,Finland,United States of America,5079,2671,2408
2010,352,Iceland,United States of America,1938,1022,916
2010,372,Ireland,United States of America,30043,13375,16668
2010,833,Isle of Man,United States of America,265,94,171
2010,428,Latvia,United States of America,712,388,324
2010,440,Lithuania,United States of America,719,352,367
2010,578,Norway,United States of America,16046,7744,8302
2010,752,Sweden,United States of America,17179,9066,8113
2010,826,United Kingdom,United States of America,188055,78140,109915
2010,8,Albania,United States of America,2408,1512,896
2010,20,Andorra,United States of America,100,53,47
2010,191,Croatia,United States of America,1606,749,857
2010,300,Greece,United States of America,24284,10483,13801
2010,380,Italy,United States of America,57242,24783,32459
2010,470,Malta,United States of America,1053,541,512
2010,499,Montenegro,United States of America,302,64,238
2010,620,Portugal,United States of America,6137,3001,3136
2010,688,Serbia,United States of America,1316,652,664
2010,705,Slovenia,United States of America,666,333,333
2010,724,Spain,United States of America,35239,17145,18094
2010,40,Austria,United States of America,9451,4628,4823
2010,56,Belgium,United States of America,15171,7455,7716
2010,250,France,United States of America,50621,21047,29574
2010,276,Germany,United States of America,111303,63013,48290
2010,438,Liechtenstein,United States of America,124,66,58
2010,442,Luxembourg,United States of America,718,420,298
2010,528,Netherlands,United States of America,24368,12007,12361
2010,756,Switzerland,United States of America,33718,16386,17332
2010,60,Bermuda,United States of America,3481,1837,1644
2010,124,Canada,United States of America,263470,119643,143827
2010,304,Greenland,United States of America,30,19,11
2010,666,Saint Pierre and Miquelon,United States of America,65,38,27
2015,480,Mauritius,United States of America,49,24,25
2015,800,Uganda,United States of America,859,425,434
2015,834,United Republic of Tanzania,United States of America,1291,664,627
2015,894,Zambia,United States of America,836,441,395
2015,120,Cameroon,United States of America,837,392,445
2015,140,Central African Republic,United States of America,548,475,73
2015,178,Congo,United States of America,166,99,67
2015,266,Gabon,United States of America,502,311,191
2015,72,Botswana,United States of America,862,404,458
2015,748,Eswatini,United States of America,256,102,154
2015,426,Lesotho,United States of America,89,47,42
2015,516,Namibia,United States of America,1027,434,593
2015,710,South Africa,United States of America,15848,6368,9480
2015,132,Cabo Verde,United States of America,351,174,177
2015,288,Ghana,United States of America,625,291,334
2015,324,Guinea,United States of America,301,182,119
2015,624,Guinea-Bissau,United States of America,311,130,181
2015,430,Liberia,United States of America,517,271,246
2015,466,Mali,United States of America,1444,909,535
2015,478,Mauritania,United States of America,108,66,42
2015,686,Senegal,United States of America,802,400,402
2015,694,Sierra Leone,United States of America,179,110,69
2015,768,Togo,United States of America,182,87,95
2015,12,Algeria,United States of America,1046,490,556
2015,818,Egypt,United States of America,4207,2488,1719
2015,434,Libya,United States of America,9885,6678,3207
2015,504,Morocco,United States of America,1806,907,899
2015,788,Tunisia,United States of America,607,314,293
2015,48,Bahrain,United States of America,1120,750,370
2015,196,Cyprus,United States of America,3329,1572,1757
2015,268,Georgia,United States of America,107,67,40
2015,376,Israel,United States of America,79082,37776,41306
2015,400,Jordan,United States of America,2539,1406,1133
2015,414,Kuwait,United States of America,4763,2876,1887
2015,422,Lebanon,United States of America,686,329,357
2015,634,Qatar,United States of America,2280,1857,423
2015,275,State of Palestine,United States of America,7826,3641,4185
2015,792,Turkey,United States of America,13634,7089,6545
2015,784,United Arab Emirates,United States of America,14329,9865,4464
2015,762,Tajikistan,United States of America,274,146,128
2015,50,Bangladesh,United States of America,46008,24845,21163
2015,64,Bhutan,United States of America,136,71,65
2015,356,India,United States of America,2719,1331,1388
2015,462,Maldives,United States of America,44,40,4
2015,144,Sri Lanka,United States of America,609,308,301
2015,156,China,United States of America,26777,17843,8934
2015,344,"China, Hong Kong SAR",United States of America,13250,7114,6136
2015,408,Dem. People's Republic of Korea,United States of America,1028,549,479
2015,392,Japan,United States of America,52271,23315,28956
2015,496,Mongolia,United States of America,799,369,430
2015,410,Republic of Korea,United States of America,66621,52719,13902
2015,96,Brunei Darussalam,United States of America,153,108,45
2015,116,Cambodia,United States of America,195,119,76
2015,360,Indonesia,United States of America,12077,7007,5070
2015,608,Philippines,United States of America,35564,18277,17287
2015,702,Singapore,United States of America,17161,8881,8280
2015,764,Thailand,United States of America,4055,2909,1146
2015,626,Timor-Leste,United States of America,59,36,23
2015,704,Viet Nam,United States of America,3164,1838,1326
2015,660,Anguilla,United States of America,454,131,323
2015,28,Antigua and Barbuda,United States of America,2626,1311,1315
2015,533,Aruba,United States of America,612,301,311
2015,44,Bahamas,United States of America,9664,4694,4970
2015,52,Barbados,United States of America,1034,476,558
2015,92,British Virgin Islands,United States of America,1722,788,934
2015,535,"Bonaire, Sint Eustatius and Saba",United States of America,588,387,201
2015,136,Cayman Islands,United States of America,2876,1449,1427
2015,192,Cuba,United States of America,181,76,105
2015,531,Curaçao,United States of America,330,172,158
2015,212,Dominica,United States of America,623,383,240
2015,214,Dominican Republic,United States of America,14010,7373,6637
2015,312,Guadeloupe,United States of America,496,224,272
2015,332,Haiti,United States of America,1516,809,707
2015,388,Jamaica,United States of America,6193,3186,3007
2015,500,Montserrat,United States of America,120,63,57
2015,630,Puerto Rico,United States of America,165147,77034,88113
2015,662,Saint Lucia,United States of America,877,463,414
2015,670,Saint Vincent and the Grenadines,United States of America,342,183,159
2015,534,Sint Maarten (Dutch part),United States of America,312,140,172
2015,780,Trinidad and Tobago,United States of America,5798,3036,2762
2015,796,Turks and Caicos Islands,United States of America,925,499,426
2015,850,United States Virgin Islands,United States of America,16861,8193,8668
2015,84,Belize,United States of America,4097,2142,1955
2015,188,Costa Rica,United States of America,12673,7214,5459
2015,222,El Salvador,United States of America,5397,2676,2721
2015,320,Guatemala,United States of America,8643,4799,3844
2015,340,Honduras,United States of America,6799,3751,3048
2015,484,Mexico,United States of America,739362,369694,369668
2015,558,Nicaragua,United States of America,3606,1928,1678
2015,591,Panama,United States of America,14040,8361,5679
2015,32,Argentina,United States of America,5135,2797,2338
2015,68,Bolivia (Plurinational State of),United States of America,4896,2551,2345
2015,76,Brazil,United States of America,21068,9664,11404
2015,152,Chile,United States of America,15178,8426,6752
2015,170,Colombia,United States of America,19690,10455,9235
2015,218,Ecuador,United States of America,26802,13980,12822
2015,238,Falkland Islands (Malvinas),United States of America,19,8,11
2015,328,Guyana,United States of America,1255,689,566
2015,600,Paraguay,United States of America,1576,843,733
2015,604,Peru,United States of America,18958,11472,7486
2015,858,Uruguay,United States of America,623,327,296
2015,862,Venezuela (Bolivarian Republic of),United States of America,11242,5627,5615
2015,36,Australia,United States of America,104650,54014,50636
2015,554,New Zealand,United States of America,22300,10784,11516
2015,598,Papua New Guinea,United States of America,731,600,131
2015,90,Solomon Islands,United States of America,29,17,12
2015,316,Guam,United States of America,18508,9547,8961
2015,296,Kiribati,United States of America,40,29,11
2015,584,Marshall Islands,United States of America,1430,876,554
2015,583,Micronesia (Fed. States of),United States of America,172,94,78
2015,580,Northern Mariana Islands,United States of America,1249,646,603
2015,585,Palau,United States of America,324,172,152
2015,16,American Samoa,United States of America,2548,1267,1281
2015,184,Cook Islands,United States of America,26,16,10
2015,258,French Polynesia,United States of America,419,235,184
2015,570,Niue,United States of America,10,8,2
2015,882,Samoa,United States of America,316,151,165
2015,798,Tuvalu,United States of America,4,3,1
2015,112,Belarus,United States of America,87,37,50
2015,100,Bulgaria,United States of America,2431,1301,1130
2015,203,Czechia,United States of America,5209,3264,1945
2015,348,Hungary,United States of America,7777,4122,3655
2015,616,Poland,United States of America,13671,6846,6825
2015,642,Romania,United States of America,2876,1522,1354
2015,643,Russian Federation,United States of America,4588,2505,2083
2015,703,Slovakia,United States of America,2181,1148,1033
2015,804,Ukraine,United States of America,2738,1487,1251
2015,208,Denmark,United States of America,12871,6718,6153
2015,233,Estonia,United States of America,642,413,229
2015,234,Faroe Islands,United States of America,41,19,22
2015,246,Finland,United States of America,5722,3172,2550
2015,352,Iceland,United States of America,2019,1084,935
2015,372,Ireland,United States of America,30690,13453,17237
2015,833,Isle of Man,United States of America,227,101,126
2015,428,Latvia,United States of America,426,245,181
2015,440,Lithuania,United States of America,554,261,293
2015,578,Norway,United States of America,17695,8688,9007
2015,752,Sweden,United States of America,19515,10236,9279
2015,826,United Kingdom,United States of America,190133,90963,99170
2015,8,Albania,United States of America,2373,1490,883
2015,20,Andorra,United States of America,105,59,46
2015,191,Croatia,United States of America,1616,751,865
2015,300,Greece,United States of America,22792,9287,13505
2015,380,Italy,United States of America,51058,22084,28974
2015,470,Malta,United States of America,1667,912,755
2015,499,Montenegro,United States of America,317,69,248
2015,620,Portugal,United States of America,6957,3219,3738
2015,688,Serbia,United States of America,1286,636,650
2015,705,Slovenia,United States of America,702,379,323
2015,724,Spain,United States of America,42291,19947,22344
2015,40,Austria,United States of America,11054,5444,5610
2015,56,Belgium,United States of America,15979,7972,8007
2015,250,France,United States of America,56076,22411,33665
2015,276,Germany,United States of America,115973,65538,50435
2015,438,Liechtenstein,United States of America,129,66,63
2015,442,Luxembourg,United States of America,1095,648,447
2015,528,Netherlands,United States of America,28285,14212,14073
2015,756,Switzerland,United States of America,37392,17910,19482
2015,60,Bermuda,United States of America,3527,1864,1663
2015,124,Canada,United States of America,252159,112741,139418
2015,304,Greenland,United States of America,37,23,14
2015,666,Saint Pierre and Miquelon,United States of America,63,35,28
2019,480,Mauritius,United States of America,49,24,25
2019,800,Uganda,United States of America,861,425,436
2019,834,United Republic of Tanzania,United States of America,1157,592,565
2019,894,Zambia,United States of America,1077,570,507
2019,120,Cameroon,United States of America,832,390,442
2019,140,Central African Republic,United States of America,608,528,80
2019,178,Congo,United States of America,171,102,69
2019,266,Gabon,United States of America,544,336,208
2019,72,Botswana,United States of America,923,433,490
2019,748,Eswatini,United States of America,255,101,154
2019,426,Lesotho,United States of America,93,49,44
2019,516,Namibia,United States of America,1087,460,627
2019,710,South Africa,United States of America,17763,7148,10615
2019,132,Cabo Verde,United States of America,368,183,185
2019,288,Ghana,United States of America,703,328,375
2019,324,Guinea,United States of America,287,174,113
2019,624,Guinea-Bissau,United States of America,341,143,198
2019,430,Liberia,United States of America,429,225,204
2019,466,Mali,United States of America,1607,1012,595
2019,478,Mauritania,United States of America,112,69,43
2019,686,Senegal,United States of America,828,413,415
2019,694,Sierra Leone,United States of America,158,98,60
2019,768,Togo,United States of America,183,88,95
2019,12,Algeria,United States of America,1087,509,578
2019,818,Egypt,United States of America,5996,3257,2739
2019,434,Libya,United States of America,10488,7086,3402
2019,504,Morocco,United States of America,1926,968,958
2019,788,Tunisia,United States of America,616,319,297
2019,48,Bahrain,United States of America,1178,789,389
2019,196,Cyprus,United States of America,3327,1589,1738
2019,268,Georgia,United States of America,110,69,41
2019,376,Israel,United States of America,76904,36736,40168
2019,400,Jordan,United States of America,2730,1512,1218
2019,414,Kuwait,United States of America,5043,3045,1998
2019,422,Lebanon,United States of America,647,310,337
2019,634,Qatar,United States of America,4325,3466,859
2019,275,State of Palestine,United States of America,7771,3616,4155
2019,792,Turkey,United States of America,18435,9673,8762
2019,784,United Arab Emirates,United States of America,15390,10595,4795
2019,762,Tajikistan,United States of America,272,145,127
2019,50,Bangladesh,United States of America,46614,14215,32399
2019,64,Bhutan,United States of America,141,74,67
2019,356,India,United States of America,2674,1309,1365
2019,462,Maldives,United States of America,47,43,4
2019,144,Sri Lanka,United States of America,613,310,303
2019,156,China,United States of America,28223,18807,9416
2019,344,"China, Hong Kong SAR",United States of America,17166,8978,8188
2019,408,Dem. People's Republic of Korea,United States of America,1047,559,488
2019,392,Japan,United States of America,56321,25122,31199
2019,496,Mongolia,United States of America,848,392,456
2019,410,Republic of Korea,United States of America,67819,53662,14157
2019,96,Brunei Darussalam,United States of America,164,116,48
2019,116,Cambodia,United States of America,207,127,80
2019,360,Indonesia,United States of America,12613,7318,5295
2019,608,Philippines,United States of America,36683,18853,17830
2019,702,Singapore,United States of America,14543,7518,7025
2019,764,Thailand,United States of America,4227,3032,1195
2019,626,Timor-Leste,United States of America,58,36,22
2019,704,Viet Nam,United States of America,3307,1921,1386
2019,660,Anguilla,United States of America,471,136,335
2019,28,Antigua and Barbuda,United States of America,2731,1364,1367
2019,533,Aruba,United States of America,619,305,314
2019,44,Bahamas,United States of America,10259,4983,5276
2019,52,Barbados,United States of America,1043,480,563
2019,92,British Virgin Islands,United States of America,1870,856,1014
2019,535,"Bonaire, Sint Eustatius and Saba",United States of America,700,461,239
2019,136,Cayman Islands,United States of America,3184,1604,1580
2019,192,Cuba,United States of America,166,69,97
2019,531,Curaçao,United States of America,358,187,171
2019,212,Dominica,United States of America,636,391,245
2019,214,Dominican Republic,United States of America,14478,7620,6858
2019,312,Guadeloupe,United States of America,503,227,276
2019,332,Haiti,United States of America,1576,841,735
2019,388,Jamaica,United States of America,6286,3229,3057
2019,500,Montserrat,United States of America,122,65,57
2019,630,Puerto Rico,United States of America,159260,73939,85321
2019,662,Saint Lucia,United States of America,857,452,405
2019,670,Saint Vincent and the Grenadines,United States of America,345,186,159
2019,534,Sint Maarten (Dutch part),United States of America,323,145,178
2019,780,Trinidad and Tobago,United States of America,6241,3405,2836
2019,796,Turks and Caicos Islands,United States of America,998,539,459
2019,850,United States Virgin Islands,United States of America,16868,8197,8671
2019,84,Belize,United States of America,4495,2350,2145
2019,188,Costa Rica,United States of America,12859,7356,5503
2019,222,El Salvador,United States of America,5470,2713,2757
2019,320,Guatemala,United States of America,8871,4926,3945
2019,340,Honduras,United States of America,6908,3812,3096
2019,484,Mexico,United States of America,762290,381156,381134
2019,558,Nicaragua,United States of America,3777,2020,1757
2019,591,Panama,United States of America,14949,8904,6045
2019,32,Argentina,United States of America,5225,2843,2382
2019,68,Bolivia (Plurinational State of),United States of America,5345,2785,2560
2019,76,Brazil,United States of America,23726,10883,12843
2019,152,Chile,United States of America,20278,10755,9523
2019,170,Colombia,United States of America,20140,10694,9446
2019,218,Ecuador,United States of America,26386,13757,12629
2019,238,Falkland Islands (Malvinas),United States of America,23,10,13
2019,328,Guyana,United States of America,1280,703,577
2019,600,Paraguay,United States of America,1616,865,751
2019,604,Peru,United States of America,26369,17493,8876
2019,858,Uruguay,United States of America,644,339,305
2019,862,Venezuela (Bolivarian Republic of),United States of America,11011,5487,5524
2019,36,Australia,United States of America,114549,56779,57770
2019,554,New Zealand,United States of America,22922,11085,11837
2019,598,Papua New Guinea,United States of America,737,606,131
2019,90,Solomon Islands,United States of America,28,17,11
2019,316,Guam,United States of America,19421,10018,9403
2019,296,Kiribati,United States of America,41,30,11
2019,584,Marshall Islands,United States of America,1435,880,555
2019,583,Micronesia (Fed. States of),United States of America,175,96,79
2019,580,Northern Mariana Islands,United States of America,1258,651,607
2019,585,Palau,United States of America,332,161,171
2019,16,American Samoa,United States of America,2550,1268,1282
2019,184,Cook Islands,United States of America,26,16,10
2019,258,French Polynesia,United States of America,434,243,191
2019,570,Niue,United States of America,10,8,2
2019,882,Samoa,United States of America,299,143,156
2019,798,Tuvalu,United States of America,4,3,1
2019,112,Belarus,United States of America,85,36,49
2019,100,Bulgaria,United States of America,3153,1713,1440
2019,203,Czechia,United States of America,7650,4288,3362
2019,348,Hungary,United States of America,8324,4371,3953
2019,616,Poland,United States of America,14478,7528,6950
2019,642,Romania,United States of America,4855,2531,2324
2019,643,Russian Federation,United States of America,4586,2504,2082
2019,703,Slovakia,United States of America,2398,1286,1112
2019,804,Ukraine,United States of America,2765,1502,1263
2019,208,Denmark,United States of America,15110,7406,7704
2019,233,Estonia,United States of America,711,464,247
2019,234,Faroe Islands,United States of America,45,22,23
2019,246,Finland,United States of America,6686,3722,2964
2019,352,Iceland,United States of America,2461,1350,1111
2019,372,Ireland,United States of America,33693,14827,18866
2019,833,Isle of Man,United States of America,230,103,127
2019,428,Latvia,United States of America,465,278,187
2019,440,Lithuania,United States of America,410,184,226
2019,578,Norway,United States of America,19207,9391,9816
2019,752,Sweden,United States of America,22524,11721,10803
2019,826,United Kingdom,United States of America,215915,103582,112333
2019,8,Albania,United States of America,2242,1408,834
2019,20,Andorra,United States of America,112,64,48
2019,191,Croatia,United States of America,1492,691,801
2019,300,Greece,United States of America,22259,9570,12689
2019,380,Italy,United States of America,54184,23744,30440
2019,470,Malta,United States of America,2690,1480,1210
2019,499,Montenegro,United States of America,318,71,247
2019,620,Portugal,United States of America,7075,3282,3793
2019,688,Serbia,United States of America,1306,647,659
2019,705,Slovenia,United States of America,743,395,348
2019,724,Spain,United States of America,48225,22565,25660
2019,40,Austria,United States of America,13049,6541,6508
2019,56,Belgium,United States of America,16980,8567,8413
2019,250,France,United States of America,59356,23640,35716
2019,276,Germany,United States of America,127218,73790,53428
2019,438,Liechtenstein,United States of America,132,67,65
2019,442,Luxembourg,United States of America,2962,1549,1413
2019,528,Netherlands,United States of America,32596,15734,16862
2019,756,Switzerland,United States of America,39304,18969,20335
2019,60,Bermuda,United States of America,3565,1884,1681
2019,124,Canada,United States of America,270217,120815,149402
2019,304,Greenland,United States of America,36,23,13
2019,666,Saint Pierre and Miquelon,United States of America,63,35,28
1990,132,Cabo Verde,United States Virgin Islands,20,10,10
1990,762,Tajikistan,United States Virgin Islands,37,17,20
1990,660,Anguilla,United States Virgin Islands,192,71,121
1990,28,Antigua and Barbuda,United States Virgin Islands,295,142,153
1990,535,"Bonaire, Sint Eustatius and Saba",United States Virgin Islands,52,24,28
1990,214,Dominican Republic,United States Virgin Islands,472,297,175
1990,308,Grenada,United States Virgin Islands,7,4,3
1990,630,Puerto Rico,United States Virgin Islands,936,443,493
1990,659,Saint Kitts and Nevis,United States Virgin Islands,265,121,144
1990,662,Saint Lucia,United States Virgin Islands,9,3,6
1990,188,Costa Rica,United States Virgin Islands,6,3,3
1990,152,Chile,United States Virgin Islands,1,1,0
1990,826,United Kingdom,United States Virgin Islands,21,13,8
1990,300,Greece,United States Virgin Islands,14,8,6
1990,250,France,United States Virgin Islands,1,1,0
1990,124,Canada,United States Virgin Islands,34,17,17
1995,132,Cabo Verde,United States Virgin Islands,30,16,14
1995,762,Tajikistan,United States Virgin Islands,30,14,16
1995,660,Anguilla,United States Virgin Islands,247,88,159
1995,28,Antigua and Barbuda,United States Virgin Islands,440,213,227
1995,535,"Bonaire, Sint Eustatius and Saba",United States Virgin Islands,108,49,59
1995,214,Dominican Republic,United States Virgin Islands,524,325,199
1995,308,Grenada,United States Virgin Islands,321,317,4
1995,630,Puerto Rico,United States Virgin Islands,939,446,493
1995,659,Saint Kitts and Nevis,United States Virgin Islands,350,162,188
1995,662,Saint Lucia,United States Virgin Islands,11,4,7
1995,188,Costa Rica,United States Virgin Islands,4,2,2
1995,152,Chile,United States Virgin Islands,1,1,0
1995,826,United Kingdom,United States Virgin Islands,85,41,44
1995,300,Greece,United States Virgin Islands,14,5,9
1995,250,France,United States Virgin Islands,1,1,0
1995,124,Canada,United States Virgin Islands,34,17,17
2000,132,Cabo Verde,United States Virgin Islands,39,21,18
2000,762,Tajikistan,United States Virgin Islands,26,13,13
2000,660,Anguilla,United States Virgin Islands,302,105,197
2000,28,Antigua and Barbuda,United States Virgin Islands,584,283,301
2000,535,"Bonaire, Sint Eustatius and Saba",United States Virgin Islands,164,74,90
2000,214,Dominican Republic,United States Virgin Islands,576,353,223
2000,308,Grenada,United States Virgin Islands,635,630,5
2000,630,Puerto Rico,United States Virgin Islands,945,449,496
2000,659,Saint Kitts and Nevis,United States Virgin Islands,483,227,256
2000,662,Saint Lucia,United States Virgin Islands,16,6,10
2000,188,Costa Rica,United States Virgin Islands,5,2,3
2000,152,Chile,United States Virgin Islands,1,1,0
2000,826,United Kingdom,United States Virgin Islands,152,71,81
2000,300,Greece,United States Virgin Islands,15,3,12
2000,250,France,United States Virgin Islands,1,1,0
2000,124,Canada,United States Virgin Islands,35,17,18
2005,132,Cabo Verde,United States Virgin Islands,54,28,26
2005,762,Tajikistan,United States Virgin Islands,24,11,13
2005,660,Anguilla,United States Virgin Islands,348,122,226
2005,28,Antigua and Barbuda,United States Virgin Islands,627,304,323
2005,535,"Bonaire, Sint Eustatius and Saba",United States Virgin Islands,174,79,95
2005,214,Dominican Republic,United States Virgin Islands,328,199,129
2005,308,Grenada,United States Virgin Islands,665,660,5
2005,630,Puerto Rico,United States Virgin Islands,740,352,388
2005,659,Saint Kitts and Nevis,United States Virgin Islands,550,260,290
2005,662,Saint Lucia,United States Virgin Islands,59,21,38
2005,534,Sint Maarten (Dutch part),United States Virgin Islands,33,17,16
2005,188,Costa Rica,United States Virgin Islands,3,1,2
2005,152,Chile,United States Virgin Islands,1,1,0
2005,826,United Kingdom,United States Virgin Islands,130,62,68
2005,300,Greece,United States Virgin Islands,8,2,6
2005,250,France,United States Virgin Islands,23,16,7
2005,124,Canada,United States Virgin Islands,45,20,25
2010,132,Cabo Verde,United States Virgin Islands,68,35,33
2010,466,Mali,United States Virgin Islands,378,184,194
2010,762,Tajikistan,United States Virgin Islands,23,11,12
2010,660,Anguilla,United States Virgin Islands,379,134,245
2010,28,Antigua and Barbuda,United States Virgin Islands,669,324,345
2010,531,Curaçao,United States Virgin Islands,26,7,19
2010,214,Dominican Republic,United States Virgin Islands,78,43,35
2010,308,Grenada,United States Virgin Islands,696,691,5
2010,630,Puerto Rico,United States Virgin Islands,443,208,235
2010,659,Saint Kitts and Nevis,United States Virgin Islands,596,283,313
2010,662,Saint Lucia,United States Virgin Islands,99,35,64
2010,534,Sint Maarten (Dutch part),United States Virgin Islands,67,34,33
2010,188,Costa Rica,United States Virgin Islands,7,3,4
2010,152,Chile,United States Virgin Islands,2,2,0
2010,826,United Kingdom,United States Virgin Islands,136,66,70
2010,250,France,United States Virgin Islands,1,1,0
2010,124,Canada,United States Virgin Islands,45,19,26
2015,132,Cabo Verde,United States Virgin Islands,71,37,34
2015,466,Mali,United States Virgin Islands,468,228,240
2015,762,Tajikistan,United States Virgin Islands,22,11,11
2015,660,Anguilla,United States Virgin Islands,406,144,262
2015,28,Antigua and Barbuda,United States Virgin Islands,711,344,367
2015,531,Curaçao,United States Virgin Islands,28,8,20
2015,214,Dominican Republic,United States Virgin Islands,82,46,36
2015,308,Grenada,United States Virgin Islands,704,699,5
2015,630,Puerto Rico,United States Virgin Islands,433,202,231
2015,659,Saint Kitts and Nevis,United States Virgin Islands,613,292,321
2015,662,Saint Lucia,United States Virgin Islands,94,34,60
2015,534,Sint Maarten (Dutch part),United States Virgin Islands,70,36,34
2015,188,Costa Rica,United States Virgin Islands,7,3,4
2015,152,Chile,United States Virgin Islands,3,3,0
2015,826,United Kingdom,United States Virgin Islands,173,81,92
2015,250,France,United States Virgin Islands,1,1,0
2015,124,Canada,United States Virgin Islands,89,50,39
2019,132,Cabo Verde,United States Virgin Islands,74,39,35
2019,466,Mali,United States Virgin Islands,521,254,267
2019,762,Tajikistan,United States Virgin Islands,21,11,10
2019,660,Anguilla,United States Virgin Islands,421,150,271
2019,28,Antigua and Barbuda,United States Virgin Islands,739,358,381
2019,531,Curaçao,United States Virgin Islands,30,9,21
2019,214,Dominican Republic,United States Virgin Islands,84,47,37
2019,308,Grenada,United States Virgin Islands,710,705,5
2019,630,Puerto Rico,United States Virgin Islands,411,191,220
2019,659,Saint Kitts and Nevis,United States Virgin Islands,624,297,327
2019,662,Saint Lucia,United States Virgin Islands,90,33,57
2019,534,Sint Maarten (Dutch part),United States Virgin Islands,72,37,35
2019,188,Costa Rica,United States Virgin Islands,7,3,4
2019,152,Chile,United States Virgin Islands,4,4,0
2019,826,United Kingdom,United States Virgin Islands,196,92,104
2019,250,France,United States Virgin Islands,1,1,0
2019,124,Canada,United States Virgin Islands,95,54,41
1990,710,South Africa,Uruguay,111,73,38
1990,196,Cyprus,Uruguay,1,0,1
1990,376,Israel,Uruguay,4315,2047,2268
1990,792,Turkey,Uruguay,10,6,4
1990,496,Mongolia,Uruguay,7,4,3
1990,44,Bahamas,Uruguay,2,0,2
1990,214,Dominican Republic,Uruguay,1625,667,958
1990,332,Haiti,Uruguay,286,112,174
1990,188,Costa Rica,Uruguay,252,137,115
1990,222,El Salvador,Uruguay,120,75,45
1990,320,Guatemala,Uruguay,95,46,49
1990,340,Honduras,Uruguay,51,33,18
1990,484,Mexico,Uruguay,1113,594,519
1990,558,Nicaragua,Uruguay,11,5,6
1990,591,Panama,Uruguay,147,84,63
1990,32,Argentina,Uruguay,136906,66665,70241
1990,68,Bolivia (Plurinational State of),Uruguay,402,211,191
1990,76,Brazil,Uruguay,23363,12682,10681
1990,152,Chile,Uruguay,1393,722,671
1990,170,Colombia,Uruguay,360,202,158
1990,218,Ecuador,Uruguay,320,201,119
1990,600,Paraguay,Uruguay,3293,1840,1453
1990,604,Peru,Uruguay,389,223,166
1990,862,Venezuela (Bolivarian Republic of),Uruguay,6076,3231,2845
1990,36,Australia,Uruguay,11795,5821,5974
1990,112,Belarus,Uruguay,21,7,14
1990,100,Bulgaria,Uruguay,2,0,2
1990,203,Czechia,Uruguay,9,6,3
1990,348,Hungary,Uruguay,60,27,33
1990,616,Poland,Uruguay,14,6,8
1990,643,Russian Federation,Uruguay,479,235,244
1990,208,Denmark,Uruguay,164,83,81
1990,246,Finland,Uruguay,34,22,12
1990,352,Iceland,Uruguay,3,2,1
1990,372,Ireland,Uruguay,11,5,6
1990,428,Latvia,Uruguay,3,1,2
1990,440,Lithuania,Uruguay,22,8,14
1990,578,Norway,Uruguay,145,67,78
1990,752,Sweden,Uruguay,1749,918,831
1990,826,United Kingdom,Uruguay,134,78,56
1990,20,Andorra,Uruguay,78,42,36
1990,300,Greece,Uruguay,56,30,26
1990,380,Italy,Uruguay,678,236,442
1990,620,Portugal,Uruguay,39,20,19
1990,724,Spain,Uruguay,10922,5228,5694
1990,40,Austria,Uruguay,155,70,85
1990,56,Belgium,Uruguay,337,182,155
1990,250,France,Uruguay,2065,977,1088
1990,276,Germany,Uruguay,830,422,408
1990,528,Netherlands,Uruguay,284,155,129
1990,756,Switzerland,Uruguay,950,445,505
1990,124,Canada,Uruguay,5033,2451,2582
1990,840,United States of America,Uruguay,20766,9095,11671
1995,710,South Africa,Uruguay,69,48,21
1995,196,Cyprus,Uruguay,2,0,2
1995,376,Israel,Uruguay,4936,2302,2634
1995,792,Turkey,Uruguay,25,14,11
1995,496,Mongolia,Uruguay,6,4,2
1995,44,Bahamas,Uruguay,2,0,2
1995,214,Dominican Republic,Uruguay,1805,715,1090
1995,332,Haiti,Uruguay,271,106,165
1995,188,Costa Rica,Uruguay,196,106,90
1995,222,El Salvador,Uruguay,94,59,35
1995,320,Guatemala,Uruguay,92,49,43
1995,340,Honduras,Uruguay,51,32,19
1995,484,Mexico,Uruguay,1506,768,738
1995,558,Nicaragua,Uruguay,9,4,5
1995,591,Panama,Uruguay,199,115,84
1995,32,Argentina,Uruguay,125366,61245,64121
1995,68,Bolivia (Plurinational State of),Uruguay,430,231,199
1995,76,Brazil,Uruguay,24081,12830,11251
1995,152,Chile,Uruguay,1816,947,869
1995,170,Colombia,Uruguay,362,210,152
1995,218,Ecuador,Uruguay,359,225,134
1995,600,Paraguay,Uruguay,3303,1869,1434
1995,604,Peru,Uruguay,382,216,166
1995,862,Venezuela (Bolivarian Republic of),Uruguay,5364,2856,2508
1995,36,Australia,Uruguay,11366,5550,5816
1995,112,Belarus,Uruguay,25,6,19
1995,100,Bulgaria,Uruguay,5,2,3
1995,203,Czechia,Uruguay,13,9,4
1995,348,Hungary,Uruguay,53,23,30
1995,616,Poland,Uruguay,11,5,6
1995,643,Russian Federation,Uruguay,498,246,252
1995,208,Denmark,Uruguay,184,94,90
1995,246,Finland,Uruguay,39,26,13
1995,352,Iceland,Uruguay,5,3,2
1995,372,Ireland,Uruguay,30,13,17
1995,428,Latvia,Uruguay,4,2,2
1995,440,Lithuania,Uruguay,25,9,16
1995,578,Norway,Uruguay,145,73,72
1995,752,Sweden,Uruguay,2076,1082,994
1995,826,United Kingdom,Uruguay,530,246,284
1995,20,Andorra,Uruguay,78,41,37
1995,300,Greece,Uruguay,87,34,53
1995,380,Italy,Uruguay,1637,573,1064
1995,620,Portugal,Uruguay,84,43,41
1995,724,Spain,Uruguay,12691,6192,6499
1995,40,Austria,Uruguay,175,81,94
1995,56,Belgium,Uruguay,337,182,155
1995,250,France,Uruguay,2132,989,1143
1995,276,Germany,Uruguay,782,367,415
1995,528,Netherlands,Uruguay,417,223,194
1995,756,Switzerland,Uruguay,1060,522,538
1995,124,Canada,Uruguay,5570,2698,2872
1995,840,United States of America,Uruguay,23208,10283,12925
2000,710,South Africa,Uruguay,48,36,12
2000,196,Cyprus,Uruguay,2,0,2
2000,376,Israel,Uruguay,5280,2456,2824
2000,792,Turkey,Uruguay,41,22,19
2000,496,Mongolia,Uruguay,7,4,3
2000,44,Bahamas,Uruguay,2,0,2
2000,214,Dominican Republic,Uruguay,1985,763,1222
2000,332,Haiti,Uruguay,257,101,156
2000,188,Costa Rica,Uruguay,239,125,114
2000,222,El Salvador,Uruguay,67,43,24
2000,320,Guatemala,Uruguay,89,53,36
2000,340,Honduras,Uruguay,50,31,19
2000,484,Mexico,Uruguay,1966,980,986
2000,558,Nicaragua,Uruguay,21,9,12
2000,591,Panama,Uruguay,264,152,112
2000,32,Argentina,Uruguay,113827,55827,58000
2000,68,Bolivia (Plurinational State of),Uruguay,453,248,205
2000,76,Brazil,Uruguay,24799,12978,11821
2000,152,Chile,Uruguay,2238,1161,1077
2000,170,Colombia,Uruguay,364,218,146
2000,218,Ecuador,Uruguay,398,250,148
2000,600,Paraguay,Uruguay,3303,1883,1420
2000,604,Peru,Uruguay,447,253,194
2000,862,Venezuela (Bolivarian Republic of),Uruguay,4692,2498,2194
2000,36,Australia,Uruguay,10570,5161,5409
2000,112,Belarus,Uruguay,28,4,24
2000,100,Bulgaria,Uruguay,8,4,4
2000,203,Czechia,Uruguay,17,12,5
2000,348,Hungary,Uruguay,46,20,26
2000,616,Poland,Uruguay,10,4,6
2000,643,Russian Federation,Uruguay,500,249,251
2000,208,Denmark,Uruguay,204,106,98
2000,246,Finland,Uruguay,43,30,13
2000,352,Iceland,Uruguay,6,4,2
2000,372,Ireland,Uruguay,65,29,36
2000,428,Latvia,Uruguay,5,2,3
2000,440,Lithuania,Uruguay,19,7,12
2000,578,Norway,Uruguay,163,81,82
2000,752,Sweden,Uruguay,2227,1154,1073
2000,826,United Kingdom,Uruguay,935,416,519
2000,20,Andorra,Uruguay,77,40,37
2000,300,Greece,Uruguay,119,37,82
2000,380,Italy,Uruguay,2596,910,1686
2000,620,Portugal,Uruguay,134,68,66
2000,705,Slovenia,Uruguay,5,3,2
2000,724,Spain,Uruguay,19920,9995,9925
2000,40,Austria,Uruguay,195,92,103
2000,56,Belgium,Uruguay,326,177,149
2000,250,France,Uruguay,2198,1001,1197
2000,276,Germany,Uruguay,733,312,421
2000,528,Netherlands,Uruguay,565,297,268
2000,756,Switzerland,Uruguay,1175,602,573
2000,124,Canada,Uruguay,6240,3011,3229
2000,840,United States of America,Uruguay,25673,11499,14174
2005,710,South Africa,Uruguay,63,46,17
2005,196,Cyprus,Uruguay,3,0,3
2005,376,Israel,Uruguay,5697,2647,3050
2005,792,Turkey,Uruguay,42,22,20
2005,496,Mongolia,Uruguay,3,2,1
2005,44,Bahamas,Uruguay,9,4,5
2005,214,Dominican Republic,Uruguay,1083,427,656
2005,332,Haiti,Uruguay,244,96,148
2005,188,Costa Rica,Uruguay,157,81,76
2005,222,El Salvador,Uruguay,70,46,24
2005,320,Guatemala,Uruguay,106,66,40
2005,340,Honduras,Uruguay,49,30,19
2005,484,Mexico,Uruguay,2049,1065,984
2005,558,Nicaragua,Uruguay,34,13,21
2005,591,Panama,Uruguay,445,258,187
2005,32,Argentina,Uruguay,114433,55162,59271
2005,68,Bolivia (Plurinational State of),Uruguay,445,253,192
2005,76,Brazil,Uruguay,24495,12705,11790
2005,152,Chile,Uruguay,3359,1768,1591
2005,170,Colombia,Uruguay,354,217,137
2005,218,Ecuador,Uruguay,469,298,171
2005,600,Paraguay,Uruguay,3146,1794,1352
2005,604,Peru,Uruguay,525,299,226
2005,862,Venezuela (Bolivarian Republic of),Uruguay,4672,2488,2184
2005,36,Australia,Uruguay,10790,5200,5590
2005,112,Belarus,Uruguay,27,4,23
2005,100,Bulgaria,Uruguay,12,7,5
2005,203,Czechia,Uruguay,19,12,7
2005,348,Hungary,Uruguay,57,25,32
2005,616,Poland,Uruguay,52,26,26
2005,643,Russian Federation,Uruguay,312,153,159
2005,208,Denmark,Uruguay,213,110,103
2005,246,Finland,Uruguay,64,43,21
2005,352,Iceland,Uruguay,7,5,2
2005,372,Ireland,Uruguay,65,31,34
2005,428,Latvia,Uruguay,3,2,1
2005,440,Lithuania,Uruguay,24,10,14
2005,578,Norway,Uruguay,155,74,81
2005,752,Sweden,Uruguay,2312,1182,1130
2005,826,United Kingdom,Uruguay,1079,496,583
2005,20,Andorra,Uruguay,105,55,50
2005,300,Greece,Uruguay,117,41,76
2005,380,Italy,Uruguay,5048,2091,2957
2005,620,Portugal,Uruguay,181,112,69
2005,705,Slovenia,Uruguay,7,2,5
2005,724,Spain,Uruguay,65654,33750,31904
2005,40,Austria,Uruguay,218,100,118
2005,56,Belgium,Uruguay,443,227,216
2005,250,France,Uruguay,2114,972,1142
2005,276,Germany,Uruguay,1839,841,998
2005,528,Netherlands,Uruguay,608,315,293
2005,756,Switzerland,Uruguay,1300,643,657
2005,124,Canada,Uruguay,6280,3032,3248
2005,840,United States of America,Uruguay,37981,17128,20853
2010,710,South Africa,Uruguay,98,72,26
2010,466,Mali,Uruguay,410,194,216
2010,196,Cyprus,Uruguay,4,0,4
2010,376,Israel,Uruguay,6184,2865,3319
2010,792,Turkey,Uruguay,43,22,21
2010,496,Mongolia,Uruguay,1,1,0
2010,44,Bahamas,Uruguay,16,9,7
2010,214,Dominican Republic,Uruguay,173,88,85
2010,332,Haiti,Uruguay,256,101,155
2010,188,Costa Rica,Uruguay,309,160,149
2010,222,El Salvador,Uruguay,72,48,24
2010,320,Guatemala,Uruguay,122,79,43
2010,340,Honduras,Uruguay,48,30,18
2010,484,Mexico,Uruguay,2371,1275,1096
2010,558,Nicaragua,Uruguay,36,14,22
2010,591,Panama,Uruguay,648,380,268
2010,32,Argentina,Uruguay,115039,54497,60542
2010,68,Bolivia (Plurinational State of),Uruguay,437,258,179
2010,76,Brazil,Uruguay,23840,12237,11603
2010,152,Chile,Uruguay,4480,2376,2104
2010,170,Colombia,Uruguay,406,256,150
2010,218,Ecuador,Uruguay,659,413,246
2010,600,Paraguay,Uruguay,2997,1707,1290
2010,604,Peru,Uruguay,587,334,253
2010,862,Venezuela (Bolivarian Republic of),Uruguay,4700,2506,2194
2010,36,Australia,Uruguay,10630,5108,5522
2010,112,Belarus,Uruguay,26,4,22
2010,100,Bulgaria,Uruguay,16,10,6
2010,203,Czechia,Uruguay,19,10,9
2010,348,Hungary,Uruguay,68,30,38
2010,616,Poland,Uruguay,97,48,49
2010,643,Russian Federation,Uruguay,118,53,65
2010,208,Denmark,Uruguay,217,111,106
2010,233,Estonia,Uruguay,4,2,2
2010,246,Finland,Uruguay,97,62,35
2010,352,Iceland,Uruguay,8,6,2
2010,372,Ireland,Uruguay,54,23,31
2010,428,Latvia,Uruguay,2,2,0
2010,440,Lithuania,Uruguay,26,11,15
2010,578,Norway,Uruguay,188,90,98
2010,752,Sweden,Uruguay,2247,1137,1110
2010,826,United Kingdom,Uruguay,1136,535,601
2010,20,Andorra,Uruguay,122,65,57
2010,300,Greece,Uruguay,119,47,72
2010,380,Italy,Uruguay,7912,3440,4472
2010,620,Portugal,Uruguay,198,137,61
2010,705,Slovenia,Uruguay,18,7,11
2010,724,Spain,Uruguay,84809,43454,41355
2010,40,Austria,Uruguay,241,108,133
2010,56,Belgium,Uruguay,432,215,217
2010,250,France,Uruguay,2287,1013,1274
2010,276,Germany,Uruguay,2759,1295,1464
2010,528,Netherlands,Uruguay,619,314,305
2010,756,Switzerland,Uruguay,1553,712,841
2010,124,Canada,Uruguay,6600,3198,3402
2010,840,United States of America,Uruguay,51776,20076,31700
2015,710,South Africa,Uruguay,175,127,48
2015,324,Guinea,Uruguay,1,1,0
2015,466,Mali,Uruguay,508,241,267
2015,196,Cyprus,Uruguay,3,0,3
2015,376,Israel,Uruguay,6378,2938,3440
2015,792,Turkey,Uruguay,43,22,21
2015,496,Mongolia,Uruguay,1,1,0
2015,44,Bahamas,Uruguay,17,9,8
2015,214,Dominican Republic,Uruguay,182,93,89
2015,332,Haiti,Uruguay,268,106,162
2015,188,Costa Rica,Uruguay,313,161,152
2015,222,El Salvador,Uruguay,75,50,25
2015,320,Guatemala,Uruguay,140,91,49
2015,340,Honduras,Uruguay,66,42,24
2015,484,Mexico,Uruguay,3210,1274,1936
2015,558,Nicaragua,Uruguay,38,15,23
2015,591,Panama,Uruguay,762,446,316
2015,32,Argentina,Uruguay,132749,62845,69904
2015,68,Bolivia (Plurinational State of),Uruguay,509,301,208
2015,76,Brazil,Uruguay,28708,14736,13972
2015,152,Chile,Uruguay,6786,3530,3256
2015,170,Colombia,Uruguay,454,288,166
2015,218,Ecuador,Uruguay,958,598,360
2015,600,Paraguay,Uruguay,2925,1665,1260
2015,604,Peru,Uruguay,623,361,262
2015,862,Venezuela (Bolivarian Republic of),Uruguay,4795,2526,2269
2015,36,Australia,Uruguay,10580,5129,5451
2015,112,Belarus,Uruguay,28,4,24
2015,100,Bulgaria,Uruguay,18,13,5
2015,203,Czechia,Uruguay,31,21,10
2015,348,Hungary,Uruguay,66,32,34
2015,616,Poland,Uruguay,93,47,46
2015,643,Russian Federation,Uruguay,121,54,67
2015,208,Denmark,Uruguay,249,127,122
2015,233,Estonia,Uruguay,5,3,2
2015,246,Finland,Uruguay,126,70,56
2015,352,Iceland,Uruguay,9,6,3
2015,372,Ireland,Uruguay,55,23,32
2015,428,Latvia,Uruguay,3,2,1
2015,440,Lithuania,Uruguay,25,9,16
2015,578,Norway,Uruguay,236,118,118
2015,752,Sweden,Uruguay,2159,1102,1057
2015,826,United Kingdom,Uruguay,1452,661,791
2015,20,Andorra,Uruguay,102,55,47
2015,300,Greece,Uruguay,111,41,70
2015,380,Italy,Uruguay,7196,3109,4087
2015,620,Portugal,Uruguay,225,153,72
2015,705,Slovenia,Uruguay,11,4,7
2015,724,Spain,Uruguay,73640,37286,36354
2015,40,Austria,Uruguay,282,127,155
2015,56,Belgium,Uruguay,490,248,242
2015,250,France,Uruguay,2533,1083,1450
2015,276,Germany,Uruguay,2875,1346,1529
2015,528,Netherlands,Uruguay,658,336,322
2015,756,Switzerland,Uruguay,1592,729,863
2015,124,Canada,Uruguay,6494,3233,3261
2015,840,United States of America,Uruguay,52070,20027,32043
2019,710,South Africa,Uruguay,195,142,53
2019,466,Mali,Uruguay,565,268,297
2019,196,Cyprus,Uruguay,2,0,2
2019,376,Israel,Uruguay,6202,2857,3345
2019,792,Turkey,Uruguay,58,30,28
2019,496,Mongolia,Uruguay,1,1,0
2019,44,Bahamas,Uruguay,18,10,8
2019,214,Dominican Republic,Uruguay,188,97,91
2019,332,Haiti,Uruguay,278,110,168
2019,188,Costa Rica,Uruguay,317,164,153
2019,222,El Salvador,Uruguay,76,51,25
2019,320,Guatemala,Uruguay,143,93,50
2019,340,Honduras,Uruguay,67,43,24
2019,484,Mexico,Uruguay,3309,1313,1996
2019,558,Nicaragua,Uruguay,39,15,24
2019,591,Panama,Uruguay,810,474,336
2019,32,Argentina,Uruguay,135076,63830,71246
2019,68,Bolivia (Plurinational State of),Uruguay,555,328,227
2019,76,Brazil,Uruguay,32331,16596,15735
2019,152,Chile,Uruguay,9066,4474,4592
2019,170,Colombia,Uruguay,464,295,169
2019,218,Ecuador,Uruguay,943,589,354
2019,600,Paraguay,Uruguay,3000,1708,1292
2019,604,Peru,Uruguay,884,534,350
2019,862,Venezuela (Bolivarian Republic of),Uruguay,4696,2464,2232
2019,36,Australia,Uruguay,11246,5408,5838
2019,112,Belarus,Uruguay,27,4,23
2019,100,Bulgaria,Uruguay,20,14,6
2019,203,Czechia,Uruguay,37,23,14
2019,348,Hungary,Uruguay,58,25,33
2019,616,Poland,Uruguay,98,52,46
2019,643,Russian Federation,Uruguay,120,54,66
2019,208,Denmark,Uruguay,248,124,124
2019,233,Estonia,Uruguay,5,4,1
2019,246,Finland,Uruguay,153,84,69
2019,352,Iceland,Uruguay,11,8,3
2019,372,Ireland,Uruguay,60,25,35
2019,428,Latvia,Uruguay,1,1,0
2019,440,Lithuania,Uruguay,21,9,12
2019,578,Norway,Uruguay,257,136,121
2019,752,Sweden,Uruguay,2191,1128,1063
2019,826,United Kingdom,Uruguay,1648,753,895
2019,20,Andorra,Uruguay,108,59,49
2019,300,Greece,Uruguay,108,43,65
2019,380,Italy,Uruguay,7446,3254,4192
2019,620,Portugal,Uruguay,228,155,73
2019,705,Slovenia,Uruguay,15,6,9
2019,724,Spain,Uruguay,75539,37688,37851
2019,40,Austria,Uruguay,332,153,179
2019,56,Belgium,Uruguay,516,267,249
2019,250,France,Uruguay,2681,1143,1538
2019,276,Germany,Uruguay,3153,1559,1594
2019,528,Netherlands,Uruguay,722,359,363
2019,756,Switzerland,Uruguay,1648,761,887
2019,124,Canada,Uruguay,6959,3465,3494
2019,840,United States of America,Uruguay,56230,21255,34975
1990,818,Egypt,Uzbekistan,85,66,19
1990,434,Libya,Uzbekistan,243,191,52
1990,51,Armenia,Uzbekistan,1150,288,862
1990,31,Azerbaijan,Uzbekistan,23232,10255,12977
1990,196,Cyprus,Uzbekistan,18,8,10
1990,268,Georgia,Uzbekistan,10078,4523,5555
1990,376,Israel,Uzbekistan,31121,15148,15973
1990,792,Turkey,Uzbekistan,1992,1026,966
1990,398,Kazakhstan,Uzbekistan,131905,65619,66286
1990,417,Kyrgyzstan,Uzbekistan,18416,7899,10517
1990,762,Tajikistan,Uzbekistan,18848,8276,10572
1990,795,Turkmenistan,Uzbekistan,110271,50005,60266
1990,4,Afghanistan,Uzbekistan,2027,1144,883
1990,410,Republic of Korea,Uzbekistan,30,24,6
1990,188,Costa Rica,Uzbekistan,1,0,1
1990,152,Chile,Uzbekistan,40,25,15
1990,36,Australia,Uzbekistan,245,123,122
1990,112,Belarus,Uzbekistan,17154,8207,8947
1990,100,Bulgaria,Uzbekistan,24,7,17
1990,203,Czechia,Uzbekistan,44,21,23
1990,348,Hungary,Uzbekistan,102,44,58
1990,616,Poland,Uzbekistan,498,188,310
1990,498,Republic of Moldova,Uzbekistan,4024,2006,2018
1990,643,Russian Federation,Uzbekistan,890893,437172,453721
1990,703,Slovakia,Uzbekistan,8,1,7
1990,804,Ukraine,Uzbekistan,131997,56561,75436
1990,208,Denmark,Uzbekistan,37,12,25
1990,233,Estonia,Uzbekistan,2614,1502,1112
1990,352,Iceland,Uzbekistan,2,1,1
1990,372,Ireland,Uzbekistan,18,8,10
1990,428,Latvia,Uzbekistan,309,108,201
1990,440,Lithuania,Uzbekistan,4197,2152,2045
1990,578,Norway,Uzbekistan,3,3,0
1990,752,Sweden,Uzbekistan,121,44,77
1990,826,United Kingdom,Uzbekistan,73,43,30
1990,300,Greece,Uzbekistan,1284,711,573
1990,380,Italy,Uzbekistan,191,67,124
1990,470,Malta,Uzbekistan,7,2,5
1990,620,Portugal,Uzbekistan,5,5,0
1990,688,Serbia,Uzbekistan,9,1,8
1990,705,Slovenia,Uzbekistan,2,1,1
1990,724,Spain,Uzbekistan,27,10,17
1990,40,Austria,Uzbekistan,415,184,231
1990,56,Belgium,Uzbekistan,10,5,5
1990,250,France,Uzbekistan,303,135,168
1990,276,Germany,Uzbekistan,2864,1444,1420
1990,528,Netherlands,Uzbekistan,4895,2626,2269
1990,756,Switzerland,Uzbekistan,96,40,56
1990,124,Canada,Uzbekistan,1459,711,748
1990,840,United States of America,Uzbekistan,14633,7158,7475
1995,818,Egypt,Uzbekistan,80,62,18
1995,434,Libya,Uzbekistan,257,210,47
1995,51,Armenia,Uzbekistan,1220,340,880
1995,31,Azerbaijan,Uzbekistan,20391,9690,10701
1995,196,Cyprus,Uzbekistan,26,11,15
1995,268,Georgia,Uzbekistan,9342,4253,5089
1995,376,Israel,Uzbekistan,31147,14899,16248
1995,792,Turkey,Uzbekistan,4632,2266,2366
1995,398,Kazakhstan,Uzbekistan,150058,74744,75314
1995,417,Kyrgyzstan,Uzbekistan,16955,7428,9527
1995,762,Tajikistan,Uzbekistan,12829,5917,6912
1995,795,Turkmenistan,Uzbekistan,87778,42981,44797
1995,4,Afghanistan,Uzbekistan,1836,1036,800
1995,410,Republic of Korea,Uzbekistan,1823,1405,418
1995,188,Costa Rica,Uzbekistan,1,0,1
1995,68,Bolivia (Plurinational State of),Uzbekistan,3,1,2
1995,152,Chile,Uzbekistan,22,6,16
1995,36,Australia,Uzbekistan,383,186,197
1995,112,Belarus,Uzbekistan,16225,7808,8417
1995,100,Bulgaria,Uzbekistan,163,55,108
1995,203,Czechia,Uzbekistan,66,32,34
1995,348,Hungary,Uzbekistan,91,39,52
1995,616,Poland,Uzbekistan,425,157,268
1995,498,Republic of Moldova,Uzbekistan,2716,1318,1398
1995,643,Russian Federation,Uzbekistan,918869,458355,460514
1995,703,Slovakia,Uzbekistan,16,6,10
1995,804,Ukraine,Uzbekistan,190478,89941,100537
1995,208,Denmark,Uzbekistan,40,13,27
1995,233,Estonia,Uzbekistan,1848,1000,848
1995,246,Finland,Uzbekistan,6,3,3
1995,352,Iceland,Uzbekistan,2,1,1
1995,372,Ireland,Uzbekistan,49,20,29
1995,428,Latvia,Uzbekistan,1614,720,894
1995,440,Lithuania,Uzbekistan,2077,1069,1008
1995,578,Norway,Uzbekistan,4,0,4
1995,752,Sweden,Uzbekistan,144,52,92
1995,826,United Kingdom,Uzbekistan,287,133,154
1995,300,Greece,Uzbekistan,3199,1541,1658
1995,380,Italy,Uzbekistan,676,71,605
1995,470,Malta,Uzbekistan,9,3,6
1995,620,Portugal,Uzbekistan,11,11,0
1995,688,Serbia,Uzbekistan,61,6,55
1995,705,Slovenia,Uzbekistan,4,3,1
1995,724,Spain,Uzbekistan,41,16,25
1995,40,Austria,Uzbekistan,469,213,256
1995,56,Belgium,Uzbekistan,8,4,4
1995,250,France,Uzbekistan,313,136,177
1995,276,Germany,Uzbekistan,9029,3998,5031
1995,528,Netherlands,Uzbekistan,7210,3793,3417
1995,756,Switzerland,Uzbekistan,273,116,157
1995,124,Canada,Uzbekistan,1465,710,755
1995,840,United States of America,Uzbekistan,19082,9433,9649
2000,818,Egypt,Uzbekistan,82,64,18
2000,434,Libya,Uzbekistan,277,234,43
2000,51,Armenia,Uzbekistan,1335,395,940
2000,31,Azerbaijan,Uzbekistan,20549,9611,10938
2000,196,Cyprus,Uzbekistan,33,14,19
2000,268,Georgia,Uzbekistan,736,260,476
2000,376,Israel,Uzbekistan,29428,13990,15438
2000,792,Turkey,Uzbekistan,7375,3565,3810
2000,398,Kazakhstan,Uzbekistan,168223,83869,84354
2000,417,Kyrgyzstan,Uzbekistan,14993,6717,8276
2000,762,Tajikistan,Uzbekistan,7984,3803,4181
2000,795,Turkmenistan,Uzbekistan,71162,33744,37418
2000,4,Afghanistan,Uzbekistan,1646,929,717
2000,410,Republic of Korea,Uzbekistan,4198,3260,938
2000,188,Costa Rica,Uzbekistan,1,0,1
2000,68,Bolivia (Plurinational State of),Uzbekistan,5,2,3
2000,152,Chile,Uzbekistan,4,1,3
2000,36,Australia,Uzbekistan,490,253,237
2000,112,Belarus,Uzbekistan,15344,7420,7924
2000,100,Bulgaria,Uzbekistan,302,103,199
2000,203,Czechia,Uzbekistan,88,43,45
2000,348,Hungary,Uzbekistan,79,33,46
2000,616,Poland,Uzbekistan,364,131,233
2000,498,Republic of Moldova,Uzbekistan,1833,865,968
2000,643,Russian Federation,Uzbekistan,913322,463099,450223
2000,703,Slovakia,Uzbekistan,29,11,18
2000,804,Ukraine,Uzbekistan,251285,124418,126867
2000,208,Denmark,Uzbekistan,42,13,29
2000,233,Estonia,Uzbekistan,1082,499,583
2000,246,Finland,Uzbekistan,11,5,6
2000,352,Iceland,Uzbekistan,2,1,1
2000,372,Ireland,Uzbekistan,108,47,61
2000,428,Latvia,Uzbekistan,2919,1332,1587
2000,440,Lithuania,Uzbekistan,1626,835,791
2000,578,Norway,Uzbekistan,30,12,18
2000,752,Sweden,Uzbekistan,155,55,100
2000,826,United Kingdom,Uzbekistan,506,223,283
2000,300,Greece,Uzbekistan,5167,2366,2801
2000,380,Italy,Uzbekistan,1161,75,1086
2000,470,Malta,Uzbekistan,10,3,7
2000,620,Portugal,Uzbekistan,18,16,2
2000,688,Serbia,Uzbekistan,84,7,77
2000,705,Slovenia,Uzbekistan,4,0,4
2000,724,Spain,Uzbekistan,499,223,276
2000,40,Austria,Uzbekistan,522,241,281
2000,56,Belgium,Uzbekistan,6,3,3
2000,250,France,Uzbekistan,322,137,185
2000,276,Germany,Uzbekistan,15193,6551,8642
2000,528,Netherlands,Uzbekistan,9766,5077,4689
2000,756,Switzerland,Uzbekistan,451,192,259
2000,124,Canada,Uzbekistan,1505,726,779
2000,840,United States of America,Uzbekistan,23613,11763,11850
2005,818,Egypt,Uzbekistan,98,78,20
2005,434,Libya,Uzbekistan,305,267,38
2005,51,Armenia,Uzbekistan,883,281,602
2005,31,Azerbaijan,Uzbekistan,19501,8801,10700
2005,196,Cyprus,Uzbekistan,49,21,28
2005,268,Georgia,Uzbekistan,699,247,452
2005,376,Israel,Uzbekistan,25379,11987,13392
2005,792,Turkey,Uzbekistan,7615,3594,4021
2005,398,Kazakhstan,Uzbekistan,216537,111094,105443
2005,417,Kyrgyzstan,Uzbekistan,12800,5704,7096
2005,762,Tajikistan,Uzbekistan,7688,3726,3962
2005,795,Turkmenistan,Uzbekistan,70180,33723,36457
2005,4,Afghanistan,Uzbekistan,1422,803,619
2005,410,Republic of Korea,Uzbekistan,9821,7438,2383
2005,188,Costa Rica,Uzbekistan,1,0,1
2005,68,Bolivia (Plurinational State of),Uzbekistan,5,2,3
2005,152,Chile,Uzbekistan,6,2,4
2005,36,Australia,Uzbekistan,760,350,410
2005,112,Belarus,Uzbekistan,15108,7303,7805
2005,100,Bulgaria,Uzbekistan,488,174,314
2005,203,Czechia,Uzbekistan,1202,890,312
2005,348,Hungary,Uzbekistan,98,42,56
2005,616,Poland,Uzbekistan,432,149,283
2005,498,Republic of Moldova,Uzbekistan,1266,585,681
2005,643,Russian Federation,Uzbekistan,1030041,532421,497620
2005,703,Slovakia,Uzbekistan,33,13,20
2005,804,Ukraine,Uzbekistan,229608,113846,115762
2005,208,Denmark,Uzbekistan,147,65,82
2005,233,Estonia,Uzbekistan,1133,520,613
2005,246,Finland,Uzbekistan,50,24,26
2005,352,Iceland,Uzbekistan,4,2,2
2005,372,Ireland,Uzbekistan,108,50,58
2005,428,Latvia,Uzbekistan,2641,1211,1430
2005,440,Lithuania,Uzbekistan,1480,754,726
2005,578,Norway,Uzbekistan,111,44,67
2005,752,Sweden,Uzbekistan,964,449,515
2005,826,United Kingdom,Uzbekistan,1468,694,774
2005,300,Greece,Uzbekistan,6778,2986,3792
2005,380,Italy,Uzbekistan,1835,279,1556
2005,470,Malta,Uzbekistan,14,4,10
2005,620,Portugal,Uzbekistan,432,303,129
2005,688,Serbia,Uzbekistan,83,6,77
2005,705,Slovenia,Uzbekistan,8,3,5
2005,724,Spain,Uzbekistan,240,105,135
2005,40,Austria,Uzbekistan,584,262,322
2005,56,Belgium,Uzbekistan,180,77,103
2005,250,France,Uzbekistan,728,222,506
2005,276,Germany,Uzbekistan,25587,11759,13828
2005,528,Netherlands,Uzbekistan,3540,1819,1721
2005,756,Switzerland,Uzbekistan,535,209,326
2005,124,Canada,Uzbekistan,3063,1513,1550
2005,840,United States of America,Uzbekistan,26322,13187,13135
2010,818,Egypt,Uzbekistan,106,84,22
2010,434,Libya,Uzbekistan,334,293,41
2010,51,Armenia,Uzbekistan,736,252,484
2010,31,Azerbaijan,Uzbekistan,17853,8412,9441
2010,196,Cyprus,Uzbekistan,80,35,45
2010,268,Georgia,Uzbekistan,705,249,456
2010,376,Israel,Uzbekistan,21638,10102,11536
2010,792,Turkey,Uzbekistan,7867,3623,4244
2010,398,Kazakhstan,Uzbekistan,264862,138322,126540
2010,417,Kyrgyzstan,Uzbekistan,10426,4592,5834
2010,762,Tajikistan,Uzbekistan,7669,3733,3936
2010,795,Turkmenistan,Uzbekistan,67903,31280,36623
2010,4,Afghanistan,Uzbekistan,1199,677,522
2010,410,Republic of Korea,Uzbekistan,19326,14407,4919
2010,188,Costa Rica,Uzbekistan,1,0,1
2010,68,Bolivia (Plurinational State of),Uzbekistan,4,2,2
2010,76,Brazil,Uzbekistan,26,1,25
2010,152,Chile,Uzbekistan,8,3,5
2010,36,Australia,Uzbekistan,1300,606,694
2010,112,Belarus,Uzbekistan,14919,7212,7707
2010,100,Bulgaria,Uzbekistan,654,238,416
2010,203,Czechia,Uzbekistan,2197,1661,536
2010,348,Hungary,Uzbekistan,117,51,66
2010,616,Poland,Uzbekistan,515,171,344
2010,498,Republic of Moldova,Uzbekistan,919,430,489
2010,643,Russian Federation,Uzbekistan,1125335,591087,534248
2010,703,Slovakia,Uzbekistan,37,15,22
2010,804,Ukraine,Uzbekistan,219081,108780,110301
2010,208,Denmark,Uzbekistan,246,115,131
2010,233,Estonia,Uzbekistan,1174,534,640
2010,246,Finland,Uzbekistan,98,45,53
2010,352,Iceland,Uzbekistan,5,2,3
2010,372,Ireland,Uzbekistan,90,37,53
2010,428,Latvia,Uzbekistan,2296,1038,1258
2010,440,Lithuania,Uzbekistan,1133,533,600
2010,578,Norway,Uzbekistan,303,137,166
2010,752,Sweden,Uzbekistan,2385,1174,1211
2010,826,United Kingdom,Uzbekistan,1546,748,798
2010,300,Greece,Uzbekistan,8819,3764,5055
2010,380,Italy,Uzbekistan,2424,449,1975
2010,470,Malta,Uzbekistan,16,4,12
2010,620,Portugal,Uzbekistan,776,541,235
2010,688,Serbia,Uzbekistan,82,6,76
2010,705,Slovenia,Uzbekistan,31,8,23
2010,724,Spain,Uzbekistan,507,219,288
2010,40,Austria,Uzbekistan,645,283,362
2010,56,Belgium,Uzbekistan,343,171,172
2010,250,France,Uzbekistan,1036,427,609
2010,276,Germany,Uzbekistan,34199,16172,18027
2010,528,Netherlands,Uzbekistan,1283,654,629
2010,756,Switzerland,Uzbekistan,597,216,381
2010,124,Canada,Uzbekistan,4795,2391,2404
2010,840,United States of America,Uzbekistan,29911,14780,15131
2015,324,Guinea,Uzbekistan,1,1,0
2015,818,Egypt,Uzbekistan,78,64,14
2015,434,Libya,Uzbekistan,376,330,46
2015,51,Armenia,Uzbekistan,989,339,650
2015,31,Azerbaijan,Uzbekistan,17030,8219,8811
2015,196,Cyprus,Uzbekistan,76,34,42
2015,268,Georgia,Uzbekistan,740,262,478
2015,376,Israel,Uzbekistan,22316,10360,11956
2015,792,Turkey,Uzbekistan,7997,3587,4410
2015,398,Kazakhstan,Uzbekistan,281713,149326,132387
2015,417,Kyrgyzstan,Uzbekistan,9183,4015,5168
2015,762,Tajikistan,Uzbekistan,7539,3643,3896
2015,795,Turkmenistan,Uzbekistan,67505,31345,36160
2015,4,Afghanistan,Uzbekistan,751,318,433
2015,410,Republic of Korea,Uzbekistan,24012,17758,6254
2015,188,Costa Rica,Uzbekistan,1,0,1
2015,68,Bolivia (Plurinational State of),Uzbekistan,5,3,2
2015,76,Brazil,Uzbekistan,31,1,30
2015,152,Chile,Uzbekistan,12,5,7
2015,36,Australia,Uzbekistan,1840,820,1020
2015,112,Belarus,Uzbekistan,14788,7152,7636
2015,100,Bulgaria,Uzbekistan,770,278,492
2015,203,Czechia,Uzbekistan,2166,1468,698
2015,348,Hungary,Uzbekistan,137,64,73
2015,616,Poland,Uzbekistan,496,171,325
2015,498,Republic of Moldova,Uzbekistan,704,333,371
2015,643,Russian Federation,Uzbekistan,1146803,599638,547165
2015,703,Slovakia,Uzbekistan,46,19,27
2015,804,Ukraine,Uzbekistan,219814,109298,110516
2015,208,Denmark,Uzbekistan,291,136,155
2015,233,Estonia,Uzbekistan,1091,499,592
2015,246,Finland,Uzbekistan,164,84,80
2015,352,Iceland,Uzbekistan,10,4,6
2015,372,Ireland,Uzbekistan,92,37,55
2015,428,Latvia,Uzbekistan,2052,961,1091
2015,440,Lithuania,Uzbekistan,945,432,513
2015,578,Norway,Uzbekistan,493,213,280
2015,752,Sweden,Uzbekistan,3612,1804,1808
2015,826,United Kingdom,Uzbekistan,1977,927,1050
2015,300,Greece,Uzbekistan,8277,3331,4946
2015,380,Italy,Uzbekistan,2518,470,2048
2015,470,Malta,Uzbekistan,27,8,19
2015,620,Portugal,Uzbekistan,879,600,279
2015,688,Serbia,Uzbekistan,80,6,74
2015,705,Slovenia,Uzbekistan,32,9,23
2015,724,Spain,Uzbekistan,642,227,415
2015,40,Austria,Uzbekistan,754,333,421
2015,56,Belgium,Uzbekistan,395,195,200
2015,250,France,Uzbekistan,1146,454,692
2015,276,Germany,Uzbekistan,35633,16805,18828
2015,528,Netherlands,Uzbekistan,443,227,216
2015,756,Switzerland,Uzbekistan,903,308,595
2015,124,Canada,Uzbekistan,6345,2960,3385
2015,840,United States of America,Uzbekistan,61204,30078,31126
2019,818,Egypt,Uzbekistan,111,89,22
2019,434,Libya,Uzbekistan,2099,1251,848
2019,51,Armenia,Uzbekistan,983,343,640
2019,31,Azerbaijan,Uzbekistan,16362,7897,8465
2019,196,Cyprus,Uzbekistan,75,34,41
2019,268,Georgia,Uzbekistan,762,270,492
2019,376,Israel,Uzbekistan,21701,10075,11626
2019,792,Turkey,Uzbekistan,10813,4910,5903
2019,398,Kazakhstan,Uzbekistan,294395,156044,138351
2019,417,Kyrgyzstan,Uzbekistan,8997,3934,5063
2019,762,Tajikistan,Uzbekistan,7510,3629,3881
2019,795,Turkmenistan,Uzbekistan,67075,31601,35474
2019,4,Afghanistan,Uzbekistan,229,95,134
2019,410,Republic of Korea,Uzbekistan,24444,18076,6368
2019,188,Costa Rica,Uzbekistan,1,0,1
2019,68,Bolivia (Plurinational State of),Uzbekistan,5,3,2
2019,76,Brazil,Uzbekistan,34,1,33
2019,152,Chile,Uzbekistan,16,7,9
2019,36,Australia,Uzbekistan,2147,987,1160
2019,112,Belarus,Uzbekistan,14603,7063,7540
2019,100,Bulgaria,Uzbekistan,950,332,618
2019,203,Czechia,Uzbekistan,2597,1735,862
2019,348,Hungary,Uzbekistan,158,70,88
2019,616,Poland,Uzbekistan,525,195,330
2019,498,Republic of Moldova,Uzbekistan,693,329,364
2019,643,Russian Federation,Uzbekistan,1146535,599498,547037
2019,703,Slovakia,Uzbekistan,53,27,26
2019,804,Ukraine,Uzbekistan,222012,110391,111621
2019,208,Denmark,Uzbekistan,324,146,178
2019,233,Estonia,Uzbekistan,1069,491,578
2019,246,Finland,Uzbekistan,259,142,117
2019,352,Iceland,Uzbekistan,12,4,8
2019,372,Ireland,Uzbekistan,101,41,60
2019,428,Latvia,Uzbekistan,2024,971,1053
2019,440,Lithuania,Uzbekistan,736,314,422
2019,578,Norway,Uzbekistan,645,293,352
2019,752,Sweden,Uzbekistan,4385,2181,2204
2019,826,United Kingdom,Uzbekistan,2245,1056,1189
2019,300,Greece,Uzbekistan,8083,3436,4647
2019,380,Italy,Uzbekistan,2685,508,2177
2019,470,Malta,Uzbekistan,43,13,30
2019,620,Portugal,Uzbekistan,893,610,283
2019,688,Serbia,Uzbekistan,81,6,75
2019,705,Slovenia,Uzbekistan,65,25,40
2019,724,Spain,Uzbekistan,665,225,440
2019,40,Austria,Uzbekistan,890,402,488
2019,56,Belgium,Uzbekistan,436,221,215
2019,250,France,Uzbekistan,1213,479,734
2019,276,Germany,Uzbekistan,39088,18260,20828
2019,528,Netherlands,Uzbekistan,506,262,244
2019,756,Switzerland,Uzbekistan,1002,337,665
2019,124,Canada,Uzbekistan,6799,3172,3627
2019,840,United States of America,Uzbekistan,66093,32119,33974
1990,32,Argentina,Vanuatu,18,18,0
1990,68,Bolivia (Plurinational State of),Vanuatu,2,2,0
1990,152,Chile,Vanuatu,1,0,1
1990,170,Colombia,Vanuatu,190,89,101
1990,36,Australia,Vanuatu,861,405,456
1990,242,Fiji,Vanuatu,170,91,79
1990,540,New Caledonia,Vanuatu,3153,1723,1430
1990,598,Papua New Guinea,Vanuatu,152,66,86
1990,90,Solomon Islands,Vanuatu,9,3,6
1990,258,French Polynesia,Vanuatu,187,106,81
1990,882,Samoa,Vanuatu,9,8,1
1990,876,Wallis and Futuna Islands,Vanuatu,152,79,73
1990,203,Czechia,Vanuatu,1,1,0
1990,208,Denmark,Vanuatu,4,2,2
1990,826,United Kingdom,Vanuatu,16,9,7
1990,300,Greece,Vanuatu,3,1,2
1990,380,Italy,Vanuatu,1,0,1
1990,40,Austria,Vanuatu,4,1,3
1990,250,France,Vanuatu,127,42,85
1995,32,Argentina,Vanuatu,18,18,0
1995,68,Bolivia (Plurinational State of),Vanuatu,1,1,0
1995,152,Chile,Vanuatu,1,1,0
1995,170,Colombia,Vanuatu,185,87,98
1995,36,Australia,Vanuatu,1005,481,524
1995,242,Fiji,Vanuatu,167,88,79
1995,540,New Caledonia,Vanuatu,3654,1972,1682
1995,598,Papua New Guinea,Vanuatu,155,63,92
1995,90,Solomon Islands,Vanuatu,9,3,6
1995,258,French Polynesia,Vanuatu,205,114,91
1995,882,Samoa,Vanuatu,15,13,2
1995,876,Wallis and Futuna Islands,Vanuatu,165,85,80
1995,203,Czechia,Vanuatu,2,1,1
1995,208,Denmark,Vanuatu,4,2,2
1995,372,Ireland,Vanuatu,1,1,0
1995,826,United Kingdom,Vanuatu,67,29,38
1995,300,Greece,Vanuatu,4,2,2
1995,380,Italy,Vanuatu,2,0,2
1995,40,Austria,Vanuatu,5,1,4
1995,250,France,Vanuatu,132,42,90
2000,32,Argentina,Vanuatu,18,18,0
2000,152,Chile,Vanuatu,1,0,1
2000,170,Colombia,Vanuatu,180,85,95
2000,36,Australia,Vanuatu,1060,525,535
2000,242,Fiji,Vanuatu,167,88,79
2000,540,New Caledonia,Vanuatu,4156,2221,1935
2000,598,Papua New Guinea,Vanuatu,116,54,62
2000,90,Solomon Islands,Vanuatu,9,3,6
2000,258,French Polynesia,Vanuatu,220,120,100
2000,882,Samoa,Vanuatu,22,18,4
2000,876,Wallis and Futuna Islands,Vanuatu,195,99,96
2000,203,Czechia,Vanuatu,3,2,1
2000,208,Denmark,Vanuatu,4,2,2
2000,372,Ireland,Vanuatu,2,1,1
2000,826,United Kingdom,Vanuatu,121,50,71
2000,300,Greece,Vanuatu,5,3,2
2000,380,Italy,Vanuatu,3,0,3
2000,40,Austria,Vanuatu,5,1,4
2000,250,France,Vanuatu,136,42,94
2005,32,Argentina,Vanuatu,13,13,0
2005,152,Chile,Vanuatu,1,0,1
2005,170,Colombia,Vanuatu,172,82,90
2005,36,Australia,Vanuatu,1180,563,617
2005,242,Fiji,Vanuatu,167,88,79
2005,540,New Caledonia,Vanuatu,4427,2374,2053
2005,598,Papua New Guinea,Vanuatu,116,56,60
2005,90,Solomon Islands,Vanuatu,38,21,17
2005,258,French Polynesia,Vanuatu,230,127,103
2005,882,Samoa,Vanuatu,20,16,4
2005,876,Wallis and Futuna Islands,Vanuatu,197,100,97
2005,100,Bulgaria,Vanuatu,1,0,1
2005,203,Czechia,Vanuatu,2,1,1
2005,208,Denmark,Vanuatu,4,1,3
2005,246,Finland,Vanuatu,1,1,0
2005,372,Ireland,Vanuatu,2,1,1
2005,826,United Kingdom,Vanuatu,130,56,74
2005,300,Greece,Vanuatu,39,35,4
2005,380,Italy,Vanuatu,13,2,11
2005,40,Austria,Vanuatu,6,1,5
2005,250,France,Vanuatu,678,299,379
2010,32,Argentina,Vanuatu,8,8,0
2010,152,Chile,Vanuatu,2,1,1
2010,170,Colombia,Vanuatu,194,95,99
2010,36,Australia,Vanuatu,1300,615,685
2010,242,Fiji,Vanuatu,179,95,84
2010,540,New Caledonia,Vanuatu,4698,2527,2171
2010,598,Papua New Guinea,Vanuatu,98,49,49
2010,90,Solomon Islands,Vanuatu,71,40,31
2010,258,French Polynesia,Vanuatu,222,125,97
2010,882,Samoa,Vanuatu,17,14,3
2010,876,Wallis and Futuna Islands,Vanuatu,118,60,58
2010,100,Bulgaria,Vanuatu,1,0,1
2010,203,Czechia,Vanuatu,3,2,1
2010,208,Denmark,Vanuatu,2,0,2
2010,246,Finland,Vanuatu,1,1,0
2010,372,Ireland,Vanuatu,1,0,1
2010,752,Sweden,Vanuatu,1,0,1
2010,826,United Kingdom,Vanuatu,136,60,76
2010,300,Greece,Vanuatu,75,70,5
2010,380,Italy,Vanuatu,19,4,15
2010,40,Austria,Vanuatu,6,1,5
2010,250,France,Vanuatu,694,204,490
2015,32,Argentina,Vanuatu,8,8,0
2015,152,Chile,Vanuatu,3,2,1
2015,170,Colombia,Vanuatu,217,108,109
2015,36,Australia,Vanuatu,1380,714,666
2015,242,Fiji,Vanuatu,184,98,86
2015,540,New Caledonia,Vanuatu,3611,1749,1862
2015,598,Papua New Guinea,Vanuatu,99,51,48
2015,90,Solomon Islands,Vanuatu,66,38,28
2015,258,French Polynesia,Vanuatu,210,118,92
2015,882,Samoa,Vanuatu,14,9,5
2015,876,Wallis and Futuna Islands,Vanuatu,29,15,14
2015,100,Bulgaria,Vanuatu,16,11,5
2015,203,Czechia,Vanuatu,4,3,1
2015,208,Denmark,Vanuatu,3,1,2
2015,246,Finland,Vanuatu,1,1,0
2015,372,Ireland,Vanuatu,1,0,1
2015,752,Sweden,Vanuatu,1,1,0
2015,826,United Kingdom,Vanuatu,173,73,100
2015,300,Greece,Vanuatu,70,66,4
2015,380,Italy,Vanuatu,21,5,16
2015,40,Austria,Vanuatu,7,2,5
2015,250,France,Vanuatu,769,212,557
2019,32,Argentina,Vanuatu,8,8,0
2019,152,Chile,Vanuatu,4,3,1
2019,170,Colombia,Vanuatu,221,110,111
2019,36,Australia,Vanuatu,1565,786,779
2019,242,Fiji,Vanuatu,187,100,87
2019,540,New Caledonia,Vanuatu,3802,1835,1967
2019,598,Papua New Guinea,Vanuatu,99,51,48
2019,90,Solomon Islands,Vanuatu,64,37,27
2019,258,French Polynesia,Vanuatu,218,123,95
2019,882,Samoa,Vanuatu,13,9,4
2019,876,Wallis and Futuna Islands,Vanuatu,28,15,13
2019,100,Bulgaria,Vanuatu,17,12,5
2019,203,Czechia,Vanuatu,6,5,1
2019,208,Denmark,Vanuatu,6,3,3
2019,246,Finland,Vanuatu,1,1,0
2019,372,Ireland,Vanuatu,1,0,1
2019,826,United Kingdom,Vanuatu,196,83,113
2019,300,Greece,Vanuatu,68,65,3
2019,380,Italy,Vanuatu,21,5,16
2019,40,Austria,Vanuatu,8,3,5
2019,250,France,Vanuatu,813,223,590
1990,710,South Africa,Venezuela (Bolivarian Republic of),296,118,178
1990,818,Egypt,Venezuela (Bolivarian Republic of),26,9,17
1990,196,Cyprus,Venezuela (Bolivarian Republic of),16,7,9
1990,376,Israel,Venezuela (Bolivarian Republic of),640,295,345
1990,400,Jordan,Venezuela (Bolivarian Republic of),45,14,31
1990,792,Turkey,Venezuela (Bolivarian Republic of),9,4,5
1990,28,Antigua and Barbuda,Venezuela (Bolivarian Republic of),11,5,6
1990,533,Aruba,Venezuela (Bolivarian Republic of),1144,654,490
1990,44,Bahamas,Venezuela (Bolivarian Republic of),16,6,10
1990,535,"Bonaire, Sint Eustatius and Saba",Venezuela (Bolivarian Republic of),454,203,251
1990,136,Cayman Islands,Venezuela (Bolivarian Republic of),10,6,4
1990,192,Cuba,Venezuela (Bolivarian Republic of),431,222,209
1990,212,Dominica,Venezuela (Bolivarian Republic of),11,2,9
1990,214,Dominican Republic,Venezuela (Bolivarian Republic of),14235,7698,6537
1990,308,Grenada,Venezuela (Bolivarian Republic of),43,21,22
1990,332,Haiti,Venezuela (Bolivarian Republic of),2510,1325,1185
1990,630,Puerto Rico,Venezuela (Bolivarian Republic of),1264,599,665
1990,662,Saint Lucia,Venezuela (Bolivarian Republic of),27,12,15
1990,780,Trinidad and Tobago,Venezuela (Bolivarian Republic of),1337,534,803
1990,188,Costa Rica,Venezuela (Bolivarian Republic of),1030,529,501
1990,222,El Salvador,Venezuela (Bolivarian Republic of),258,109,149
1990,320,Guatemala,Venezuela (Bolivarian Republic of),113,41,72
1990,340,Honduras,Venezuela (Bolivarian Republic of),75,40,35
1990,484,Mexico,Venezuela (Bolivarian Republic of),1460,634,826
1990,558,Nicaragua,Venezuela (Bolivarian Republic of),146,68,78
1990,591,Panama,Venezuela (Bolivarian Republic of),487,240,247
1990,32,Argentina,Venezuela (Bolivarian Republic of),1981,840,1141
1990,68,Bolivia (Plurinational State of),Venezuela (Bolivarian Republic of),369,174,195
1990,76,Brazil,Venezuela (Bolivarian Republic of),1220,572,648
1990,152,Chile,Venezuela (Bolivarian Republic of),2349,1139,1210
1990,170,Colombia,Venezuela (Bolivarian Republic of),33123,15410,17713
1990,218,Ecuador,Venezuela (Bolivarian Republic of),2549,1268,1281
1990,328,Guyana,Venezuela (Bolivarian Republic of),478,239,239
1990,604,Peru,Venezuela (Bolivarian Republic of),2019,968,1051
1990,858,Uruguay,Venezuela (Bolivarian Republic of),773,408,365
1990,36,Australia,Venezuela (Bolivarian Republic of),606,278,328
1990,100,Bulgaria,Venezuela (Bolivarian Republic of),1,1,0
1990,203,Czechia,Venezuela (Bolivarian Republic of),11,7,4
1990,348,Hungary,Venezuela (Bolivarian Republic of),169,92,77
1990,616,Poland,Venezuela (Bolivarian Republic of),67,38,29
1990,642,Romania,Venezuela (Bolivarian Republic of),3,1,2
1990,643,Russian Federation,Venezuela (Bolivarian Republic of),371,182,189
1990,208,Denmark,Venezuela (Bolivarian Republic of),188,92,96
1990,246,Finland,Venezuela (Bolivarian Republic of),34,17,17
1990,352,Iceland,Venezuela (Bolivarian Republic of),6,2,4
1990,372,Ireland,Venezuela (Bolivarian Republic of),24,11,13
1990,428,Latvia,Venezuela (Bolivarian Republic of),6,3,3
1990,578,Norway,Venezuela (Bolivarian Republic of),80,37,43
1990,752,Sweden,Venezuela (Bolivarian Republic of),352,175,177
1990,826,United Kingdom,Venezuela (Bolivarian Republic of),555,323,232
1990,300,Greece,Venezuela (Bolivarian Republic of),585,241,344
1990,380,Italy,Venezuela (Bolivarian Republic of),9773,2920,6853
1990,620,Portugal,Venezuela (Bolivarian Republic of),14959,7204,7755
1990,688,Serbia,Venezuela (Bolivarian Republic of),4,2,2
1990,724,Spain,Venezuela (Bolivarian Republic of),32469,15105,17364
1990,40,Austria,Venezuela (Bolivarian Republic of),504,201,303
1990,56,Belgium,Venezuela (Bolivarian Republic of),565,214,351
1990,250,France,Venezuela (Bolivarian Republic of),3253,1346,1907
1990,276,Germany,Venezuela (Bolivarian Republic of),1662,798,864
1990,442,Luxembourg,Venezuela (Bolivarian Republic of),25,10,15
1990,528,Netherlands,Venezuela (Bolivarian Republic of),1474,658,816
1990,756,Switzerland,Venezuela (Bolivarian Republic of),1787,756,1031
1990,124,Canada,Venezuela (Bolivarian Republic of),3339,1625,1714
1990,840,United States of America,Venezuela (Bolivarian Republic of),42119,16260,25859
1995,710,South Africa,Venezuela (Bolivarian Republic of),184,82,102
1995,818,Egypt,Venezuela (Bolivarian Republic of),25,9,16
1995,196,Cyprus,Venezuela (Bolivarian Republic of),23,10,13
1995,376,Israel,Venezuela (Bolivarian Republic of),624,283,341
1995,400,Jordan,Venezuela (Bolivarian Republic of),42,17,25
1995,792,Turkey,Venezuela (Bolivarian Republic of),22,10,12
1995,28,Antigua and Barbuda,Venezuela (Bolivarian Republic of),22,10,12
1995,533,Aruba,Venezuela (Bolivarian Republic of),2000,1100,900
1995,44,Bahamas,Venezuela (Bolivarian Republic of),20,8,12
1995,535,"Bonaire, Sint Eustatius and Saba",Venezuela (Bolivarian Republic of),947,421,526
1995,136,Cayman Islands,Venezuela (Bolivarian Republic of),21,12,9
1995,192,Cuba,Venezuela (Bolivarian Republic of),327,162,165
1995,212,Dominica,Venezuela (Bolivarian Republic of),14,2,12
1995,214,Dominican Republic,Venezuela (Bolivarian Republic of),15811,8374,7437
1995,308,Grenada,Venezuela (Bolivarian Republic of),175,147,28
1995,332,Haiti,Venezuela (Bolivarian Republic of),2384,1259,1125
1995,630,Puerto Rico,Venezuela (Bolivarian Republic of),1617,768,849
1995,662,Saint Lucia,Venezuela (Bolivarian Republic of),35,16,19
1995,780,Trinidad and Tobago,Venezuela (Bolivarian Republic of),1213,483,730
1995,188,Costa Rica,Venezuela (Bolivarian Republic of),834,427,407
1995,222,El Salvador,Venezuela (Bolivarian Republic of),219,94,125
1995,320,Guatemala,Venezuela (Bolivarian Republic of),144,61,83
1995,340,Honduras,Venezuela (Bolivarian Republic of),74,38,36
1995,484,Mexico,Venezuela (Bolivarian Republic of),2194,972,1222
1995,558,Nicaragua,Venezuela (Bolivarian Republic of),116,53,63
1995,591,Panama,Venezuela (Bolivarian Republic of),715,354,361
1995,32,Argentina,Venezuela (Bolivarian Republic of),2290,1021,1269
1995,68,Bolivia (Plurinational State of),Venezuela (Bolivarian Republic of),458,217,241
1995,76,Brazil,Venezuela (Bolivarian Republic of),1694,834,860
1995,152,Chile,Venezuela (Bolivarian Republic of),3197,1546,1651
1995,170,Colombia,Venezuela (Bolivarian Republic of),35162,16510,18652
1995,218,Ecuador,Venezuela (Bolivarian Republic of),3120,1495,1625
1995,328,Guyana,Venezuela (Bolivarian Republic of),768,389,379
1995,604,Peru,Venezuela (Bolivarian Republic of),2021,976,1045
1995,858,Uruguay,Venezuela (Bolivarian Republic of),713,363,350
1995,36,Australia,Venezuela (Bolivarian Republic of),915,431,484
1995,100,Bulgaria,Venezuela (Bolivarian Republic of),7,4,3
1995,203,Czechia,Venezuela (Bolivarian Republic of),17,11,6
1995,348,Hungary,Venezuela (Bolivarian Republic of),150,80,70
1995,616,Poland,Venezuela (Bolivarian Republic of),57,32,25
1995,642,Romania,Venezuela (Bolivarian Republic of),5,2,3
1995,643,Russian Federation,Venezuela (Bolivarian Republic of),376,191,185
1995,208,Denmark,Venezuela (Bolivarian Republic of),289,128,161
1995,246,Finland,Venezuela (Bolivarian Republic of),41,21,20
1995,352,Iceland,Venezuela (Bolivarian Republic of),9,3,6
1995,372,Ireland,Venezuela (Bolivarian Republic of),67,29,38
1995,428,Latvia,Venezuela (Bolivarian Republic of),9,5,4
1995,578,Norway,Venezuela (Bolivarian Republic of),133,55,78
1995,752,Sweden,Venezuela (Bolivarian Republic of),418,206,212
1995,826,United Kingdom,Venezuela (Bolivarian Republic of),2182,1016,1166
1995,191,Croatia,Venezuela (Bolivarian Republic of),13,6,7
1995,300,Greece,Venezuela (Bolivarian Republic of),716,298,418
1995,380,Italy,Venezuela (Bolivarian Republic of),9261,2660,6601
1995,620,Portugal,Venezuela (Bolivarian Republic of),18220,8679,9541
1995,688,Serbia,Venezuela (Bolivarian Republic of),27,14,13
1995,724,Spain,Venezuela (Bolivarian Republic of),38704,18104,20600
1995,40,Austria,Venezuela (Bolivarian Republic of),569,232,337
1995,56,Belgium,Venezuela (Bolivarian Republic of),562,211,351
1995,250,France,Venezuela (Bolivarian Republic of),3358,1356,2002
1995,276,Germany,Venezuela (Bolivarian Republic of),2306,898,1408
1995,442,Luxembourg,Venezuela (Bolivarian Republic of),23,10,13
1995,528,Netherlands,Venezuela (Bolivarian Republic of),1774,773,1001
1995,756,Switzerland,Venezuela (Bolivarian Republic of),2224,991,1233
1995,124,Canada,Venezuela (Bolivarian Republic of),5582,2699,2883
1995,840,United States of America,Venezuela (Bolivarian Republic of),75572,29717,45855
2000,710,South Africa,Venezuela (Bolivarian Republic of),126,66,60
2000,818,Egypt,Venezuela (Bolivarian Republic of),25,9,16
2000,196,Cyprus,Venezuela (Bolivarian Republic of),29,12,17
2000,376,Israel,Venezuela (Bolivarian Republic of),574,259,315
2000,400,Jordan,Venezuela (Bolivarian Republic of),38,19,19
2000,792,Turkey,Venezuela (Bolivarian Republic of),37,17,20
2000,28,Antigua and Barbuda,Venezuela (Bolivarian Republic of),32,15,17
2000,533,Aruba,Venezuela (Bolivarian Republic of),2856,1547,1309
2000,44,Bahamas,Venezuela (Bolivarian Republic of),24,10,14
2000,535,"Bonaire, Sint Eustatius and Saba",Venezuela (Bolivarian Republic of),1441,639,802
2000,136,Cayman Islands,Venezuela (Bolivarian Republic of),37,20,17
2000,192,Cuba,Venezuela (Bolivarian Republic of),222,101,121
2000,212,Dominica,Venezuela (Bolivarian Republic of),17,3,14
2000,214,Dominican Republic,Venezuela (Bolivarian Republic of),17386,9050,8336
2000,308,Grenada,Venezuela (Bolivarian Republic of),308,274,34
2000,332,Haiti,Venezuela (Bolivarian Republic of),2264,1196,1068
2000,630,Puerto Rico,Venezuela (Bolivarian Republic of),1974,937,1037
2000,662,Saint Lucia,Venezuela (Bolivarian Republic of),49,22,27
2000,780,Trinidad and Tobago,Venezuela (Bolivarian Republic of),1413,580,833
2000,188,Costa Rica,Venezuela (Bolivarian Republic of),1054,522,532
2000,222,El Salvador,Venezuela (Bolivarian Republic of),179,79,100
2000,320,Guatemala,Venezuela (Bolivarian Republic of),175,81,94
2000,340,Honduras,Venezuela (Bolivarian Republic of),73,36,37
2000,484,Mexico,Venezuela (Bolivarian Republic of),3024,1359,1665
2000,558,Nicaragua,Venezuela (Bolivarian Republic of),125,61,64
2000,591,Panama,Venezuela (Bolivarian Republic of),989,489,500
2000,32,Argentina,Venezuela (Bolivarian Republic of),2600,1203,1397
2000,68,Bolivia (Plurinational State of),Venezuela (Bolivarian Republic of),543,259,284
2000,76,Brazil,Venezuela (Bolivarian Republic of),2167,1096,1071
2000,152,Chile,Venezuela (Bolivarian Republic of),4044,1944,2100
2000,170,Colombia,Venezuela (Bolivarian Republic of),37200,17609,19591
2000,218,Ecuador,Venezuela (Bolivarian Republic of),3691,1723,1968
2000,328,Guyana,Venezuela (Bolivarian Republic of),1057,539,518
2000,604,Peru,Venezuela (Bolivarian Republic of),2362,1136,1226
2000,858,Uruguay,Venezuela (Bolivarian Republic of),659,322,337
2000,36,Australia,Venezuela (Bolivarian Republic of),1170,560,610
2000,100,Bulgaria,Venezuela (Bolivarian Republic of),12,6,6
2000,203,Czechia,Venezuela (Bolivarian Republic of),23,15,8
2000,348,Hungary,Venezuela (Bolivarian Republic of),131,69,62
2000,616,Poland,Venezuela (Bolivarian Republic of),49,27,22
2000,642,Romania,Venezuela (Bolivarian Republic of),7,2,5
2000,643,Russian Federation,Venezuela (Bolivarian Republic of),369,193,176
2000,208,Denmark,Venezuela (Bolivarian Republic of),389,164,225
2000,246,Finland,Venezuela (Bolivarian Republic of),47,25,22
2000,352,Iceland,Venezuela (Bolivarian Republic of),12,4,8
2000,372,Ireland,Venezuela (Bolivarian Republic of),148,67,81
2000,428,Latvia,Venezuela (Bolivarian Republic of),12,6,6
2000,578,Norway,Venezuela (Bolivarian Republic of),178,69,109
2000,752,Sweden,Venezuela (Bolivarian Republic of),449,220,229
2000,826,United Kingdom,Venezuela (Bolivarian Republic of),3846,1722,2124
2000,191,Croatia,Venezuela (Bolivarian Republic of),24,11,13
2000,300,Greece,Venezuela (Bolivarian Republic of),859,352,507
2000,380,Italy,Venezuela (Bolivarian Republic of),8748,2400,6348
2000,620,Portugal,Venezuela (Bolivarian Republic of),22222,10544,11678
2000,688,Serbia,Venezuela (Bolivarian Republic of),38,19,19
2000,724,Spain,Venezuela (Bolivarian Republic of),61587,29787,31800
2000,40,Austria,Venezuela (Bolivarian Republic of),633,263,370
2000,56,Belgium,Venezuela (Bolivarian Republic of),545,207,338
2000,250,France,Venezuela (Bolivarian Republic of),3463,1366,2097
2000,276,Germany,Venezuela (Bolivarian Republic of),2950,999,1951
2000,442,Luxembourg,Venezuela (Bolivarian Republic of),22,9,13
2000,528,Netherlands,Venezuela (Bolivarian Republic of),2136,911,1225
2000,756,Switzerland,Venezuela (Bolivarian Republic of),2671,1234,1437
2000,124,Canada,Venezuela (Bolivarian Republic of),7958,3838,4120
2000,840,United States of America,Venezuela (Bolivarian Republic of),109748,43552,66196
2005,710,South Africa,Venezuela (Bolivarian Republic of),166,84,82
2005,818,Egypt,Venezuela (Bolivarian Republic of),30,12,18
2005,196,Cyprus,Venezuela (Bolivarian Republic of),42,17,25
2005,376,Israel,Venezuela (Bolivarian Republic of),465,209,256
2005,400,Jordan,Venezuela (Bolivarian Republic of),55,31,24
2005,792,Turkey,Venezuela (Bolivarian Republic of),38,17,21
2005,28,Antigua and Barbuda,Venezuela (Bolivarian Republic of),35,17,18
2005,533,Aruba,Venezuela (Bolivarian Republic of),3074,1597,1477
2005,44,Bahamas,Venezuela (Bolivarian Republic of),26,10,16
2005,535,"Bonaire, Sint Eustatius and Saba",Venezuela (Bolivarian Republic of),1535,681,854
2005,136,Cayman Islands,Venezuela (Bolivarian Republic of),34,18,16
2005,192,Cuba,Venezuela (Bolivarian Republic of),148,67,81
2005,212,Dominica,Venezuela (Bolivarian Republic of),21,4,17
2005,214,Dominican Republic,Venezuela (Bolivarian Republic of),11299,5819,5480
2005,308,Grenada,Venezuela (Bolivarian Republic of),322,287,35
2005,332,Haiti,Venezuela (Bolivarian Republic of),2150,1136,1014
2005,630,Puerto Rico,Venezuela (Bolivarian Republic of),2198,1040,1158
2005,662,Saint Lucia,Venezuela (Bolivarian Republic of),41,19,22
2005,534,Sint Maarten (Dutch part),Venezuela (Bolivarian Republic of),20,11,9
2005,780,Trinidad and Tobago,Venezuela (Bolivarian Republic of),1516,620,896
2005,188,Costa Rica,Venezuela (Bolivarian Republic of),690,337,353
2005,222,El Salvador,Venezuela (Bolivarian Republic of),206,93,113
2005,320,Guatemala,Venezuela (Bolivarian Republic of),211,100,111
2005,340,Honduras,Venezuela (Bolivarian Republic of),73,35,38
2005,484,Mexico,Venezuela (Bolivarian Republic of),6526,2893,3633
2005,558,Nicaragua,Venezuela (Bolivarian Republic of),139,70,69
2005,591,Panama,Venezuela (Bolivarian Republic of),4592,2313,2279
2005,32,Argentina,Venezuela (Bolivarian Republic of),1918,904,1014
2005,68,Bolivia (Plurinational State of),Venezuela (Bolivarian Republic of),604,309,295
2005,76,Brazil,Venezuela (Bolivarian Republic of),2524,1286,1238
2005,152,Chile,Venezuela (Bolivarian Republic of),6070,2968,3102
2005,170,Colombia,Venezuela (Bolivarian Republic of),37137,17802,19335
2005,218,Ecuador,Venezuela (Bolivarian Republic of),4357,2083,2274
2005,328,Guyana,Venezuela (Bolivarian Republic of),1424,733,691
2005,604,Peru,Venezuela (Bolivarian Republic of),2794,1354,1440
2005,858,Uruguay,Venezuela (Bolivarian Republic of),610,299,311
2005,36,Australia,Venezuela (Bolivarian Republic of),1580,726,854
2005,100,Bulgaria,Venezuela (Bolivarian Republic of),19,9,10
2005,203,Czechia,Venezuela (Bolivarian Republic of),56,32,24
2005,348,Hungary,Venezuela (Bolivarian Republic of),162,87,75
2005,616,Poland,Venezuela (Bolivarian Republic of),61,46,15
2005,642,Romania,Venezuela (Bolivarian Republic of),8,3,5
2005,643,Russian Federation,Venezuela (Bolivarian Republic of),234,120,114
2005,208,Denmark,Venezuela (Bolivarian Republic of),498,209,289
2005,246,Finland,Venezuela (Bolivarian Republic of),90,48,42
2005,352,Iceland,Venezuela (Bolivarian Republic of),25,9,16
2005,372,Ireland,Venezuela (Bolivarian Republic of),149,73,76
2005,428,Latvia,Venezuela (Bolivarian Republic of),23,13,10
2005,578,Norway,Venezuela (Bolivarian Republic of),261,97,164
2005,752,Sweden,Venezuela (Bolivarian Republic of),585,277,308
2005,826,United Kingdom,Venezuela (Bolivarian Republic of),6053,2752,3301
2005,191,Croatia,Venezuela (Bolivarian Republic of),40,18,22
2005,300,Greece,Venezuela (Bolivarian Republic of),954,387,567
2005,380,Italy,Venezuela (Bolivarian Republic of),28803,11607,17196
2005,620,Portugal,Venezuela (Bolivarian Republic of),23744,11235,12509
2005,688,Serbia,Venezuela (Bolivarian Republic of),38,19,19
2005,724,Spain,Venezuela (Bolivarian Republic of),108707,50911,57796
2005,40,Austria,Venezuela (Bolivarian Republic of),708,284,424
2005,56,Belgium,Venezuela (Bolivarian Republic of),889,338,551
2005,250,France,Venezuela (Bolivarian Republic of),5493,2424,3069
2005,276,Germany,Venezuela (Bolivarian Republic of),5362,2247,3115
2005,442,Luxembourg,Venezuela (Bolivarian Republic of),19,9,10
2005,528,Netherlands,Venezuela (Bolivarian Republic of),2898,1204,1694
2005,756,Switzerland,Venezuela (Bolivarian Republic of),3003,1312,1691
2005,124,Canada,Venezuela (Bolivarian Republic of),12434,5829,6605
2005,840,United States of America,Venezuela (Bolivarian Republic of),142706,57108,85598
2010,710,South Africa,Venezuela (Bolivarian Republic of),259,131,128
2010,818,Egypt,Venezuela (Bolivarian Republic of),32,12,20
2010,196,Cyprus,Venezuela (Bolivarian Republic of),68,28,40
2010,376,Israel,Venezuela (Bolivarian Republic of),362,162,200
2010,400,Jordan,Venezuela (Bolivarian Republic of),70,41,29
2010,792,Turkey,Venezuela (Bolivarian Republic of),39,17,22
2010,28,Antigua and Barbuda,Venezuela (Bolivarian Republic of),37,18,19
2010,533,Aruba,Venezuela (Bolivarian Republic of),3231,1615,1616
2010,44,Bahamas,Venezuela (Bolivarian Republic of),28,10,18
2010,535,"Bonaire, Sint Eustatius and Saba",Venezuela (Bolivarian Republic of),422,199,223
2010,136,Cayman Islands,Venezuela (Bolivarian Republic of),34,18,16
2010,192,Cuba,Venezuela (Bolivarian Republic of),82,37,45
2010,531,Curaçao,Venezuela (Bolivarian Republic of),1645,689,956
2010,212,Dominica,Venezuela (Bolivarian Republic of),26,4,22
2010,214,Dominican Republic,Venezuela (Bolivarian Republic of),5132,2547,2585
2010,308,Grenada,Venezuela (Bolivarian Republic of),337,300,37
2010,332,Haiti,Venezuela (Bolivarian Republic of),2257,1193,1064
2010,630,Puerto Rico,Venezuela (Bolivarian Republic of),2147,1006,1141
2010,662,Saint Lucia,Venezuela (Bolivarian Republic of),31,14,17
2010,534,Sint Maarten (Dutch part),Venezuela (Bolivarian Republic of),40,21,19
2010,780,Trinidad and Tobago,Venezuela (Bolivarian Republic of),1672,709,963
2010,188,Costa Rica,Venezuela (Bolivarian Republic of),1360,666,694
2010,222,El Salvador,Venezuela (Bolivarian Republic of),232,106,126
2010,320,Guatemala,Venezuela (Bolivarian Republic of),246,118,128
2010,340,Honduras,Venezuela (Bolivarian Republic of),73,35,38
2010,484,Mexico,Venezuela (Bolivarian Republic of),10786,4769,6017
2010,558,Nicaragua,Venezuela (Bolivarian Republic of),148,75,73
2010,591,Panama,Venezuela (Bolivarian Republic of),8415,4283,4132
2010,32,Argentina,Venezuela (Bolivarian Republic of),1236,605,631
2010,68,Bolivia (Plurinational State of),Venezuela (Bolivarian Republic of),664,358,306
2010,76,Brazil,Venezuela (Bolivarian Republic of),2844,1456,1388
2010,152,Chile,Venezuela (Bolivarian Republic of),8095,3993,4102
2010,170,Colombia,Venezuela (Bolivarian Republic of),43511,21372,22139
2010,218,Ecuador,Venezuela (Bolivarian Republic of),6120,2845,3275
2010,328,Guyana,Venezuela (Bolivarian Republic of),1791,928,863
2010,604,Peru,Venezuela (Bolivarian Republic of),3504,1758,1746
2010,858,Uruguay,Venezuela (Bolivarian Republic of),565,275,290
2010,36,Australia,Venezuela (Bolivarian Republic of),3350,1631,1719
2010,100,Bulgaria,Venezuela (Bolivarian Republic of),25,12,13
2010,203,Czechia,Venezuela (Bolivarian Republic of),84,48,36
2010,348,Hungary,Venezuela (Bolivarian Republic of),193,106,87
2010,616,Poland,Venezuela (Bolivarian Republic of),75,66,9
2010,642,Romania,Venezuela (Bolivarian Republic of),13,2,11
2010,643,Russian Federation,Venezuela (Bolivarian Republic of),96,46,50
2010,208,Denmark,Venezuela (Bolivarian Republic of),595,249,346
2010,233,Estonia,Venezuela (Bolivarian Republic of),8,5,3
2010,246,Finland,Venezuela (Bolivarian Republic of),140,72,68
2010,352,Iceland,Venezuela (Bolivarian Republic of),36,13,23
2010,372,Ireland,Venezuela (Bolivarian Republic of),125,56,69
2010,428,Latvia,Venezuela (Bolivarian Republic of),35,21,14
2010,578,Norway,Venezuela (Bolivarian Republic of),631,275,356
2010,752,Sweden,Venezuela (Bolivarian Republic of),865,410,455
2010,826,United Kingdom,Venezuela (Bolivarian Republic of),6376,2970,3406
2010,191,Croatia,Venezuela (Bolivarian Republic of),55,24,31
2010,300,Greece,Venezuela (Bolivarian Republic of),1091,439,652
2010,380,Italy,Venezuela (Bolivarian Republic of),48676,20607,28069
2010,620,Portugal,Venezuela (Bolivarian Republic of),21323,10087,11236
2010,688,Serbia,Venezuela (Bolivarian Republic of),38,19,19
2010,724,Spain,Venezuela (Bolivarian Republic of),148147,69142,79005
2010,40,Austria,Venezuela (Bolivarian Republic of),782,305,477
2010,56,Belgium,Venezuela (Bolivarian Republic of),1089,460,629
2010,250,France,Venezuela (Bolivarian Republic of),5950,2266,3684
2010,276,Germany,Venezuela (Bolivarian Republic of),7362,3304,4058
2010,442,Luxembourg,Venezuela (Bolivarian Republic of),17,9,8
2010,528,Netherlands,Venezuela (Bolivarian Republic of),3333,1379,1954
2010,756,Switzerland,Venezuela (Bolivarian Republic of),3530,1420,2110
2010,124,Canada,Venezuela (Bolivarian Republic of),16005,7421,8584
2010,840,United States of America,Venezuela (Bolivarian Republic of),180905,70901,110004
2015,710,South Africa,Venezuela (Bolivarian Republic of),466,225,241
2015,818,Egypt,Venezuela (Bolivarian Republic of),23,11,12
2015,196,Cyprus,Venezuela (Bolivarian Republic of),65,27,38
2015,376,Israel,Venezuela (Bolivarian Republic of),373,166,207
2015,400,Jordan,Venezuela (Bolivarian Republic of),30,15,15
2015,792,Turkey,Venezuela (Bolivarian Republic of),39,17,22
2015,28,Antigua and Barbuda,Venezuela (Bolivarian Republic of),39,19,20
2015,533,Aruba,Venezuela (Bolivarian Republic of),3399,1699,1700
2015,44,Bahamas,Venezuela (Bolivarian Republic of),30,10,20
2015,535,"Bonaire, Sint Eustatius and Saba",Venezuela (Bolivarian Republic of),480,227,253
2015,136,Cayman Islands,Venezuela (Bolivarian Republic of),36,20,16
2015,192,Cuba,Venezuela (Bolivarian Republic of),65,29,36
2015,531,Curaçao,Venezuela (Bolivarian Republic of),1787,750,1037
2015,212,Dominica,Venezuela (Bolivarian Republic of),30,4,26
2015,214,Dominican Republic,Venezuela (Bolivarian Republic of),3561,1695,1866
2015,308,Grenada,Venezuela (Bolivarian Republic of),341,304,37
2015,332,Haiti,Venezuela (Bolivarian Republic of),2369,1252,1117
2015,630,Puerto Rico,Venezuela (Bolivarian Republic of),2302,1074,1228
2015,662,Saint Lucia,Venezuela (Bolivarian Republic of),29,14,15
2015,534,Sint Maarten (Dutch part),Venezuela (Bolivarian Republic of),41,21,20
2015,780,Trinidad and Tobago,Venezuela (Bolivarian Republic of),1870,879,991
2015,188,Costa Rica,Venezuela (Bolivarian Republic of),1381,672,709
2015,222,El Salvador,Venezuela (Bolivarian Republic of),242,111,131
2015,320,Guatemala,Venezuela (Bolivarian Republic of),283,138,145
2015,340,Honduras,Venezuela (Bolivarian Republic of),102,49,53
2015,484,Mexico,Venezuela (Bolivarian Republic of),16736,7058,9678
2015,558,Nicaragua,Venezuela (Bolivarian Republic of),159,81,78
2015,591,Panama,Venezuela (Bolivarian Republic of),9883,5019,4864
2015,32,Argentina,Venezuela (Bolivarian Republic of),1240,606,634
2015,68,Bolivia (Plurinational State of),Venezuela (Bolivarian Republic of),773,417,356
2015,76,Brazil,Venezuela (Bolivarian Republic of),3425,1754,1671
2015,152,Chile,Venezuela (Bolivarian Republic of),54787,26423,28364
2015,170,Colombia,Venezuela (Bolivarian Republic of),48714,24168,24546
2015,218,Ecuador,Venezuela (Bolivarian Republic of),8901,4104,4797
2015,328,Guyana,Venezuela (Bolivarian Republic of),2099,1087,1012
2015,604,Peru,Venezuela (Bolivarian Republic of),4129,2135,1994
2015,858,Uruguay,Venezuela (Bolivarian Republic of),583,284,299
2015,36,Australia,Venezuela (Bolivarian Republic of),5760,2911,2849
2015,100,Bulgaria,Venezuela (Bolivarian Republic of),38,17,21
2015,203,Czechia,Venezuela (Bolivarian Republic of),122,61,61
2015,348,Hungary,Venezuela (Bolivarian Republic of),217,117,100
2015,616,Poland,Venezuela (Bolivarian Republic of),72,64,8
2015,642,Romania,Venezuela (Bolivarian Republic of),31,9,22
2015,643,Russian Federation,Venezuela (Bolivarian Republic of),98,47,51
2015,208,Denmark,Venezuela (Bolivarian Republic of),734,307,427
2015,233,Estonia,Venezuela (Bolivarian Republic of),11,9,2
2015,246,Finland,Venezuela (Bolivarian Republic of),259,135,124
2015,352,Iceland,Venezuela (Bolivarian Republic of),39,13,26
2015,372,Ireland,Venezuela (Bolivarian Republic of),128,57,71
2015,428,Latvia,Venezuela (Bolivarian Republic of),22,15,7
2015,578,Norway,Venezuela (Bolivarian Republic of),1070,475,595
2015,752,Sweden,Venezuela (Bolivarian Republic of),1186,571,615
2015,826,United Kingdom,Venezuela (Bolivarian Republic of),8153,3669,4484
2015,191,Croatia,Venezuela (Bolivarian Republic of),55,24,31
2015,300,Greece,Venezuela (Bolivarian Republic of),1023,385,638
2015,380,Italy,Venezuela (Bolivarian Republic of),48320,20284,28036
2015,620,Portugal,Venezuela (Bolivarian Republic of),24174,10780,13394
2015,688,Serbia,Venezuela (Bolivarian Republic of),37,19,18
2015,724,Spain,Venezuela (Bolivarian Republic of),160478,73721,86757
2015,40,Austria,Venezuela (Bolivarian Republic of),915,360,555
2015,56,Belgium,Venezuela (Bolivarian Republic of),1511,659,852
2015,250,France,Venezuela (Bolivarian Republic of),6592,2399,4193
2015,276,Germany,Venezuela (Bolivarian Republic of),7671,3433,4238
2015,442,Luxembourg,Venezuela (Bolivarian Republic of),25,13,12
2015,528,Netherlands,Venezuela (Bolivarian Republic of),3878,1635,2243
2015,756,Switzerland,Venezuela (Bolivarian Republic of),4517,1856,2661
2015,124,Canada,Venezuela (Bolivarian Republic of),20652,9367,11285
2015,840,United States of America,Venezuela (Bolivarian Republic of),236264,91861,144403
2019,710,South Africa,Venezuela (Bolivarian Republic of),521,252,269
2019,818,Egypt,Venezuela (Bolivarian Republic of),32,13,19
2019,196,Cyprus,Venezuela (Bolivarian Republic of),64,27,37
2019,376,Israel,Venezuela (Bolivarian Republic of),362,161,201
2019,400,Jordan,Venezuela (Bolivarian Republic of),32,16,16
2019,792,Turkey,Venezuela (Bolivarian Republic of),52,23,29
2019,28,Antigua and Barbuda,Venezuela (Bolivarian Republic of),40,20,20
2019,533,Aruba,Venezuela (Bolivarian Republic of),3438,1719,1719
2019,44,Bahamas,Venezuela (Bolivarian Republic of),31,10,21
2019,535,"Bonaire, Sint Eustatius and Saba",Venezuela (Bolivarian Republic of),571,270,301
2019,136,Cayman Islands,Venezuela (Bolivarian Republic of),39,22,17
2019,192,Cuba,Venezuela (Bolivarian Republic of),59,26,33
2019,531,Curaçao,Venezuela (Bolivarian Republic of),2942,1315,1627
2019,212,Dominica,Venezuela (Bolivarian Republic of),30,4,26
2019,214,Dominican Republic,Venezuela (Bolivarian Republic of),3680,1752,1928
2019,308,Grenada,Venezuela (Bolivarian Republic of),344,307,37
2019,332,Haiti,Venezuela (Bolivarian Republic of),2463,1302,1161
2019,630,Puerto Rico,Venezuela (Bolivarian Republic of),2189,1017,1172
2019,662,Saint Lucia,Venezuela (Bolivarian Republic of),28,14,14
2019,534,Sint Maarten (Dutch part),Venezuela (Bolivarian Republic of),42,22,20
2019,780,Trinidad and Tobago,Venezuela (Bolivarian Republic of),7420,2504,4916
2019,188,Costa Rica,Venezuela (Bolivarian Republic of),1401,687,714
2019,222,El Salvador,Venezuela (Bolivarian Republic of),245,113,132
2019,320,Guatemala,Venezuela (Bolivarian Republic of),290,142,148
2019,340,Honduras,Venezuela (Bolivarian Republic of),103,50,53
2019,484,Mexico,Venezuela (Bolivarian Republic of),17254,7276,9978
2019,558,Nicaragua,Venezuela (Bolivarian Republic of),166,85,81
2019,591,Panama,Venezuela (Bolivarian Republic of),13474,7022,6452
2019,32,Argentina,Venezuela (Bolivarian Republic of),91315,44627,46688
2019,68,Bolivia (Plurinational State of),Venezuela (Bolivarian Republic of),843,455,388
2019,76,Brazil,Venezuela (Bolivarian Republic of),3857,1976,1881
2019,152,Chile,Venezuela (Bolivarian Republic of),109798,49787,60011
2019,170,Colombia,Venezuela (Bolivarian Republic of),1048714,524357,524357
2019,218,Ecuador,Venezuela (Bolivarian Republic of),8763,4039,4724
2019,328,Guyana,Venezuela (Bolivarian Republic of),2141,1109,1032
2019,604,Peru,Venezuela (Bolivarian Republic of),602595,315398,287197
2019,858,Uruguay,Venezuela (Bolivarian Republic of),602,294,308
2019,36,Australia,Venezuela (Bolivarian Republic of),7427,3728,3699
2019,100,Bulgaria,Venezuela (Bolivarian Republic of),50,22,28
2019,203,Czechia,Venezuela (Bolivarian Republic of),194,110,84
2019,348,Hungary,Venezuela (Bolivarian Republic of),279,144,135
2019,616,Poland,Venezuela (Bolivarian Republic of),76,68,8
2019,642,Romania,Venezuela (Bolivarian Republic of),115,41,74
2019,643,Russian Federation,Venezuela (Bolivarian Republic of),97,47,50
2019,208,Denmark,Venezuela (Bolivarian Republic of),892,364,528
2019,233,Estonia,Venezuela (Bolivarian Republic of),18,16,2
2019,246,Finland,Venezuela (Bolivarian Republic of),338,165,173
2019,352,Iceland,Venezuela (Bolivarian Republic of),58,22,36
2019,372,Ireland,Venezuela (Bolivarian Republic of),140,63,77
2019,428,Latvia,Venezuela (Bolivarian Republic of),24,17,7
2019,578,Norway,Venezuela (Bolivarian Republic of),1188,527,661
2019,752,Sweden,Venezuela (Bolivarian Republic of),1597,748,849
2019,826,United Kingdom,Venezuela (Bolivarian Republic of),9258,4179,5079
2019,191,Croatia,Venezuela (Bolivarian Republic of),50,22,28
2019,300,Greece,Venezuela (Bolivarian Republic of),999,400,599
2019,380,Italy,Venezuela (Bolivarian Republic of),53007,22535,30472
2019,620,Portugal,Venezuela (Bolivarian Republic of),24584,10992,13592
2019,688,Serbia,Venezuela (Bolivarian Republic of),37,19,18
2019,724,Spain,Venezuela (Bolivarian Republic of),202859,91690,111169
2019,40,Austria,Venezuela (Bolivarian Republic of),1080,437,643
2019,56,Belgium,Venezuela (Bolivarian Republic of),1844,795,1049
2019,250,France,Venezuela (Bolivarian Republic of),6977,2529,4448
2019,276,Germany,Venezuela (Bolivarian Republic of),8414,3792,4622
2019,442,Luxembourg,Venezuela (Bolivarian Republic of),478,236,242
2019,528,Netherlands,Venezuela (Bolivarian Republic of),4619,1975,2644
2019,756,Switzerland,Venezuela (Bolivarian Republic of),5066,2111,2955
2019,124,Canada,Venezuela (Bolivarian Republic of),22130,10037,12093
2019,840,United States of America,Venezuela (Bolivarian Republic of),255141,97522,157619
1990,710,South Africa,Viet Nam,156,42,114
1990,196,Cyprus,Viet Nam,16,3,13
1990,792,Turkey,Viet Nam,7,3,4
1990,887,Yemen,Viet Nam,706,410,296
1990,417,Kyrgyzstan,Viet Nam,372,158,214
1990,50,Bangladesh,Viet Nam,40088,21648,18440
1990,356,India,Viet Nam,2832,759,2073
1990,156,China,Viet Nam,18063,11453,6610
1990,344,"China, Hong Kong SAR",Viet Nam,7324,3118,4206
1990,408,Dem. People's Republic of Korea,Viet Nam,716,429,287
1990,392,Japan,Viet Nam,6235,3176,3059
1990,496,Mongolia,Viet Nam,11,10,1
1990,410,Republic of Korea,Viet Nam,445,263,182
1990,116,Cambodia,Viet Nam,16771,8024,8747
1990,418,Lao People's Democratic Republic,Viet Nam,13852,6845,7007
1990,458,Malaysia,Viet Nam,12877,7584,5293
1990,608,Philippines,Viet Nam,18174,8113,10061
1990,764,Thailand,Viet Nam,18879,9431,9448
1990,626,Timor-Leste,Viet Nam,162,69,93
1990,630,Puerto Rico,Viet Nam,124,59,65
1990,188,Costa Rica,Viet Nam,2,1,1
1990,484,Mexico,Viet Nam,81,58,23
1990,591,Panama,Viet Nam,5,3,2
1990,32,Argentina,Viet Nam,11,7,4
1990,68,Bolivia (Plurinational State of),Viet Nam,1,0,1
1990,152,Chile,Viet Nam,10,5,5
1990,218,Ecuador,Viet Nam,16,9,7
1990,862,Venezuela (Bolivarian Republic of),Viet Nam,10,4,6
1990,36,Australia,Viet Nam,136918,71083,65835
1990,554,New Zealand,Viet Nam,3076,1653,1423
1990,540,New Caledonia,Viet Nam,499,240,259
1990,316,Guam,Viet Nam,352,151,201
1990,16,American Samoa,Viet Nam,1,1,0
1990,112,Belarus,Viet Nam,182,107,75
1990,100,Bulgaria,Viet Nam,346,244,102
1990,203,Czechia,Viet Nam,3604,2426,1178
1990,348,Hungary,Viet Nam,653,290,363
1990,616,Poland,Viet Nam,2343,1475,868
1990,642,Romania,Viet Nam,4,3,1
1990,643,Russian Federation,Viet Nam,32251,15826,16425
1990,703,Slovakia,Viet Nam,241,171,70
1990,804,Ukraine,Viet Nam,14964,8191,6773
1990,208,Denmark,Viet Nam,5087,2941,2146
1990,246,Finland,Viet Nam,1645,870,775
1990,352,Iceland,Viet Nam,76,34,42
1990,372,Ireland,Viet Nam,122,47,75
1990,428,Latvia,Viet Nam,3,2,1
1990,440,Lithuania,Viet Nam,66,48,18
1990,578,Norway,Viet Nam,7522,4234,3288
1990,752,Sweden,Viet Nam,8563,4118,4445
1990,826,United Kingdom,Viet Nam,19674,9856,9818
1990,300,Greece,Viet Nam,713,462,251
1990,380,Italy,Viet Nam,636,221,415
1990,620,Portugal,Viet Nam,5,3,2
1990,724,Spain,Viet Nam,363,165,198
1990,40,Austria,Viet Nam,1842,862,980
1990,56,Belgium,Viet Nam,2690,1308,1382
1990,250,France,Viet Nam,99095,47528,51567
1990,276,Germany,Viet Nam,69594,40331,29263
1990,442,Luxembourg,Viet Nam,70,22,48
1990,528,Netherlands,Viet Nam,7130,3767,3363
1990,756,Switzerland,Viet Nam,7338,3611,3727
1990,124,Canada,Viet Nam,108997,53063,55934
1990,840,United States of America,Viet Nam,543262,279380,263882
1995,710,South Africa,Viet Nam,97,32,65
1995,694,Sierra Leone,Viet Nam,1,1,0
1995,196,Cyprus,Viet Nam,23,4,19
1995,792,Turkey,Viet Nam,17,7,10
1995,417,Kyrgyzstan,Viet Nam,278,138,140
1995,50,Bangladesh,Viet Nam,29184,15760,13424
1995,356,India,Viet Nam,1762,533,1229
1995,156,China,Viet Nam,19149,11936,7213
1995,344,"China, Hong Kong SAR",Viet Nam,8174,3448,4726
1995,408,Dem. People's Republic of Korea,Viet Nam,699,410,289
1995,392,Japan,Viet Nam,9224,4427,4797
1995,496,Mongolia,Viet Nam,11,11,0
1995,410,Republic of Korea,Viet Nam,7664,4914,2750
1995,116,Cambodia,Viet Nam,44367,21155,23212
1995,418,Lao People's Democratic Republic,Viet Nam,13368,6589,6779
1995,458,Malaysia,Viet Nam,28668,16905,11763
1995,608,Philippines,Viet Nam,24458,10649,13809
1995,764,Thailand,Viet Nam,12336,6103,6233
1995,626,Timor-Leste,Viet Nam,176,75,101
1995,630,Puerto Rico,Viet Nam,130,62,68
1995,188,Costa Rica,Viet Nam,1,1,0
1995,484,Mexico,Viet Nam,64,43,21
1995,591,Panama,Viet Nam,6,4,2
1995,32,Argentina,Viet Nam,11,7,4
1995,68,Bolivia (Plurinational State of),Viet Nam,3,1,2
1995,152,Chile,Viet Nam,10,7,3
1995,218,Ecuador,Viet Nam,18,10,8
1995,862,Venezuela (Bolivarian Republic of),Viet Nam,10,4,6
1995,36,Australia,Viet Nam,157398,79267,78131
1995,554,New Zealand,Viet Nam,3371,1745,1626
1995,540,New Caledonia,Viet Nam,578,268,310
1995,316,Guam,Viet Nam,352,153,199
1995,16,American Samoa,Viet Nam,102,53,49
1995,112,Belarus,Viet Nam,282,144,138
1995,100,Bulgaria,Viet Nam,381,263,118
1995,203,Czechia,Viet Nam,5386,3684,1702
1995,348,Hungary,Viet Nam,1499,702,797
1995,616,Poland,Viet Nam,2003,1250,753
1995,642,Romania,Viet Nam,6,5,1
1995,643,Russian Federation,Viet Nam,28489,16574,11915
1995,703,Slovakia,Viet Nam,713,415,298
1995,804,Ukraine,Viet Nam,14476,8109,6367
1995,208,Denmark,Viet Nam,6865,3658,3207
1995,246,Finland,Viet Nam,2035,1048,987
1995,352,Iceland,Viet Nam,148,67,81
1995,372,Ireland,Viet Nam,338,121,217
1995,428,Latvia,Viet Nam,5,4,1
1995,440,Lithuania,Viet Nam,74,53,21
1995,578,Norway,Viet Nam,10594,5668,4926
1995,752,Sweden,Viet Nam,10162,4847,5315
1995,826,United Kingdom,Viet Nam,20943,10135,10808
1995,300,Greece,Viet Nam,465,292,173
1995,380,Italy,Viet Nam,1327,518,809
1995,620,Portugal,Viet Nam,12,6,6
1995,724,Spain,Viet Nam,423,198,225
1995,40,Austria,Viet Nam,2078,990,1088
1995,56,Belgium,Viet Nam,3562,1451,2111
1995,250,France,Viet Nam,102298,48168,54130
1995,276,Germany,Viet Nam,75465,41503,33962
1995,442,Luxembourg,Viet Nam,66,21,45
1995,528,Netherlands,Viet Nam,8861,4480,4381
1995,756,Switzerland,Viet Nam,7764,3822,3942
1995,124,Canada,Viet Nam,127335,61658,65677
1995,840,United States of America,Viet Nam,775967,400638,375329
2000,710,South Africa,Viet Nam,68,30,38
2000,694,Sierra Leone,Viet Nam,1,1,0
2000,196,Cyprus,Viet Nam,29,4,25
2000,792,Turkey,Viet Nam,29,12,17
2000,887,Yemen,Viet Nam,9,6,3
2000,417,Kyrgyzstan,Viet Nam,178,115,63
2000,50,Bangladesh,Viet Nam,18280,9872,8408
2000,356,India,Viet Nam,692,307,385
2000,156,China,Viet Nam,20235,12418,7817
2000,344,"China, Hong Kong SAR",Viet Nam,9023,3778,5245
2000,408,Dem. People's Republic of Korea,Viet Nam,681,390,291
2000,392,Japan,Viet Nam,16909,7812,9097
2000,496,Mongolia,Viet Nam,13,12,1
2000,410,Republic of Korea,Viet Nam,17554,11441,6113
2000,116,Cambodia,Viet Nam,71963,34286,37677
2000,418,Lao People's Democratic Republic,Viet Nam,11611,5786,5825
2000,458,Malaysia,Viet Nam,54395,32038,22357
2000,608,Philippines,Viet Nam,601,375,226
2000,764,Thailand,Viet Nam,8340,3884,4456
2000,626,Timor-Leste,Viet Nam,192,80,112
2000,630,Puerto Rico,Viet Nam,138,66,72
2000,188,Costa Rica,Viet Nam,1,1,0
2000,484,Mexico,Viet Nam,50,30,20
2000,591,Panama,Viet Nam,8,4,4
2000,32,Argentina,Viet Nam,11,7,4
2000,68,Bolivia (Plurinational State of),Viet Nam,4,2,2
2000,152,Chile,Viet Nam,10,6,4
2000,218,Ecuador,Viet Nam,20,11,9
2000,862,Venezuela (Bolivarian Republic of),Viet Nam,10,4,6
2000,36,Australia,Viet Nam,163700,80520,83180
2000,554,New Zealand,Viet Nam,3841,1868,1973
2000,540,New Caledonia,Viet Nam,658,307,351
2000,316,Guam,Viet Nam,351,155,196
2000,16,American Samoa,Viet Nam,203,105,98
2000,112,Belarus,Viet Nam,381,180,201
2000,100,Bulgaria,Viet Nam,416,283,133
2000,203,Czechia,Viet Nam,7208,4950,2258
2000,348,Hungary,Viet Nam,2345,1114,1231
2000,616,Poland,Viet Nam,1713,1059,654
2000,642,Romania,Viet Nam,8,6,2
2000,643,Russian Federation,Viet Nam,23695,16725,6970
2000,703,Slovakia,Viet Nam,1381,772,609
2000,804,Ukraine,Viet Nam,14166,8127,6039
2000,208,Denmark,Viet Nam,8651,4405,4246
2000,246,Finland,Viet Nam,2424,1226,1198
2000,352,Iceland,Viet Nam,220,101,119
2000,372,Ireland,Viet Nam,740,280,460
2000,428,Latvia,Viet Nam,7,6,1
2000,440,Lithuania,Viet Nam,57,41,16
2000,578,Norway,Viet Nam,11177,5755,5422
2000,752,Sweden,Viet Nam,10898,5160,5738
2000,826,United Kingdom,Viet Nam,22566,10558,12008
2000,300,Greece,Viet Nam,224,124,100
2000,380,Italy,Viet Nam,2017,814,1203
2000,620,Portugal,Viet Nam,20,9,11
2000,724,Spain,Viet Nam,665,321,344
2000,40,Austria,Viet Nam,2314,1119,1195
2000,56,Belgium,Viet Nam,4325,1560,2765
2000,250,France,Viet Nam,105501,48808,56693
2000,276,Germany,Viet Nam,81335,42675,38660
2000,442,Luxembourg,Viet Nam,63,19,44
2000,528,Netherlands,Viet Nam,10560,5228,5332
2000,756,Switzerland,Viet Nam,8220,4060,4160
2000,124,Canada,Viet Nam,148701,71734,76967
2000,840,United States of America,Viet Nam,1013266,524898,488368
2005,710,South Africa,Viet Nam,89,37,52
2005,694,Sierra Leone,Viet Nam,1,1,0
2005,196,Cyprus,Viet Nam,42,5,37
2005,792,Turkey,Viet Nam,29,12,17
2005,417,Kyrgyzstan,Viet Nam,150,97,53
2005,50,Bangladesh,Viet Nam,22153,11963,10190
2005,356,India,Viet Nam,640,283,357
2005,156,China,Viet Nam,22324,14608,7716
2005,344,"China, Hong Kong SAR",Viet Nam,9852,3838,6014
2005,408,Dem. People's Republic of Korea,Viet Nam,682,382,300
2005,392,Japan,Viet Nam,39408,17951,21457
2005,496,Mongolia,Viet Nam,112,107,5
2005,410,Republic of Korea,Viet Nam,45497,25913,19584
2005,116,Cambodia,Viet Nam,56174,27571,28603
2005,418,Lao People's Democratic Republic,Viet Nam,10717,5428,5289
2005,458,Malaysia,Viet Nam,68238,41490,26748
2005,608,Philippines,Viet Nam,486,306,180
2005,764,Thailand,Viet Nam,7172,3358,3814
2005,626,Timor-Leste,Viet Nam,204,85,119
2005,630,Puerto Rico,Viet Nam,108,52,56
2005,188,Costa Rica,Viet Nam,1,1,0
2005,484,Mexico,Viet Nam,61,34,27
2005,591,Panama,Viet Nam,28,17,11
2005,32,Argentina,Viet Nam,8,5,3
2005,68,Bolivia (Plurinational State of),Viet Nam,7,5,2
2005,152,Chile,Viet Nam,15,10,5
2005,218,Ecuador,Viet Nam,24,14,10
2005,862,Venezuela (Bolivarian Republic of),Viet Nam,10,4,6
2005,36,Australia,Viet Nam,174440,83963,90477
2005,554,New Zealand,Viet Nam,4662,2263,2399
2005,540,New Caledonia,Viet Nam,706,331,375
2005,316,Guam,Viet Nam,351,168,183
2005,16,American Samoa,Viet Nam,208,107,101
2005,112,Belarus,Viet Nam,366,173,193
2005,100,Bulgaria,Viet Nam,518,354,164
2005,203,Czechia,Viet Nam,31521,19234,12287
2005,348,Hungary,Viet Nam,2898,1405,1493
2005,616,Poland,Viet Nam,2268,1370,898
2005,642,Romania,Viet Nam,9,8,1
2005,643,Russian Federation,Viet Nam,18748,12700,6048
2005,703,Slovakia,Viet Nam,1546,874,672
2005,804,Ukraine,Viet Nam,12943,7433,5510
2005,208,Denmark,Viet Nam,9301,4547,4754
2005,246,Finland,Viet Nam,3560,1684,1876
2005,352,Iceland,Viet Nam,355,159,196
2005,372,Ireland,Viet Nam,742,308,434
2005,428,Latvia,Viet Nam,8,6,2
2005,440,Lithuania,Viet Nam,52,35,17
2005,578,Norway,Viet Nam,12108,5910,6198
2005,752,Sweden,Viet Nam,12352,5776,6576
2005,826,United Kingdom,Viet Nam,24711,11237,13474
2005,300,Greece,Viet Nam,220,114,106
2005,380,Italy,Viet Nam,3637,1573,2064
2005,620,Portugal,Viet Nam,37,19,18
2005,705,Slovenia,Viet Nam,1,0,1
2005,724,Spain,Viet Nam,765,352,413
2005,40,Austria,Viet Nam,2587,1219,1368
2005,56,Belgium,Viet Nam,6866,2582,4284
2005,250,France,Viet Nam,118704,55090,63614
2005,276,Germany,Viet Nam,86970,43276,43694
2005,442,Luxembourg,Viet Nam,54,19,35
2005,528,Netherlands,Viet Nam,12154,5897,6257
2005,756,Switzerland,Viet Nam,9148,4286,4862
2005,124,Canada,Viet Nam,151603,72280,79323
2005,840,United States of America,Viet Nam,1106433,576108,530325
2010,710,South Africa,Viet Nam,139,58,81
2010,694,Sierra Leone,Viet Nam,1,1,0
2010,196,Cyprus,Viet Nam,68,9,59
2010,792,Turkey,Viet Nam,29,12,17
2010,887,Yemen,Viet Nam,28,16,12
2010,417,Kyrgyzstan,Viet Nam,122,78,44
2010,50,Bangladesh,Viet Nam,25830,13949,11881
2010,356,India,Viet Nam,587,259,328
2010,156,China,Viet Nam,24413,16797,7616
2010,344,"China, Hong Kong SAR",Viet Nam,10704,3907,6797
2010,408,Dem. People's Republic of Korea,Viet Nam,682,373,309
2010,392,Japan,Viet Nam,41781,18793,22988
2010,496,Mongolia,Viet Nam,225,215,10
2010,410,Republic of Korea,Viet Nam,91420,49441,41979
2010,116,Cambodia,Viet Nam,40384,20856,19528
2010,418,Lao People's Democratic Republic,Viet Nam,14827,8395,6432
2010,458,Malaysia,Viet Nam,78326,48913,29413
2010,608,Philippines,Viet Nam,406,250,156
2010,764,Thailand,Viet Nam,6519,3152,3367
2010,626,Timor-Leste,Viet Nam,209,86,123
2010,630,Puerto Rico,Viet Nam,65,31,34
2010,188,Costa Rica,Viet Nam,1,1,0
2010,484,Mexico,Viet Nam,81,42,39
2010,591,Panama,Viet Nam,50,30,20
2010,32,Argentina,Viet Nam,5,3,2
2010,68,Bolivia (Plurinational State of),Viet Nam,10,8,2
2010,76,Brazil,Viet Nam,126,82,44
2010,152,Chile,Viet Nam,20,13,7
2010,218,Ecuador,Viet Nam,33,19,14
2010,862,Venezuela (Bolivarian Republic of),Viet Nam,11,4,7
2010,36,Australia,Viet Nam,203770,95267,108503
2010,554,New Zealand,Viet Nam,5572,2700,2872
2010,540,New Caledonia,Viet Nam,753,360,393
2010,316,Guam,Viet Nam,351,182,169
2010,16,American Samoa,Viet Nam,212,108,104
2010,112,Belarus,Viet Nam,351,167,184
2010,100,Bulgaria,Viet Nam,598,409,189
2010,203,Czechia,Viet Nam,52748,32141,20607
2010,348,Hungary,Viet Nam,3450,1695,1755
2010,616,Poland,Viet Nam,2896,1718,1178
2010,642,Romania,Viet Nam,21,16,5
2010,643,Russian Federation,Viet Nam,13416,8418,4998
2010,703,Slovakia,Viet Nam,1737,994,743
2010,804,Ukraine,Viet Nam,12349,7099,5250
2010,208,Denmark,Viet Nam,9775,4609,5166
2010,233,Estonia,Viet Nam,11,8,3
2010,246,Finland,Viet Nam,5526,2306,3220
2010,352,Iceland,Viet Nam,489,218,271
2010,372,Ireland,Viet Nam,622,230,392
2010,428,Latvia,Viet Nam,10,6,4
2010,440,Lithuania,Viet Nam,40,22,18
2010,578,Norway,Viet Nam,12958,6103,6855
2010,752,Sweden,Viet Nam,14584,6726,7858
2010,826,United Kingdom,Viet Nam,26032,12130,13902
2010,300,Greece,Viet Nam,223,107,116
2010,380,Italy,Viet Nam,4973,2247,2726
2010,620,Portugal,Viet Nam,48,25,23
2010,705,Slovenia,Viet Nam,6,0,6
2010,724,Spain,Viet Nam,1112,547,565
2010,40,Austria,Viet Nam,2859,1319,1540
2010,56,Belgium,Viet Nam,7909,3541,4368
2010,250,France,Viet Nam,118068,53199,64869
2010,276,Germany,Viet Nam,91388,43607,47781
2010,442,Luxembourg,Viet Nam,47,19,28
2010,528,Netherlands,Viet Nam,12185,5664,6521
2010,756,Switzerland,Viet Nam,10860,4753,6107
2010,124,Canada,Viet Nam,165125,78097,87028
2010,840,United States of America,Viet Nam,1236000,635422,600578
2015,710,South Africa,Viet Nam,249,97,152
2015,324,Guinea,Viet Nam,5,4,1
2015,196,Cyprus,Viet Nam,65,9,56
2015,792,Turkey,Viet Nam,29,12,17
2015,887,Yemen,Viet Nam,15,8,7
2015,417,Kyrgyzstan,Viet Nam,107,68,39
2015,50,Bangladesh,Viet Nam,27521,14862,12659
2015,356,India,Viet Nam,565,249,316
2015,156,China,Viet Nam,28095,19731,8364
2015,344,"China, Hong Kong SAR",Viet Nam,10930,3718,7212
2015,408,Dem. People's Republic of Korea,Viet Nam,751,413,338
2015,392,Japan,Viet Nam,146956,70322,76634
2015,496,Mongolia,Viet Nam,278,263,15
2015,410,Republic of Korea,Viet Nam,113589,60217,53372
2015,116,Cambodia,Viet Nam,36436,19175,17261
2015,418,Lao People's Democratic Republic,Viet Nam,18938,11362,7576
2015,458,Malaysia,Viet Nam,95517,60152,35365
2015,608,Philippines,Viet Nam,413,254,159
2015,764,Thailand,Viet Nam,7049,3396,3653
2015,626,Timor-Leste,Viet Nam,208,124,84
2015,630,Puerto Rico,Viet Nam,64,30,34
2015,188,Costa Rica,Viet Nam,1,1,0
2015,484,Mexico,Viet Nam,85,44,41
2015,591,Panama,Viet Nam,59,36,23
2015,32,Argentina,Viet Nam,5,3,2
2015,68,Bolivia (Plurinational State of),Viet Nam,12,10,2
2015,76,Brazil,Viet Nam,152,99,53
2015,152,Chile,Viet Nam,30,20,10
2015,218,Ecuador,Viet Nam,48,28,20
2015,862,Venezuela (Bolivarian Republic of),Viet Nam,12,5,7
2015,36,Australia,Viet Nam,235590,108279,127311
2015,554,New Zealand,Viet Nam,6393,3092,3301
2015,540,New Caledonia,Viet Nam,583,238,345
2015,316,Guam,Viet Nam,354,184,170
2015,16,American Samoa,Viet Nam,211,107,104
2015,112,Belarus,Viet Nam,366,172,194
2015,100,Bulgaria,Viet Nam,635,426,209
2015,203,Czechia,Viet Nam,45525,26266,19259
2015,348,Hungary,Viet Nam,3305,1599,1706
2015,616,Poland,Viet Nam,2792,1678,1114
2015,642,Romania,Viet Nam,80,48,32
2015,643,Russian Federation,Viet Nam,13671,8553,5118
2015,703,Slovakia,Viet Nam,2145,1303,842
2015,804,Ukraine,Viet Nam,12390,7130,5260
2015,208,Denmark,Viet Nam,10935,5068,5867
2015,233,Estonia,Viet Nam,32,22,10
2015,246,Finland,Viet Nam,7438,3064,4374
2015,352,Iceland,Viet Nam,613,275,338
2015,372,Ireland,Viet Nam,635,230,405
2015,428,Latvia,Viet Nam,7,5,2
2015,440,Lithuania,Viet Nam,35,20,15
2015,578,Norway,Viet Nam,13835,6258,7577
2015,752,Sweden,Viet Nam,17085,7830,9255
2015,826,United Kingdom,Viet Nam,33291,14986,18305
2015,300,Greece,Viet Nam,209,96,113
2015,380,Italy,Viet Nam,5295,2302,2993
2015,620,Portugal,Viet Nam,53,25,28
2015,705,Slovenia,Viet Nam,15,1,14
2015,724,Spain,Viet Nam,1634,753,881
2015,40,Austria,Viet Nam,3344,1553,1791
2015,56,Belgium,Viet Nam,8206,3594,4612
2015,250,France,Viet Nam,130894,56953,73941
2015,276,Germany,Viet Nam,95221,45319,49902
2015,442,Luxembourg,Viet Nam,71,29,42
2015,528,Netherlands,Viet Nam,13600,6568,7032
2015,756,Switzerland,Viet Nam,11417,4729,6688
2015,124,Canada,Viet Nam,168212,77481,90731
2015,840,United States of America,Viet Nam,1300575,637503,663072
2019,710,South Africa,Viet Nam,278,108,170
2019,324,Guinea,Viet Nam,4,4,0
2019,196,Cyprus,Viet Nam,64,9,55
2019,792,Turkey,Viet Nam,39,17,22
2019,887,Yemen,Viet Nam,15,8,7
2019,417,Kyrgyzstan,Viet Nam,104,66,38
2019,50,Bangladesh,Viet Nam,27883,8504,19379
2019,356,India,Viet Nam,555,246,309
2019,156,China,Viet Nam,29612,20797,8815
2019,344,"China, Hong Kong SAR",Viet Nam,14161,4537,9624
2019,408,Dem. People's Republic of Korea,Viet Nam,765,421,344
2019,392,Japan,Viet Nam,209731,100362,109369
2019,496,Mongolia,Viet Nam,295,280,15
2019,410,Republic of Korea,Viet Nam,115632,61279,54353
2019,116,Cambodia,Viet Nam,38744,20390,18354
2019,418,Lao People's Democratic Republic,Viet Nam,20076,12046,8030
2019,458,Malaysia,Viet Nam,99875,63168,36707
2019,608,Philippines,Viet Nam,425,261,164
2019,764,Thailand,Viet Nam,7350,3543,3807
2019,626,Timor-Leste,Viet Nam,205,123,82
2019,630,Puerto Rico,Viet Nam,60,29,31
2019,188,Costa Rica,Viet Nam,1,1,0
2019,484,Mexico,Viet Nam,87,45,42
2019,591,Panama,Viet Nam,61,38,23
2019,32,Argentina,Viet Nam,5,3,2
2019,68,Bolivia (Plurinational State of),Viet Nam,13,11,2
2019,76,Brazil,Viet Nam,171,112,59
2019,152,Chile,Viet Nam,40,26,14
2019,218,Ecuador,Viet Nam,47,28,19
2019,862,Venezuela (Bolivarian Republic of),Viet Nam,11,5,6
2019,36,Australia,Viet Nam,265018,120145,144873
2019,554,New Zealand,Viet Nam,6571,3178,3393
2019,540,New Caledonia,Viet Nam,613,249,364
2019,316,Guam,Viet Nam,371,193,178
2019,16,American Samoa,Viet Nam,211,107,104
2019,112,Belarus,Viet Nam,361,170,191
2019,100,Bulgaria,Viet Nam,714,463,251
2019,203,Czechia,Viet Nam,46631,26388,20243
2019,348,Hungary,Viet Nam,3548,1680,1868
2019,616,Poland,Viet Nam,2956,1822,1134
2019,642,Romania,Viet Nam,246,138,108
2019,643,Russian Federation,Viet Nam,13667,8551,5116
2019,703,Slovakia,Viet Nam,2248,1366,882
2019,804,Ukraine,Viet Nam,12513,7201,5312
2019,208,Denmark,Viet Nam,10815,4829,5986
2019,233,Estonia,Viet Nam,39,24,15
2019,246,Finland,Viet Nam,10036,4205,5831
2019,352,Iceland,Viet Nam,798,357,441
2019,372,Ireland,Viet Nam,697,254,443
2019,428,Latvia,Viet Nam,24,18,6
2019,440,Lithuania,Viet Nam,31,15,16
2019,578,Norway,Viet Nam,15246,6774,8472
2019,752,Sweden,Viet Nam,20448,9395,11053
2019,826,United Kingdom,Viet Nam,37805,17071,20734
2019,300,Greece,Viet Nam,204,98,106
2019,380,Italy,Viet Nam,5909,2538,3371
2019,620,Portugal,Viet Nam,53,25,28
2019,705,Slovenia,Viet Nam,23,2,21
2019,724,Spain,Viet Nam,1693,759,934
2019,40,Austria,Viet Nam,3947,1870,2077
2019,56,Belgium,Viet Nam,8765,3801,4964
2019,250,France,Viet Nam,138552,60107,78445
2019,276,Germany,Viet Nam,104454,49742,54712
2019,442,Luxembourg,Viet Nam,600,225,375
2019,528,Netherlands,Viet Nam,14225,6250,7975
2019,756,Switzerland,Viet Nam,12093,4968,7125
2019,124,Canada,Viet Nam,180258,83030,97228
2019,840,United States of America,Viet Nam,1368746,669587,699159
1990,214,Dominican Republic,Wallis and Futuna Islands,12,6,6
1990,540,New Caledonia,Wallis and Futuna Islands,5558,2905,2653
1990,258,French Polynesia,Wallis and Futuna Islands,30,10,20
1990,300,Greece,Wallis and Futuna Islands,884,743,141
1995,214,Dominican Republic,Wallis and Futuna Islands,14,7,7
1995,540,New Caledonia,Wallis and Futuna Islands,6446,3325,3121
1995,258,French Polynesia,Wallis and Futuna Islands,32,10,22
1995,300,Greece,Wallis and Futuna Islands,451,373,78
2000,214,Dominican Republic,Wallis and Futuna Islands,15,7,8
2000,152,Chile,Wallis and Futuna Islands,1,1,0
2000,540,New Caledonia,Wallis and Futuna Islands,7325,3735,3590
2000,258,French Polynesia,Wallis and Futuna Islands,35,10,25
2000,300,Greece,Wallis and Futuna Islands,26,9,17
2005,214,Dominican Republic,Wallis and Futuna Islands,13,6,7
2005,152,Chile,Wallis and Futuna Islands,1,1,0
2005,540,New Caledonia,Wallis and Futuna Islands,7373,3677,3696
2005,258,French Polynesia,Wallis and Futuna Islands,36,11,25
2005,300,Greece,Wallis and Futuna Islands,14,5,9
2010,214,Dominican Republic,Wallis and Futuna Islands,11,5,6
2010,152,Chile,Wallis and Futuna Islands,2,2,0
2010,540,New Caledonia,Wallis and Futuna Islands,7413,3614,3799
2010,258,French Polynesia,Wallis and Futuna Islands,35,11,24
2010,300,Greece,Wallis and Futuna Islands,1,1,0
2015,214,Dominican Republic,Wallis and Futuna Islands,11,5,6
2015,152,Chile,Wallis and Futuna Islands,3,3,0
2015,540,New Caledonia,Wallis and Futuna Islands,11177,5347,5830
2015,258,French Polynesia,Wallis and Futuna Islands,33,11,22
2015,100,Bulgaria,Wallis and Futuna Islands,1,0,1
2019,214,Dominican Republic,Wallis and Futuna Islands,11,5,6
2019,152,Chile,Wallis and Futuna Islands,4,4,0
2019,540,New Caledonia,Wallis and Futuna Islands,11770,5610,6160
2019,258,French Polynesia,Wallis and Futuna Islands,34,12,22
2019,100,Bulgaria,Wallis and Futuna Islands,1,0,1
1990,12,Algeria,Western Sahara,167905,92390,75515
1990,152,Chile,Western Sahara,1,0,1
1990,203,Czechia,Western Sahara,4,2,2
1990,643,Russian Federation,Western Sahara,111,54,57
1990,300,Greece,Western Sahara,203,203,0
1990,250,France,Western Sahara,15,6,9
1995,12,Algeria,Western Sahara,166903,91693,75210
1995,152,Chile,Western Sahara,2,1,1
1995,203,Czechia,Western Sahara,6,3,3
1995,643,Russian Federation,Western Sahara,117,57,60
1995,372,Ireland,Western Sahara,1,1,0
1995,300,Greece,Western Sahara,103,102,1
1995,250,France,Western Sahara,16,6,10
2000,12,Algeria,Western Sahara,165911,90999,74912
2000,152,Chile,Western Sahara,4,1,3
2000,203,Czechia,Western Sahara,8,5,3
2000,643,Russian Federation,Western Sahara,119,58,61
2000,372,Ireland,Western Sahara,2,2,0
2000,300,Greece,Western Sahara,4,2,2
2000,250,France,Western Sahara,16,6,10
2005,12,Algeria,Western Sahara,130960,71830,59130
2005,152,Chile,Western Sahara,6,2,4
2005,203,Czechia,Western Sahara,4,2,2
2005,643,Russian Federation,Western Sahara,75,33,42
2005,372,Ireland,Western Sahara,2,2,0
2005,578,Norway,Western Sahara,5,5,0
2005,300,Greece,Western Sahara,2,1,1
2005,250,France,Western Sahara,37,20,17
2010,12,Algeria,Western Sahara,143923,76118,67805
2010,152,Chile,Western Sahara,8,3,5
2010,203,Czechia,Western Sahara,6,3,3
2010,643,Russian Federation,Western Sahara,30,6,24
2010,372,Ireland,Western Sahara,1,1,0
2010,578,Norway,Western Sahara,11,11,0
2010,705,Slovenia,Western Sahara,1,1,0
2010,250,France,Western Sahara,16,6,10
2015,478,Mauritania,Western Sahara,28007,14724,13283
2015,12,Algeria,Western Sahara,158854,83944,74910
2015,152,Chile,Western Sahara,12,5,7
2015,203,Czechia,Western Sahara,9,5,4
2015,643,Russian Federation,Western Sahara,31,7,24
2015,372,Ireland,Western Sahara,1,1,0
2015,578,Norway,Western Sahara,42,37,5
2015,300,Greece,Western Sahara,3,2,1
2015,705,Slovenia,Western Sahara,3,2,1
2015,250,France,Western Sahara,1091,532,559
2019,478,Mauritania,Western Sahara,29089,15305,13784
2019,12,Algeria,Western Sahara,165223,87310,77913
2019,152,Chile,Western Sahara,16,7,9
2019,203,Czechia,Western Sahara,13,7,6
2019,643,Russian Federation,Western Sahara,30,7,23
2019,372,Ireland,Western Sahara,1,1,0
2019,578,Norway,Western Sahara,37,33,4
2019,300,Greece,Western Sahara,7,4,3
2019,705,Slovenia,Western Sahara,2,1,1
2019,250,France,Western Sahara,1154,561,593
1990,262,Djibouti,Yemen,289,139,150
1990,231,Ethiopia,Yemen,68,36,32
1990,710,South Africa,Yemen,83,14,69
1990,12,Algeria,Yemen,2593,1522,1071
1990,818,Egypt,Yemen,3839,2197,1642
1990,434,Libya,Yemen,10956,6290,4666
1990,48,Bahrain,Yemen,5876,4201,1675
1990,196,Cyprus,Yemen,4,2,2
1990,368,Iraq,Yemen,1543,1214,329
1990,376,Israel,Yemen,36222,17242,18980
1990,400,Jordan,Yemen,2439,1715,724
1990,414,Kuwait,Yemen,36441,22064,14377
1990,422,Lebanon,Yemen,1114,783,331
1990,634,Qatar,Yemen,10506,7663,2843
1990,682,Saudi Arabia,Yemen,286032,185475,100557
1990,275,State of Palestine,Yemen,1486,764,722
1990,792,Turkey,Yemen,16,10,6
1990,784,United Arab Emirates,Yemen,44514,31692,12822
1990,558,Nicaragua,Yemen,13,5,8
1990,68,Bolivia (Plurinational State of),Yemen,1,1,0
1990,36,Australia,Yemen,221,138,83
1990,112,Belarus,Yemen,14,12,2
1990,100,Bulgaria,Yemen,28,22,6
1990,203,Czechia,Yemen,27,23,4
1990,348,Hungary,Yemen,241,172,69
1990,616,Poland,Yemen,132,122,10
1990,643,Russian Federation,Yemen,986,484,502
1990,703,Slovakia,Yemen,6,5,1
1990,208,Denmark,Yemen,73,41,32
1990,246,Finland,Yemen,4,2,2
1990,372,Ireland,Yemen,6,3,3
1990,428,Latvia,Yemen,1,1,0
1990,578,Norway,Yemen,13,9,4
1990,752,Sweden,Yemen,135,77,58
1990,826,United Kingdom,Yemen,1745,1185,560
1990,300,Greece,Yemen,69,69,0
1990,380,Italy,Yemen,40,14,26
1990,724,Spain,Yemen,21,17,4
1990,40,Austria,Yemen,52,31,21
1990,56,Belgium,Yemen,110,74,36
1990,250,France,Yemen,911,430,481
1990,276,Germany,Yemen,991,806,185
1990,528,Netherlands,Yemen,66,48,18
1990,756,Switzerland,Yemen,171,101,70
1990,124,Canada,Yemen,461,224,237
1990,840,United States of America,Yemen,4933,3174,1759
1995,262,Djibouti,Yemen,236,114,122
1995,231,Ethiopia,Yemen,89,53,36
1995,710,South Africa,Yemen,51,14,37
1995,12,Algeria,Yemen,2480,1464,1016
1995,818,Egypt,Yemen,3850,2217,1633
1995,434,Libya,Yemen,13236,8433,4803
1995,48,Bahrain,Yemen,6464,4548,1916
1995,196,Cyprus,Yemen,6,3,3
1995,368,Iraq,Yemen,1819,1334,485
1995,376,Israel,Yemen,37172,17299,19873
1995,400,Jordan,Yemen,2664,1819,845
1995,414,Kuwait,Yemen,29202,18605,10597
1995,422,Lebanon,Yemen,1213,807,406
1995,634,Qatar,Yemen,11418,8512,2906
1995,682,Saudi Arabia,Yemen,293143,190625,102518
1995,275,State of Palestine,Yemen,1452,743,709
1995,792,Turkey,Yemen,39,24,15
1995,784,United Arab Emirates,Yemen,57044,40859,16185
1995,558,Nicaragua,Yemen,11,4,7
1995,68,Bolivia (Plurinational State of),Yemen,1,1,0
1995,36,Australia,Yemen,314,189,125
1995,112,Belarus,Yemen,24,20,4
1995,100,Bulgaria,Yemen,30,23,7
1995,203,Czechia,Yemen,41,35,6
1995,348,Hungary,Yemen,214,152,62
1995,616,Poland,Yemen,112,104,8
1995,643,Russian Federation,Yemen,794,506,288
1995,703,Slovakia,Yemen,12,11,1
1995,208,Denmark,Yemen,107,56,51
1995,246,Finland,Yemen,12,7,5
1995,372,Ireland,Yemen,16,9,7
1995,428,Latvia,Yemen,1,1,0
1995,578,Norway,Yemen,22,10,12
1995,752,Sweden,Yemen,161,92,69
1995,826,United Kingdom,Yemen,6857,4051,2806
1995,300,Greece,Yemen,47,43,4
1995,380,Italy,Yemen,134,61,73
1995,724,Spain,Yemen,4,3,1
1995,40,Austria,Yemen,59,35,24
1995,56,Belgium,Yemen,110,74,36
1995,250,France,Yemen,941,436,505
1995,276,Germany,Yemen,1342,980,362
1995,528,Netherlands,Yemen,97,70,27
1995,756,Switzerland,Yemen,229,135,94
1995,124,Canada,Yemen,747,362,385
1995,840,United States of America,Yemen,12232,7927,4305
2000,262,Djibouti,Yemen,238,115,123
2000,231,Ethiopia,Yemen,127,80,47
2000,710,South Africa,Yemen,35,19,16
2000,12,Algeria,Yemen,2366,1405,961
2000,818,Egypt,Yemen,4167,2414,1753
2000,434,Libya,Yemen,15734,10827,4907
2000,48,Bahrain,Yemen,7072,4884,2188
2000,196,Cyprus,Yemen,7,3,4
2000,368,Iraq,Yemen,1724,1151,573
2000,376,Israel,Yemen,36041,16602,19439
2000,400,Jordan,Yemen,2889,1927,962
2000,414,Kuwait,Yemen,33307,22493,10814
2000,422,Lebanon,Yemen,1311,831,480
2000,634,Qatar,Yemen,10626,8102,2524
2000,682,Saudi Arabia,Yemen,301194,196308,104886
2000,275,State of Palestine,Yemen,1419,723,696
2000,792,Turkey,Yemen,64,38,26
2000,784,United Arab Emirates,Yemen,72861,52169,20692
2000,558,Nicaragua,Yemen,18,6,12
2000,36,Australia,Yemen,390,229,161
2000,112,Belarus,Yemen,33,27,6
2000,100,Bulgaria,Yemen,32,25,7
2000,203,Czechia,Yemen,55,47,8
2000,348,Hungary,Yemen,186,131,55
2000,616,Poland,Yemen,96,89,7
2000,643,Russian Federation,Yemen,574,510,64
2000,703,Slovakia,Yemen,22,19,3
2000,208,Denmark,Yemen,141,71,70
2000,246,Finland,Yemen,19,12,7
2000,372,Ireland,Yemen,36,21,15
2000,428,Latvia,Yemen,1,1,0
2000,578,Norway,Yemen,35,18,17
2000,752,Sweden,Yemen,173,98,75
2000,826,United Kingdom,Yemen,12085,6977,5108
2000,300,Greece,Yemen,25,17,8
2000,380,Italy,Yemen,227,108,119
2000,705,Slovenia,Yemen,6,5,1
2000,724,Spain,Yemen,56,44,12
2000,40,Austria,Yemen,65,39,26
2000,56,Belgium,Yemen,107,71,36
2000,250,France,Yemen,970,441,529
2000,276,Germany,Yemen,1693,1155,538
2000,528,Netherlands,Yemen,133,94,39
2000,756,Switzerland,Yemen,289,170,119
2000,124,Canada,Yemen,1050,507,543
2000,840,United States of America,Yemen,19697,12797,6900
2005,262,Djibouti,Yemen,218,113,105
2005,231,Ethiopia,Yemen,107,62,45
2005,710,South Africa,Yemen,45,23,22
2005,12,Algeria,Yemen,1867,1109,758
2005,818,Egypt,Yemen,4961,3003,1958
2005,434,Libya,Yemen,17335,12891,4444
2005,48,Bahrain,Yemen,10111,6869,3242
2005,196,Cyprus,Yemen,10,4,6
2005,368,Iraq,Yemen,1976,1504,472
2005,376,Israel,Yemen,32787,14885,17902
2005,400,Jordan,Yemen,4173,2953,1220
2005,414,Kuwait,Yemen,35975,23725,12250
2005,422,Lebanon,Yemen,1026,665,361
2005,634,Qatar,Yemen,15725,11680,4045
2005,682,Saudi Arabia,Yemen,372063,249969,122094
2005,275,State of Palestine,Yemen,1450,741,709
2005,792,Turkey,Yemen,66,39,27
2005,784,United Arab Emirates,Yemen,82490,57067,25423
2005,558,Nicaragua,Yemen,27,8,19
2005,36,Australia,Yemen,520,295,225
2005,112,Belarus,Yemen,32,26,6
2005,100,Bulgaria,Yemen,39,31,8
2005,203,Czechia,Yemen,122,90,32
2005,348,Hungary,Yemen,230,163,67
2005,616,Poland,Yemen,105,79,26
2005,643,Russian Federation,Yemen,611,546,65
2005,703,Slovakia,Yemen,25,21,4
2005,208,Denmark,Yemen,148,74,74
2005,246,Finland,Yemen,28,16,12
2005,352,Iceland,Yemen,1,0,1
2005,372,Ireland,Yemen,36,22,14
2005,578,Norway,Yemen,68,35,33
2005,752,Sweden,Yemen,242,140,102
2005,826,United Kingdom,Yemen,14104,7797,6307
2005,300,Greece,Yemen,27,17,10
2005,380,Italy,Yemen,245,124,121
2005,705,Slovenia,Yemen,5,5,0
2005,724,Spain,Yemen,27,21,6
2005,40,Austria,Yemen,73,43,30
2005,56,Belgium,Yemen,101,66,35
2005,250,France,Yemen,342,177,165
2005,276,Germany,Yemen,2049,1453,596
2005,528,Netherlands,Yemen,403,257,146
2005,756,Switzerland,Yemen,338,195,143
2005,124,Canada,Yemen,1450,721,729
2005,840,United States of America,Yemen,27207,13628,13579
2010,262,Djibouti,Yemen,240,116,124
2010,231,Ethiopia,Yemen,118,62,56
2010,710,South Africa,Yemen,76,42,34
2010,12,Algeria,Yemen,2051,1182,869
2010,818,Egypt,Yemen,5354,3160,2194
2010,434,Libya,Yemen,18963,14153,4810
2010,48,Bahrain,Yemen,15381,10378,5003
2010,196,Cyprus,Yemen,16,7,9
2010,368,Iraq,Yemen,1996,1548,448
2010,376,Israel,Yemen,29931,13313,16618
2010,400,Jordan,Yemen,5367,3887,1480
2010,414,Kuwait,Yemen,47616,31025,16591
2010,422,Lebanon,Yemen,741,500,241
2010,634,Qatar,Yemen,33584,26918,6666
2010,682,Saudi Arabia,Yemen,482400,332386,150014
2010,275,State of Palestine,Yemen,1482,759,723
2010,792,Turkey,Yemen,68,40,28
2010,784,United Arab Emirates,Yemen,172602,120868,51734
2010,558,Nicaragua,Yemen,28,8,20
2010,36,Australia,Yemen,590,317,273
2010,112,Belarus,Yemen,30,24,6
2010,100,Bulgaria,Yemen,45,36,9
2010,203,Czechia,Yemen,183,135,48
2010,348,Hungary,Yemen,274,195,79
2010,616,Poland,Yemen,118,71,47
2010,643,Russian Federation,Yemen,636,571,65
2010,703,Slovakia,Yemen,28,24,4
2010,208,Denmark,Yemen,151,76,75
2010,233,Estonia,Yemen,1,1,0
2010,246,Finland,Yemen,40,18,22
2010,372,Ireland,Yemen,30,17,13
2010,578,Norway,Yemen,170,93,77
2010,752,Sweden,Yemen,605,348,257
2010,826,United Kingdom,Yemen,14857,8350,6507
2010,300,Greece,Yemen,29,17,12
2010,380,Italy,Yemen,298,161,137
2010,705,Slovenia,Yemen,7,7,0
2010,724,Spain,Yemen,96,74,22
2010,40,Austria,Yemen,81,48,33
2010,56,Belgium,Yemen,98,66,32
2010,250,France,Yemen,457,202,255
2010,276,Germany,Yemen,2340,1697,643
2010,528,Netherlands,Yemen,377,233,144
2010,756,Switzerland,Yemen,382,207,175
2010,124,Canada,Yemen,1700,861,839
2010,840,United States of America,Yemen,35748,17661,18087
2015,262,Djibouti,Yemen,265,128,137
2015,231,Ethiopia,Yemen,145,74,71
2015,706,Somalia,Yemen,5883,2991,2892
2015,710,South Africa,Yemen,136,73,63
2015,12,Algeria,Yemen,2263,1303,960
2015,818,Egypt,Yemen,3969,2553,1416
2015,434,Libya,Yemen,21380,15883,5497
2015,48,Bahrain,Yemen,15003,10050,4953
2015,196,Cyprus,Yemen,15,7,8
2015,368,Iraq,Yemen,2001,1621,380
2015,376,Israel,Yemen,30869,13647,17222
2015,400,Jordan,Yemen,28645,17187,11458
2015,414,Kuwait,Yemen,65129,39310,25819
2015,422,Lebanon,Yemen,624,299,325
2015,634,Qatar,Yemen,34877,28410,6467
2015,682,Saudi Arabia,Yemen,616386,415997,200389
2015,275,State of Palestine,Yemen,1467,750,717
2015,792,Turkey,Yemen,100,57,43
2015,784,United Arab Emirates,Yemen,188606,129846,58760
2015,558,Nicaragua,Yemen,30,9,21
2015,36,Australia,Yemen,710,404,306
2015,112,Belarus,Yemen,33,27,6
2015,100,Bulgaria,Yemen,52,40,12
2015,203,Czechia,Yemen,274,202,72
2015,348,Hungary,Yemen,289,198,91
2015,616,Poland,Yemen,113,69,44
2015,643,Russian Federation,Yemen,648,581,67
2015,703,Slovakia,Yemen,34,28,6
2015,208,Denmark,Yemen,173,82,91
2015,233,Estonia,Yemen,5,3,2
2015,246,Finland,Yemen,80,48,32
2015,372,Ireland,Yemen,31,18,13
2015,428,Latvia,Yemen,1,1,0
2015,578,Norway,Yemen,355,189,166
2015,752,Sweden,Yemen,1499,876,623
2015,826,United Kingdom,Yemen,18999,10431,8568
2015,300,Greece,Yemen,32,16,16
2015,380,Italy,Yemen,267,147,120
2015,705,Slovenia,Yemen,13,9,4
2015,724,Spain,Yemen,139,101,38
2015,40,Austria,Yemen,95,57,38
2015,56,Belgium,Yemen,201,134,67
2015,250,France,Yemen,506,216,290
2015,276,Germany,Yemen,2438,1767,671
2015,528,Netherlands,Yemen,486,291,195
2015,756,Switzerland,Yemen,594,327,267
2015,124,Canada,Yemen,2941,1465,1476
2015,840,United States of America,Yemen,45642,22424,23218
2019,262,Djibouti,Yemen,272,132,140
2019,231,Ethiopia,Yemen,156,80,76
2019,706,Somalia,Yemen,7051,3542,3509
2019,710,South Africa,Yemen,151,82,69
2019,12,Algeria,Yemen,2353,1355,998
2019,818,Egypt,Yemen,5657,3401,2256
2019,434,Libya,Yemen,6297,3752,2545
2019,48,Bahrain,Yemen,15791,10578,5213
2019,196,Cyprus,Yemen,14,7,7
2019,368,Iraq,Yemen,2049,1660,389
2019,376,Israel,Yemen,30019,13272,16747
2019,400,Jordan,Yemen,30805,18483,12322
2019,414,Kuwait,Yemen,68962,41624,27338
2019,422,Lebanon,Yemen,589,283,306
2019,634,Qatar,Yemen,35574,28507,7067
2019,682,Saudi Arabia,Yemen,750919,501414,249505
2019,275,State of Palestine,Yemen,1456,744,712
2019,792,Turkey,Yemen,135,78,57
2019,784,United Arab Emirates,Yemen,202574,139452,63122
2019,558,Nicaragua,Yemen,31,10,21
2019,36,Australia,Yemen,888,505,383
2019,112,Belarus,Yemen,32,27,5
2019,100,Bulgaria,Yemen,80,59,21
2019,203,Czechia,Yemen,411,303,108
2019,348,Hungary,Yemen,326,215,111
2019,616,Poland,Yemen,119,75,44
2019,643,Russian Federation,Yemen,647,581,66
2019,703,Slovakia,Yemen,42,35,7
2019,208,Denmark,Yemen,178,81,97
2019,233,Estonia,Yemen,8,5,3
2019,246,Finland,Yemen,166,104,62
2019,352,Iceland,Yemen,1,1,0
2019,372,Ireland,Yemen,34,20,14
2019,578,Norway,Yemen,527,292,235
2019,752,Sweden,Yemen,3194,1909,1285
2019,826,United Kingdom,Yemen,21575,11870,9705
2019,300,Greece,Yemen,267,131,136
2019,380,Italy,Yemen,327,177,150
2019,705,Slovenia,Yemen,14,9,5
2019,724,Spain,Yemen,144,104,40
2019,40,Austria,Yemen,112,68,44
2019,56,Belgium,Yemen,302,195,107
2019,250,France,Yemen,535,228,307
2019,276,Germany,Yemen,4100,2899,1201
2019,528,Netherlands,Yemen,719,417,302
2019,756,Switzerland,Yemen,668,377,291
2019,124,Canada,Yemen,3151,1570,1581
2019,840,United States of America,Yemen,49289,23955,25334
1990,232,Eritrea,Zambia,91,57,34
1990,454,Malawi,Zambia,5637,1076,4561
1990,508,Mozambique,Zambia,1948,1034,914
1990,800,Uganda,Zambia,194,88,106
1990,834,United Republic of Tanzania,Zambia,18188,8349,9839
1990,716,Zimbabwe,Zambia,18966,11251,7715
1990,24,Angola,Zambia,119,50,69
1990,72,Botswana,Zambia,1991,1099,892
1990,426,Lesotho,Zambia,77,40,37
1990,516,Namibia,Zambia,4473,2889,1584
1990,710,South Africa,Zambia,6346,3219,3127
1990,818,Egypt,Zambia,26,18,8
1990,196,Cyprus,Zambia,34,13,21
1990,762,Tajikistan,Zambia,38,18,20
1990,356,India,Zambia,1008,430,578
1990,136,Cayman Islands,Zambia,2,2,0
1990,32,Argentina,Zambia,1,1,0
1990,152,Chile,Zambia,2,1,1
1990,36,Australia,Zambia,2312,1175,1137
1990,554,New Zealand,Zambia,222,107,115
1990,100,Bulgaria,Zambia,3,2,1
1990,203,Czechia,Zambia,5,4,1
1990,348,Hungary,Zambia,2,0,2
1990,616,Poland,Zambia,53,35,18
1990,643,Russian Federation,Zambia,354,174,180
1990,208,Denmark,Zambia,175,76,99
1990,246,Finland,Zambia,45,24,21
1990,352,Iceland,Zambia,2,0,2
1990,372,Ireland,Zambia,65,31,34
1990,578,Norway,Zambia,115,66,49
1990,752,Sweden,Zambia,192,93,99
1990,826,United Kingdom,Zambia,16558,8233,8325
1990,300,Greece,Zambia,189,144,45
1990,380,Italy,Zambia,20,7,13
1990,688,Serbia,Zambia,6,3,3
1990,724,Spain,Zambia,13,6,7
1990,40,Austria,Zambia,63,26,37
1990,56,Belgium,Zambia,221,107,114
1990,250,France,Zambia,275,129,146
1990,276,Germany,Zambia,303,216,87
1990,528,Netherlands,Zambia,411,213,198
1990,756,Switzerland,Zambia,165,83,82
1990,124,Canada,Zambia,1339,652,687
1990,840,United States of America,Zambia,2954,1358,1596
1995,232,Eritrea,Zambia,121,76,45
1995,454,Malawi,Zambia,47571,19569,28002
1995,508,Mozambique,Zambia,2680,1428,1252
1995,800,Uganda,Zambia,183,80,103
1995,834,United Republic of Tanzania,Zambia,14501,6664,7837
1995,716,Zimbabwe,Zambia,22815,13016,9799
1995,24,Angola,Zambia,139,55,84
1995,72,Botswana,Zambia,3213,1755,1458
1995,426,Lesotho,Zambia,72,37,35
1995,516,Namibia,Zambia,4277,2772,1505
1995,710,South Africa,Zambia,12880,6563,6317
1995,818,Egypt,Zambia,22,15,7
1995,196,Cyprus,Zambia,48,17,31
1995,762,Tajikistan,Zambia,31,15,16
1995,356,India,Zambia,920,418,502
1995,136,Cayman Islands,Zambia,6,5,1
1995,32,Argentina,Zambia,1,1,0
1995,68,Bolivia (Plurinational State of),Zambia,2,1,1
1995,152,Chile,Zambia,3,2,1
1995,36,Australia,Zambia,2979,1493,1486
1995,554,New Zealand,Zambia,269,130,139
1995,100,Bulgaria,Zambia,5,3,2
1995,203,Czechia,Zambia,7,6,1
1995,348,Hungary,Zambia,7,2,5
1995,616,Poland,Zambia,44,29,15
1995,643,Russian Federation,Zambia,305,182,123
1995,208,Denmark,Zambia,259,107,152
1995,246,Finland,Zambia,52,25,27
1995,352,Iceland,Zambia,3,0,3
1995,372,Ireland,Zambia,181,83,98
1995,578,Norway,Zambia,140,81,59
1995,752,Sweden,Zambia,228,109,119
1995,826,United Kingdom,Zambia,18532,8930,9602
1995,300,Greece,Zambia,213,135,78
1995,380,Italy,Zambia,90,38,52
1995,688,Serbia,Zambia,44,21,23
1995,724,Spain,Zambia,21,10,11
1995,40,Austria,Zambia,71,30,41
1995,56,Belgium,Zambia,221,107,114
1995,250,France,Zambia,284,130,154
1995,276,Germany,Zambia,342,216,126
1995,528,Netherlands,Zambia,605,307,298
1995,756,Switzerland,Zambia,216,111,105
1995,124,Canada,Zambia,1766,855,911
1995,840,United States of America,Zambia,4529,2109,2420
2000,232,Eritrea,Zambia,151,94,57
2000,454,Malawi,Zambia,45797,18764,27033
2000,508,Mozambique,Zambia,3118,1614,1504
2000,800,Uganda,Zambia,7,4,3
2000,834,United Republic of Tanzania,Zambia,13584,6228,7356
2000,716,Zimbabwe,Zambia,26337,15020,11317
2000,24,Angola,Zambia,158,60,98
2000,72,Botswana,Zambia,4773,2595,2178
2000,426,Lesotho,Zambia,66,34,32
2000,516,Namibia,Zambia,3971,2580,1391
2000,710,South Africa,Zambia,23416,11629,11787
2000,818,Egypt,Zambia,19,13,6
2000,196,Cyprus,Zambia,62,21,41
2000,762,Tajikistan,Zambia,27,14,13
2000,356,India,Zambia,831,405,426
2000,136,Cayman Islands,Zambia,11,8,3
2000,32,Argentina,Zambia,1,1,0
2000,68,Bolivia (Plurinational State of),Zambia,3,1,2
2000,152,Chile,Zambia,5,2,3
2000,36,Australia,Zambia,3450,1726,1724
2000,554,New Zealand,Zambia,921,448,473
2000,100,Bulgaria,Zambia,6,3,3
2000,203,Czechia,Zambia,9,8,1
2000,348,Hungary,Zambia,12,5,7
2000,616,Poland,Zambia,38,25,13
2000,643,Russian Federation,Zambia,245,183,62
2000,208,Denmark,Zambia,342,137,205
2000,246,Finland,Zambia,59,27,32
2000,352,Iceland,Zambia,4,1,3
2000,372,Ireland,Zambia,396,187,209
2000,578,Norway,Zambia,184,89,95
2000,752,Sweden,Zambia,245,116,129
2000,826,United Kingdom,Zambia,20818,9752,11066
2000,300,Greece,Zambia,240,126,114
2000,380,Italy,Zambia,159,69,90
2000,688,Serbia,Zambia,60,28,32
2000,705,Slovenia,Zambia,6,4,2
2000,724,Spain,Zambia,247,116,131
2000,40,Austria,Zambia,79,34,45
2000,56,Belgium,Zambia,213,104,109
2000,250,France,Zambia,293,132,161
2000,276,Germany,Zambia,381,217,164
2000,528,Netherlands,Zambia,820,409,411
2000,756,Switzerland,Zambia,269,139,130
2000,124,Canada,Zambia,2234,1078,1156
2000,840,United States of America,Zambia,6139,2881,3258
2005,232,Eritrea,Zambia,194,123,71
2005,454,Malawi,Zambia,43640,17803,25837
2005,508,Mozambique,Zambia,4217,1993,2224
2005,800,Uganda,Zambia,6,4,2
2005,834,United Republic of Tanzania,Zambia,11845,5515,6330
2005,716,Zimbabwe,Zambia,29759,17170,12589
2005,24,Angola,Zambia,205,75,130
2005,72,Botswana,Zambia,7203,3875,3328
2005,426,Lesotho,Zambia,67,35,32
2005,516,Namibia,Zambia,3139,2033,1106
2005,710,South Africa,Zambia,30816,14627,16189
2005,818,Egypt,Zambia,23,16,7
2005,196,Cyprus,Zambia,91,30,61
2005,762,Tajikistan,Zambia,25,12,13
2005,356,India,Zambia,768,373,395
2005,136,Cayman Islands,Zambia,10,7,3
2005,32,Argentina,Zambia,1,1,0
2005,68,Bolivia (Plurinational State of),Zambia,3,1,2
2005,152,Chile,Zambia,7,3,4
2005,36,Australia,Zambia,4540,2270,2270
2005,554,New Zealand,Zambia,1256,610,646
2005,100,Bulgaria,Zambia,9,4,5
2005,203,Czechia,Zambia,31,21,10
2005,348,Hungary,Zambia,15,5,10
2005,616,Poland,Zambia,40,31,9
2005,643,Russian Federation,Zambia,357,257,100
2005,208,Denmark,Zambia,441,169,272
2005,246,Finland,Zambia,107,47,60
2005,352,Iceland,Zambia,6,1,5
2005,372,Ireland,Zambia,397,200,197
2005,578,Norway,Zambia,254,117,137
2005,752,Sweden,Zambia,305,138,167
2005,826,United Kingdom,Zambia,23215,10614,12601
2005,191,Croatia,Zambia,23,13,10
2005,300,Greece,Zambia,242,116,126
2005,380,Italy,Zambia,517,241,276
2005,688,Serbia,Zambia,60,28,32
2005,705,Slovenia,Zambia,5,4,1
2005,724,Spain,Zambia,119,55,64
2005,40,Austria,Zambia,88,37,51
2005,56,Belgium,Zambia,289,145,144
2005,250,France,Zambia,372,182,190
2005,276,Germany,Zambia,581,279,302
2005,528,Netherlands,Zambia,958,455,503
2005,756,Switzerland,Zambia,287,141,146
2005,124,Canada,Zambia,2813,1378,1435
2005,840,United States of America,Zambia,11649,5501,6148
2010,232,Eritrea,Zambia,237,152,85
2010,454,Malawi,Zambia,42865,17447,25418
2010,508,Mozambique,Zambia,4884,2308,2576
2010,800,Uganda,Zambia,6,4,2
2010,834,United Republic of Tanzania,Zambia,10265,4712,5553
2010,716,Zimbabwe,Zambia,30373,17226,13147
2010,24,Angola,Zambia,251,89,162
2010,72,Botswana,Zambia,3790,2110,1680
2010,426,Lesotho,Zambia,68,36,32
2010,516,Namibia,Zambia,3024,1961,1063
2010,710,South Africa,Zambia,48274,22819,25455
2010,466,Mali,Zambia,475,195,280
2010,818,Egypt,Zambia,25,17,8
2010,196,Cyprus,Zambia,149,51,98
2010,762,Tajikistan,Zambia,24,12,12
2010,356,India,Zambia,705,342,363
2010,136,Cayman Islands,Zambia,10,6,4
2010,32,Argentina,Zambia,1,1,0
2010,68,Bolivia (Plurinational State of),Zambia,2,1,1
2010,152,Chile,Zambia,10,5,5
2010,36,Australia,Zambia,6170,3119,3051
2010,554,New Zealand,Zambia,1374,667,707
2010,100,Bulgaria,Zambia,11,5,6
2010,203,Czechia,Zambia,3341,2274,1067
2010,348,Hungary,Zambia,18,6,12
2010,616,Poland,Zambia,44,38,6
2010,643,Russian Federation,Zambia,463,326,137
2010,208,Denmark,Zambia,530,199,331
2010,233,Estonia,Zambia,1,1,0
2010,246,Finland,Zambia,179,72,107
2010,352,Iceland,Zambia,7,1,6
2010,372,Ireland,Zambia,333,155,178
2010,578,Norway,Zambia,468,216,252
2010,752,Sweden,Zambia,405,165,240
2010,826,United Kingdom,Zambia,24456,11454,13002
2010,191,Croatia,Zambia,46,27,19
2010,300,Greece,Zambia,253,110,143
2010,380,Italy,Zambia,874,412,462
2010,688,Serbia,Zambia,59,27,32
2010,705,Slovenia,Zambia,6,5,1
2010,724,Spain,Zambia,149,69,80
2010,40,Austria,Zambia,97,40,57
2010,56,Belgium,Zambia,325,141,184
2010,250,France,Zambia,325,142,183
2010,276,Germany,Zambia,747,334,413
2010,528,Netherlands,Zambia,950,453,497
2010,756,Switzerland,Zambia,356,164,192
2010,124,Canada,Zambia,3220,1595,1625
2010,840,United States of America,Zambia,17662,7269,10393
2015,232,Eritrea,Zambia,241,156,85
2015,454,Malawi,Zambia,42362,17218,25144
2015,508,Mozambique,Zambia,5128,2424,2704
2015,800,Uganda,Zambia,6,4,2
2015,834,United Republic of Tanzania,Zambia,8573,4261,4312
2015,716,Zimbabwe,Zambia,30538,17105,13433
2015,24,Angola,Zambia,297,103,194
2015,72,Botswana,Zambia,4136,2301,1835
2015,426,Lesotho,Zambia,69,37,32
2015,516,Namibia,Zambia,2959,1922,1037
2015,710,South Africa,Zambia,87077,38822,48255
2015,466,Mali,Zambia,588,242,346
2015,694,Sierra Leone,Zambia,18,12,6
2015,818,Egypt,Zambia,18,13,5
2015,196,Cyprus,Zambia,143,50,93
2015,762,Tajikistan,Zambia,23,12,11
2015,356,India,Zambia,679,330,349
2015,136,Cayman Islands,Zambia,9,6,3
2015,32,Argentina,Zambia,1,1,0
2015,68,Bolivia (Plurinational State of),Zambia,2,1,1
2015,152,Chile,Zambia,15,8,7
2015,36,Australia,Zambia,7310,3642,3668
2015,554,New Zealand,Zambia,1471,712,759
2015,100,Bulgaria,Zambia,11,6,5
2015,203,Czechia,Zambia,3161,2090,1071
2015,348,Hungary,Zambia,17,9,8
2015,616,Poland,Zambia,42,37,5
2015,643,Russian Federation,Zambia,471,330,141
2015,208,Denmark,Zambia,632,238,394
2015,233,Estonia,Zambia,2,2,0
2015,246,Finland,Zambia,237,98,139
2015,352,Iceland,Zambia,8,1,7
2015,372,Ireland,Zambia,340,156,184
2015,578,Norway,Zambia,543,247,296
2015,752,Sweden,Zambia,524,219,305
2015,826,United Kingdom,Zambia,31275,14155,17120
2015,191,Croatia,Zambia,46,27,19
2015,300,Greece,Zambia,237,98,139
2015,380,Italy,Zambia,874,404,470
2015,688,Serbia,Zambia,57,26,31
2015,705,Slovenia,Zambia,5,4,1
2015,724,Spain,Zambia,148,69,79
2015,40,Austria,Zambia,113,46,67
2015,56,Belgium,Zambia,338,136,202
2015,250,France,Zambia,358,151,207
2015,276,Germany,Zambia,848,352,496
2015,528,Netherlands,Zambia,994,461,533
2015,756,Switzerland,Zambia,357,158,199
2015,124,Canada,Zambia,3692,1798,1894
2015,840,United States of America,Zambia,24856,10155,14701
2019,232,Eritrea,Zambia,243,158,85
2019,454,Malawi,Zambia,42971,17465,25506
2019,508,Mozambique,Zambia,5333,2521,2812
2019,800,Uganda,Zambia,6,4,2
2019,834,United Republic of Tanzania,Zambia,7688,3800,3888
2019,716,Zimbabwe,Zambia,31359,17713,13646
2019,24,Angola,Zambia,314,120,194
2019,72,Botswana,Zambia,4429,2464,1965
2019,426,Lesotho,Zambia,72,39,33
2019,516,Namibia,Zambia,3132,2035,1097
2019,710,South Africa,Zambia,97672,43587,54085
2019,466,Mali,Zambia,654,269,385
2019,694,Sierra Leone,Zambia,18,12,6
2019,818,Egypt,Zambia,25,18,7
2019,196,Cyprus,Zambia,142,50,92
2019,762,Tajikistan,Zambia,22,12,10
2019,356,India,Zambia,667,325,342
2019,136,Cayman Islands,Zambia,10,7,3
2019,32,Argentina,Zambia,1,1,0
2019,68,Bolivia (Plurinational State of),Zambia,2,1,1
2019,152,Chile,Zambia,20,11,9
2019,36,Australia,Zambia,8009,3956,4053
2019,554,New Zealand,Zambia,1512,732,780
2019,100,Bulgaria,Zambia,14,8,6
2019,203,Czechia,Zambia,38824,22076,16748
2019,348,Hungary,Zambia,19,10,9
2019,616,Poland,Zambia,44,39,5
2019,643,Russian Federation,Zambia,470,330,140
2019,208,Denmark,Zambia,700,246,454
2019,233,Estonia,Zambia,1,1,0
2019,246,Finland,Zambia,409,189,220
2019,352,Iceland,Zambia,9,2,7
2019,372,Ireland,Zambia,373,172,201
2019,578,Norway,Zambia,576,266,310
2019,752,Sweden,Zambia,731,321,410
2019,826,United Kingdom,Zambia,35516,16124,19392
2019,191,Croatia,Zambia,42,25,17
2019,300,Greece,Zambia,231,101,130
2019,380,Italy,Zambia,902,426,476
2019,688,Serbia,Zambia,57,26,31
2019,705,Slovenia,Zambia,6,3,3
2019,724,Spain,Zambia,153,70,83
2019,40,Austria,Zambia,133,56,77
2019,56,Belgium,Zambia,367,150,217
2019,250,France,Zambia,378,159,219
2019,276,Germany,Zambia,930,392,538
2019,528,Netherlands,Zambia,1057,508,549
2019,756,Switzerland,Zambia,404,175,229
2019,124,Canada,Zambia,3956,1927,2029
2019,840,United States of America,Zambia,26841,10796,16045
1990,232,Eritrea,Zimbabwe,82,56,26
1990,454,Malawi,Zimbabwe,3851,1124,2727
1990,508,Mozambique,Zimbabwe,35711,18895,16816
1990,800,Uganda,Zimbabwe,84,46,38
1990,834,United Republic of Tanzania,Zimbabwe,488,292,196
1990,894,Zambia,Zimbabwe,34829,16834,17995
1990,72,Botswana,Zimbabwe,4905,2928,1977
1990,426,Lesotho,Zimbabwe,77,40,37
1990,516,Namibia,Zimbabwe,21364,10751,10613
1990,710,South Africa,Zimbabwe,61875,35063,26812
1990,818,Egypt,Zimbabwe,38,31,7
1990,196,Cyprus,Zimbabwe,76,33,43
1990,136,Cayman Islands,Zimbabwe,5,4,1
1990,662,Saint Lucia,Zimbabwe,1,1,0
1990,188,Costa Rica,Zimbabwe,2,0,2
1990,32,Argentina,Zimbabwe,3,0,3
1990,68,Bolivia (Plurinational State of),Zimbabwe,1,0,1
1990,152,Chile,Zimbabwe,2,2,0
1990,862,Venezuela (Bolivarian Republic of),Zimbabwe,14,8,6
1990,36,Australia,Zimbabwe,8265,4184,4081
1990,554,New Zealand,Zimbabwe,676,323,353
1990,100,Bulgaria,Zimbabwe,4,3,1
1990,203,Czechia,Zimbabwe,5,3,2
1990,348,Hungary,Zimbabwe,9,3,6
1990,616,Poland,Zimbabwe,35,20,15
1990,643,Russian Federation,Zimbabwe,265,130,135
1990,208,Denmark,Zimbabwe,149,79,70
1990,246,Finland,Zimbabwe,10,7,3
1990,352,Iceland,Zimbabwe,4,0,4
1990,372,Ireland,Zimbabwe,185,91,94
1990,428,Latvia,Zimbabwe,1,1,0
1990,578,Norway,Zimbabwe,70,39,31
1990,752,Sweden,Zimbabwe,199,98,101
1990,826,United Kingdom,Zimbabwe,20857,9909,10948
1990,300,Greece,Zimbabwe,61,37,24
1990,380,Italy,Zimbabwe,30,10,20
1990,470,Malta,Zimbabwe,15,9,6
1990,620,Portugal,Zimbabwe,395,177,218
1990,688,Serbia,Zimbabwe,3,2,1
1990,724,Spain,Zimbabwe,23,11,12
1990,40,Austria,Zimbabwe,165,82,83
1990,56,Belgium,Zimbabwe,174,78,96
1990,250,France,Zimbabwe,386,176,210
1990,528,Netherlands,Zimbabwe,1521,756,765
1990,756,Switzerland,Zimbabwe,462,192,270
1990,124,Canada,Zimbabwe,2221,1081,1140
1990,840,United States of America,Zimbabwe,4767,2148,2619
1995,232,Eritrea,Zimbabwe,125,88,37
1995,454,Malawi,Zimbabwe,41271,18156,23115
1995,508,Mozambique,Zimbabwe,49118,26094,23024
1995,800,Uganda,Zimbabwe,79,42,37
1995,834,United Republic of Tanzania,Zimbabwe,652,390,262
1995,894,Zambia,Zimbabwe,23707,11429,12278
1995,72,Botswana,Zimbabwe,7917,4390,3527
1995,426,Lesotho,Zimbabwe,72,37,35
1995,516,Namibia,Zimbabwe,20430,10346,10084
1995,710,South Africa,Zimbabwe,82744,47853,34891
1995,818,Egypt,Zimbabwe,30,24,6
1995,196,Cyprus,Zimbabwe,108,45,63
1995,136,Cayman Islands,Zimbabwe,11,8,3
1995,188,Costa Rica,Zimbabwe,1,0,1
1995,32,Argentina,Zimbabwe,3,0,3
1995,68,Bolivia (Plurinational State of),Zimbabwe,6,2,4
1995,152,Chile,Zimbabwe,6,4,2
1995,862,Venezuela (Bolivarian Republic of),Zimbabwe,13,7,6
1995,36,Australia,Zimbabwe,10498,5291,5207
1995,554,New Zealand,Zimbabwe,822,398,424
1995,100,Bulgaria,Zimbabwe,9,6,3
1995,203,Czechia,Zimbabwe,8,5,3
1995,348,Hungary,Zimbabwe,18,10,8
1995,616,Poland,Zimbabwe,30,18,12
1995,643,Russian Federation,Zimbabwe,258,136,122
1995,208,Denmark,Zimbabwe,209,103,106
1995,246,Finland,Zimbabwe,15,9,6
1995,352,Iceland,Zimbabwe,6,0,6
1995,372,Ireland,Zimbabwe,653,311,342
1995,428,Latvia,Zimbabwe,1,1,0
1995,578,Norway,Zimbabwe,90,48,42
1995,752,Sweden,Zimbabwe,236,115,121
1995,826,United Kingdom,Zimbabwe,34085,15823,18262
1995,300,Greece,Zimbabwe,253,119,134
1995,380,Italy,Zimbabwe,91,27,64
1995,470,Malta,Zimbabwe,18,10,8
1995,620,Portugal,Zimbabwe,852,380,472
1995,688,Serbia,Zimbabwe,21,9,12
1995,724,Spain,Zimbabwe,35,17,18
1995,40,Austria,Zimbabwe,186,93,93
1995,56,Belgium,Zimbabwe,174,78,96
1995,250,France,Zimbabwe,399,178,221
1995,528,Netherlands,Zimbabwe,1215,597,618
1995,756,Switzerland,Zimbabwe,598,285,313
1995,124,Canada,Zimbabwe,3099,1499,1600
1995,840,United States of America,Zimbabwe,7829,3577,4252
2000,232,Eritrea,Zimbabwe,168,119,49
2000,454,Malawi,Zimbabwe,39732,17417,22315
2000,508,Mozambique,Zimbabwe,57131,29480,27651
2000,800,Uganda,Zimbabwe,3,3,0
2000,834,United Republic of Tanzania,Zimbabwe,693,415,278
2000,894,Zambia,Zimbabwe,9056,4446,4610
2000,72,Botswana,Zimbabwe,11763,6314,5449
2000,426,Lesotho,Zimbabwe,66,34,32
2000,516,Namibia,Zimbabwe,18964,9649,9315
2000,710,South Africa,Zimbabwe,128983,73705,55278
2000,818,Egypt,Zimbabwe,25,20,5
2000,196,Cyprus,Zimbabwe,139,56,83
2000,136,Cayman Islands,Zimbabwe,19,13,6
2000,662,Saint Lucia,Zimbabwe,1,1,0
2000,188,Costa Rica,Zimbabwe,1,1,0
2000,32,Argentina,Zimbabwe,3,0,3
2000,68,Bolivia (Plurinational State of),Zimbabwe,10,4,6
2000,152,Chile,Zimbabwe,11,6,5
2000,862,Venezuela (Bolivarian Republic of),Zimbabwe,13,7,6
2000,36,Australia,Zimbabwe,12110,6121,5989
2000,554,New Zealand,Zimbabwe,2807,1365,1442
2000,100,Bulgaria,Zimbabwe,14,10,4
2000,203,Czechia,Zimbabwe,11,8,3
2000,348,Hungary,Zimbabwe,27,18,9
2000,616,Poland,Zimbabwe,26,15,11
2000,643,Russian Federation,Zimbabwe,243,137,106
2000,208,Denmark,Zimbabwe,268,127,141
2000,246,Finland,Zimbabwe,19,11,8
2000,352,Iceland,Zimbabwe,8,0,8
2000,372,Ireland,Zimbabwe,1480,730,750
2000,428,Latvia,Zimbabwe,2,2,0
2000,578,Norway,Zimbabwe,148,79,69
2000,752,Sweden,Zimbabwe,254,123,131
2000,826,United Kingdom,Zimbabwe,47888,21956,25932
2000,300,Greece,Zimbabwe,450,200,250
2000,380,Italy,Zimbabwe,151,43,108
2000,470,Malta,Zimbabwe,23,14,9
2000,620,Portugal,Zimbabwe,1344,600,744
2000,688,Serbia,Zimbabwe,29,12,17
2000,705,Slovenia,Zimbabwe,4,3,1
2000,724,Spain,Zimbabwe,424,222,202
2000,40,Austria,Zimbabwe,207,105,102
2000,56,Belgium,Zimbabwe,167,75,92
2000,250,France,Zimbabwe,411,180,231
2000,528,Netherlands,Zimbabwe,954,457,497
2000,756,Switzerland,Zimbabwe,738,380,358
2000,124,Canada,Zimbabwe,4051,1954,2097
2000,840,United States of America,Zimbabwe,10957,5044,5913
2005,232,Eritrea,Zimbabwe,243,171,72
2005,454,Malawi,Zimbabwe,37861,16533,21328
2005,508,Mozambique,Zimbabwe,77268,36395,40873
2005,800,Uganda,Zimbabwe,2,2,0
2005,834,United Republic of Tanzania,Zimbabwe,753,439,314
2005,894,Zambia,Zimbabwe,12444,6110,6334
2005,72,Botswana,Zimbabwe,33461,20439,13022
2005,426,Lesotho,Zimbabwe,67,35,32
2005,516,Namibia,Zimbabwe,14995,7585,7410
2005,710,South Africa,Zimbabwe,169894,96102,73792
2005,818,Egypt,Zimbabwe,30,24,6
2005,196,Cyprus,Zimbabwe,203,81,122
2005,44,Bahamas,Zimbabwe,7,3,4
2005,136,Cayman Islands,Zimbabwe,18,13,5
2005,188,Costa Rica,Zimbabwe,1,1,0
2005,32,Argentina,Zimbabwe,3,0,3
2005,68,Bolivia (Plurinational State of),Zimbabwe,7,3,4
2005,152,Chile,Zimbabwe,16,9,7
2005,862,Venezuela (Bolivarian Republic of),Zimbabwe,13,7,6
2005,36,Australia,Zimbabwe,21680,10948,10732
2005,554,New Zealand,Zimbabwe,7794,3783,4011
2005,100,Bulgaria,Zimbabwe,21,15,6
2005,203,Czechia,Zimbabwe,25,15,10
2005,348,Hungary,Zimbabwe,33,22,11
2005,616,Poland,Zimbabwe,65,31,34
2005,643,Russian Federation,Zimbabwe,158,90,68
2005,208,Denmark,Zimbabwe,310,145,165
2005,246,Finland,Zimbabwe,42,26,16
2005,352,Iceland,Zimbabwe,9,1,8
2005,372,Ireland,Zimbabwe,2459,1244,1215
2005,428,Latvia,Zimbabwe,3,3,0
2005,578,Norway,Zimbabwe,181,92,89
2005,752,Sweden,Zimbabwe,339,182,157
2005,826,United Kingdom,Zimbabwe,79861,35995,43866
2005,300,Greece,Zimbabwe,440,196,244
2005,380,Italy,Zimbabwe,516,227,289
2005,470,Malta,Zimbabwe,28,16,12
2005,620,Portugal,Zimbabwe,1283,823,460
2005,688,Serbia,Zimbabwe,29,12,17
2005,705,Slovenia,Zimbabwe,9,5,4
2005,724,Spain,Zimbabwe,204,105,99
2005,40,Austria,Zimbabwe,231,114,117
2005,56,Belgium,Zimbabwe,285,139,146
2005,250,France,Zimbabwe,475,224,251
2005,528,Netherlands,Zimbabwe,1140,569,571
2005,756,Switzerland,Zimbabwe,818,399,419
2005,124,Canada,Zimbabwe,6795,3333,3462
2005,840,United States of America,Zimbabwe,27363,12678,14685
2010,232,Eritrea,Zimbabwe,319,224,95
2010,454,Malawi,Zimbabwe,37189,16206,20983
2010,508,Mozambique,Zimbabwe,89469,42142,47327
2010,800,Uganda,Zimbabwe,2,2,0
2010,834,United Republic of Tanzania,Zimbabwe,809,486,323
2010,894,Zambia,Zimbabwe,17226,7838,9388
2010,72,Botswana,Zimbabwe,55160,31670,23490
2010,426,Lesotho,Zimbabwe,68,36,32
2010,516,Namibia,Zimbabwe,14449,7324,7125
2010,710,South Africa,Zimbabwe,266144,150070,116074
2010,818,Egypt,Zimbabwe,32,25,7
2010,196,Cyprus,Zimbabwe,332,135,197
2010,764,Thailand,Zimbabwe,1,1,0
2010,44,Bahamas,Zimbabwe,14,7,7
2010,136,Cayman Islands,Zimbabwe,18,12,6
2010,188,Costa Rica,Zimbabwe,1,1,0
2010,32,Argentina,Zimbabwe,2,0,2
2010,68,Bolivia (Plurinational State of),Zimbabwe,3,2,1
2010,76,Brazil,Zimbabwe,101,58,43
2010,152,Chile,Zimbabwe,22,13,9
2010,862,Venezuela (Bolivarian Republic of),Zimbabwe,15,8,7
2010,36,Australia,Zimbabwe,33710,16864,16846
2010,554,New Zealand,Zimbabwe,8170,3959,4211
2010,100,Bulgaria,Zimbabwe,28,20,8
2010,203,Czechia,Zimbabwe,1114,758,356
2010,348,Hungary,Zimbabwe,39,26,13
2010,616,Poland,Zimbabwe,107,48,59
2010,643,Russian Federation,Zimbabwe,71,41,30
2010,208,Denmark,Zimbabwe,345,161,184
2010,233,Estonia,Zimbabwe,6,6,0
2010,246,Finland,Zimbabwe,70,45,25
2010,352,Iceland,Zimbabwe,10,2,8
2010,372,Ireland,Zimbabwe,3033,1398,1635
2010,428,Latvia,Zimbabwe,4,4,0
2010,578,Norway,Zimbabwe,228,120,108
2010,752,Sweden,Zimbabwe,442,223,219
2010,826,United Kingdom,Zimbabwe,126091,57403,68688
2010,300,Greece,Zimbabwe,446,197,249
2010,380,Italy,Zimbabwe,881,411,470
2010,470,Malta,Zimbabwe,29,19,10
2010,620,Portugal,Zimbabwe,1010,911,99
2010,688,Serbia,Zimbabwe,29,12,17
2010,705,Slovenia,Zimbabwe,15,7,8
2010,724,Spain,Zimbabwe,306,151,155
2010,40,Austria,Zimbabwe,255,124,131
2010,56,Belgium,Zimbabwe,457,229,228
2010,250,France,Zimbabwe,658,281,377
2010,528,Netherlands,Zimbabwe,1392,679,713
2010,756,Switzerland,Zimbabwe,976,450,526
2010,124,Canada,Zimbabwe,9060,4483,4577
2010,840,United States of America,Zimbabwe,45037,20535,24502
2015,232,Eritrea,Zimbabwe,324,229,95
2015,454,Malawi,Zimbabwe,36753,15997,20756
2015,508,Mozambique,Zimbabwe,93942,44249,49693
2015,800,Uganda,Zimbabwe,2,2,0
2015,834,United Republic of Tanzania,Zimbabwe,852,344,508
2015,894,Zambia,Zimbabwe,13175,5874,7301
2015,72,Botswana,Zimbabwe,60205,34544,25661
2015,426,Lesotho,Zimbabwe,69,37,32
2015,516,Namibia,Zimbabwe,14141,7186,6955
2015,710,South Africa,Zimbabwe,336046,181966,154080
2015,324,Guinea,Zimbabwe,4,3,1
2015,818,Egypt,Zimbabwe,23,19,4
2015,196,Cyprus,Zimbabwe,318,130,188
2015,764,Thailand,Zimbabwe,1,1,0
2015,44,Bahamas,Zimbabwe,15,7,8
2015,136,Cayman Islands,Zimbabwe,18,13,5
2015,188,Costa Rica,Zimbabwe,1,1,0
2015,32,Argentina,Zimbabwe,2,0,2
2015,68,Bolivia (Plurinational State of),Zimbabwe,3,2,1
2015,76,Brazil,Zimbabwe,122,70,52
2015,152,Chile,Zimbabwe,33,20,13
2015,862,Venezuela (Bolivarian Republic of),Zimbabwe,15,8,7
2015,36,Australia,Zimbabwe,40170,20276,19894
2015,554,New Zealand,Zimbabwe,8416,4070,4346
2015,100,Bulgaria,Zimbabwe,30,20,10
2015,203,Czechia,Zimbabwe,1054,696,358
2015,348,Hungary,Zimbabwe,35,22,13
2015,616,Poland,Zimbabwe,103,48,55
2015,643,Russian Federation,Zimbabwe,73,43,30
2015,208,Denmark,Zimbabwe,443,208,235
2015,233,Estonia,Zimbabwe,4,2,2
2015,246,Finland,Zimbabwe,113,74,39
2015,352,Iceland,Zimbabwe,11,3,8
2015,372,Ireland,Zimbabwe,3098,1407,1691
2015,428,Latvia,Zimbabwe,3,3,0
2015,578,Norway,Zimbabwe,294,150,144
2015,752,Sweden,Zimbabwe,565,289,276
2015,826,United Kingdom,Zimbabwe,161251,70805,90446
2015,300,Greece,Zimbabwe,418,167,251
2015,380,Italy,Zimbabwe,881,403,478
2015,470,Malta,Zimbabwe,49,33,16
2015,620,Portugal,Zimbabwe,1145,1028,117
2015,688,Serbia,Zimbabwe,28,12,16
2015,705,Slovenia,Zimbabwe,12,7,5
2015,724,Spain,Zimbabwe,335,170,165
2015,40,Austria,Zimbabwe,298,146,152
2015,56,Belgium,Zimbabwe,459,214,245
2015,250,France,Zimbabwe,729,299,430
2015,528,Netherlands,Zimbabwe,1453,728,725
2015,756,Switzerland,Zimbabwe,992,454,538
2015,124,Canada,Zimbabwe,10430,5081,5349
2015,840,United States of America,Zimbabwe,55463,25134,30329
2019,232,Eritrea,Zimbabwe,327,232,95
2019,454,Malawi,Zimbabwe,37294,16233,21061
2019,508,Mozambique,Zimbabwe,97699,46019,51680
2019,800,Uganda,Zimbabwe,2,2,0
2019,834,United Republic of Tanzania,Zimbabwe,764,306,458
2019,894,Zambia,Zimbabwe,15478,6892,8586
2019,72,Botswana,Zimbabwe,64477,36998,27479
2019,426,Lesotho,Zimbabwe,72,39,33
2019,516,Namibia,Zimbabwe,14968,7606,7362
2019,710,South Africa,Zimbabwe,376668,204126,172542
2019,324,Guinea,Zimbabwe,3,3,0
2019,818,Egypt,Zimbabwe,32,26,6
2019,196,Cyprus,Zimbabwe,317,132,185
2019,764,Thailand,Zimbabwe,1,1,0
2019,44,Bahamas,Zimbabwe,15,7,8
2019,136,Cayman Islands,Zimbabwe,20,15,5
2019,188,Costa Rica,Zimbabwe,1,1,0
2019,32,Argentina,Zimbabwe,2,0,2
2019,68,Bolivia (Plurinational State of),Zimbabwe,3,2,1
2019,76,Brazil,Zimbabwe,137,79,58
2019,152,Chile,Zimbabwe,44,26,18
2019,862,Venezuela (Bolivarian Republic of),Zimbabwe,14,8,6
2019,36,Australia,Zimbabwe,45102,22654,22448
2019,554,New Zealand,Zimbabwe,8650,4183,4467
2019,100,Bulgaria,Zimbabwe,40,26,14
2019,203,Czechia,Zimbabwe,12942,7359,5583
2019,348,Hungary,Zimbabwe,56,32,24
2019,616,Poland,Zimbabwe,109,53,56
2019,643,Russian Federation,Zimbabwe,72,43,29
2019,208,Denmark,Zimbabwe,454,213,241
2019,233,Estonia,Zimbabwe,5,3,2
2019,246,Finland,Zimbabwe,139,86,53
2019,352,Iceland,Zimbabwe,13,5,8
2019,372,Ireland,Zimbabwe,3401,1551,1850
2019,428,Latvia,Zimbabwe,2,2,0
2019,578,Norway,Zimbabwe,316,165,151
2019,752,Sweden,Zimbabwe,720,370,350
2019,826,United Kingdom,Zimbabwe,183117,80666,102451
2019,300,Greece,Zimbabwe,408,173,235
2019,380,Italy,Zimbabwe,905,430,475
2019,470,Malta,Zimbabwe,79,54,25
2019,620,Portugal,Zimbabwe,1164,1046,118
2019,688,Serbia,Zimbabwe,28,12,16
2019,705,Slovenia,Zimbabwe,15,9,6
2019,724,Spain,Zimbabwe,347,172,175
2019,40,Austria,Zimbabwe,351,175,176
2019,56,Belgium,Zimbabwe,506,232,274
2019,250,France,Zimbabwe,771,315,456
2019,528,Netherlands,Zimbabwe,1537,750,787
2019,756,Switzerland,Zimbabwe,1032,485,547
2019,124,Canada,Zimbabwe,11176,5444,5732
2019,840,United States of America,Zimbabwe,59895,26791,33104
